"TEAM_ABBR","OT","Q1","Q2","Q3","SHTOUT","TOTAL_GOALS","OT_ALWD","Q1_ALWD","Q2_ALWD","Q3_ALWD","SHTOUT_ALWD","TOTAL_GOALS_ALWD","HOME_AWAY","SHOOTOUT_FLAG","GAME_DATE","GAME_ID"
"BOS",1,0,0,1,0,2,0,0,1,0,0,1,"H","N","2010-01-01","201001010BOS"
"PHI",0,0,1,0,0,1,1,0,0,1,0,2,"A","N","2010-01-01","201001010BOS"
"ATL",0,0,3,0,0,3,1,0,1,2,0,4,"A","N","2010-01-01","201001010BUF"
"BUF",1,0,1,2,0,4,0,0,3,0,0,3,"H","N","2010-01-01","201001010BUF"
"CBJ",0,1,1,0,0,2,0,0,1,2,0,3,"H","N","2010-01-02","201001020CBJ"
"COL",0,0,1,2,0,3,0,1,1,0,0,2,"A","N","2010-01-02","201001020CBJ"
"CGY",0,0,2,1,0,3,0,1,0,0,0,1,"H","N","2010-01-02","201001020CGY"
"TOR",0,1,0,0,0,1,0,0,2,1,0,3,"A","N","2010-01-02","201001020CGY"
"DAL",0,0,0,1,0,1,0,0,1,2,0,3,"H","N","2010-01-02","201001020DAL"
"VAN",0,0,1,2,0,3,0,0,0,1,0,1,"A","N","2010-01-02","201001020DAL"
"LAK",0,1,0,1,0,2,0,0,1,0,0,1,"H","N","2010-01-02","201001020LAK"
"WSH",0,0,1,0,0,1,0,1,0,1,0,2,"A","N","2010-01-02","201001020LAK"
"MIN",0,0,2,1,0,3,0,0,3,2,0,5,"H","N","2010-01-02","201001020MIN"
"NJD",0,0,3,2,0,5,0,0,2,1,0,3,"A","N","2010-01-02","201001020MIN"
"ANA",0,1,0,0,0,1,0,0,1,2,0,3,"A","N","2010-01-02","201001020NSH"
"NSH",0,0,1,2,0,3,0,1,0,0,0,1,"H","N","2010-01-02","201001020NSH"
"ATL",0,0,4,1,0,5,0,3,2,0,1,6,"A","Y","2010-01-02","201001020NYI"
"NYI",0,3,2,0,1,6,0,0,4,1,0,5,"H","Y","2010-01-02","201001020NYI"
"CAR",1,0,1,0,0,2,0,0,0,1,0,1,"A","N","2010-01-02","201001020NYR"
"NYR",0,0,0,1,0,1,1,0,1,0,0,2,"H","N","2010-01-02","201001020NYR"
"DET",0,1,1,2,0,4,0,0,1,0,0,1,"A","N","2010-01-02","201001020PHX"
"PHX",0,0,1,0,0,1,0,1,1,2,0,4,"H","N","2010-01-02","201001020PHX"
"EDM",0,0,1,0,0,1,0,2,2,0,0,4,"A","N","2010-01-02","201001020SJS"
"SJS",0,2,2,0,0,4,0,0,1,0,0,1,"H","N","2010-01-02","201001020SJS"
"CHI",0,2,2,2,0,6,0,2,0,1,0,3,"A","N","2010-01-02","201001020STL"
"STL",0,2,0,1,0,3,0,2,2,2,0,6,"H","N","2010-01-02","201001020STL"
"PIT",0,1,0,0,0,1,0,1,1,1,0,3,"A","N","2010-01-02","201001020TBL"
"TBL",0,1,1,1,0,3,0,1,0,0,0,1,"H","N","2010-01-02","201001020TBL"
"ANA",0,0,0,2,0,2,0,0,2,3,0,5,"A","N","2010-01-03","201001030CHI"
"CHI",0,0,2,3,0,5,0,0,0,2,0,2,"H","N","2010-01-03","201001030CHI"
"FLA",0,1,2,3,0,6,0,2,0,0,0,2,"H","N","2010-01-03","201001030FLA"
"PIT",0,2,0,0,0,2,0,1,2,3,0,6,"A","N","2010-01-03","201001030FLA"
"BUF",0,0,1,0,0,1,0,0,0,0,0,0,"A","N","2010-01-03","201001030MTL"
"MTL",0,0,0,0,0,0,0,0,1,0,0,1,"H","N","2010-01-03","201001030MTL"
"OTT",0,4,0,3,0,7,0,1,3,0,0,4,"H","N","2010-01-03","201001030OTT"
"PHI",0,1,3,0,0,4,0,4,0,3,0,7,"A","N","2010-01-03","201001030OTT"
"BOS",0,0,0,2,0,2,0,1,1,1,0,3,"A","N","2010-01-04","201001040NYR"
"NYR",0,1,1,1,0,3,0,0,0,2,0,2,"H","N","2010-01-04","201001040NYR"
"LAK",0,3,2,1,0,6,0,0,0,2,0,2,"A","N","2010-01-04","201001040SJS"
"SJS",0,0,0,2,0,2,0,3,2,1,0,6,"H","N","2010-01-04","201001040SJS"
"ANA",0,2,0,2,0,4,0,0,0,1,0,1,"H","N","2010-01-05","201001050ANA"
"DET",0,0,0,1,0,1,0,2,0,2,0,4,"A","N","2010-01-05","201001050ANA"
"CHI",0,1,1,2,0,4,0,1,0,0,0,1,"H","N","2010-01-05","201001050CHI"
"MIN",0,1,0,0,0,1,0,1,1,2,0,4,"A","N","2010-01-05","201001050CHI"
"EDM",0,0,2,2,0,4,1,1,3,0,0,5,"H","N","2010-01-05","201001050EDM"
"PHX",1,1,3,0,0,5,0,0,2,2,0,4,"A","N","2010-01-05","201001050EDM"
"DAL",0,0,0,0,0,0,0,1,3,0,0,4,"A","N","2010-01-05","201001050NJD"
"NJD",0,1,3,0,0,4,0,0,0,0,0,0,"H","N","2010-01-05","201001050NJD"
"CGY",0,0,2,1,0,3,0,0,0,1,0,1,"A","N","2010-01-05","201001050NSH"
"NSH",0,0,0,1,0,1,0,0,2,1,0,3,"H","N","2010-01-05","201001050NSH"
"BOS",0,4,0,0,0,4,0,0,1,0,0,1,"A","N","2010-01-05","201001050OTT"
"OTT",0,0,1,0,0,1,0,4,0,0,0,4,"H","N","2010-01-05","201001050OTT"
"ATL",0,0,2,0,0,2,0,0,3,2,0,5,"A","N","2010-01-05","201001050PIT"
"PIT",0,0,3,2,0,5,0,0,2,0,0,2,"H","N","2010-01-05","201001050PIT"
"FLA",0,2,0,0,0,2,0,1,2,0,0,3,"A","N","2010-01-05","201001050TOR"
"TOR",0,1,2,0,0,3,0,2,0,0,0,2,"H","N","2010-01-05","201001050TOR"
"CBJ",0,2,1,0,0,3,0,3,3,1,0,7,"A","N","2010-01-05","201001050VAN"
"VAN",0,3,3,1,0,7,0,2,1,0,0,3,"H","N","2010-01-05","201001050VAN"
"MTL",0,0,1,1,0,2,0,0,3,1,0,4,"A","N","2010-01-05","201001050WSH"
"WSH",0,0,3,1,0,4,0,0,1,1,0,2,"H","N","2010-01-05","201001050WSH"
"BUF",0,3,2,0,0,5,0,2,1,0,0,3,"H","N","2010-01-06","201001060BUF"
"TBL",0,2,1,0,0,3,0,3,2,0,0,5,"A","N","2010-01-06","201001060BUF"
"COL",0,1,0,1,0,2,0,1,1,1,0,3,"H","N","2010-01-06","201001060COL"
"NYI",0,1,1,1,0,3,0,1,0,1,0,2,"A","N","2010-01-06","201001060COL"
"CGY",0,1,0,0,0,1,0,1,2,1,0,4,"A","N","2010-01-06","201001060MIN"
"MIN",0,1,2,1,0,4,0,1,0,0,0,1,"H","N","2010-01-06","201001060MIN"
"DAL",0,1,1,0,0,2,0,2,1,2,0,5,"A","N","2010-01-06","201001060NYR"
"NYR",0,2,1,2,0,5,0,1,1,0,0,2,"H","N","2010-01-06","201001060NYR"
"PHI",0,2,1,3,0,6,0,0,0,2,0,2,"H","N","2010-01-06","201001060PHI"
"TOR",0,0,0,2,0,2,0,2,1,3,0,6,"A","N","2010-01-06","201001060PHI"
"SJS",1,0,0,1,0,2,0,0,1,0,0,1,"H","N","2010-01-06","201001060SJS"
"STL",0,0,1,0,0,1,1,0,0,1,0,2,"A","N","2010-01-06","201001060SJS"
"ANA",0,0,1,3,0,4,0,1,0,1,0,2,"H","N","2010-01-07","201001070ANA"
"STL",0,1,0,1,0,2,0,0,1,3,0,4,"A","N","2010-01-07","201001070ANA"
"ATL",0,0,0,1,1,2,0,0,1,0,0,1,"H","Y","2010-01-07","201001070ATL"
"NYR",0,0,1,0,0,1,0,0,0,1,1,2,"A","Y","2010-01-07","201001070ATL"
"BOS",0,2,0,0,0,2,0,2,2,1,0,5,"H","N","2010-01-07","201001070BOS"
"CHI",0,2,2,1,0,5,0,2,0,0,0,2,"A","N","2010-01-07","201001070BOS"
"CBJ",0,1,1,2,0,4,0,1,0,1,0,2,"A","N","2010-01-07","201001070EDM"
"EDM",0,1,0,1,0,2,0,1,1,2,0,4,"H","N","2010-01-07","201001070EDM"
"DET",0,1,0,1,0,2,0,0,0,1,0,1,"A","N","2010-01-07","201001070LAK"
"LAK",0,0,0,1,0,1,0,1,0,1,0,2,"H","N","2010-01-07","201001070LAK"
"FLA",0,0,0,0,0,0,0,1,0,1,0,2,"A","N","2010-01-07","201001070MTL"
"MTL",0,1,0,1,0,2,0,0,0,0,0,0,"H","N","2010-01-07","201001070MTL"
"CAR",0,1,0,1,0,2,0,2,1,1,0,4,"A","N","2010-01-07","201001070NSH"
"NSH",0,2,1,1,0,4,0,1,0,1,0,2,"H","N","2010-01-07","201001070NSH"
"PHI",0,3,2,2,0,7,0,2,1,1,0,4,"A","N","2010-01-07","201001070PIT"
"PIT",0,2,1,1,0,4,0,3,2,2,0,7,"H","N","2010-01-07","201001070PIT"
"PHX",0,0,0,0,0,0,0,1,1,2,0,4,"A","N","2010-01-07","201001070VAN"
"VAN",0,1,1,2,0,4,0,0,0,0,0,0,"H","N","2010-01-07","201001070VAN"
"OTT",0,0,1,1,0,2,0,2,0,3,0,5,"A","N","2010-01-07","201001070WSH"
"WSH",0,2,0,3,0,5,0,0,1,1,0,2,"H","N","2010-01-07","201001070WSH"
"BUF",0,2,1,0,0,3,0,0,0,2,0,2,"H","N","2010-01-08","201001080BUF"
"TOR",0,0,0,2,0,2,0,2,1,0,0,3,"A","N","2010-01-08","201001080BUF"
"CAR",0,1,1,0,0,2,0,0,0,1,0,1,"H","N","2010-01-08","201001080CAR"
"COL",0,0,0,1,0,1,0,1,1,0,0,2,"A","N","2010-01-08","201001080CAR"
"CBJ",0,1,1,1,0,3,0,1,0,1,0,2,"A","N","2010-01-08","201001080CGY"
"CGY",0,1,0,1,0,2,0,1,1,1,0,3,"H","N","2010-01-08","201001080CGY"
"DAL",0,1,3,0,0,4,0,2,1,0,0,3,"H","N","2010-01-08","201001080DAL"
"NYI",0,2,1,0,0,3,0,1,3,0,0,4,"A","N","2010-01-08","201001080DAL"
"NJD",0,0,0,2,0,2,0,1,2,1,0,4,"H","N","2010-01-08","201001080NJD"
"TBL",0,1,2,1,0,4,0,0,0,2,0,2,"A","N","2010-01-08","201001080NJD"
"ATL",0,0,1,0,0,1,0,3,1,4,0,8,"H","N","2010-01-09","201001090ATL"
"WSH",0,3,1,4,0,8,0,0,1,0,0,1,"A","N","2010-01-09","201001090ATL"
"BOS",0,0,0,1,0,1,0,1,1,1,0,3,"H","N","2010-01-09","201001090BOS"
"NYR",0,1,1,1,0,3,0,0,0,1,0,1,"A","N","2010-01-09","201001090BOS"
"BUF",0,0,1,2,0,3,0,2,1,0,1,4,"H","Y","2010-01-09","201001090BUF"
"COL",0,2,1,0,1,4,0,0,1,2,0,3,"A","Y","2010-01-09","201001090BUF"
"LAK",0,0,1,2,0,3,0,1,1,2,0,4,"H","N","2010-01-09","201001090LAK"
"STL",0,1,1,2,0,4,0,0,1,2,0,3,"A","N","2010-01-09","201001090LAK"
"CHI",0,3,2,0,0,5,0,1,0,4,1,6,"A","Y","2010-01-09","201001090MIN"
"MIN",0,1,0,4,1,6,0,3,2,0,0,5,"H","Y","2010-01-09","201001090MIN"
"MTL",0,0,1,0,0,1,1,1,0,0,0,2,"H","N","2010-01-09","201001090MTL"
"NJD",1,1,0,0,0,2,0,0,1,0,0,1,"A","N","2010-01-09","201001090MTL"
"ANA",0,1,2,0,0,3,0,0,0,2,0,2,"A","N","2010-01-09","201001090NSH"
"NSH",0,0,0,2,0,2,0,1,2,0,0,3,"H","N","2010-01-09","201001090NSH"
"FLA",0,1,2,0,0,3,0,0,0,0,0,0,"A","N","2010-01-09","201001090OTT"
"OTT",0,0,0,0,0,0,0,1,2,0,0,3,"H","N","2010-01-09","201001090OTT"
"PHI",0,1,0,3,0,4,0,0,0,1,0,1,"H","N","2010-01-09","201001090PHI"
"TBL",0,0,0,1,0,1,0,1,0,3,0,4,"A","N","2010-01-09","201001090PHI"
"NYI",0,2,2,0,1,5,0,1,0,3,0,4,"A","Y","2010-01-09","201001090PHX"
"PHX",0,1,0,3,0,4,0,2,2,0,1,5,"H","Y","2010-01-09","201001090PHX"
"DET",0,0,3,1,0,4,0,1,0,0,0,1,"A","N","2010-01-09","201001090SJS"
"SJS",0,1,0,0,0,1,0,0,3,1,0,4,"H","N","2010-01-09","201001090SJS"
"PIT",0,1,2,1,0,4,0,1,0,0,0,1,"A","N","2010-01-09","201001090TOR"
"TOR",0,1,0,0,0,1,0,1,2,1,0,4,"H","N","2010-01-09","201001090TOR"
"CGY",0,1,1,0,1,3,0,1,1,0,0,2,"A","Y","2010-01-09","201001090VAN"
"VAN",0,1,1,0,0,2,0,1,1,0,1,3,"H","Y","2010-01-09","201001090VAN"
"CAR",0,0,2,2,0,4,0,0,1,0,0,1,"H","N","2010-01-10","201001100CAR"
"OTT",0,0,1,0,0,1,0,0,2,2,0,4,"A","N","2010-01-10","201001100CAR"
"CBJ",0,1,0,1,0,2,0,0,0,0,0,0,"H","N","2010-01-10","201001100CBJ"
"DAL",0,0,0,0,0,0,0,1,0,1,0,2,"A","N","2010-01-10","201001100CBJ"
"ANA",0,2,0,1,0,3,0,0,0,1,0,1,"A","N","2010-01-10","201001100CHI"
"CHI",0,0,0,1,0,1,0,2,0,1,0,3,"H","N","2010-01-10","201001100CHI"
"CGY",0,1,1,0,0,2,0,0,2,0,1,3,"H","Y","2010-01-11","201001110CGY"
"COL",0,0,2,0,1,3,0,1,1,0,0,2,"A","Y","2010-01-11","201001110CGY"
"LAK",0,0,1,0,0,1,0,1,1,0,0,2,"H","N","2010-01-11","201001110LAK"
"SJS",0,1,1,0,0,2,0,0,1,0,0,1,"A","N","2010-01-11","201001110LAK"
"MIN",0,1,2,1,0,4,0,1,1,1,0,3,"H","N","2010-01-11","201001110MIN"
"PIT",0,1,1,1,0,3,0,1,2,1,0,4,"A","N","2010-01-11","201001110MIN"
"NSH",0,2,0,1,0,3,0,1,1,0,0,2,"A","N","2010-01-11","201001110VAN"
"VAN",0,1,1,0,0,2,0,2,0,1,0,3,"H","N","2010-01-11","201001110VAN"
"ATL",0,3,2,1,0,6,0,1,0,0,0,1,"H","N","2010-01-12","201001120ATL"
"OTT",0,1,0,0,0,1,0,3,2,1,0,6,"A","N","2010-01-12","201001120ATL"
"EDM",0,0,0,3,0,3,0,3,1,1,0,5,"H","N","2010-01-12","201001120EDM"
"NSH",0,3,1,1,0,5,0,0,0,3,0,3,"A","N","2010-01-12","201001120EDM"
"DET",0,0,0,0,0,0,0,2,2,2,0,6,"A","N","2010-01-12","201001120NYI"
"NYI",0,2,2,2,0,6,0,0,0,0,0,0,"H","N","2010-01-12","201001120NYI"
"NJD",0,0,0,0,1,1,0,0,0,0,0,0,"A","Y","2010-01-12","201001120NYR"
"NYR",0,0,0,0,0,0,0,0,0,0,1,1,"H","Y","2010-01-12","201001120NYR"
"DAL",0,0,1,2,0,3,0,1,4,1,0,6,"A","N","2010-01-12","201001120PHI"
"PHI",0,1,4,1,0,6,0,0,1,2,0,3,"H","N","2010-01-12","201001120PHI"
"PHX",0,0,0,1,0,1,0,2,1,0,0,3,"H","N","2010-01-12","201001120PHX"
"SJS",0,2,1,0,0,3,0,0,0,1,0,1,"A","N","2010-01-12","201001120PHX"
"CBJ",0,0,1,0,0,1,0,3,0,1,0,4,"A","N","2010-01-12","201001120STL"
"STL",0,3,0,1,0,4,0,0,1,0,0,1,"H","N","2010-01-12","201001120STL"
"TBL",0,4,1,2,0,7,0,1,3,0,0,4,"H","N","2010-01-12","201001120TBL"
"WSH",0,1,3,0,0,4,0,4,1,2,0,7,"A","N","2010-01-12","201001120TBL"
"CAR",0,1,1,2,0,4,0,1,1,0,0,2,"A","N","2010-01-12","201001120TOR"
"TOR",0,1,1,0,0,2,0,1,1,2,0,4,"H","N","2010-01-12","201001120TOR"
"ANA",0,1,1,2,0,4,0,0,3,0,0,3,"H","N","2010-01-13","201001130ANA"
"BOS",0,0,3,0,0,3,0,1,1,2,0,4,"A","N","2010-01-13","201001130ANA"
"CGY",0,0,1,0,0,1,0,1,1,1,0,3,"H","N","2010-01-13","201001130CGY"
"PIT",0,1,1,1,0,3,0,0,1,0,0,1,"A","N","2010-01-13","201001130CGY"
"FLA",0,2,2,0,0,4,0,0,2,2,1,5,"H","Y","2010-01-13","201001130FLA"
"WSH",0,0,2,2,1,5,0,2,2,0,0,4,"A","Y","2010-01-13","201001130FLA"
"MIN",0,2,0,3,0,5,0,1,1,0,0,2,"H","N","2010-01-13","201001130MIN"
"VAN",0,1,1,0,0,2,0,2,0,3,0,5,"A","N","2010-01-13","201001130MIN"
"ATL",0,0,1,0,0,1,1,0,1,0,0,2,"H","N","2010-01-14","201001140ATL"
"BUF",1,0,1,0,0,2,0,0,1,0,0,1,"A","N","2010-01-14","201001140ATL"
"CBJ",0,0,0,0,0,0,0,1,1,1,0,3,"A","N","2010-01-14","201001140CHI"
"CHI",0,1,1,1,0,3,0,0,0,0,0,0,"H","N","2010-01-14","201001140CHI"
"CAR",0,0,0,1,0,1,0,1,1,1,0,3,"A","N","2010-01-14","201001140DET"
"DET",0,1,1,1,0,3,0,0,0,1,0,1,"H","N","2010-01-14","201001140DET"
"EDM",0,0,2,0,0,2,0,0,0,3,0,3,"H","N","2010-01-14","201001140EDM"
"PIT",0,0,0,3,0,3,0,0,2,0,0,2,"A","N","2010-01-14","201001140EDM"
"ANA",0,0,0,0,0,0,0,1,3,0,0,4,"A","N","2010-01-14","201001140LAK"
"LAK",0,1,3,0,0,4,0,0,0,0,0,0,"H","N","2010-01-14","201001140LAK"
"DAL",0,2,1,0,0,3,0,1,2,2,0,5,"A","N","2010-01-14","201001140MTL"
"MTL",0,1,2,2,0,5,0,2,1,0,0,3,"H","N","2010-01-14","201001140MTL"
"NYR",0,0,0,0,0,0,0,0,0,2,0,2,"H","N","2010-01-14","201001140NYR"
"OTT",0,0,0,2,0,2,0,0,0,0,0,0,"A","N","2010-01-14","201001140NYR"
"NJD",0,0,2,1,0,3,0,2,0,2,0,4,"A","N","2010-01-14","201001140PHX"
"PHX",0,2,0,2,0,4,0,0,2,1,0,3,"H","N","2010-01-14","201001140PHX"
"BOS",0,0,1,0,1,2,0,0,1,0,0,1,"A","Y","2010-01-14","201001140SJS"
"SJS",0,0,1,0,0,1,0,0,1,0,1,2,"H","Y","2010-01-14","201001140SJS"
"MIN",0,0,0,0,0,0,0,0,0,1,0,1,"A","N","2010-01-14","201001140STL"
"STL",0,0,0,1,0,1,0,0,0,0,0,0,"H","N","2010-01-14","201001140STL"
"FLA",0,1,0,2,0,3,0,2,0,0,0,2,"A","N","2010-01-14","201001140TBL"
"TBL",0,2,0,0,0,2,0,1,0,2,0,3,"H","N","2010-01-14","201001140TBL"
"PHI",0,0,0,0,0,0,0,0,2,2,0,4,"A","N","2010-01-14","201001140TOR"
"TOR",0,0,2,2,0,4,0,0,0,0,0,0,"H","N","2010-01-14","201001140TOR"
"CGY",0,0,0,0,0,0,0,0,0,1,0,1,"H","N","2010-01-15","201001150CGY"
"NSH",0,0,0,1,0,1,0,0,0,0,0,0,"A","N","2010-01-15","201001150CGY"
"TOR",0,0,1,0,0,1,0,2,2,2,0,6,"A","N","2010-01-15","201001150WSH"
"WSH",0,2,2,2,0,6,0,0,1,0,0,1,"H","N","2010-01-15","201001150WSH"
"ATL",0,1,2,2,0,5,0,1,0,2,0,3,"A","N","2010-01-16","201001160CAR"
"CAR",0,1,0,2,0,3,0,1,2,2,0,5,"H","N","2010-01-16","201001160CAR"
"CBJ",0,2,2,1,0,5,0,3,0,3,0,6,"H","N","2010-01-16","201001160CBJ"
"CHI",0,3,0,3,0,6,0,2,2,1,0,5,"A","N","2010-01-16","201001160CBJ"
"COL",0,2,0,1,0,3,0,0,0,1,0,1,"H","N","2010-01-16","201001160COL"
"NJD",0,0,0,1,0,1,0,2,0,1,0,3,"A","N","2010-01-16","201001160COL"
"DAL",0,0,1,1,1,3,0,2,0,0,0,2,"H","Y","2010-01-16","201001160DAL"
"DET",0,2,0,0,0,2,0,0,1,1,1,3,"A","Y","2010-01-16","201001160DAL"
"FLA",0,3,2,0,0,5,0,2,0,0,0,2,"H","N","2010-01-16","201001160FLA"
"TBL",0,2,0,0,0,2,0,3,2,0,0,5,"A","N","2010-01-16","201001160FLA"
"BOS",0,1,2,0,0,3,0,1,0,2,1,4,"A","Y","2010-01-16","201001160LAK"
"LAK",0,1,0,2,1,4,0,1,2,0,0,3,"H","Y","2010-01-16","201001160LAK"
"MTL",0,1,1,0,0,2,0,1,2,1,0,4,"H","N","2010-01-16","201001160MTL"
"OTT",0,1,2,1,0,4,0,1,1,0,0,2,"A","N","2010-01-16","201001160MTL"
"BUF",0,0,1,1,0,2,0,1,1,0,1,3,"A","Y","2010-01-16","201001160NYI"
"NYI",0,1,1,0,1,3,0,0,1,1,0,2,"H","Y","2010-01-16","201001160NYI"
"MIN",0,0,1,3,0,4,0,2,0,4,0,6,"A","N","2010-01-16","201001160PHX"
"PHX",0,2,0,4,0,6,0,0,1,3,0,4,"H","N","2010-01-16","201001160PHX"
"EDM",0,1,0,1,0,2,0,2,2,0,0,4,"A","N","2010-01-16","201001160SJS"
"SJS",0,2,2,0,0,4,0,1,0,1,0,2,"H","N","2010-01-16","201001160SJS"
"NYR",0,0,1,0,0,1,0,1,0,3,0,4,"A","N","2010-01-16","201001160STL"
"STL",0,1,0,3,0,4,0,0,1,0,0,1,"H","N","2010-01-16","201001160STL"
"PIT",0,1,1,0,0,2,0,2,4,0,0,6,"A","N","2010-01-16","201001160VAN"
"VAN",0,2,4,0,0,6,0,1,1,0,0,2,"H","N","2010-01-16","201001160VAN"
"ANA",0,3,0,2,0,5,0,2,2,0,0,4,"H","N","2010-01-17","201001170ANA"
"CGY",0,2,2,0,0,4,0,3,0,2,0,5,"A","N","2010-01-17","201001170ANA"
"CHI",0,2,1,0,1,4,0,1,1,1,0,3,"A","Y","2010-01-17","201001170DET"
"DET",0,1,1,1,0,3,0,2,1,0,1,4,"H","Y","2010-01-17","201001170DET"
"MTL",0,2,0,0,0,2,0,0,3,3,0,6,"A","N","2010-01-17","201001170NYR"
"NYR",0,0,3,3,0,6,0,2,0,0,0,2,"H","N","2010-01-17","201001170NYR"
"PHI",0,2,0,1,0,3,0,2,1,2,0,5,"A","N","2010-01-17","201001170WSH"
"WSH",0,2,1,2,0,5,0,2,0,1,0,3,"H","N","2010-01-17","201001170WSH"
"BOS",0,0,0,1,0,1,0,2,2,1,0,5,"H","N","2010-01-18","201001180BOS"
"OTT",0,2,2,1,0,5,0,0,0,1,0,1,"A","N","2010-01-18","201001180BOS"
"CAR",0,0,1,1,0,2,0,1,1,1,0,3,"H","N","2010-01-18","201001180CAR"
"TBL",0,1,1,1,0,3,0,0,1,1,0,2,"A","N","2010-01-18","201001180CAR"
"CBJ",0,2,1,1,0,4,0,1,1,0,0,2,"H","N","2010-01-18","201001180CBJ"
"STL",0,1,1,0,0,2,0,2,1,1,0,4,"A","N","2010-01-18","201001180CBJ"
"COL",0,2,2,2,0,6,0,0,0,0,0,0,"H","N","2010-01-18","201001180COL"
"EDM",0,0,0,0,0,0,0,2,2,2,0,6,"A","N","2010-01-18","201001180COL"
"DAL",0,1,3,0,0,4,0,0,1,2,0,3,"H","N","2010-01-18","201001180DAL"
"MIN",0,0,1,2,0,3,0,1,3,0,0,4,"A","N","2010-01-18","201001180DAL"
"ATL",0,0,0,0,0,0,0,0,1,0,0,1,"A","N","2010-01-18","201001180FLA"
"FLA",0,0,1,0,0,1,0,0,0,0,0,0,"H","N","2010-01-18","201001180FLA"
"NSH",0,0,1,2,0,3,0,3,0,1,0,4,"H","N","2010-01-18","201001180NSH"
"TOR",0,3,0,1,0,4,0,0,1,2,0,3,"A","N","2010-01-18","201001180NSH"
"NJD",0,0,0,0,0,0,0,2,2,0,0,4,"A","N","2010-01-18","201001180NYI"
"NYI",0,2,2,0,0,4,0,0,0,0,0,0,"H","N","2010-01-18","201001180NYI"
"BUF",0,1,4,2,0,7,0,0,1,1,0,2,"A","N","2010-01-18","201001180PHX"
"PHX",0,0,1,1,0,2,0,1,4,2,0,7,"H","N","2010-01-18","201001180PHX"
"CGY",0,0,0,1,0,1,0,3,3,3,0,9,"A","N","2010-01-18","201001180SJS"
"SJS",0,3,3,3,0,9,0,0,0,1,0,1,"H","N","2010-01-18","201001180SJS"
"ANA",0,4,0,1,0,5,0,0,3,1,0,4,"H","N","2010-01-19","201001190ANA"
"BUF",0,0,3,1,0,4,0,4,0,1,0,5,"A","N","2010-01-19","201001190ANA"
"ATL",0,0,2,2,0,4,0,2,0,1,0,3,"H","N","2010-01-19","201001190ATL"
"TOR",0,2,0,1,0,3,0,0,2,2,0,4,"A","N","2010-01-19","201001190ATL"
"LAK",0,0,1,0,0,1,0,3,1,1,0,5,"H","N","2010-01-19","201001190LAK"
"SJS",0,3,1,1,0,5,0,0,1,0,0,1,"A","N","2010-01-19","201001190LAK"
"NYR",0,3,2,3,0,8,0,1,1,0,0,2,"H","N","2010-01-19","201001190NYR"
"TBL",0,1,1,0,0,2,0,3,2,3,0,8,"A","N","2010-01-19","201001190NYR"
"CHI",0,0,1,0,0,1,0,2,1,1,0,4,"A","N","2010-01-19","201001190OTT"
"OTT",0,2,1,1,0,4,0,0,1,0,0,1,"H","N","2010-01-19","201001190OTT"
"CBJ",0,0,2,1,0,3,0,1,3,1,0,5,"A","N","2010-01-19","201001190PHI"
"PHI",0,1,3,1,0,5,0,0,2,1,0,3,"H","N","2010-01-19","201001190PHI"
"NYI",0,0,2,2,0,4,0,1,3,2,0,6,"A","N","2010-01-19","201001190PIT"
"PIT",0,1,3,2,0,6,0,0,2,2,0,4,"H","N","2010-01-19","201001190PIT"
"DET",0,0,1,1,0,2,0,0,1,2,0,3,"A","N","2010-01-19","201001190WSH"
"WSH",0,0,1,2,0,3,0,0,1,1,0,2,"H","N","2010-01-19","201001190WSH"
"EDM",0,1,1,0,0,2,1,1,0,1,0,3,"H","N","2010-01-20","201001200EDM"
"VAN",1,1,0,1,0,3,0,1,1,0,0,2,"A","N","2010-01-20","201001200EDM"
"MTL",0,1,0,2,0,3,1,3,0,0,0,4,"H","N","2010-01-20","201001200MTL"
"STL",1,3,0,0,0,4,0,1,0,2,0,3,"A","N","2010-01-20","201001200MTL"
"FLA",0,0,0,0,0,0,0,0,1,1,0,2,"A","N","2010-01-20","201001200NJD"
"NJD",0,0,1,1,0,2,0,0,0,0,0,0,"H","N","2010-01-20","201001200NJD"
"ATL",0,0,1,1,0,2,0,2,2,1,0,5,"H","N","2010-01-21","201001210ATL"
"CAR",0,2,2,1,0,5,0,0,1,1,0,2,"A","N","2010-01-21","201001210ATL"
"BOS",0,1,1,0,0,2,0,1,0,2,0,3,"H","N","2010-01-21","201001210BOS"
"CBJ",0,1,0,2,0,3,0,1,1,0,0,2,"A","N","2010-01-21","201001210BOS"
"CGY",0,0,1,0,0,1,0,0,1,2,0,3,"H","N","2010-01-21","201001210CGY"
"CHI",0,0,1,2,0,3,0,0,1,0,0,1,"A","N","2010-01-21","201001210CGY"
"BUF",0,0,2,1,0,3,0,1,1,1,1,4,"A","Y","2010-01-21","201001210LAK"
"LAK",0,1,1,1,1,4,0,0,2,1,0,3,"H","Y","2010-01-21","201001210LAK"
"DET",0,1,0,2,1,4,0,0,1,2,0,3,"A","Y","2010-01-21","201001210MIN"
"MIN",0,0,1,2,0,3,0,1,0,2,1,4,"H","Y","2010-01-21","201001210MIN"
"FLA",0,0,1,0,0,1,0,0,1,0,1,2,"A","Y","2010-01-21","201001210NYI"
"NYI",0,0,1,0,1,2,0,0,1,0,0,1,"H","Y","2010-01-21","201001210NYI"
"OTT",0,1,1,1,0,3,0,0,1,1,0,2,"H","N","2010-01-21","201001210OTT"
"STL",0,0,1,1,0,2,0,1,1,1,0,3,"A","N","2010-01-21","201001210OTT"
"NYR",0,0,0,0,0,0,0,1,1,0,0,2,"A","N","2010-01-21","201001210PHI"
"PHI",0,1,1,0,0,2,0,0,0,0,0,0,"H","N","2010-01-21","201001210PHI"
"NSH",0,0,2,0,0,2,0,0,1,3,0,4,"A","N","2010-01-21","201001210PHX"
"PHX",0,0,1,3,0,4,0,0,2,0,0,2,"H","N","2010-01-21","201001210PHX"
"PIT",0,1,2,0,0,3,0,1,2,3,0,6,"H","N","2010-01-21","201001210PIT"
"WSH",0,1,2,3,0,6,0,1,2,0,0,3,"A","N","2010-01-21","201001210PIT"
"ANA",0,0,0,1,0,1,0,0,2,1,0,3,"A","N","2010-01-21","201001210SJS"
"SJS",0,0,2,1,0,3,0,0,0,1,0,1,"H","N","2010-01-21","201001210SJS"
"TBL",1,0,1,1,0,3,0,0,1,1,0,2,"H","N","2010-01-21","201001210TBL"
"TOR",0,0,1,1,0,2,1,0,1,1,0,3,"A","N","2010-01-21","201001210TBL"
"DAL",0,1,1,1,0,3,0,1,1,2,0,4,"A","N","2010-01-21","201001210VAN"
"VAN",0,1,1,2,0,4,0,1,1,1,0,3,"H","N","2010-01-21","201001210VAN"
"COL",0,1,1,0,0,2,0,0,1,0,0,1,"H","N","2010-01-22","201001220COL"
"NSH",0,0,1,0,0,1,0,1,1,0,0,2,"A","N","2010-01-22","201001220COL"
"DAL",0,2,1,1,0,4,0,1,1,1,0,3,"A","N","2010-01-22","201001220EDM"
"EDM",0,1,1,1,0,3,0,2,1,1,0,4,"H","N","2010-01-22","201001220EDM"
"MTL",0,1,1,1,0,3,0,1,0,0,0,1,"A","N","2010-01-22","201001220NJD"
"NJD",0,1,0,0,0,1,0,1,1,1,0,3,"H","N","2010-01-22","201001220NJD"
"BOS",0,0,1,0,0,1,0,1,1,0,0,2,"H","N","2010-01-23","201001230BOS"
"OTT",0,1,1,0,0,2,0,0,1,0,0,1,"A","N","2010-01-23","201001230BOS"
"DET",0,2,0,0,0,2,0,0,1,2,0,3,"H","N","2010-01-23","201001230DET"
"LAK",0,0,1,2,0,3,0,2,0,0,0,2,"A","N","2010-01-23","201001230DET"
"FLA",0,0,1,1,0,2,0,0,0,0,0,0,"H","N","2010-01-23","201001230FLA"
"TOR",0,0,0,0,0,0,0,0,1,1,0,2,"A","N","2010-01-23","201001230FLA"
"CBJ",0,0,0,2,0,2,0,1,2,1,0,4,"A","N","2010-01-23","201001230MIN"
"MIN",0,1,2,1,0,4,0,0,0,2,0,2,"H","N","2010-01-23","201001230MIN"
"MTL",0,1,4,1,0,6,0,0,0,0,0,0,"H","N","2010-01-23","201001230MTL"
"NYR",0,0,0,0,0,0,0,1,4,1,0,6,"A","N","2010-01-23","201001230MTL"
"NJD",0,1,1,2,0,4,0,0,2,0,0,2,"A","N","2010-01-23","201001230NYI"
"NYI",0,0,2,0,0,2,0,1,1,2,0,4,"H","N","2010-01-23","201001230NYI"
"CAR",0,1,0,1,0,2,0,1,2,1,0,4,"A","N","2010-01-23","201001230PHI"
"PHI",0,1,2,1,0,4,0,1,0,1,0,2,"H","N","2010-01-23","201001230PHI"
"BUF",0,1,0,1,0,2,0,0,2,3,0,5,"A","N","2010-01-23","201001230SJS"
"SJS",0,0,2,3,0,5,0,1,0,1,0,2,"H","N","2010-01-23","201001230SJS"
"ANA",0,0,0,3,1,4,0,0,2,1,0,3,"A","Y","2010-01-23","201001230STL"
"STL",0,0,2,1,0,3,0,0,0,3,1,4,"H","Y","2010-01-23","201001230STL"
"ATL",0,1,0,0,0,1,0,1,0,0,1,2,"A","Y","2010-01-23","201001230TBL"
"TBL",0,1,0,0,1,2,0,1,0,0,0,1,"H","Y","2010-01-23","201001230TBL"
"CHI",0,0,0,1,0,1,0,3,0,2,0,5,"A","N","2010-01-23","201001230VAN"
"VAN",0,3,0,2,0,5,0,0,0,1,0,1,"H","N","2010-01-23","201001230VAN"
"PHX",0,1,0,1,0,2,0,1,2,1,0,4,"A","N","2010-01-23","201001230WSH"
"WSH",0,1,2,1,0,4,0,1,0,1,0,2,"H","N","2010-01-23","201001230WSH"
"BOS",0,0,0,1,0,1,0,1,3,1,0,5,"A","N","2010-01-24","201001240CAR"
"CAR",0,1,3,1,0,5,0,0,0,1,0,1,"H","N","2010-01-24","201001240CAR"
"COL",0,2,1,1,0,4,0,0,0,0,0,0,"H","N","2010-01-24","201001240COL"
"DAL",0,0,0,0,0,0,0,2,1,1,0,4,"A","N","2010-01-24","201001240COL"
"PHI",0,1,0,0,0,1,0,1,0,1,0,2,"H","N","2010-01-24","201001240PHI"
"PIT",0,1,0,1,0,2,0,1,0,0,0,1,"A","N","2010-01-24","201001240PHI"
"CGY",0,0,0,0,0,0,0,0,1,1,0,2,"H","N","2010-01-25","201001250CGY"
"STL",0,0,1,1,0,2,0,0,0,0,0,0,"A","N","2010-01-25","201001250CGY"
"NYR",0,0,1,1,0,2,0,1,0,3,0,4,"H","N","2010-01-25","201001250NYR"
"PIT",0,1,0,3,0,4,0,0,1,1,0,2,"A","N","2010-01-25","201001250NYR"
"BUF",0,0,1,1,0,2,0,0,2,1,0,3,"A","N","2010-01-25","201001250VAN"
"VAN",0,0,2,1,0,3,0,0,1,1,0,2,"H","N","2010-01-25","201001250VAN"
"ANA",0,0,1,0,0,1,0,0,1,1,0,2,"A","N","2010-01-26","201001260ATL"
"ATL",0,0,1,1,0,2,0,0,1,0,0,1,"H","N","2010-01-26","201001260ATL"
"CBJ",0,0,1,2,0,3,0,0,0,2,0,2,"H","N","2010-01-26","201001260CBJ"
"NSH",0,0,0,2,0,2,0,0,1,2,0,3,"A","N","2010-01-26","201001260CBJ"
"DET",0,1,1,2,0,4,1,0,2,2,0,5,"H","N","2010-01-26","201001260DET"
"PHX",1,0,2,2,0,5,0,1,1,2,0,4,"A","N","2010-01-26","201001260DET"
"CHI",0,1,3,0,0,4,0,0,1,1,0,2,"A","N","2010-01-26","201001260EDM"
"EDM",0,0,1,1,0,2,0,1,3,0,0,4,"H","N","2010-01-26","201001260EDM"
"FLA",0,0,0,2,0,2,0,0,1,0,0,1,"H","N","2010-01-26","201001260FLA"
"MTL",0,0,1,0,0,1,0,0,0,2,0,2,"A","N","2010-01-26","201001260FLA"
"NYI",0,1,1,0,0,2,0,4,2,1,0,7,"H","N","2010-01-26","201001260NYI"
"WSH",0,4,2,1,0,7,0,1,1,0,0,2,"A","N","2010-01-26","201001260NYI"
"NJD",0,0,0,0,0,0,0,2,1,0,0,3,"A","N","2010-01-26","201001260OTT"
"OTT",0,2,1,0,0,3,0,0,0,0,0,0,"H","N","2010-01-26","201001260OTT"
"LAK",0,1,3,1,0,5,0,1,1,1,0,3,"A","N","2010-01-26","201001260TOR"
"TOR",0,1,1,1,0,3,0,1,3,1,0,5,"H","N","2010-01-26","201001260TOR"
"BUF",0,1,0,0,1,2,0,0,1,0,0,1,"H","Y","2010-01-27","201001270BUF"
"NJD",0,0,1,0,0,1,0,1,0,0,1,2,"A","Y","2010-01-27","201001270BUF"
"CGY",0,2,1,0,0,3,0,1,1,1,1,4,"A","Y","2010-01-27","201001270DAL"
"DAL",0,1,1,1,1,4,0,2,1,0,0,3,"H","Y","2010-01-27","201001270DAL"
"DET",0,2,0,0,0,2,0,3,0,2,0,5,"A","N","2010-01-27","201001270MIN"
"MIN",0,3,0,2,0,5,0,2,0,0,0,2,"H","N","2010-01-27","201001270MIN"
"CAR",0,2,1,2,0,5,0,0,1,0,0,1,"A","N","2010-01-27","201001270NYR"
"NYR",0,0,1,0,0,1,0,2,1,2,0,5,"H","N","2010-01-27","201001270NYR"
"MTL",0,0,0,0,0,0,0,1,2,0,0,3,"A","N","2010-01-27","201001270TBL"
"TBL",0,1,2,0,0,3,0,0,0,0,0,0,"H","N","2010-01-27","201001270TBL"
"STL",0,1,0,1,0,2,0,1,0,2,0,3,"A","N","2010-01-27","201001270VAN"
"VAN",0,1,0,2,0,3,0,1,0,1,0,2,"H","N","2010-01-27","201001270VAN"
"ANA",0,0,1,0,0,1,0,1,0,4,0,5,"A","N","2010-01-27","201001270WSH"
"WSH",0,1,0,4,0,5,0,0,1,0,0,1,"H","N","2010-01-27","201001270WSH"
"CAR",0,2,0,2,0,4,0,0,0,1,0,1,"H","N","2010-01-28","201001280CAR"
"NYI",0,0,0,1,0,1,0,2,0,2,0,4,"A","N","2010-01-28","201001280CAR"
"CBJ",0,0,0,1,0,1,0,1,1,2,0,4,"H","N","2010-01-28","201001280CBJ"
"LAK",0,1,1,2,0,4,0,0,0,1,0,1,"A","N","2010-01-28","201001280CBJ"
"COL",0,0,0,0,0,0,0,0,0,1,0,1,"H","N","2010-01-28","201001280COL"
"MIN",0,0,0,1,0,1,0,0,0,0,0,0,"A","N","2010-01-28","201001280COL"
"EDM",0,0,1,0,0,1,0,0,1,1,0,2,"H","N","2010-01-28","201001280EDM"
"STL",0,0,1,1,0,2,0,0,1,0,0,1,"A","N","2010-01-28","201001280EDM"
"ATL",0,1,0,3,0,4,0,0,3,0,0,3,"A","N","2010-01-28","201001280PHI"
"PHI",0,0,3,0,0,3,0,1,0,3,0,4,"H","N","2010-01-28","201001280PHI"
"CGY",0,0,1,1,0,2,0,0,2,0,1,3,"A","Y","2010-01-28","201001280PHX"
"PHX",0,0,2,0,1,3,0,0,1,1,0,2,"H","Y","2010-01-28","201001280PHX"
"OTT",0,2,0,2,0,4,0,1,0,0,0,1,"A","N","2010-01-28","201001280PIT"
"PIT",0,1,0,0,0,1,0,2,0,2,0,4,"H","N","2010-01-28","201001280PIT"
"CHI",1,3,0,0,0,4,0,1,1,1,0,3,"A","N","2010-01-28","201001280SJS"
"SJS",0,1,1,1,0,3,1,3,0,0,0,4,"H","N","2010-01-28","201001280SJS"
"BOS",0,0,1,0,0,1,0,2,0,0,0,2,"A","N","2010-01-29","201001290BUF"
"BUF",0,2,0,0,0,2,0,0,1,0,0,1,"H","N","2010-01-29","201001290BUF"
"COL",0,1,1,0,0,2,0,2,0,1,0,3,"A","N","2010-01-29","201001290DAL"
"DAL",0,2,0,1,0,3,0,1,1,0,0,2,"H","N","2010-01-29","201001290DAL"
"DET",0,1,2,1,0,4,0,1,0,1,0,2,"H","N","2010-01-29","201001290DET"
"NSH",0,1,0,1,0,2,0,1,2,1,0,4,"A","N","2010-01-29","201001290DET"
"NJD",1,2,2,0,0,5,0,1,1,2,0,4,"H","N","2010-01-29","201001290NJD"
"TOR",0,1,1,2,0,4,1,2,2,0,0,5,"A","N","2010-01-29","201001290NJD"
"ANA",0,0,1,0,1,2,0,1,0,0,0,1,"A","Y","2010-01-29","201001290TBL"
"TBL",0,1,0,0,0,1,0,0,1,0,1,2,"H","Y","2010-01-29","201001290TBL"
"FLA",0,0,1,0,0,1,0,1,1,2,0,4,"A","N","2010-01-29","201001290WSH"
"WSH",0,1,1,2,0,4,0,0,1,0,0,1,"H","N","2010-01-29","201001290WSH"
"BOS",0,0,1,1,0,2,0,1,0,1,1,3,"H","Y","2010-01-30","201001300BOS"
"LAK",0,1,0,1,1,3,0,0,1,1,0,2,"A","Y","2010-01-30","201001300BOS"
"CAR",0,1,1,2,0,4,0,0,1,1,0,2,"H","N","2010-01-30","201001300CAR"
"CHI",0,0,1,1,0,2,0,1,1,2,0,4,"A","N","2010-01-30","201001300CAR"
"CGY",0,2,3,1,0,6,0,1,0,0,0,1,"H","N","2010-01-30","201001300CGY"
"EDM",0,1,0,0,0,1,0,2,3,1,0,6,"A","N","2010-01-30","201001300CGY"
"ATL",0,1,2,0,0,3,0,2,1,1,0,4,"A","N","2010-01-30","201001300NSH"
"NSH",0,2,1,1,0,4,0,1,2,0,0,3,"H","N","2010-01-30","201001300NSH"
"MTL",0,0,1,1,0,2,1,1,1,0,0,3,"A","N","2010-01-30","201001300OTT"
"OTT",1,1,1,0,0,3,0,0,1,1,0,2,"H","N","2010-01-30","201001300OTT"
"NYI",0,0,1,0,0,1,0,2,0,0,0,2,"A","N","2010-01-30","201001300PHI"
"PHI",0,2,0,0,0,2,0,0,1,0,0,1,"H","N","2010-01-30","201001300PHI"
"NYR",0,0,0,2,0,2,0,3,0,0,0,3,"A","N","2010-01-30","201001300PHX"
"PHX",0,3,0,0,0,3,0,0,0,2,0,2,"H","N","2010-01-30","201001300PHX"
"MIN",0,2,0,0,0,2,0,1,2,2,0,5,"A","N","2010-01-30","201001300SJS"
"SJS",0,1,2,2,0,5,0,2,0,0,0,2,"H","N","2010-01-30","201001300SJS"
"CBJ",1,1,1,0,0,3,0,1,0,1,0,2,"A","N","2010-01-30","201001300STL"
"STL",0,1,0,1,0,2,1,1,1,0,0,3,"H","N","2010-01-30","201001300STL"
"TOR",0,3,0,0,0,3,0,0,1,4,0,5,"H","N","2010-01-30","201001300TOR"
"VAN",0,0,1,4,0,5,0,3,0,0,0,3,"A","N","2010-01-30","201001300TOR"
"COL",0,0,0,1,0,1,0,1,1,1,0,3,"H","N","2010-01-31","201001310COL"
"NYR",0,1,1,1,0,3,0,0,0,1,0,1,"A","N","2010-01-31","201001310COL"
"DAL",0,0,1,1,0,2,0,1,1,2,0,4,"H","N","2010-01-31","201001310DAL"
"PHX",0,1,1,2,0,4,0,0,1,1,0,2,"A","N","2010-01-31","201001310DAL"
"FLA",0,1,1,0,0,2,0,0,0,0,0,0,"H","N","2010-01-31","201001310FLA"
"NYI",0,0,0,0,0,0,0,1,1,0,0,2,"A","N","2010-01-31","201001310FLA"
"LAK",0,0,1,2,0,3,0,1,1,0,0,2,"A","N","2010-01-31","201001310NJD"
"NJD",0,1,1,0,0,2,0,0,1,2,0,3,"H","N","2010-01-31","201001310NJD"
"DET",0,0,0,1,0,1,0,0,1,0,1,2,"A","Y","2010-01-31","201001310PIT"
"PIT",0,0,1,0,1,2,0,0,0,1,0,1,"H","Y","2010-01-31","201001310PIT"
"TBL",0,0,0,2,0,2,0,0,2,1,0,3,"A","N","2010-01-31","201001310WSH"
"WSH",0,0,2,1,0,3,0,0,0,2,0,2,"H","N","2010-01-31","201001310WSH"
"CGY",0,0,0,0,0,0,0,0,1,2,0,3,"H","N","2010-02-01","201002010CGY"
"PHI",0,0,1,2,0,3,0,0,0,0,0,0,"A","N","2010-02-01","201002010CGY"
"CAR",0,1,1,0,0,2,0,2,2,0,0,4,"A","N","2010-02-01","201002010EDM"
"EDM",0,2,2,0,0,4,0,1,1,0,0,2,"H","N","2010-02-01","201002010EDM"
"ANA",0,0,2,1,0,3,0,0,0,0,0,0,"A","N","2010-02-01","201002010FLA"
"FLA",0,0,0,0,0,0,0,0,2,1,0,3,"H","N","2010-02-01","201002010FLA"
"BUF",0,2,1,1,0,4,0,1,4,0,0,5,"A","N","2010-02-01","201002010PIT"
"PIT",0,1,4,0,0,5,0,2,1,1,0,4,"H","N","2010-02-01","201002010PIT"
"ATL",0,0,1,0,0,1,0,2,0,0,0,2,"H","N","2010-02-02","201002020ATL"
"TBL",0,2,0,0,0,2,0,0,1,0,0,1,"A","N","2010-02-02","201002020ATL"
"BOS",0,1,0,0,0,1,0,0,1,3,0,4,"H","N","2010-02-02","201002020BOS"
"WSH",0,0,1,3,0,4,0,1,0,0,0,1,"A","N","2010-02-02","201002020BOS"
"CBJ",0,1,0,0,0,1,0,1,1,3,0,5,"A","N","2010-02-02","201002020COL"
"COL",0,1,1,3,0,5,0,1,0,0,0,1,"H","N","2010-02-02","201002020COL"
"DAL",0,1,2,1,0,4,0,0,1,1,0,2,"H","N","2010-02-02","201002020DAL"
"MIN",0,0,1,1,0,2,0,1,2,1,0,4,"A","N","2010-02-02","201002020DAL"
"LAK",0,0,1,1,0,2,0,0,0,1,0,1,"H","N","2010-02-02","201002020LAK"
"NYR",0,0,0,1,0,1,0,0,1,1,0,2,"A","N","2010-02-02","201002020LAK"
"MTL",0,2,0,1,0,3,0,1,0,1,0,2,"H","N","2010-02-02","201002020MTL"
"VAN",0,1,0,1,0,2,0,2,0,1,0,3,"A","N","2010-02-02","201002020MTL"
"NSH",0,0,0,0,0,0,0,0,0,0,1,1,"H","Y","2010-02-02","201002020NSH"
"PHX",0,0,0,0,1,1,0,0,0,0,0,0,"A","Y","2010-02-02","201002020NSH"
"DET",0,2,0,2,0,4,0,2,0,0,0,2,"A","N","2010-02-02","201002020SJS"
"SJS",0,2,0,0,0,2,0,2,0,2,0,4,"H","N","2010-02-02","201002020SJS"
"NJD",0,0,0,0,0,0,0,1,2,0,0,3,"A","N","2010-02-02","201002020TOR"
"TOR",0,1,2,0,0,3,0,0,0,0,0,0,"H","N","2010-02-02","201002020TOR"
"ANA",0,2,1,0,0,3,0,0,1,0,0,1,"H","N","2010-02-03","201002030ANA"
"DET",0,0,1,0,0,1,0,2,1,0,0,3,"A","N","2010-02-03","201002030ANA"
"BUF",0,0,0,2,0,2,0,0,1,3,0,4,"H","N","2010-02-03","201002030BUF"
"OTT",0,0,1,3,0,4,0,0,0,2,0,2,"A","N","2010-02-03","201002030BUF"
"CAR",0,0,1,0,0,1,0,1,2,1,0,4,"A","N","2010-02-03","201002030CGY"
"CGY",0,1,2,1,0,4,0,0,1,0,0,1,"H","N","2010-02-03","201002030CGY"
"CHI",0,1,0,1,0,2,0,0,3,0,0,3,"H","N","2010-02-03","201002030CHI"
"STL",0,0,3,0,0,3,0,1,0,1,0,2,"A","N","2010-02-03","201002030CHI"
"EDM",0,0,0,1,0,1,0,0,0,0,0,0,"H","N","2010-02-03","201002030EDM"
"PHI",0,0,0,0,0,0,0,0,0,1,0,1,"A","N","2010-02-03","201002030EDM"
"BOS",0,1,1,0,0,2,0,0,2,0,1,3,"H","Y","2010-02-04","201002040BOS"
"MTL",0,0,2,0,1,3,0,1,1,0,0,2,"A","Y","2010-02-04","201002040BOS"
"CBJ",0,1,0,1,0,2,0,0,0,1,0,1,"H","N","2010-02-04","201002040CBJ"
"DAL",0,0,0,1,0,1,0,1,0,1,0,2,"A","N","2010-02-04","201002040CBJ"
"ANA",0,1,0,3,0,4,0,1,2,3,0,6,"A","N","2010-02-04","201002040LAK"
"LAK",0,1,2,3,0,6,0,1,0,3,0,4,"H","N","2010-02-04","201002040LAK"
"EDM",0,0,1,1,0,2,0,0,1,3,0,4,"A","N","2010-02-04","201002040MIN"
"MIN",0,0,1,3,0,4,0,0,1,1,0,2,"H","N","2010-02-04","201002040MIN"
"COL",0,1,1,1,0,3,0,0,4,1,0,5,"A","N","2010-02-04","201002040NSH"
"NSH",0,0,4,1,0,5,0,1,1,1,0,3,"H","N","2010-02-04","201002040NSH"
"NYR",0,2,3,0,0,5,0,1,3,2,0,6,"H","N","2010-02-04","201002040NYR"
"WSH",0,1,3,2,0,6,0,2,3,0,0,5,"A","N","2010-02-04","201002040NYR"
"OTT",0,2,0,1,0,3,0,0,0,1,0,1,"H","N","2010-02-04","201002040OTT"
"VAN",0,0,0,1,0,1,0,2,0,1,0,3,"A","N","2010-02-04","201002040OTT"
"SJS",0,2,1,1,0,4,0,1,0,1,0,2,"A","N","2010-02-04","201002040STL"
"STL",0,1,0,1,0,2,0,2,1,1,0,4,"H","N","2010-02-04","201002040STL"
"NYI",0,1,1,0,0,2,0,1,2,2,0,5,"A","N","2010-02-04","201002040TBL"
"TBL",0,1,2,2,0,5,0,1,1,0,0,2,"H","N","2010-02-04","201002040TBL"
"BUF",0,1,0,2,0,3,0,1,0,3,0,4,"H","N","2010-02-05","201002050BUF"
"CAR",0,1,0,3,0,4,0,1,0,2,0,3,"A","N","2010-02-05","201002050BUF"
"CHI",0,1,0,0,0,1,0,0,1,0,1,2,"H","Y","2010-02-05","201002050CHI"
"PHX",0,0,1,0,1,2,0,1,0,0,0,1,"A","Y","2010-02-05","201002050CHI"
"CGY",0,1,1,0,0,2,0,0,1,0,0,1,"A","N","2010-02-05","201002050FLA"
"FLA",0,0,1,0,0,1,0,1,1,0,0,2,"H","N","2010-02-05","201002050FLA"
"NJD",0,1,0,3,0,4,0,0,3,0,0,3,"H","N","2010-02-05","201002050NJD"
"TOR",0,0,3,0,0,3,0,1,0,3,0,4,"A","N","2010-02-05","201002050NJD"
"ATL",0,1,0,1,0,2,0,1,1,3,0,5,"A","N","2010-02-05","201002050WSH"
"WSH",0,1,1,3,0,5,0,1,0,1,0,2,"H","N","2010-02-05","201002050WSH"
"ATL",0,0,2,2,0,4,0,2,0,0,0,2,"H","N","2010-02-06","201002060ATL"
"FLA",0,2,0,0,0,2,0,0,2,2,0,4,"A","N","2010-02-06","201002060ATL"
"BOS",0,2,0,0,0,2,0,0,1,1,1,3,"H","Y","2010-02-06","201002060BOS"
"VAN",0,0,1,1,1,3,0,2,0,0,0,2,"A","Y","2010-02-06","201002060BOS"
"BUF",0,0,0,0,0,0,0,0,2,2,0,4,"A","N","2010-02-06","201002060CBJ"
"CBJ",0,0,2,2,0,4,0,0,0,0,0,0,"H","N","2010-02-06","201002060CBJ"
"COL",0,0,1,2,0,3,0,0,0,0,0,0,"H","N","2010-02-06","201002060COL"
"EDM",0,0,0,0,0,0,0,0,1,2,0,3,"A","N","2010-02-06","201002060COL"
"DAL",0,2,2,0,0,4,0,0,0,0,0,0,"H","N","2010-02-06","201002060DAL"
"PHX",0,0,0,0,0,0,0,2,2,0,0,4,"A","N","2010-02-06","201002060DAL"
"DET",0,3,0,0,0,3,0,0,3,1,0,4,"A","N","2010-02-06","201002060LAK"
"LAK",0,0,3,1,0,4,0,3,0,0,0,3,"H","N","2010-02-06","201002060LAK"
"MIN",0,1,1,0,0,2,0,1,0,0,0,1,"H","N","2010-02-06","201002060MIN"
"PHI",0,1,0,0,0,1,0,1,1,0,0,2,"A","N","2010-02-06","201002060MIN"
"MTL",0,1,2,2,0,5,0,1,1,1,0,3,"H","N","2010-02-06","201002060MTL"
"PIT",0,1,1,1,0,3,0,1,2,2,0,5,"A","N","2010-02-06","201002060MTL"
"NSH",0,1,2,0,0,3,0,1,2,1,0,4,"H","N","2010-02-06","201002060NSH"
"SJS",0,1,2,1,0,4,0,1,2,0,0,3,"A","N","2010-02-06","201002060NSH"
"CAR",0,1,1,1,0,3,0,0,1,0,0,1,"A","N","2010-02-06","201002060NYI"
"NYI",0,0,1,0,0,1,0,1,1,1,0,3,"H","N","2010-02-06","201002060NYI"
"NJD",0,0,0,1,0,1,0,0,3,0,0,3,"A","N","2010-02-06","201002060NYR"
"NYR",0,0,3,0,0,3,0,0,0,1,0,1,"H","N","2010-02-06","201002060NYR"
"CHI",0,2,0,0,0,2,0,0,0,1,0,1,"A","N","2010-02-06","201002060STL"
"STL",0,0,0,1,0,1,0,2,0,0,0,2,"H","N","2010-02-06","201002060STL"
"CGY",0,1,0,0,0,1,1,0,0,1,0,2,"A","N","2010-02-06","201002060TBL"
"TBL",1,0,0,1,0,2,0,1,0,0,0,1,"H","N","2010-02-06","201002060TBL"
"OTT",0,0,0,0,0,0,0,3,1,1,0,5,"A","N","2010-02-06","201002060TOR"
"TOR",0,3,1,1,0,5,0,0,0,0,0,0,"H","N","2010-02-06","201002060TOR"
"BOS",0,2,0,1,0,3,0,0,0,0,0,0,"A","N","2010-02-07","201002070MTL"
"MTL",0,0,0,0,0,0,0,2,0,1,0,3,"H","N","2010-02-07","201002070MTL"
"PIT",0,2,2,0,0,4,1,0,2,2,0,5,"A","N","2010-02-07","201002070WSH"
"WSH",1,0,2,2,0,5,0,2,2,0,0,4,"H","N","2010-02-07","201002070WSH"
"ANA",0,1,3,0,0,4,0,1,1,0,0,2,"H","N","2010-02-08","201002080ANA"
"LAK",0,1,1,0,0,2,0,1,3,0,0,4,"A","N","2010-02-08","201002080ANA"
"COL",0,2,3,0,0,5,0,2,0,0,0,2,"H","N","2010-02-08","201002080COL"
"STL",0,2,0,0,0,2,0,2,3,0,0,5,"A","N","2010-02-08","201002080COL"
"NJD",0,1,1,0,0,2,0,0,2,1,0,3,"A","N","2010-02-08","201002080PHI"
"PHI",0,0,2,1,0,3,0,1,1,0,0,2,"H","N","2010-02-08","201002080PHI"
"EDM",0,0,0,1,0,1,0,2,2,2,0,6,"A","N","2010-02-08","201002080PHX"
"PHX",0,2,2,2,0,6,0,0,0,1,0,1,"H","N","2010-02-08","201002080PHX"
"SJS",0,0,2,1,0,3,0,1,1,0,0,2,"A","N","2010-02-08","201002080TOR"
"TOR",0,1,1,0,0,2,0,0,2,1,0,3,"H","N","2010-02-08","201002080TOR"
"BOS",0,2,0,0,1,3,0,0,2,0,0,2,"A","Y","2010-02-09","201002090BUF"
"BUF",0,0,2,0,0,2,0,2,0,0,1,3,"H","Y","2010-02-09","201002090BUF"
"CAR",0,0,2,2,0,4,0,0,1,0,0,1,"H","N","2010-02-09","201002090CAR"
"FLA",0,0,1,0,0,1,0,0,2,2,0,4,"A","N","2010-02-09","201002090CAR"
"CHI",0,2,0,1,1,4,0,2,0,1,0,3,"H","Y","2010-02-09","201002090CHI"
"DAL",0,2,0,1,0,3,0,2,0,1,1,4,"A","Y","2010-02-09","201002090CHI"
"NSH",0,0,2,1,0,3,0,0,2,1,1,4,"A","Y","2010-02-09","201002090NYI"
"NYI",0,0,2,1,1,4,0,0,2,1,0,3,"H","Y","2010-02-09","201002090NYI"
"CGY",0,1,1,0,0,2,0,1,2,0,0,3,"A","N","2010-02-09","201002090OTT"
"OTT",0,1,2,0,0,3,0,1,1,0,0,2,"H","N","2010-02-09","201002090OTT"
"DET",0,1,0,2,0,3,0,0,2,1,1,4,"A","Y","2010-02-09","201002090STL"
"STL",0,0,2,1,1,4,0,1,0,2,0,3,"H","Y","2010-02-09","201002090STL"
"TBL",0,1,0,2,0,3,0,0,1,0,0,1,"H","N","2010-02-09","201002090TBL"
"VAN",0,0,1,0,0,1,0,1,0,2,0,3,"A","N","2010-02-09","201002090TBL"
"ANA",0,1,1,1,0,3,0,0,2,0,0,2,"H","N","2010-02-10","201002100ANA"
"EDM",0,0,2,0,0,2,0,1,1,1,0,3,"A","N","2010-02-10","201002100ANA"
"CBJ",0,1,1,1,0,3,0,0,0,0,0,0,"H","N","2010-02-10","201002100CBJ"
"SJS",0,0,0,0,0,0,0,1,1,1,0,3,"A","N","2010-02-10","201002100CBJ"
"ATL",0,1,1,1,0,3,1,1,0,2,0,4,"A","N","2010-02-10","201002100COL"
"COL",1,1,0,2,0,4,0,1,1,1,0,3,"H","N","2010-02-10","201002100COL"
"MIN",0,1,0,1,0,2,0,1,1,1,0,3,"H","N","2010-02-10","201002100MIN"
"PHX",0,1,1,1,0,3,0,1,0,1,0,2,"A","N","2010-02-10","201002100MIN"
"MTL",1,1,4,0,0,6,0,1,1,3,0,5,"H","N","2010-02-10","201002100MTL"
"WSH",0,1,1,3,0,5,1,1,4,0,0,6,"A","N","2010-02-10","201002100MTL"
"NJD",0,2,0,0,0,2,1,1,1,0,0,3,"H","N","2010-02-10","201002100NJD"
"PHI",1,1,1,0,0,3,0,2,0,0,0,2,"A","N","2010-02-10","201002100NJD"
"NSH",0,1,1,0,0,2,0,0,1,0,0,1,"A","N","2010-02-10","201002100NYR"
"NYR",0,0,1,0,0,1,0,1,1,0,0,2,"H","N","2010-02-10","201002100NYR"
"NYI",0,0,0,1,0,1,0,0,2,1,0,3,"A","N","2010-02-10","201002100PIT"
"PIT",0,0,2,1,0,3,0,0,0,1,0,1,"H","N","2010-02-10","201002100PIT"
"BUF",0,2,0,1,0,3,1,2,1,0,0,4,"A","N","2010-02-11","201002110CAR"
"CAR",1,2,1,0,0,4,0,2,0,1,0,3,"H","N","2010-02-11","201002110CAR"
"CGY",0,1,0,0,0,1,0,0,1,2,0,3,"H","N","2010-02-11","201002110CGY"
"DAL",0,0,1,2,0,3,0,1,0,0,0,1,"A","N","2010-02-11","201002110CGY"
"DET",0,1,0,1,0,2,0,2,0,0,1,3,"H","Y","2010-02-11","201002110DET"
"SJS",0,2,0,0,1,3,0,1,0,1,0,2,"A","Y","2010-02-11","201002110DET"
"FLA",0,0,0,0,0,0,0,0,2,1,0,3,"H","N","2010-02-11","201002110FLA"
"VAN",0,0,2,1,0,3,0,0,0,0,0,0,"A","N","2010-02-11","201002110FLA"
"EDM",0,0,1,1,1,3,0,0,0,2,0,2,"A","Y","2010-02-11","201002110LAK"
"LAK",0,0,0,2,0,2,0,0,1,1,1,3,"H","Y","2010-02-11","201002110LAK"
"OTT",0,3,1,2,0,6,0,1,3,1,0,5,"H","N","2010-02-11","201002110OTT"
"WSH",0,1,3,1,0,5,0,3,1,2,0,6,"A","N","2010-02-11","201002110OTT"
"BOS",0,4,1,0,0,5,0,0,2,2,0,4,"A","N","2010-02-11","201002110TBL"
"TBL",0,0,2,2,0,4,0,4,1,0,0,5,"H","N","2010-02-11","201002110TBL"
"CBJ",0,2,1,0,0,3,0,1,1,2,0,4,"H","N","2010-02-12","201002120CBJ"
"VAN",0,1,1,2,0,4,0,2,1,0,0,3,"A","N","2010-02-12","201002120CBJ"
"COL",0,1,0,1,0,2,0,0,1,0,0,1,"H","N","2010-02-12","201002120COL"
"PHX",0,0,1,0,0,1,0,1,0,1,0,2,"A","N","2010-02-12","201002120COL"
"ATL",0,2,0,1,0,3,0,2,0,0,0,2,"A","N","2010-02-12","201002120MIN"
"MIN",0,2,0,0,0,2,0,2,0,1,0,3,"H","N","2010-02-12","201002120MIN"
"NJD",0,1,1,3,0,5,0,1,1,0,0,2,"H","N","2010-02-12","201002120NJD"
"NSH",0,1,1,0,0,2,0,1,1,3,0,5,"A","N","2010-02-12","201002120NJD"
"MTL",0,0,0,2,0,2,0,1,2,0,0,3,"A","N","2010-02-12","201002120PHI"
"PHI",0,1,2,0,0,3,0,0,0,2,0,2,"H","N","2010-02-12","201002120PHI"
"NYR",1,0,2,0,0,3,0,1,0,1,0,2,"A","N","2010-02-12","201002120PIT"
"PIT",0,1,0,1,0,2,1,0,2,0,0,3,"H","N","2010-02-12","201002120PIT"
"STL",0,1,2,1,0,4,0,0,0,0,0,0,"H","N","2010-02-12","201002120STL"
"TOR",0,0,0,0,0,0,0,1,2,1,0,4,"A","N","2010-02-12","201002120STL"
"BUF",0,0,3,0,0,3,0,0,0,1,0,1,"H","N","2010-02-13","201002130BUF"
"SJS",0,0,0,1,0,1,0,0,3,0,0,3,"A","N","2010-02-13","201002130BUF"
"CAR",0,1,2,2,0,5,0,0,0,2,0,2,"H","N","2010-02-13","201002130CAR"
"NJD",0,0,0,2,0,2,0,1,2,2,0,5,"A","N","2010-02-13","201002130CAR"
"ANA",0,1,0,0,0,1,0,1,2,0,0,3,"A","N","2010-02-13","201002130CGY"
"CGY",0,1,2,0,0,3,0,1,0,0,0,1,"H","N","2010-02-13","201002130CGY"
"ATL",0,1,3,0,0,4,0,3,0,1,1,5,"A","Y","2010-02-13","201002130CHI"
"CHI",0,3,0,1,1,5,0,1,3,0,0,4,"H","Y","2010-02-13","201002130CHI"
"DET",0,2,1,1,0,4,0,0,1,0,0,1,"H","N","2010-02-13","201002130DET"
"OTT",0,0,1,0,0,1,0,2,1,1,0,4,"A","N","2010-02-13","201002130DET"
"BOS",0,1,0,1,1,3,0,2,0,0,0,2,"A","Y","2010-02-13","201002130FLA"
"FLA",0,2,0,0,0,2,0,1,0,1,1,3,"H","Y","2010-02-13","201002130FLA"
"COL",0,0,0,0,0,0,0,0,1,2,0,3,"A","N","2010-02-13","201002130LAK"
"LAK",0,0,1,2,0,3,0,0,0,0,0,0,"H","N","2010-02-13","201002130LAK"
"MTL",0,0,1,1,0,2,0,3,2,1,0,6,"H","N","2010-02-13","201002130MTL"
"PHI",0,3,2,1,0,6,0,0,1,1,0,2,"A","N","2010-02-13","201002130MTL"
"NYI",0,1,3,1,0,5,0,2,1,1,0,4,"H","N","2010-02-13","201002130NYI"
"TBL",0,2,1,1,0,4,0,1,3,1,0,5,"A","N","2010-02-13","201002130NYI"
"DAL",0,0,2,1,0,3,0,0,0,0,0,0,"A","N","2010-02-13","201002130PHX"
"PHX",0,0,0,0,0,0,0,0,2,1,0,3,"H","N","2010-02-13","201002130PHX"
"STL",0,1,2,0,1,4,0,1,2,0,0,3,"H","Y","2010-02-13","201002130STL"
"WSH",0,1,2,0,0,3,0,1,2,0,1,4,"A","Y","2010-02-13","201002130STL"
"CBJ",0,2,1,1,0,4,0,1,3,0,1,5,"H","Y","2010-02-14","201002140CBJ"
"CHI",0,1,3,0,1,5,0,2,1,1,0,4,"A","Y","2010-02-14","201002140CBJ"
"ANA",0,2,1,4,0,7,0,1,1,1,0,3,"A","N","2010-02-14","201002140EDM"
"EDM",0,1,1,1,0,3,0,2,1,4,0,7,"H","N","2010-02-14","201002140EDM"
"MIN",0,1,2,3,0,6,0,0,0,2,0,2,"H","N","2010-02-14","201002140MIN"
"VAN",0,0,0,2,0,2,0,1,2,3,0,6,"A","N","2010-02-14","201002140MIN"
"NYI",0,1,2,0,0,3,0,1,0,3,0,4,"H","N","2010-02-14","201002140NYI"
"OTT",0,1,0,3,0,4,0,1,2,0,0,3,"A","N","2010-02-14","201002140NYI"
"NYR",0,0,4,1,0,5,0,2,0,0,0,2,"H","N","2010-02-14","201002140NYR"
"TBL",0,2,0,0,0,2,0,0,4,1,0,5,"A","N","2010-02-14","201002140NYR"
"NSH",0,0,2,1,1,4,0,1,1,1,0,3,"A","Y","2010-02-14","201002140PIT"
"PIT",0,1,1,1,0,3,0,0,2,1,1,4,"H","Y","2010-02-14","201002140PIT"
"COL",0,0,2,0,0,2,0,2,0,1,0,3,"H","N","2010-03-01","201003010COL"
"DET",0,2,0,1,0,3,0,0,2,0,0,2,"A","N","2010-03-01","201003010COL"
"ATL",0,2,2,0,0,4,0,2,0,0,0,2,"H","N","2010-03-02","201003020ATL"
"FLA",0,2,0,0,0,2,0,2,2,0,0,4,"A","N","2010-03-02","201003020ATL"
"BOS",0,1,0,0,0,1,0,0,0,4,0,4,"H","N","2010-03-02","201003020BOS"
"MTL",0,0,0,4,0,4,0,1,0,0,0,1,"A","N","2010-03-02","201003020BOS"
"CBJ",0,2,1,0,0,3,1,0,2,1,0,4,"H","N","2010-03-02","201003020CBJ"
"VAN",1,0,2,1,0,4,0,2,1,0,0,3,"A","N","2010-03-02","201003020CBJ"
"DAL",0,0,0,1,0,1,0,1,3,1,0,5,"H","N","2010-03-02","201003020DAL"
"LAK",0,1,3,1,0,5,0,0,0,1,0,1,"A","N","2010-03-02","201003020DAL"
"EDM",0,1,1,1,0,3,0,2,1,1,0,4,"A","N","2010-03-02","201003020NSH"
"NSH",0,2,1,1,0,4,0,1,1,1,0,3,"H","N","2010-03-02","201003020NSH"
"CHI",0,2,0,1,0,3,0,1,4,0,0,5,"A","N","2010-03-02","201003020NYI"
"NYI",0,1,4,0,0,5,0,2,0,1,0,3,"H","N","2010-03-02","201003020NYI"
"NYR",0,0,4,0,0,4,0,1,0,0,0,1,"A","N","2010-03-02","201003020OTT"
"OTT",0,1,0,0,0,1,0,0,4,0,0,4,"H","N","2010-03-02","201003020OTT"
"PHX",0,1,0,1,0,2,0,2,3,0,0,5,"H","N","2010-03-02","201003020PHX"
"STL",0,2,3,0,0,5,0,1,0,1,0,2,"A","N","2010-03-02","201003020PHX"
"BUF",0,0,1,1,0,2,0,1,1,1,0,3,"A","N","2010-03-02","201003020PIT"
"PIT",0,1,1,1,0,3,0,0,1,1,0,2,"H","N","2010-03-02","201003020PIT"
"NJD",0,0,3,1,0,4,0,0,0,3,0,3,"A","N","2010-03-02","201003020SJS"
"SJS",0,0,0,3,0,3,0,0,3,1,0,4,"H","N","2010-03-02","201003020SJS"
"PHI",0,1,1,5,0,7,0,1,1,0,0,2,"A","N","2010-03-02","201003020TBL"
"TBL",0,1,1,0,0,2,0,1,1,5,0,7,"H","N","2010-03-02","201003020TBL"
"CAR",0,1,3,1,0,5,0,0,0,1,0,1,"A","N","2010-03-02","201003020TOR"
"TOR",0,0,0,1,0,1,0,1,3,1,0,5,"H","N","2010-03-02","201003020TOR"
"ANA",0,1,1,1,0,3,0,0,2,2,0,4,"H","N","2010-03-03","201003030ANA"
"COL",0,0,2,2,0,4,0,1,1,1,0,3,"A","N","2010-03-03","201003030ANA"
"BUF",0,0,1,0,0,1,0,0,1,2,0,3,"H","N","2010-03-03","201003030BUF"
"WSH",0,0,1,2,0,3,0,0,1,0,0,1,"A","N","2010-03-03","201003030BUF"
"CGY",0,0,0,0,0,0,0,1,2,1,0,4,"H","N","2010-03-03","201003030CGY"
"MIN",0,1,2,1,0,4,0,0,0,0,0,0,"A","N","2010-03-03","201003030CGY"
"CHI",0,0,2,3,0,5,0,0,2,0,0,2,"H","N","2010-03-03","201003030CHI"
"EDM",0,0,2,0,0,2,0,0,2,3,0,5,"A","N","2010-03-03","201003030CHI"
"DET",0,1,1,1,0,3,0,2,3,1,0,6,"H","N","2010-03-03","201003030DET"
"VAN",0,2,3,1,0,6,0,1,1,1,0,3,"A","N","2010-03-03","201003030DET"
"FLA",0,2,4,1,0,7,0,0,3,1,0,4,"H","N","2010-03-03","201003030FLA"
"PHI",0,0,3,1,0,4,0,2,4,1,0,7,"A","N","2010-03-03","201003030FLA"
"ATL",0,4,2,0,0,6,0,1,0,2,0,3,"H","N","2010-03-04","201003040ATL"
"NYI",0,1,0,2,0,3,0,4,2,0,0,6,"A","N","2010-03-04","201003040ATL"
"BOS",0,1,1,0,1,3,0,1,0,1,0,2,"H","Y","2010-03-04","201003040BOS"
"TOR",0,1,0,1,0,2,0,1,1,0,1,3,"A","Y","2010-03-04","201003040BOS"
"CAR",0,2,1,1,0,4,0,0,0,1,0,1,"H","N","2010-03-04","201003040CAR"
"OTT",0,0,0,1,0,1,0,2,1,1,0,4,"A","N","2010-03-04","201003040CAR"
"DAL",0,1,0,0,0,1,0,3,1,2,0,6,"H","N","2010-03-04","201003040DAL"
"STL",0,3,1,2,0,6,0,1,0,0,0,1,"A","N","2010-03-04","201003040DAL"
"LAK",0,1,0,1,0,2,0,1,1,2,0,4,"A","N","2010-03-04","201003040NSH"
"NSH",0,1,1,2,0,4,0,1,0,1,0,2,"H","N","2010-03-04","201003040NSH"
"NYR",0,2,2,0,0,4,1,2,1,1,0,5,"H","N","2010-03-04","201003040NYR"
"PIT",1,2,1,1,0,5,0,2,2,0,0,4,"A","N","2010-03-04","201003040NYR"
"COL",0,0,1,0,0,1,0,1,0,2,0,3,"A","N","2010-03-04","201003040PHX"
"PHX",0,1,0,2,0,3,0,0,1,0,0,1,"H","N","2010-03-04","201003040PHX"
"MTL",0,1,1,0,0,2,0,0,1,2,0,3,"A","N","2010-03-04","201003040SJS"
"SJS",0,0,1,2,0,3,0,1,1,0,0,2,"H","N","2010-03-04","201003040SJS"
"TBL",0,1,1,2,0,4,0,1,2,2,0,5,"A","N","2010-03-04","201003040WSH"
"WSH",0,1,2,2,0,5,0,1,1,2,0,4,"H","N","2010-03-04","201003040WSH"
"BUF",1,0,1,1,0,3,0,0,1,1,0,2,"H","N","2010-03-05","201003050BUF"
"PHI",0,0,1,1,0,2,1,0,1,1,0,3,"A","N","2010-03-05","201003050BUF"
"CGY",0,0,3,2,0,5,0,1,0,2,0,3,"H","N","2010-03-05","201003050CGY"
"NJD",0,1,0,2,0,3,0,0,3,2,0,5,"A","N","2010-03-05","201003050CGY"
"CHI",0,5,1,0,0,6,0,1,1,1,0,3,"H","N","2010-03-05","201003050CHI"
"VAN",0,1,1,1,0,3,0,5,1,0,0,6,"A","N","2010-03-05","201003050CHI"
"DET",0,2,2,1,0,5,0,0,1,1,0,2,"H","N","2010-03-05","201003050DET"
"NSH",0,0,1,1,0,2,0,2,2,1,0,5,"A","N","2010-03-05","201003050DET"
"EDM",0,1,0,0,1,2,0,0,1,0,0,1,"H","Y","2010-03-05","201003050EDM"
"MIN",0,0,1,0,0,1,0,1,0,0,1,2,"A","Y","2010-03-05","201003050EDM"
"COL",0,2,4,1,0,7,0,1,1,1,0,3,"H","N","2010-03-06","201003060COL"
"STL",0,1,1,1,0,3,0,2,4,1,0,7,"A","N","2010-03-06","201003060COL"
"CAR",0,0,0,1,0,1,0,2,0,2,0,4,"A","N","2010-03-06","201003060FLA"
"FLA",0,2,0,2,0,4,0,0,0,1,0,1,"H","N","2010-03-06","201003060FLA"
"LAK",0,1,0,1,0,2,0,1,1,2,0,4,"H","N","2010-03-06","201003060LAK"
"MTL",0,1,1,2,0,4,0,1,0,1,0,2,"A","N","2010-03-06","201003060LAK"
"BOS",0,1,2,0,0,3,0,0,1,1,0,2,"A","N","2010-03-06","201003060NYI"
"NYI",0,0,1,1,0,2,0,1,2,0,0,3,"H","N","2010-03-06","201003060NYI"
"OTT",0,1,0,0,0,1,0,0,1,0,1,2,"H","Y","2010-03-06","201003060OTT"
"TOR",0,0,1,0,1,2,0,1,0,0,0,1,"A","Y","2010-03-06","201003060OTT"
"ANA",0,0,0,0,0,0,0,1,2,1,0,4,"A","N","2010-03-06","201003060PHX"
"PHX",0,1,2,1,0,4,0,0,0,0,0,0,"H","N","2010-03-06","201003060PHX"
"DAL",0,1,2,0,0,3,0,1,3,2,0,6,"A","N","2010-03-06","201003060PIT"
"PIT",0,1,3,2,0,6,0,1,2,0,0,3,"H","N","2010-03-06","201003060PIT"
"CBJ",0,0,1,0,0,1,0,0,0,2,0,2,"A","N","2010-03-06","201003060SJS"
"SJS",0,0,0,2,0,2,0,0,1,0,0,1,"H","N","2010-03-06","201003060SJS"
"ATL",0,1,1,0,0,2,0,3,1,2,0,6,"A","N","2010-03-06","201003060TBL"
"TBL",0,3,1,2,0,6,0,1,1,0,0,2,"H","N","2010-03-06","201003060TBL"
"NYR",0,0,0,0,0,0,0,1,1,0,0,2,"A","N","2010-03-06","201003060WSH"
"WSH",0,1,1,0,0,2,0,0,0,0,0,0,"H","N","2010-03-06","201003060WSH"
"ANA",0,3,0,0,0,3,0,0,1,2,1,4,"H","Y","2010-03-07","201003070ANA"
"MTL",0,0,1,2,1,4,0,3,0,0,0,3,"A","Y","2010-03-07","201003070ANA"
"ATL",0,0,0,0,0,0,0,1,1,2,0,4,"H","N","2010-03-07","201003070ATL"
"CAR",0,1,1,2,0,4,0,0,0,0,0,0,"A","N","2010-03-07","201003070ATL"
"CHI",0,2,0,2,0,4,0,0,5,0,0,5,"H","N","2010-03-07","201003070CHI"
"DET",0,0,5,0,0,5,0,2,0,2,0,4,"A","N","2010-03-07","201003070CHI"
"EDM",0,0,1,1,0,2,0,0,0,0,0,0,"H","N","2010-03-07","201003070EDM"
"NJD",0,0,0,0,0,0,0,0,1,1,0,2,"A","N","2010-03-07","201003070EDM"
"CGY",0,2,1,2,0,5,0,0,2,0,0,2,"A","N","2010-03-07","201003070MIN"
"MIN",0,0,2,0,0,2,0,2,1,2,0,5,"H","N","2010-03-07","201003070MIN"
"NSH",0,1,1,0,0,2,0,1,0,3,0,4,"H","N","2010-03-07","201003070NSH"
"VAN",0,1,0,3,0,4,0,1,1,0,0,2,"A","N","2010-03-07","201003070NSH"
"BUF",1,0,0,1,0,2,0,0,0,1,0,1,"A","N","2010-03-07","201003070NYR"
"NYR",0,0,0,1,0,1,1,0,0,1,0,2,"H","N","2010-03-07","201003070NYR"
"PHI",0,1,2,0,0,3,0,0,1,0,0,1,"H","N","2010-03-07","201003070PHI"
"TOR",0,0,1,0,0,1,0,1,2,0,0,3,"A","N","2010-03-07","201003070PHI"
"BOS",0,0,1,0,0,1,0,0,1,1,0,2,"A","N","2010-03-07","201003070PIT"
"PIT",0,0,1,1,0,2,0,0,1,0,0,1,"H","N","2010-03-07","201003070PIT"
"CBJ",0,0,0,0,0,0,0,4,2,0,0,6,"A","N","2010-03-08","201003080LAK"
"LAK",0,4,2,0,0,6,0,0,0,0,0,0,"H","N","2010-03-08","201003080LAK"
"DAL",0,0,0,3,1,4,0,1,1,1,0,3,"A","Y","2010-03-08","201003080WSH"
"WSH",0,1,1,1,0,3,0,0,0,3,1,4,"H","Y","2010-03-08","201003080WSH"
"ANA",0,0,0,2,0,2,0,1,2,2,0,5,"H","N","2010-03-09","201003090ANA"
"CBJ",0,1,2,2,0,5,0,0,0,2,0,2,"A","N","2010-03-09","201003090ANA"
"ATL",0,0,1,0,0,1,0,2,0,0,0,2,"H","N","2010-03-09","201003090ATL"
"NSH",0,2,0,0,0,2,0,0,1,0,0,1,"A","N","2010-03-09","201003090ATL"
"COL",0,3,1,0,0,4,0,0,3,3,0,6,"H","N","2010-03-09","201003090COL"
"VAN",0,0,3,3,0,6,0,3,1,0,0,4,"A","N","2010-03-09","201003090COL"
"CGY",0,0,1,3,0,4,0,0,2,0,0,2,"A","N","2010-03-09","201003090DET"
"DET",0,0,2,0,0,2,0,0,1,3,0,4,"H","N","2010-03-09","201003090DET"
"EDM",0,0,1,0,0,1,0,0,1,3,0,4,"H","N","2010-03-09","201003090EDM"
"OTT",0,0,1,3,0,4,0,0,1,0,0,1,"A","N","2010-03-09","201003090EDM"
"FLA",0,0,0,2,1,3,0,2,0,0,0,2,"A","Y","2010-03-09","201003090MIN"
"MIN",0,2,0,0,0,2,0,0,0,2,1,3,"H","Y","2010-03-09","201003090MIN"
"MTL",0,2,2,1,0,5,0,0,2,1,0,3,"H","N","2010-03-09","201003090MTL"
"TBL",0,0,2,1,0,3,0,2,2,1,0,5,"A","N","2010-03-09","201003090MTL"
"NYI",0,1,1,0,0,2,0,0,1,2,0,3,"A","N","2010-03-09","201003090PHI"
"PHI",0,0,1,2,0,3,0,1,1,0,0,2,"H","N","2010-03-09","201003090PHI"
"BOS",0,1,1,1,0,3,1,0,2,1,0,4,"A","N","2010-03-09","201003090TOR"
"TOR",1,0,2,1,0,4,0,1,1,1,0,3,"H","N","2010-03-09","201003090TOR"
"BUF",0,3,1,1,0,5,0,3,0,0,0,3,"H","N","2010-03-10","201003100BUF"
"DAL",0,3,0,0,0,3,0,3,1,1,0,5,"A","N","2010-03-10","201003100BUF"
"CHI",1,1,1,0,0,3,0,0,2,0,0,2,"H","N","2010-03-10","201003100CHI"
"LAK",0,0,2,0,0,2,1,1,1,0,0,3,"A","N","2010-03-10","201003100CHI"
"NJD",0,2,3,1,0,6,0,1,2,0,0,3,"H","N","2010-03-10","201003100NJD"
"NYR",0,1,2,0,0,3,0,2,3,1,0,6,"A","N","2010-03-10","201003100NJD"
"PHX",0,1,1,1,1,4,0,1,1,1,0,3,"H","Y","2010-03-10","201003100PHX"
"VAN",0,1,1,1,0,3,0,1,1,1,1,4,"A","Y","2010-03-10","201003100PHX"
"CAR",0,1,2,0,0,3,1,2,1,0,0,4,"A","N","2010-03-10","201003100WSH"
"WSH",1,2,1,0,0,4,0,1,2,0,0,3,"H","N","2010-03-10","201003100WSH"
"CAR",1,2,1,0,0,4,0,2,1,0,0,3,"H","N","2010-03-11","201003110CAR"
"PIT",0,2,1,0,0,3,1,2,1,0,0,4,"A","N","2010-03-11","201003110CAR"
"ATL",0,0,0,1,0,1,0,1,1,0,0,2,"A","N","2010-03-11","201003110CBJ"
"CBJ",0,1,1,0,0,2,0,0,0,1,0,1,"H","N","2010-03-11","201003110CBJ"
"CGY",0,1,0,1,0,2,0,0,0,0,0,0,"H","N","2010-03-11","201003110CGY"
"OTT",0,0,0,0,0,0,0,1,0,1,0,2,"A","N","2010-03-11","201003110CGY"
"COL",0,0,2,1,0,3,0,0,0,0,0,0,"H","N","2010-03-11","201003110COL"
"FLA",0,0,0,0,0,0,0,0,2,1,0,3,"A","N","2010-03-11","201003110COL"
"DET",0,3,1,1,0,5,0,1,0,0,0,1,"H","N","2010-03-11","201003110DET"
"MIN",0,1,0,0,0,1,0,3,1,1,0,5,"A","N","2010-03-11","201003110DET"
"EDM",0,2,0,2,0,4,0,2,1,1,1,5,"A","Y","2010-03-11","201003110MTL"
"MTL",0,2,1,1,1,5,0,2,0,2,0,4,"H","Y","2010-03-11","201003110MTL"
"NYI",0,1,0,0,0,1,0,0,1,0,1,2,"H","Y","2010-03-11","201003110NYI"
"STL",0,0,1,0,1,2,0,1,0,0,0,1,"A","Y","2010-03-11","201003110NYI"
"BOS",0,1,3,1,0,5,0,0,1,0,0,1,"A","N","2010-03-11","201003110PHI"
"PHI",0,0,1,0,0,1,0,1,3,1,0,5,"H","N","2010-03-11","201003110PHI"
"NSH",0,1,3,1,0,5,0,1,1,6,0,8,"A","N","2010-03-11","201003110SJS"
"SJS",0,1,1,6,0,8,0,1,3,1,0,5,"H","N","2010-03-11","201003110SJS"
"TBL",0,1,1,1,0,3,1,0,2,1,0,4,"A","N","2010-03-11","201003110TOR"
"TOR",1,0,2,1,0,4,0,1,1,1,0,3,"H","N","2010-03-11","201003110TOR"
"ANA",0,0,0,0,0,0,0,1,0,0,0,1,"H","N","2010-03-12","201003120ANA"
"NSH",0,1,0,0,0,1,0,0,0,0,0,0,"A","N","2010-03-12","201003120ANA"
"ATL",0,0,1,1,0,2,0,3,1,1,0,5,"H","N","2010-03-12","201003120ATL"
"NYR",0,3,1,1,0,5,0,0,1,1,0,2,"A","N","2010-03-12","201003120ATL"
"BUF",0,0,0,2,0,2,0,2,1,0,0,3,"H","N","2010-03-12","201003120BUF"
"MIN",0,2,1,0,0,3,0,0,0,2,0,2,"A","N","2010-03-12","201003120BUF"
"DAL",0,0,0,1,0,1,0,1,0,0,1,2,"H","Y","2010-03-12","201003120DAL"
"LAK",0,1,0,0,1,2,0,0,0,1,0,1,"A","Y","2010-03-12","201003120DAL"
"NJD",0,1,0,2,0,3,0,1,0,0,0,1,"H","N","2010-03-12","201003120NJD"
"PIT",0,1,0,0,0,1,0,1,0,2,0,3,"A","N","2010-03-12","201003120NJD"
"TBL",0,1,2,0,0,3,0,1,0,1,0,2,"A","N","2010-03-12","201003120WSH"
"WSH",0,1,0,1,0,2,0,1,2,0,0,3,"H","N","2010-03-12","201003120WSH"
"CAR",0,0,0,0,0,0,0,2,1,1,0,4,"H","N","2010-03-13","201003130CAR"
"PHX",0,2,1,1,0,4,0,0,0,0,0,0,"A","N","2010-03-13","201003130CAR"
"CBJ",0,0,0,1,0,1,0,0,3,2,0,5,"H","N","2010-03-13","201003130CBJ"
"STL",0,0,3,2,0,5,0,0,0,1,0,1,"A","N","2010-03-13","201003130CBJ"
"BUF",0,1,1,0,0,2,1,2,0,0,0,3,"A","N","2010-03-13","201003130DET"
"DET",1,2,0,0,0,3,0,1,1,0,0,2,"H","N","2010-03-13","201003130DET"
"BOS",0,0,1,1,0,2,0,2,0,1,0,3,"A","N","2010-03-13","201003130MTL"
"MTL",0,2,0,1,0,3,0,0,1,1,0,2,"H","N","2010-03-13","201003130MTL"
"NJD",0,1,0,1,0,2,0,1,2,1,0,4,"A","N","2010-03-13","201003130NYI"
"NYI",0,1,2,1,0,4,0,1,0,1,0,2,"H","N","2010-03-13","201003130NYI"
"CHI",0,0,0,2,0,2,0,0,0,3,0,3,"A","N","2010-03-13","201003130PHI"
"PHI",0,0,0,3,0,3,0,0,0,2,0,2,"H","N","2010-03-13","201003130PHI"
"FLA",1,0,1,1,0,3,0,2,0,0,0,2,"A","N","2010-03-13","201003130SJS"
"SJS",0,2,0,0,0,2,1,0,1,1,0,3,"H","N","2010-03-13","201003130SJS"
"EDM",0,0,2,2,0,4,0,2,3,1,0,6,"A","N","2010-03-13","201003130TOR"
"TOR",0,2,3,1,0,6,0,0,2,2,0,4,"H","N","2010-03-13","201003130TOR"
"OTT",0,0,1,0,0,1,0,1,3,1,0,5,"A","N","2010-03-13","201003130VAN"
"VAN",0,1,3,1,0,5,0,0,1,0,0,1,"H","N","2010-03-13","201003130VAN"
"ANA",0,3,0,1,0,4,0,0,0,2,0,2,"H","N","2010-03-14","201003140ANA"
"SJS",0,0,0,2,0,2,0,3,0,1,0,4,"A","N","2010-03-14","201003140ANA"
"ATL",0,0,0,2,0,2,0,0,1,1,1,3,"H","Y","2010-03-14","201003140ATL"
"PHX",0,0,1,1,1,3,0,0,0,2,0,2,"A","Y","2010-03-14","201003140ATL"
"CHI",0,2,1,0,0,3,1,0,0,3,0,4,"H","N","2010-03-14","201003140CHI"
"WSH",1,0,0,3,0,4,0,2,1,0,0,3,"A","N","2010-03-14","201003140CHI"
"COL",0,1,3,1,0,5,0,1,2,0,0,3,"A","N","2010-03-14","201003140DAL"
"DAL",0,1,2,0,0,3,0,1,3,1,0,5,"H","N","2010-03-14","201003140DAL"
"LAK",0,1,0,1,0,2,0,1,0,2,0,3,"H","N","2010-03-14","201003140LAK"
"NSH",0,1,0,2,0,3,0,1,0,1,0,2,"A","N","2010-03-14","201003140LAK"
"MIN",0,3,1,0,0,4,0,0,1,1,0,2,"H","N","2010-03-14","201003140MIN"
"STL",0,0,1,1,0,2,0,3,1,0,0,4,"A","N","2010-03-14","201003140MIN"
"NYI",0,2,1,1,0,4,0,1,0,0,0,1,"H","N","2010-03-14","201003140NYI"
"TOR",0,1,0,0,0,1,0,2,1,1,0,4,"A","N","2010-03-14","201003140NYI"
"NYR",0,0,2,1,0,3,0,1,0,0,0,1,"H","N","2010-03-14","201003140NYR"
"PHI",0,1,0,0,0,1,0,0,2,1,0,3,"A","N","2010-03-14","201003140NYR"
"PIT",0,0,0,2,0,2,0,0,1,0,0,1,"A","N","2010-03-14","201003140TBL"
"TBL",0,0,1,0,0,1,0,0,0,2,0,2,"H","N","2010-03-14","201003140TBL"
"CGY",0,0,0,1,0,1,0,3,0,0,0,3,"A","N","2010-03-14","201003140VAN"
"VAN",0,3,0,0,0,3,0,0,0,1,0,1,"H","N","2010-03-14","201003140VAN"
"CBJ",0,1,1,3,0,5,0,0,1,2,0,3,"H","N","2010-03-15","201003150CBJ"
"EDM",0,0,1,2,0,3,0,1,1,3,0,5,"A","N","2010-03-15","201003150CBJ"
"CGY",0,1,0,0,0,1,0,0,1,1,0,2,"H","N","2010-03-15","201003150CGY"
"DET",0,0,1,1,0,2,0,1,0,0,0,1,"A","N","2010-03-15","201003150CGY"
"BOS",0,0,1,1,0,2,0,3,0,0,0,3,"A","N","2010-03-15","201003150NJD"
"NJD",0,3,0,0,0,3,0,0,1,1,0,2,"H","N","2010-03-15","201003150NJD"
"ATL",0,3,0,1,0,4,0,1,1,1,0,3,"H","N","2010-03-16","201003160ATL"
"BUF",0,1,1,1,0,3,0,3,0,1,0,4,"A","N","2010-03-16","201003160ATL"
"BOS",0,1,1,3,0,5,0,0,1,1,0,2,"A","N","2010-03-16","201003160CAR"
"CAR",0,0,1,1,0,2,0,1,1,3,0,5,"H","N","2010-03-16","201003160CAR"
"DAL",0,1,3,4,0,8,0,0,1,1,0,2,"H","N","2010-03-16","201003160DAL"
"SJS",0,0,1,1,0,2,0,1,3,4,0,8,"A","N","2010-03-16","201003160DAL"
"FLA",0,1,1,1,0,3,0,2,4,1,0,7,"H","N","2010-03-16","201003160FLA"
"WSH",0,2,4,1,0,7,0,1,1,1,0,3,"A","N","2010-03-16","201003160FLA"
"EDM",0,0,1,1,0,2,0,1,1,2,0,4,"A","N","2010-03-16","201003160MIN"
"MIN",0,1,1,2,0,4,0,0,1,1,0,2,"H","N","2010-03-16","201003160MIN"
"NSH",0,3,0,0,1,4,0,1,0,2,0,3,"H","Y","2010-03-16","201003160NSH"
"PHI",0,1,0,2,0,3,0,3,0,0,1,4,"A","Y","2010-03-16","201003160NSH"
"MTL",0,1,0,2,0,3,0,0,1,0,0,1,"A","N","2010-03-16","201003160NYR"
"NYR",0,0,1,0,0,1,0,1,0,2,0,3,"H","N","2010-03-16","201003160NYR"
"OTT",0,0,1,0,0,1,0,1,2,1,0,4,"H","N","2010-03-16","201003160OTT"
"TOR",0,1,2,1,0,4,0,0,1,0,0,1,"A","N","2010-03-16","201003160OTT"
"COL",0,2,2,1,0,5,0,1,2,0,0,3,"A","N","2010-03-16","201003160STL"
"STL",0,1,2,0,0,3,0,2,2,1,0,5,"H","N","2010-03-16","201003160STL"
"PHX",0,2,0,0,0,2,0,0,1,0,0,1,"A","N","2010-03-16","201003160TBL"
"TBL",0,0,1,0,0,1,0,2,0,0,0,2,"H","N","2010-03-16","201003160TBL"
"NYI",0,2,2,1,0,5,0,0,2,0,0,2,"A","N","2010-03-16","201003160VAN"
"VAN",0,0,2,0,0,2,0,2,2,1,0,5,"H","N","2010-03-16","201003160VAN"
"ANA",0,1,1,2,0,4,0,1,0,1,0,2,"H","N","2010-03-17","201003170ANA"
"CHI",0,1,0,1,0,2,0,1,1,2,0,4,"A","N","2010-03-17","201003170ANA"
"CGY",0,2,1,0,0,3,0,0,1,1,0,2,"A","N","2010-03-17","201003170COL"
"COL",0,0,1,1,0,2,0,2,1,0,0,3,"H","N","2010-03-17","201003170COL"
"NJD",0,2,2,1,0,5,0,1,0,1,0,2,"H","N","2010-03-17","201003170NJD"
"PIT",0,1,0,1,0,2,0,2,2,1,0,5,"A","N","2010-03-17","201003170NJD"
"ATL",0,1,2,3,0,6,0,0,3,0,0,3,"H","N","2010-03-18","201003180ATL"
"OTT",0,0,3,0,0,3,0,1,2,3,0,6,"A","N","2010-03-18","201003180ATL"
"BOS",0,0,0,0,0,0,0,1,1,1,0,3,"H","N","2010-03-18","201003180BOS"
"PIT",0,1,1,1,0,3,0,0,0,0,0,0,"A","N","2010-03-18","201003180BOS"
"CAR",1,0,1,2,0,4,0,0,2,1,0,3,"H","N","2010-03-18","201003180CAR"
"WSH",0,0,2,1,0,3,1,0,1,2,0,4,"A","N","2010-03-18","201003180CAR"
"DAL",0,2,0,0,0,2,0,1,1,1,0,3,"H","N","2010-03-18","201003180DAL"
"PHI",0,1,1,1,0,3,0,2,0,0,0,2,"A","N","2010-03-18","201003180DAL"
"FLA",0,1,2,0,0,3,0,0,0,3,1,4,"H","Y","2010-03-18","201003180FLA"
"PHX",0,0,0,3,1,4,0,1,2,0,0,3,"A","Y","2010-03-18","201003180FLA"
"CHI",0,0,1,2,0,3,0,0,0,0,0,0,"A","N","2010-03-18","201003180LAK"
"LAK",0,0,0,0,0,0,0,0,1,2,0,3,"H","N","2010-03-18","201003180LAK"
"MIN",0,0,0,0,0,0,0,3,1,1,0,5,"A","N","2010-03-18","201003180NSH"
"NSH",0,3,1,1,0,5,0,0,0,0,0,0,"H","N","2010-03-18","201003180NSH"
"NYR",0,2,0,1,0,3,0,1,2,1,0,4,"H","N","2010-03-18","201003180NYR"
"STL",0,1,2,1,0,4,0,2,0,1,0,3,"A","N","2010-03-18","201003180NYR"
"BUF",0,3,1,2,0,6,0,0,0,2,0,2,"A","N","2010-03-18","201003180TBL"
"TBL",0,0,0,2,0,2,0,3,1,2,0,6,"H","N","2010-03-18","201003180TBL"
"NJD",0,0,1,0,0,1,0,1,0,0,1,2,"A","Y","2010-03-18","201003180TOR"
"TOR",0,1,0,0,1,2,0,0,1,0,0,1,"H","Y","2010-03-18","201003180TOR"
"SJS",0,0,1,1,0,2,0,2,1,0,0,3,"A","N","2010-03-18","201003180VAN"
"VAN",0,2,1,0,0,3,0,0,1,1,0,2,"H","N","2010-03-18","201003180VAN"
"ANA",1,2,0,2,0,5,0,2,2,0,0,4,"H","N","2010-03-19","201003190ANA"
"NYI",0,2,2,0,0,4,1,2,0,2,0,5,"A","N","2010-03-19","201003190ANA"
"CBJ",0,0,1,3,0,4,0,1,1,0,0,2,"H","N","2010-03-19","201003190CBJ"
"MIN",0,1,1,0,0,2,0,0,1,3,0,4,"A","N","2010-03-19","201003190CBJ"
"CGY",0,2,2,0,0,4,0,0,1,2,0,3,"H","N","2010-03-19","201003190CGY"
"SJS",0,0,1,2,0,3,0,2,2,0,0,4,"A","N","2010-03-19","201003190CGY"
"DET",0,0,1,1,0,2,0,2,0,0,1,3,"A","Y","2010-03-19","201003190EDM"
"EDM",0,2,0,0,1,3,0,0,1,1,0,2,"H","Y","2010-03-19","201003190EDM"
"ATL",0,2,1,2,0,5,0,1,1,0,0,2,"H","N","2010-03-20","201003200ATL"
"PHI",0,1,1,0,0,2,0,2,1,2,0,5,"A","N","2010-03-20","201003200ATL"
"DAL",0,2,2,1,0,5,0,2,1,1,0,4,"H","N","2010-03-20","201003200DAL"
"OTT",0,2,1,1,0,4,0,2,2,1,0,5,"A","N","2010-03-20","201003200DAL"
"BUF",0,1,1,1,0,3,0,0,1,0,0,1,"A","N","2010-03-20","201003200FLA"
"FLA",0,0,1,0,0,1,0,1,1,1,0,3,"H","N","2010-03-20","201003200FLA"
"LAK",0,1,0,0,0,1,0,0,0,0,0,0,"H","N","2010-03-20","201003200LAK"
"NYI",0,0,0,0,0,0,0,1,0,0,0,1,"A","N","2010-03-20","201003200LAK"
"NJD",0,0,0,0,0,0,0,1,0,0,0,1,"H","N","2010-03-20","201003200NJD"
"STL",0,1,0,0,0,1,0,0,0,0,0,0,"A","N","2010-03-20","201003200NJD"
"CBJ",0,0,0,0,0,0,1,0,0,0,0,1,"A","N","2010-03-20","201003200NSH"
"NSH",1,0,0,0,0,1,0,0,0,0,0,0,"H","N","2010-03-20","201003200NSH"
"CHI",0,1,1,2,0,4,0,0,1,3,1,5,"A","Y","2010-03-20","201003200PHX"
"PHX",0,0,1,3,1,5,0,1,1,2,0,4,"H","Y","2010-03-20","201003200PHX"
"CAR",1,1,0,1,0,3,0,0,1,1,0,2,"A","N","2010-03-20","201003200PIT"
"PIT",0,0,1,1,0,2,1,1,0,1,0,3,"H","N","2010-03-20","201003200PIT"
"TBL",0,1,0,0,0,1,0,2,0,1,0,3,"H","N","2010-03-20","201003200TBL"
"WSH",0,2,0,1,0,3,0,1,0,0,0,1,"A","N","2010-03-20","201003200TBL"
"MTL",0,1,0,1,0,2,0,1,1,0,1,3,"A","Y","2010-03-20","201003200TOR"
"TOR",0,1,1,0,1,3,0,1,0,1,0,2,"H","Y","2010-03-20","201003200TOR"
"DET",1,0,3,0,0,4,0,2,0,1,0,3,"A","N","2010-03-20","201003200VAN"
"VAN",0,2,0,1,0,3,1,0,3,0,0,4,"H","N","2010-03-20","201003200VAN"
"ANA",0,2,2,1,0,5,0,0,0,2,0,2,"H","N","2010-03-21","201003210ANA"
"COL",0,0,0,2,0,2,0,2,2,1,0,5,"A","N","2010-03-21","201003210ANA"
"BOS",0,0,1,1,0,2,0,0,0,1,0,1,"H","N","2010-03-21","201003210BOS"
"NYR",0,0,0,1,0,1,0,0,1,1,0,2,"A","N","2010-03-21","201003210BOS"
"BUF",0,1,4,0,0,5,0,0,1,2,0,3,"A","N","2010-03-21","201003210CAR"
"CAR",0,0,1,2,0,3,0,1,4,0,0,5,"H","N","2010-03-21","201003210CAR"
"DAL",0,0,1,1,0,2,0,1,1,0,1,3,"H","Y","2010-03-21","201003210DAL"
"PHX",0,1,1,0,1,3,0,0,1,1,0,2,"A","Y","2010-03-21","201003210DAL"
"EDM",0,2,1,2,0,5,0,0,0,1,0,1,"H","N","2010-03-21","201003210EDM"
"SJS",0,0,0,1,0,1,0,2,1,2,0,5,"A","N","2010-03-21","201003210EDM"
"FLA",0,3,0,2,0,5,0,1,0,1,0,2,"H","N","2010-03-21","201003210FLA"
"TBL",0,1,0,1,0,2,0,3,0,2,0,5,"A","N","2010-03-21","201003210FLA"
"CGY",0,1,1,1,0,3,0,2,2,0,0,4,"A","N","2010-03-21","201003210MIN"
"MIN",0,2,2,0,0,4,0,1,1,1,0,3,"H","N","2010-03-21","201003210MIN"
"ATL",0,2,0,1,0,3,0,0,0,1,0,1,"A","N","2010-03-21","201003210PHI"
"PHI",0,0,0,1,0,1,0,2,0,1,0,3,"H","N","2010-03-21","201003210PHI"
"NSH",0,0,1,2,0,3,0,1,0,1,0,2,"A","N","2010-03-21","201003210STL"
"STL",0,1,0,1,0,2,0,0,1,2,0,3,"H","N","2010-03-21","201003210STL"
"DET",0,1,1,1,0,3,0,0,1,0,0,1,"H","N","2010-03-22","201003220DET"
"PIT",0,0,1,0,0,1,0,1,1,1,0,3,"A","N","2010-03-22","201003220DET"
"COL",0,1,0,2,0,3,1,1,1,1,0,4,"A","N","2010-03-22","201003220LAK"
"LAK",1,1,1,1,0,4,0,1,0,2,0,3,"H","N","2010-03-22","201003220LAK"
"MTL",0,0,0,0,0,0,0,1,0,1,0,2,"H","N","2010-03-22","201003220MTL"
"OTT",0,1,0,1,0,2,0,0,0,0,0,0,"A","N","2010-03-22","201003220MTL"
"ATL",0,0,0,0,0,0,0,1,2,1,0,4,"H","N","2010-03-23","201003230ATL"
"BOS",0,1,2,1,0,4,0,0,0,0,0,0,"A","N","2010-03-23","201003230ATL"
"ANA",0,0,1,0,0,1,0,1,1,1,0,3,"A","N","2010-03-23","201003230CGY"
"CGY",0,1,1,1,0,3,0,0,1,0,0,1,"H","N","2010-03-23","201003230CGY"
"CHI",0,0,2,0,0,2,0,0,0,0,0,0,"H","N","2010-03-23","201003230CHI"
"PHX",0,0,0,0,0,0,0,0,2,0,0,2,"A","N","2010-03-23","201003230CHI"
"EDM",0,2,1,0,0,3,0,1,1,0,0,2,"H","N","2010-03-23","201003230EDM"
"VAN",0,1,1,0,0,2,0,2,1,0,0,3,"A","N","2010-03-23","201003230EDM"
"MIN",0,0,1,0,0,1,0,1,1,2,0,4,"H","N","2010-03-23","201003230MIN"
"SJS",0,1,1,2,0,4,0,0,1,0,0,1,"A","N","2010-03-23","201003230MIN"
"CBJ",0,0,2,1,0,3,0,1,4,1,0,6,"A","N","2010-03-23","201003230NJD"
"NJD",0,1,4,1,0,6,0,0,2,1,0,3,"H","N","2010-03-23","201003230NJD"
"DAL",0,0,1,2,0,3,0,0,1,0,0,1,"A","N","2010-03-23","201003230NSH"
"NSH",0,0,1,0,0,1,0,0,1,2,0,3,"H","N","2010-03-23","201003230NSH"
"OTT",0,1,0,1,0,2,0,0,0,0,0,0,"H","N","2010-03-23","201003230OTT"
"PHI",0,0,0,0,0,0,0,1,0,1,0,2,"A","N","2010-03-23","201003230OTT"
"CAR",0,0,2,0,0,2,1,0,1,1,0,3,"A","N","2010-03-23","201003230TBL"
"TBL",1,0,1,1,0,3,0,0,2,0,0,2,"H","N","2010-03-23","201003230TBL"
"FLA",0,1,0,3,0,4,0,0,0,1,0,1,"A","N","2010-03-23","201003230TOR"
"TOR",0,0,0,1,0,1,0,1,0,3,0,4,"H","N","2010-03-23","201003230TOR"
"BUF",0,0,0,2,1,3,0,1,1,0,0,2,"H","Y","2010-03-24","201003240BUF"
"MTL",0,1,1,0,0,2,0,0,0,2,1,3,"A","Y","2010-03-24","201003240BUF"
"COL",0,3,0,0,1,4,0,1,0,2,0,3,"H","Y","2010-03-24","201003240COL"
"LAK",0,1,0,2,0,3,0,3,0,0,1,4,"A","Y","2010-03-24","201003240COL"
"DET",0,0,2,2,0,4,0,1,0,1,0,2,"H","N","2010-03-24","201003240DET"
"STL",0,1,0,1,0,2,0,0,2,2,0,4,"A","N","2010-03-24","201003240DET"
"NYI",0,0,0,0,0,0,0,3,0,2,0,5,"A","N","2010-03-24","201003240NYR"
"NYR",0,3,0,2,0,5,0,0,0,0,0,0,"H","N","2010-03-24","201003240NYR"
"ANA",0,0,0,1,0,1,0,2,1,1,0,4,"A","N","2010-03-24","201003240VAN"
"VAN",0,2,1,1,0,4,0,0,0,1,0,1,"H","N","2010-03-24","201003240VAN"
"PIT",0,0,2,1,0,3,0,0,1,2,1,4,"A","Y","2010-03-24","201003240WSH"
"WSH",0,0,1,2,1,4,0,0,2,1,0,3,"H","Y","2010-03-24","201003240WSH"
"ATL",0,1,0,0,0,1,1,1,0,0,0,2,"H","N","2010-03-25","201003250ATL"
"TOR",1,1,0,0,0,2,0,1,0,0,0,1,"A","N","2010-03-25","201003250ATL"
"BOS",0,1,1,1,0,3,0,2,2,1,0,5,"H","N","2010-03-25","201003250BOS"
"TBL",0,2,2,1,0,5,0,1,1,1,0,3,"A","N","2010-03-25","201003250BOS"
"CAR",0,2,0,0,1,3,0,0,1,1,0,2,"H","Y","2010-03-25","201003250CAR"
"WSH",0,0,1,1,0,2,0,2,0,0,1,3,"A","Y","2010-03-25","201003250CAR"
"CBJ",0,2,4,2,0,8,0,0,1,2,0,3,"H","N","2010-03-25","201003250CBJ"
"CHI",0,0,1,2,0,3,0,2,4,2,0,8,"A","N","2010-03-25","201003250CBJ"
"FLA",0,0,0,1,0,1,0,2,0,2,0,4,"A","N","2010-03-25","201003250MTL"
"MTL",0,2,0,2,0,4,0,0,0,1,0,1,"H","N","2010-03-25","201003250MTL"
"NJD",0,1,0,2,0,3,0,0,1,2,1,4,"H","Y","2010-03-25","201003250NJD"
"NYR",0,0,1,2,1,4,0,1,0,2,0,3,"A","Y","2010-03-25","201003250NJD"
"NSH",0,1,2,0,1,4,0,1,0,2,0,3,"H","Y","2010-03-25","201003250NSH"
"PHX",0,1,0,2,0,3,0,1,2,0,1,4,"A","Y","2010-03-25","201003250NSH"
"CGY",0,1,1,0,0,2,0,1,0,2,0,3,"A","N","2010-03-25","201003250NYI"
"NYI",0,1,0,2,0,3,0,1,1,0,0,2,"H","N","2010-03-25","201003250NYI"
"MIN",1,0,1,2,0,4,0,2,1,0,0,3,"A","N","2010-03-25","201003250PHI"
"PHI",0,2,1,0,0,3,1,0,1,2,0,4,"H","N","2010-03-25","201003250PHI"
"DAL",0,0,0,0,0,0,0,0,2,1,0,3,"A","N","2010-03-25","201003250SJS"
"SJS",0,0,2,1,0,3,0,0,0,0,0,0,"H","N","2010-03-25","201003250SJS"
"LAK",0,0,0,1,0,1,0,1,1,1,0,3,"A","N","2010-03-25","201003250STL"
"STL",0,1,1,1,0,3,0,0,0,1,0,1,"H","N","2010-03-25","201003250STL"
"BUF",0,0,1,1,0,2,0,1,2,1,0,4,"H","N","2010-03-26","201003260BUF"
"OTT",0,1,2,1,0,4,0,0,1,1,0,2,"A","N","2010-03-26","201003260BUF"
"DET",0,0,4,2,0,6,0,0,1,1,0,2,"H","N","2010-03-26","201003260DET"
"MIN",0,0,1,1,0,2,0,0,4,2,0,6,"A","N","2010-03-26","201003260DET"
"ANA",0,1,0,2,0,3,0,0,1,1,0,2,"A","N","2010-03-26","201003260EDM"
"EDM",0,0,1,1,0,2,0,1,0,2,0,3,"H","N","2010-03-26","201003260EDM"
"BOS",0,1,2,2,0,5,0,0,0,0,0,0,"H","N","2010-03-27","201003270BOS"
"CGY",0,0,0,0,0,0,0,1,2,2,0,5,"A","N","2010-03-27","201003270BOS"
"BUF",0,3,3,1,0,7,0,0,1,0,0,1,"H","N","2010-03-27","201003270BUF"
"TBL",0,0,1,0,0,1,0,3,3,1,0,7,"A","N","2010-03-27","201003270BUF"
"ATL",0,0,3,1,0,4,0,0,0,0,0,0,"A","N","2010-03-27","201003270CAR"
"CAR",0,0,0,0,0,0,0,0,3,1,0,4,"H","N","2010-03-27","201003270CAR"
"CBJ",0,0,1,2,0,3,1,2,0,1,0,4,"H","N","2010-03-27","201003270CBJ"
"NYI",1,2,0,1,0,4,0,0,1,2,0,3,"A","N","2010-03-27","201003270CBJ"
"DAL",0,0,3,1,0,4,0,1,0,0,0,1,"A","N","2010-03-27","201003270LAK"
"LAK",0,1,0,0,0,1,0,0,3,1,0,4,"H","N","2010-03-27","201003270LAK"
"MTL",0,0,2,0,0,2,0,1,2,1,0,4,"H","N","2010-03-27","201003270MTL"
"NJD",0,1,2,1,0,4,0,0,2,0,0,2,"A","N","2010-03-27","201003270MTL"
"DET",0,0,0,0,1,1,0,0,0,0,0,0,"A","Y","2010-03-27","201003270NSH"
"NSH",0,0,0,0,0,0,0,0,0,0,1,1,"H","Y","2010-03-27","201003270NSH"
"FLA",0,0,1,1,0,2,0,0,2,1,0,3,"A","N","2010-03-27","201003270OTT"
"OTT",0,0,2,1,0,3,0,0,1,1,0,2,"H","N","2010-03-27","201003270OTT"
"COL",0,1,1,0,0,2,0,1,2,3,0,6,"A","N","2010-03-27","201003270PHX"
"PHX",0,1,2,3,0,6,0,1,1,0,0,2,"H","N","2010-03-27","201003270PHX"
"PHI",0,1,0,0,0,1,0,1,1,2,0,4,"A","N","2010-03-27","201003270PIT"
"PIT",0,1,1,2,0,4,0,1,0,0,0,1,"H","N","2010-03-27","201003270PIT"
"SJS",0,0,3,1,0,4,0,1,0,1,0,2,"H","N","2010-03-27","201003270SJS"
"VAN",0,1,0,1,0,2,0,0,3,1,0,4,"A","N","2010-03-27","201003270SJS"
"NYR",0,2,0,0,0,2,1,0,1,1,0,3,"A","N","2010-03-27","201003270TOR"
"TOR",1,0,1,1,0,3,0,2,0,0,0,2,"H","N","2010-03-27","201003270TOR"
"CBJ",0,1,2,1,0,4,0,1,0,1,0,2,"A","N","2010-03-28","201003280CHI"
"CHI",0,1,0,1,0,2,0,1,2,1,0,4,"H","N","2010-03-28","201003280CHI"
"NJD",0,0,0,1,0,1,0,2,2,1,0,5,"A","N","2010-03-28","201003280PHI"
"PHI",0,2,2,1,0,5,0,0,0,1,0,1,"H","N","2010-03-28","201003280PHI"
"PIT",0,1,2,1,1,5,0,1,2,1,0,4,"H","Y","2010-03-28","201003280PIT"
"TOR",0,1,2,1,0,4,0,1,2,1,1,5,"A","Y","2010-03-28","201003280PIT"
"COL",0,0,2,1,0,3,0,1,1,2,0,4,"A","N","2010-03-28","201003280SJS"
"SJS",0,1,1,2,0,4,0,0,2,1,0,3,"H","N","2010-03-28","201003280SJS"
"EDM",0,1,0,0,0,1,0,0,1,1,0,2,"A","N","2010-03-28","201003280STL"
"STL",0,0,1,1,0,2,0,1,0,0,0,1,"H","N","2010-03-28","201003280STL"
"CGY",0,4,1,0,0,5,0,0,2,1,0,3,"A","N","2010-03-28","201003280WSH"
"WSH",0,0,2,1,0,3,0,4,1,0,0,5,"H","N","2010-03-28","201003280WSH"
"ANA",0,0,3,0,0,3,0,0,1,0,0,1,"H","N","2010-03-29","201003290ANA"
"DAL",0,0,1,0,0,1,0,0,3,0,0,3,"A","N","2010-03-29","201003290ANA"
"ATL",0,1,0,0,0,1,0,0,2,2,0,4,"H","N","2010-03-29","201003290ATL"
"CAR",0,0,2,2,0,4,0,1,0,0,0,1,"A","N","2010-03-29","201003290ATL"
"BOS",0,1,0,1,0,2,0,2,1,0,0,3,"H","N","2010-03-29","201003290BOS"
"BUF",0,2,1,0,0,3,0,1,0,1,0,2,"A","N","2010-03-29","201003290BOS"
"FLA",0,0,0,2,0,2,1,0,1,1,0,3,"H","N","2010-03-29","201003290FLA"
"NSH",1,0,1,1,0,3,0,0,0,2,0,2,"A","N","2010-03-29","201003290FLA"
"LAK",0,0,1,1,0,2,0,0,2,1,0,3,"A","N","2010-03-29","201003290MIN"
"MIN",0,0,2,1,0,3,0,0,1,1,0,2,"H","N","2010-03-29","201003290MIN"
"CBJ",0,1,0,2,0,3,0,1,1,0,0,2,"H","N","2010-03-30","201003300CBJ"
"TBL",0,1,1,0,0,2,0,1,0,2,0,3,"A","N","2010-03-30","201003300CBJ"
"DET",0,3,1,1,0,5,0,0,2,2,0,4,"H","N","2010-03-30","201003300DET"
"EDM",0,0,2,2,0,4,0,3,1,1,0,5,"A","N","2010-03-30","201003300DET"
"BOS",1,0,0,0,0,1,0,0,0,0,0,0,"A","N","2010-03-30","201003300NJD"
"NJD",0,0,0,0,0,0,1,0,0,0,0,1,"H","N","2010-03-30","201003300NJD"
"LAK",0,0,0,2,0,2,0,0,0,0,0,0,"A","N","2010-03-30","201003300NSH"
"NSH",0,0,0,0,0,0,0,0,0,2,0,2,"H","N","2010-03-30","201003300NSH"
"NYI",0,2,0,1,0,3,0,0,3,1,0,4,"H","N","2010-03-30","201003300NYI"
"NYR",0,0,3,1,0,4,0,2,0,1,0,3,"A","N","2010-03-30","201003300NYI"
"CHI",0,2,0,0,0,2,0,1,1,2,0,4,"A","N","2010-03-30","201003300STL"
"STL",0,1,1,2,0,4,0,2,0,0,0,2,"H","N","2010-03-30","201003300STL"
"ATL",0,0,2,1,0,3,0,0,1,1,0,2,"A","N","2010-03-30","201003300TOR"
"TOR",0,0,1,1,0,2,0,0,2,1,0,3,"H","N","2010-03-30","201003300TOR"
"PHX",0,1,0,0,0,1,0,3,1,0,0,4,"A","N","2010-03-30","201003300VAN"
"VAN",0,3,1,0,0,4,0,1,0,0,0,1,"H","N","2010-03-30","201003300VAN"
"OTT",1,3,0,1,0,5,0,1,2,1,0,4,"A","N","2010-03-30","201003300WSH"
"WSH",0,1,2,1,0,4,1,3,0,1,0,5,"H","N","2010-03-30","201003300WSH"
"BUF",0,2,2,2,0,6,0,1,0,1,0,2,"H","N","2010-03-31","201003310BUF"
"FLA",0,1,0,1,0,2,0,2,2,2,0,6,"A","N","2010-03-31","201003310BUF"
"CGY",0,0,1,1,0,2,0,0,0,1,0,1,"H","N","2010-03-31","201003310CGY"
"PHX",0,0,0,1,0,1,0,0,1,1,0,2,"A","N","2010-03-31","201003310CGY"
"ANA",0,2,1,2,0,5,0,0,1,1,0,2,"A","N","2010-03-31","201003310COL"
"COL",0,0,1,1,0,2,0,2,1,2,0,5,"H","N","2010-03-31","201003310COL"
"DAL",0,2,3,0,0,5,0,1,0,0,0,1,"H","N","2010-03-31","201003310DAL"
"SJS",0,1,0,0,0,1,0,2,3,0,0,5,"A","N","2010-03-31","201003310DAL"
"CHI",0,1,1,2,0,4,0,0,0,0,0,0,"A","N","2010-03-31","201003310MIN"
"MIN",0,0,0,0,0,0,0,1,1,2,0,4,"H","N","2010-03-31","201003310MIN"
"CAR",0,0,1,1,0,2,0,1,0,0,0,1,"A","N","2010-03-31","201003310MTL"
"MTL",0,1,0,0,0,1,0,0,1,1,0,2,"H","N","2010-03-31","201003310MTL"
"PIT",0,0,0,0,0,0,0,1,1,0,0,2,"H","N","2010-03-31","201003310PIT"
"TBL",0,1,1,0,0,2,0,0,0,0,0,0,"A","N","2010-03-31","201003310PIT"
"BOS",0,0,0,0,0,0,0,1,0,0,0,1,"H","N","2010-04-01","201004010BOS"
"FLA",0,1,0,0,0,1,0,0,0,0,0,0,"A","N","2010-04-01","201004010BOS"
"CBJ",0,1,0,1,0,2,0,1,1,1,0,3,"A","N","2010-04-01","201004010DET"
"DET",0,1,1,1,0,3,0,1,0,1,0,2,"H","N","2010-04-01","201004010DET"
"LAK",0,3,2,3,0,8,0,0,2,1,0,3,"H","N","2010-04-01","201004010LAK"
"VAN",0,0,2,1,0,3,0,3,2,3,0,8,"A","N","2010-04-01","201004010LAK"
"NSH",0,0,2,1,0,3,0,1,1,0,0,2,"H","N","2010-04-01","201004010NSH"
"STL",0,1,1,0,0,2,0,0,2,1,0,3,"A","N","2010-04-01","201004010NSH"
"NYI",0,3,1,2,0,6,0,0,1,3,0,4,"H","N","2010-04-01","201004010NYI"
"PHI",0,0,1,3,0,4,0,3,1,2,0,6,"A","N","2010-04-01","201004010NYI"
"CAR",0,0,2,1,0,3,0,1,0,2,1,4,"A","Y","2010-04-01","201004010OTT"
"OTT",0,1,0,2,1,4,0,0,2,1,0,3,"H","Y","2010-04-01","201004010OTT"
"BUF",0,1,1,0,0,2,0,1,1,2,0,4,"A","N","2010-04-01","201004010TOR"
"TOR",0,1,1,2,0,4,0,1,1,0,0,2,"H","N","2010-04-01","201004010TOR"
"ATL",0,0,1,0,0,1,0,1,0,1,0,2,"A","N","2010-04-01","201004010WSH"
"WSH",0,1,0,1,0,2,0,0,1,0,0,1,"H","N","2010-04-01","201004010WSH"
"ANA",0,0,2,2,0,4,0,0,1,3,0,4,"H","N","2010-04-02","201004020ANA"
"VAN",0,0,1,3,0,4,0,0,2,2,0,4,"A","N","2010-04-02","201004020ANA"
"CGY",0,0,1,1,0,2,0,0,0,1,0,1,"A","N","2010-04-02","201004020COL"
"COL",0,0,0,1,0,1,0,0,1,1,0,2,"H","N","2010-04-02","201004020COL"
"DAL",0,3,0,3,0,6,0,0,3,0,0,3,"H","N","2010-04-02","201004020DAL"
"EDM",0,0,3,0,0,3,0,3,0,3,0,6,"A","N","2010-04-02","201004020DAL"
"MIN",0,0,2,0,0,2,0,2,0,1,0,3,"H","N","2010-04-02","201004020MIN"
"SJS",0,2,0,1,0,3,0,0,2,0,0,2,"A","N","2010-04-02","201004020MIN"
"CHI",0,0,0,1,1,2,0,1,0,0,0,1,"A","Y","2010-04-02","201004020NJD"
"NJD",0,1,0,0,0,1,0,0,0,1,1,2,"H","Y","2010-04-02","201004020NJD"
"MTL",0,1,0,0,0,1,0,0,0,0,0,0,"A","N","2010-04-02","201004020PHI"
"PHI",0,0,0,0,0,0,0,1,0,0,0,1,"H","N","2010-04-02","201004020PHI"
"NYR",0,4,0,1,0,5,0,0,0,0,0,0,"A","N","2010-04-02","201004020TBL"
"TBL",0,0,0,0,0,0,0,4,0,1,0,5,"H","N","2010-04-02","201004020TBL"
"CAR",0,0,0,0,0,0,0,2,0,2,0,4,"H","N","2010-04-03","201004030CAR"
"NJD",0,2,0,2,0,4,0,0,0,0,0,0,"A","N","2010-04-03","201004030CAR"
"CBJ",0,1,0,1,0,2,0,3,0,0,0,3,"H","N","2010-04-03","201004030CBJ"
"WSH",0,3,0,0,0,3,0,1,0,1,0,2,"A","N","2010-04-03","201004030CBJ"
"DET",0,1,1,1,0,3,1,0,3,0,0,4,"H","N","2010-04-03","201004030DET"
"NSH",1,0,3,0,0,4,0,1,1,1,0,3,"A","N","2010-04-03","201004030DET"
"FLA",0,0,1,0,0,1,0,0,0,4,0,4,"H","N","2010-04-03","201004030FLA"
"NYR",0,0,0,4,0,4,0,0,1,0,0,1,"A","N","2010-04-03","201004030FLA"
"ANA",0,0,0,1,1,2,0,1,0,0,0,1,"A","Y","2010-04-03","201004030LAK"
"LAK",0,1,0,0,0,1,0,0,0,1,1,2,"H","Y","2010-04-03","201004030LAK"
"BUF",0,0,0,0,0,0,0,1,1,1,0,3,"A","N","2010-04-03","201004030MTL"
"MTL",0,1,1,1,0,3,0,0,0,0,0,0,"H","N","2010-04-03","201004030MTL"
"NYI",0,0,3,1,0,4,0,0,0,1,0,1,"H","N","2010-04-03","201004030NYI"
"OTT",0,0,0,1,0,1,0,0,3,1,0,4,"A","N","2010-04-03","201004030NYI"
"EDM",0,1,0,1,0,2,0,1,1,0,1,3,"A","Y","2010-04-03","201004030PHX"
"PHX",0,1,1,0,1,3,0,1,0,1,0,2,"H","Y","2010-04-03","201004030PHX"
"ATL",0,1,1,1,0,3,1,0,1,2,0,4,"A","N","2010-04-03","201004030PIT"
"PIT",1,0,1,2,0,4,0,1,1,1,0,3,"H","N","2010-04-03","201004030PIT"
"DAL",0,0,1,0,0,1,0,0,1,1,0,2,"A","N","2010-04-03","201004030STL"
"STL",0,0,1,1,0,2,0,0,1,0,0,1,"H","N","2010-04-03","201004030STL"
"BOS",1,0,1,0,0,2,0,1,0,0,0,1,"A","N","2010-04-03","201004030TOR"
"TOR",0,1,0,0,0,1,1,0,1,0,0,2,"H","N","2010-04-03","201004030TOR"
"CGY",0,0,1,0,0,1,0,2,1,1,0,4,"A","N","2010-04-04","201004040CHI"
"CHI",0,2,1,1,0,4,0,0,1,0,0,1,"H","N","2010-04-04","201004040CHI"
"COL",1,1,2,1,0,5,0,2,0,2,0,4,"H","N","2010-04-04","201004040COL"
"SJS",0,2,0,2,0,4,1,1,2,1,0,5,"A","N","2010-04-04","201004040COL"
"DET",0,2,0,1,0,3,0,2,2,0,0,4,"A","N","2010-04-04","201004040PHI"
"PHI",0,2,2,0,0,4,0,2,0,1,0,3,"H","N","2010-04-04","201004040PHI"
"MIN",0,0,0,3,0,3,1,1,1,1,0,4,"A","N","2010-04-04","201004040VAN"
"VAN",1,1,1,1,0,4,0,0,0,3,0,3,"H","N","2010-04-04","201004040VAN"
"EDM",0,2,0,2,0,4,0,0,1,0,0,1,"H","N","2010-04-05","201004050EDM"
"MIN",0,0,1,0,0,1,0,2,0,2,0,4,"A","N","2010-04-05","201004050EDM"
"CBJ",0,1,0,0,0,1,1,0,1,0,0,2,"A","N","2010-04-05","201004050STL"
"STL",1,0,1,0,0,2,0,1,0,0,0,1,"H","N","2010-04-05","201004050STL"
"BOS",0,1,1,0,0,2,1,1,1,0,0,3,"A","N","2010-04-05","201004050WSH"
"WSH",1,1,1,0,0,3,0,1,1,0,0,2,"H","N","2010-04-05","201004050WSH"
"ANA",0,2,2,0,0,4,0,0,2,2,1,5,"H","Y","2010-04-06","201004060ANA"
"LAK",0,0,2,2,1,5,0,2,2,0,0,4,"A","Y","2010-04-06","201004060ANA"
"ATL",0,0,0,0,0,0,0,1,1,1,0,3,"H","N","2010-04-06","201004060ATL"
"NJD",0,1,1,1,0,3,0,0,0,0,0,0,"A","N","2010-04-06","201004060ATL"
"BUF",0,2,2,1,0,5,0,2,0,0,0,2,"H","N","2010-04-06","201004060BUF"
"NYR",0,2,0,0,0,2,0,2,2,1,0,5,"A","N","2010-04-06","201004060BUF"
"CGY",0,0,0,1,0,1,0,1,1,0,0,2,"H","N","2010-04-06","201004060CGY"
"SJS",0,1,1,0,0,2,0,0,0,1,0,1,"A","N","2010-04-06","201004060CGY"
"CHI",0,2,1,2,0,5,0,0,1,1,0,2,"A","N","2010-04-06","201004060DAL"
"DAL",0,0,1,1,0,2,0,2,1,2,0,5,"H","N","2010-04-06","201004060DAL"
"FLA",0,0,1,1,0,2,0,1,2,2,0,5,"H","N","2010-04-06","201004060FLA"
"OTT",0,1,2,2,0,5,0,0,1,1,0,2,"A","N","2010-04-06","201004060FLA"
"MTL",0,0,2,1,0,3,0,1,0,2,1,4,"A","Y","2010-04-06","201004060NYI"
"NYI",0,1,0,2,1,4,0,0,2,1,0,3,"H","Y","2010-04-06","201004060NYI"
"PIT",0,0,2,1,0,3,0,1,3,2,0,6,"H","N","2010-04-06","201004060PIT"
"WSH",0,1,3,2,0,6,0,0,2,1,0,3,"A","N","2010-04-06","201004060PIT"
"CAR",0,5,2,1,0,8,0,1,2,2,0,5,"A","N","2010-04-06","201004060TBL"
"TBL",0,1,2,2,0,5,0,5,2,1,0,8,"H","N","2010-04-06","201004060TBL"
"PHI",0,1,0,1,0,2,0,0,0,0,0,0,"A","N","2010-04-06","201004060TOR"
"TOR",0,0,0,0,0,0,0,1,0,1,0,2,"H","N","2010-04-06","201004060TOR"
"COL",0,2,1,0,1,4,0,1,1,1,0,3,"A","Y","2010-04-06","201004060VAN"
"VAN",0,1,1,1,0,3,0,2,1,0,1,4,"H","Y","2010-04-06","201004060VAN"
"CHI",0,4,2,0,0,6,0,1,1,3,0,5,"H","N","2010-04-07","201004070CHI"
"STL",0,1,1,3,0,5,0,4,2,0,0,6,"A","N","2010-04-07","201004070CHI"
"CBJ",0,2,0,1,0,3,0,1,0,3,0,4,"A","N","2010-04-07","201004070DET"
"DET",0,1,0,3,0,4,0,2,0,1,0,3,"H","N","2010-04-07","201004070DET"
"COL",0,3,0,1,0,4,1,2,1,1,0,5,"A","N","2010-04-07","201004070EDM"
"EDM",1,2,1,1,0,5,0,3,0,1,0,4,"H","N","2010-04-07","201004070EDM"
"NYR",0,3,0,2,0,5,0,0,0,1,0,1,"H","N","2010-04-07","201004070NYR"
"TOR",0,0,0,1,0,1,0,3,0,2,0,5,"A","N","2010-04-07","201004070NYR"
"NSH",0,1,0,1,0,2,0,1,1,3,0,5,"A","N","2010-04-07","201004070PHX"
"PHX",0,1,1,3,0,5,0,1,0,1,0,2,"H","N","2010-04-07","201004070PHX"
"BOS",0,0,1,2,0,3,0,1,0,0,0,1,"H","N","2010-04-08","201004080BOS"
"BUF",0,1,0,0,0,1,0,0,1,2,0,3,"A","N","2010-04-08","201004080BOS"
"CAR",0,0,2,3,0,5,0,0,1,1,0,2,"H","N","2010-04-08","201004080CAR"
"MTL",0,0,1,1,0,2,0,0,2,3,0,5,"A","N","2010-04-08","201004080CAR"
"CGY",0,0,1,0,0,1,0,1,0,0,1,2,"H","Y","2010-04-08","201004080CGY"
"MIN",0,1,0,0,1,2,0,0,1,0,0,1,"A","Y","2010-04-08","201004080CGY"
"ANA",0,0,1,1,0,2,0,0,1,1,1,3,"A","Y","2010-04-08","201004080DAL"
"DAL",0,0,1,1,1,3,0,0,1,1,0,2,"H","Y","2010-04-08","201004080DAL"
"FLA",0,0,1,2,0,3,0,0,1,1,0,2,"H","N","2010-04-08","201004080FLA"
"NJD",0,0,1,1,0,2,0,0,1,2,0,3,"A","N","2010-04-08","201004080FLA"
"LAK",0,0,1,1,0,2,0,0,0,2,1,3,"H","Y","2010-04-08","201004080LAK"
"PHX",0,0,0,2,1,3,0,0,1,1,0,2,"A","Y","2010-04-08","201004080LAK"
"NYI",0,2,1,0,0,3,0,4,2,1,0,7,"A","N","2010-04-08","201004080PIT"
"PIT",0,4,2,1,0,7,0,2,1,0,0,3,"H","N","2010-04-08","201004080PIT"
"SJS",0,1,3,0,0,4,0,0,0,2,0,2,"H","N","2010-04-08","201004080SJS"
"VAN",0,0,0,2,0,2,0,1,3,0,0,4,"A","N","2010-04-08","201004080SJS"
"OTT",0,0,2,1,0,3,0,2,1,0,1,4,"A","Y","2010-04-08","201004080TBL"
"TBL",0,2,1,0,1,4,0,0,2,1,0,3,"H","Y","2010-04-08","201004080TBL"
"CBJ",0,0,0,0,0,0,0,0,0,0,1,1,"H","Y","2010-04-09","201004090CBJ"
"DET",0,0,0,0,1,1,0,0,0,0,0,0,"A","Y","2010-04-09","201004090CBJ"
"CHI",0,2,1,2,0,5,0,0,1,1,0,2,"A","N","2010-04-09","201004090COL"
"COL",0,0,1,1,0,2,0,2,1,2,0,5,"H","N","2010-04-09","201004090COL"
"NYR",0,2,2,0,0,4,0,1,2,0,0,3,"H","N","2010-04-09","201004090NYR"
"PHI",0,1,2,0,0,3,0,2,2,0,0,4,"A","N","2010-04-09","201004090NYR"
"ANA",0,1,2,0,0,3,0,1,1,4,0,6,"A","N","2010-04-09","201004090STL"
"STL",0,1,1,4,0,6,0,1,2,0,0,3,"H","N","2010-04-09","201004090STL"
"ATL",0,0,2,0,0,2,0,1,1,3,0,5,"A","N","2010-04-09","201004090WSH"
"WSH",0,1,1,3,0,5,0,0,2,0,0,2,"H","N","2010-04-09","201004090WSH"
"ATL",0,0,1,0,0,1,0,0,0,0,0,0,"H","N","2010-04-10","201004100ATL"
"PIT",0,0,0,0,0,0,0,0,1,0,0,1,"A","N","2010-04-10","201004100ATL"
"BOS",0,0,3,1,0,4,0,0,2,0,0,2,"H","N","2010-04-10","201004100BOS"
"CAR",0,0,2,0,0,2,0,0,3,1,0,4,"A","N","2010-04-10","201004100BOS"
"EDM",0,1,1,1,1,4,0,0,0,3,0,3,"A","Y","2010-04-10","201004100LAK"
"LAK",0,0,0,3,0,3,0,1,1,1,1,4,"H","Y","2010-04-10","201004100LAK"
"DAL",0,0,2,1,1,4,0,2,0,1,0,3,"A","Y","2010-04-10","201004100MIN"
"MIN",0,2,0,1,0,3,0,0,2,1,1,4,"H","Y","2010-04-10","201004100MIN"
"MTL",0,2,1,0,0,3,1,1,1,1,0,4,"H","N","2010-04-10","201004100MTL"
"TOR",1,1,1,1,0,4,0,2,1,0,0,3,"A","N","2010-04-10","201004100MTL"
"NJD",0,3,2,2,0,7,0,0,0,1,0,1,"H","N","2010-04-10","201004100NJD"
"NYI",0,0,0,1,0,1,0,3,2,2,0,7,"A","N","2010-04-10","201004100NJD"
"NSH",0,0,0,1,1,2,0,0,0,1,0,1,"H","Y","2010-04-10","201004100NSH"
"STL",0,0,0,1,0,1,0,0,0,1,1,2,"A","Y","2010-04-10","201004100NSH"
"BUF",0,2,2,1,0,5,0,0,1,1,0,2,"A","N","2010-04-10","201004100OTT"
"OTT",0,0,1,1,0,2,0,2,2,1,0,5,"H","N","2010-04-10","201004100OTT"
"PHX",0,0,1,1,0,2,0,1,1,0,1,3,"A","Y","2010-04-10","201004100SJS"
"SJS",0,1,1,0,1,3,0,0,1,1,0,2,"H","Y","2010-04-10","201004100SJS"
"FLA",0,1,1,1,0,3,0,1,2,0,1,4,"A","Y","2010-04-10","201004100TBL"
"TBL",0,1,2,0,1,4,0,1,1,1,0,3,"H","Y","2010-04-10","201004100TBL"
"CGY",0,1,1,1,0,3,0,3,1,3,0,7,"A","N","2010-04-10","201004100VAN"
"VAN",0,3,1,3,0,7,0,1,1,1,0,3,"H","N","2010-04-10","201004100VAN"
"ANA",0,3,1,3,0,7,0,1,0,1,0,2,"H","N","2010-04-11","201004110ANA"
"EDM",0,1,0,1,0,2,0,3,1,3,0,7,"A","N","2010-04-11","201004110ANA"
"CHI",0,1,0,1,0,2,1,0,1,1,0,3,"H","N","2010-04-11","201004110CHI"
"DET",1,0,1,1,0,3,0,1,0,1,0,2,"A","N","2010-04-11","201004110CHI"
"COL",0,1,0,0,0,1,1,0,0,1,0,2,"H","N","2010-04-11","201004110COL"
"LAK",1,0,0,1,0,2,0,1,0,0,0,1,"A","N","2010-04-11","201004110COL"
"FLA",0,1,0,0,0,1,0,2,0,1,0,3,"H","N","2010-04-11","201004110FLA"
"TBL",0,2,0,1,0,3,0,1,0,0,0,1,"A","N","2010-04-11","201004110FLA"
"BUF",0,0,1,0,0,1,0,0,1,1,0,2,"A","N","2010-04-11","201004110NJD"
"NJD",0,0,1,1,0,2,0,0,1,0,0,1,"H","N","2010-04-11","201004110NJD"
"NYI",0,1,1,3,0,5,1,3,2,0,0,6,"H","N","2010-04-11","201004110NYI"
"PIT",1,3,2,0,0,6,0,1,1,3,0,5,"A","N","2010-04-11","201004110NYI"
"NYR",0,1,0,0,0,1,0,0,0,1,1,2,"A","Y","2010-04-11","201004110PHI"
"PHI",0,0,0,1,1,2,0,1,0,0,0,1,"H","Y","2010-04-11","201004110PHI"
"BOS",0,2,0,1,1,4,0,2,0,1,0,3,"A","Y","2010-04-11","201004110WSH"
"WSH",0,2,0,1,0,3,0,2,0,1,1,4,"H","Y","2010-04-11","201004110WSH"
"NJD",0,0,0,1,0,1,0,0,2,0,0,2,"H","N","2010-04-14","201004140NJD"
"PHI",0,0,2,0,0,2,0,0,0,1,0,1,"A","N","2010-04-14","201004140NJD"
"DET",0,2,0,0,0,2,0,1,1,1,0,3,"A","N","2010-04-14","201004140PHX"
"PHX",0,1,1,1,0,3,0,2,0,0,0,2,"H","N","2010-04-14","201004140PHX"
"OTT",0,2,2,1,0,5,0,1,1,2,0,4,"A","N","2010-04-14","201004140PIT"
"PIT",0,1,1,2,0,4,0,2,2,1,0,5,"H","N","2010-04-14","201004140PIT"
"COL",0,0,1,1,0,2,0,0,0,1,0,1,"A","N","2010-04-14","201004140SJS"
"SJS",0,0,0,1,0,1,0,0,1,1,0,2,"H","N","2010-04-14","201004140SJS"
"BOS",0,0,1,0,0,1,0,1,1,0,0,2,"A","N","2010-04-15","201004150BUF"
"BUF",0,1,1,0,0,2,0,0,1,0,0,1,"H","N","2010-04-15","201004150BUF"
"LAK",0,0,2,0,0,2,1,0,2,0,0,3,"A","N","2010-04-15","201004150VAN"
"VAN",1,0,2,0,0,3,0,0,2,0,0,2,"H","N","2010-04-15","201004150VAN"
"MTL",1,1,0,1,0,3,0,1,0,1,0,2,"A","N","2010-04-15","201004150WSH"
"WSH",0,1,0,1,0,2,1,1,0,1,0,3,"H","N","2010-04-15","201004150WSH"
"CHI",0,0,1,0,0,1,0,0,0,4,0,4,"H","N","2010-04-16","201004160CHI"
"NSH",0,0,0,4,0,4,0,0,1,0,0,1,"A","N","2010-04-16","201004160CHI"
"NJD",0,1,2,2,0,5,0,2,1,0,0,3,"H","N","2010-04-16","201004160NJD"
"PHI",0,2,1,0,0,3,0,1,2,2,0,5,"A","N","2010-04-16","201004160NJD"
"DET",0,0,3,4,0,7,0,1,2,1,0,4,"A","N","2010-04-16","201004160PHX"
"PHX",0,1,2,1,0,4,0,0,3,4,0,7,"H","N","2010-04-16","201004160PHX"
"OTT",0,1,0,0,0,1,0,1,0,1,0,2,"A","N","2010-04-16","201004160PIT"
"PIT",0,1,0,1,0,2,0,1,0,0,0,1,"H","N","2010-04-16","201004160PIT"
"COL",0,1,3,1,0,5,1,1,3,1,0,6,"A","N","2010-04-16","201004160SJS"
"SJS",1,1,3,1,0,6,0,1,3,1,0,5,"H","N","2010-04-16","201004160SJS"
"BOS",0,0,2,3,0,5,0,2,1,0,0,3,"A","N","2010-04-17","201004170BUF"
"BUF",0,2,1,0,0,3,0,0,2,3,0,5,"H","N","2010-04-17","201004170BUF"
"LAK",1,0,2,0,0,3,0,2,0,0,0,2,"A","N","2010-04-17","201004170VAN"
"VAN",0,2,0,0,0,2,1,0,2,0,0,3,"H","N","2010-04-17","201004170VAN"
"MTL",0,2,2,1,0,5,1,1,1,3,0,6,"A","N","2010-04-17","201004170WSH"
"WSH",1,1,1,3,0,6,0,2,2,1,0,5,"H","N","2010-04-17","201004170WSH"
"CHI",0,0,1,1,0,2,0,0,0,0,0,0,"H","N","2010-04-18","201004180CHI"
"NSH",0,0,0,0,0,0,0,0,1,1,0,2,"A","N","2010-04-18","201004180CHI"
"COL",1,0,0,0,0,1,0,0,0,0,0,0,"H","N","2010-04-18","201004180COL"
"SJS",0,0,0,0,0,0,1,0,0,0,0,1,"A","N","2010-04-18","201004180COL"
"DET",0,1,0,1,0,2,0,1,1,2,0,4,"H","N","2010-04-18","201004180DET"
"PHX",0,1,1,2,0,4,0,1,0,1,0,2,"A","N","2010-04-18","201004180DET"
"OTT",0,0,1,1,0,2,0,1,2,1,0,4,"H","N","2010-04-18","201004180OTT"
"PIT",0,1,2,1,0,4,0,0,1,1,0,2,"A","N","2010-04-18","201004180OTT"
"NJD",0,1,1,0,0,2,1,1,1,0,0,3,"A","N","2010-04-18","201004180PHI"
"PHI",1,1,1,0,0,3,0,1,1,0,0,2,"H","N","2010-04-18","201004180PHI"
"BOS",0,1,0,1,0,2,0,1,0,0,0,1,"H","N","2010-04-19","201004190BOS"
"BUF",0,1,0,0,0,1,0,1,0,1,0,2,"A","N","2010-04-19","201004190BOS"
"LAK",0,1,3,1,0,5,0,1,1,1,0,3,"H","N","2010-04-19","201004190LAK"
"VAN",0,1,1,1,0,3,0,1,3,1,0,5,"A","N","2010-04-19","201004190LAK"
"MTL",0,0,0,1,0,1,0,0,4,1,0,5,"H","N","2010-04-19","201004190MTL"
"WSH",0,0,4,1,0,5,0,0,0,1,0,1,"A","N","2010-04-19","201004190MTL"
"COL",0,0,1,0,0,1,1,1,0,0,0,2,"H","N","2010-04-20","201004200COL"
"SJS",1,1,0,0,0,2,0,0,1,0,0,1,"A","N","2010-04-20","201004200COL"
"DET",0,0,1,2,0,3,0,0,0,0,0,0,"H","N","2010-04-20","201004200DET"
"PHX",0,0,0,0,0,0,0,0,1,2,0,3,"A","N","2010-04-20","201004200DET"
"CHI",0,1,0,0,0,1,0,1,2,1,0,4,"A","N","2010-04-20","201004200NSH"
"NSH",0,1,2,1,0,4,0,1,0,0,0,1,"H","N","2010-04-20","201004200NSH"
"OTT",0,0,3,1,0,4,0,1,5,1,0,7,"H","N","2010-04-20","201004200OTT"
"PIT",0,1,5,1,0,7,0,0,3,1,0,4,"A","N","2010-04-20","201004200OTT"
"NJD",0,1,0,0,0,1,0,0,2,2,0,4,"A","N","2010-04-20","201004200PHI"
"PHI",0,0,2,2,0,4,0,1,0,0,0,1,"H","N","2010-04-20","201004200PHI"
"BOS",1,0,0,2,0,3,0,1,1,0,0,2,"H","N","2010-04-21","201004210BOS"
"BUF",0,1,1,0,0,2,1,0,0,2,0,3,"A","N","2010-04-21","201004210BOS"
"LAK",0,1,2,1,0,4,0,0,2,4,0,6,"H","N","2010-04-21","201004210LAK"
"VAN",0,0,2,4,0,6,0,1,2,1,0,4,"A","N","2010-04-21","201004210LAK"
"MTL",0,1,1,1,0,3,0,1,1,4,0,6,"H","N","2010-04-21","201004210MTL"
"WSH",0,1,1,4,0,6,0,1,1,1,0,3,"A","N","2010-04-21","201004210MTL"
"NJD",0,0,0,0,0,0,0,1,2,0,0,3,"H","N","2010-04-22","201004220NJD"
"PHI",0,1,2,0,0,3,0,0,0,0,0,0,"A","N","2010-04-22","201004220NJD"
"CHI",0,1,2,0,0,3,0,0,0,0,0,0,"A","N","2010-04-22","201004220NSH"
"NSH",0,0,0,0,0,0,0,1,2,0,0,3,"H","N","2010-04-22","201004220NSH"
"OTT",1,2,0,1,0,4,0,1,1,1,0,3,"A","N","2010-04-22","201004220PIT"
"PIT",0,1,1,1,0,3,1,2,0,1,0,4,"H","N","2010-04-22","201004220PIT"
"COL",0,0,0,0,0,0,0,0,3,2,0,5,"A","N","2010-04-22","201004220SJS"
"SJS",0,0,3,2,0,5,0,0,0,0,0,0,"H","N","2010-04-22","201004220SJS"
"BOS",0,0,0,1,0,1,0,2,1,1,0,4,"A","N","2010-04-23","201004230BUF"
"BUF",0,2,1,1,0,4,0,0,0,1,0,1,"H","N","2010-04-23","201004230BUF"
"DET",0,1,0,3,0,4,0,0,1,0,0,1,"A","N","2010-04-23","201004230PHX"
"PHX",0,0,1,0,0,1,0,1,0,3,0,4,"H","N","2010-04-23","201004230PHX"
"LAK",0,1,0,1,0,2,0,2,2,3,0,7,"A","N","2010-04-23","201004230VAN"
"VAN",0,2,2,3,0,7,0,1,0,1,0,2,"H","N","2010-04-23","201004230VAN"
"MTL",0,2,0,0,0,2,0,0,1,0,0,1,"A","N","2010-04-23","201004230WSH"
"WSH",0,0,1,0,0,1,0,2,0,0,0,2,"H","N","2010-04-23","201004230WSH"
"CHI",1,2,1,1,0,5,0,1,1,2,0,4,"H","N","2010-04-24","201004240CHI"
"NSH",0,1,1,2,0,4,1,2,1,1,0,5,"A","N","2010-04-24","201004240CHI"
"COL",0,0,1,1,0,2,0,1,0,4,0,5,"H","N","2010-04-24","201004240COL"
"SJS",0,1,0,4,0,5,0,0,1,1,0,2,"A","N","2010-04-24","201004240COL"
"OTT",0,1,2,0,0,3,1,0,1,2,0,4,"H","N","2010-04-24","201004240OTT"
"PIT",1,0,1,2,0,4,0,1,2,0,0,3,"A","N","2010-04-24","201004240OTT"
"DET",0,0,1,1,0,2,0,1,3,1,0,5,"H","N","2010-04-25","201004250DET"
"PHX",0,1,3,1,0,5,0,0,1,1,0,2,"A","N","2010-04-25","201004250DET"
"LAK",0,1,1,0,0,2,0,0,1,3,0,4,"H","N","2010-04-25","201004250LAK"
"VAN",0,0,1,3,0,4,0,1,1,0,0,2,"A","N","2010-04-25","201004250LAK"
"BOS",0,1,1,2,0,4,0,0,1,2,0,3,"H","N","2010-04-26","201004260BOS"
"BUF",0,0,1,2,0,3,0,1,1,2,0,4,"A","N","2010-04-26","201004260BOS"
"MTL",0,2,0,2,0,4,0,0,0,1,0,1,"H","N","2010-04-26","201004260MTL"
"WSH",0,0,0,1,0,1,0,2,0,2,0,4,"A","N","2010-04-26","201004260MTL"
"CHI",0,4,0,1,0,5,0,3,0,0,0,3,"A","N","2010-04-26","201004260NSH"
"NSH",0,3,0,0,0,3,0,4,0,1,0,5,"H","N","2010-04-26","201004260NSH"
"DET",0,0,4,2,0,6,0,0,1,0,0,1,"A","N","2010-04-27","201004270PHX"
"PHX",0,0,1,0,0,1,0,0,4,2,0,6,"H","N","2010-04-27","201004270PHX"
"MTL",0,1,0,1,0,2,0,0,0,1,0,1,"A","N","2010-04-28","201004280WSH"
"WSH",0,0,0,1,0,1,0,1,0,1,0,2,"H","N","2010-04-28","201004280WSH"
"DET",0,1,1,1,0,3,0,3,0,1,0,4,"A","N","2010-04-29","201004290SJS"
"SJS",0,3,0,1,0,4,0,1,1,1,0,3,"H","N","2010-04-29","201004290SJS"
"MTL",0,1,1,1,0,3,0,2,2,2,0,6,"A","N","2010-04-30","201004300PIT"
"PIT",0,2,2,2,0,6,0,1,1,1,0,3,"H","N","2010-04-30","201004300PIT"
"BOS",1,2,1,1,0,5,0,0,2,2,0,4,"H","N","2010-05-01","201005010BOS"
"PHI",0,0,2,2,0,4,1,2,1,1,0,5,"A","N","2010-05-01","201005010BOS"
"CHI",0,0,0,1,0,1,0,2,3,0,0,5,"H","N","2010-05-01","201005010CHI"
"VAN",0,2,3,0,0,5,0,0,0,1,0,1,"A","N","2010-05-01","201005010CHI"
"MTL",0,1,1,1,0,3,0,1,0,0,0,1,"A","N","2010-05-02","201005020PIT"
"PIT",0,1,0,0,0,1,0,1,1,1,0,3,"H","N","2010-05-02","201005020PIT"
"DET",0,2,1,0,0,3,0,2,0,2,0,4,"A","N","2010-05-02","201005020SJS"
"SJS",0,2,0,2,0,4,0,2,1,0,0,3,"H","N","2010-05-02","201005020SJS"
"BOS",0,1,1,1,0,3,0,1,1,0,0,2,"H","N","2010-05-03","201005030BOS"
"PHI",0,1,1,0,0,2,0,1,1,1,0,3,"A","N","2010-05-03","201005030BOS"
"CHI",0,1,0,3,0,4,0,2,0,0,0,2,"H","N","2010-05-03","201005030CHI"
"VAN",0,2,0,0,0,2,0,1,0,3,0,4,"A","N","2010-05-03","201005030CHI"
"DET",0,2,1,0,0,3,1,1,0,2,0,4,"H","N","2010-05-04","201005040DET"
"SJS",1,1,0,2,0,4,0,2,1,0,0,3,"A","N","2010-05-04","201005040DET"
"MTL",0,0,0,0,0,0,0,0,0,2,0,2,"H","N","2010-05-04","201005040MTL"
"PIT",0,0,0,2,0,2,0,0,0,0,0,0,"A","N","2010-05-04","201005040MTL"
"BOS",0,2,0,2,0,4,0,1,0,0,0,1,"A","N","2010-05-05","201005050PHI"
"PHI",0,1,0,0,0,1,0,2,0,2,0,4,"H","N","2010-05-05","201005050PHI"
"CHI",0,2,1,2,0,5,0,0,2,0,0,2,"A","N","2010-05-05","201005050VAN"
"VAN",0,0,2,0,0,2,0,2,1,2,0,5,"H","N","2010-05-05","201005050VAN"
"DET",0,5,1,1,0,7,0,0,1,0,0,1,"H","N","2010-05-06","201005060DET"
"SJS",0,0,1,0,0,1,0,5,1,1,0,7,"A","N","2010-05-06","201005060DET"
"MTL",0,1,0,2,0,3,0,2,0,0,0,2,"H","N","2010-05-06","201005060MTL"
"PIT",0,2,0,0,0,2,0,1,0,2,0,3,"A","N","2010-05-06","201005060MTL"
"BOS",0,1,1,2,0,4,1,1,2,1,0,5,"A","N","2010-05-07","201005070PHI"
"PHI",1,1,2,1,0,5,0,1,1,2,0,4,"H","N","2010-05-07","201005070PHI"
"CHI",0,2,3,2,0,7,0,2,1,1,0,4,"A","N","2010-05-07","201005070VAN"
"VAN",0,2,1,1,0,4,0,2,3,2,0,7,"H","N","2010-05-07","201005070VAN"
"MTL",0,0,0,1,0,1,0,1,1,0,0,2,"A","N","2010-05-08","201005080PIT"
"PIT",0,1,1,0,0,2,0,0,0,1,0,1,"H","N","2010-05-08","201005080PIT"
"DET",0,0,1,0,0,1,0,0,1,1,0,2,"A","N","2010-05-08","201005080SJS"
"SJS",0,0,1,1,0,2,0,0,1,0,0,1,"H","N","2010-05-08","201005080SJS"
"CHI",0,0,0,1,0,1,0,2,1,1,0,4,"H","N","2010-05-09","201005090CHI"
"VAN",0,2,1,1,0,4,0,0,0,1,0,1,"A","N","2010-05-09","201005090CHI"
"BOS",0,0,0,0,0,0,0,1,2,1,0,4,"H","N","2010-05-10","201005100BOS"
"PHI",0,1,2,1,0,4,0,0,0,0,0,0,"A","N","2010-05-10","201005100BOS"
"MTL",0,1,2,1,0,4,0,1,1,1,0,3,"H","N","2010-05-10","201005100MTL"
"PIT",0,1,1,1,0,3,0,1,2,1,0,4,"A","N","2010-05-10","201005100MTL"
"CHI",0,0,3,2,0,5,0,0,0,1,0,1,"A","N","2010-05-11","201005110VAN"
"VAN",0,0,0,1,0,1,0,0,3,2,0,5,"H","N","2010-05-11","201005110VAN"
"BOS",0,0,0,1,0,1,0,1,1,0,0,2,"A","N","2010-05-12","201005120PHI"
"PHI",0,1,1,0,0,2,0,0,0,1,0,1,"H","N","2010-05-12","201005120PHI"
"MTL",0,2,2,1,0,5,0,0,2,0,0,2,"A","N","2010-05-12","201005120PIT"
"PIT",0,0,2,0,0,2,0,2,2,1,0,5,"H","N","2010-05-12","201005120PIT"
"BOS",0,3,0,0,0,3,0,1,2,1,0,4,"H","N","2010-05-14","201005140BOS"
"PHI",0,1,2,1,0,4,0,3,0,0,0,3,"A","N","2010-05-14","201005140BOS"
"MTL",0,0,0,0,0,0,0,1,3,2,0,6,"A","N","2010-05-16","201005160PHI"
"PHI",0,1,3,2,0,6,0,0,0,0,0,0,"H","N","2010-05-16","201005160PHI"
"CHI",0,0,1,1,0,2,0,1,0,0,0,1,"A","N","2010-05-16","201005160SJS"
"SJS",0,1,0,0,0,1,0,0,1,1,0,2,"H","N","2010-05-16","201005160SJS"
"MTL",0,0,0,0,0,0,0,1,1,1,0,3,"A","N","2010-05-18","201005180PHI"
"PHI",0,1,1,1,0,3,0,0,0,0,0,0,"H","N","2010-05-18","201005180PHI"
"CHI",0,1,2,1,0,4,0,0,1,1,0,2,"A","N","2010-05-18","201005180SJS"
"SJS",0,0,1,1,0,2,0,1,2,1,0,4,"H","N","2010-05-18","201005180SJS"
"MTL",0,2,1,2,0,5,0,0,0,1,0,1,"H","N","2010-05-20","201005200MTL"
"PHI",0,0,0,1,0,1,0,2,1,2,0,5,"A","N","2010-05-20","201005200MTL"
"CHI",1,0,1,1,0,3,0,0,1,1,0,2,"H","N","2010-05-21","201005210CHI"
"SJS",0,0,1,1,0,2,1,0,1,1,0,3,"A","N","2010-05-21","201005210CHI"
"MTL",0,0,0,0,0,0,0,0,2,1,0,3,"H","N","2010-05-22","201005220MTL"
"PHI",0,0,2,1,0,3,0,0,0,0,0,0,"A","N","2010-05-22","201005220MTL"
"CHI",0,0,2,2,0,4,0,1,1,0,0,2,"H","N","2010-05-23","201005230CHI"
"SJS",0,1,1,0,0,2,0,0,2,2,0,4,"A","N","2010-05-23","201005230CHI"
"MTL",0,1,0,1,0,2,0,1,2,1,0,4,"A","N","2010-05-24","201005240PHI"
"PHI",0,1,2,1,0,4,0,1,0,1,0,2,"H","N","2010-05-24","201005240PHI"
"CHI",0,2,3,1,0,6,0,3,2,0,0,5,"H","N","2010-05-29","201005290CHI"
"PHI",0,3,2,0,0,5,0,2,3,1,0,6,"A","N","2010-05-29","201005290CHI"
"CHI",0,0,2,0,0,2,0,0,0,1,0,1,"H","N","2010-05-31","201005310CHI"
"PHI",0,0,0,1,0,1,0,0,2,0,0,2,"A","N","2010-05-31","201005310CHI"
"CHI",0,0,2,1,0,3,1,1,1,1,0,4,"A","N","2010-06-02","201006020PHI"
"PHI",1,1,1,1,0,4,0,0,2,1,0,3,"H","N","2010-06-02","201006020PHI"
"CHI",0,1,0,2,0,3,0,3,0,2,0,5,"A","N","2010-06-04","201006040PHI"
"PHI",0,3,0,2,0,5,0,1,0,2,0,3,"H","N","2010-06-04","201006040PHI"
"CHI",0,3,2,2,0,7,0,0,2,2,0,4,"H","N","2010-06-06","201006060CHI"
"PHI",0,0,2,2,0,4,0,3,2,2,0,7,"A","N","2010-06-06","201006060CHI"
"CHI",1,1,2,0,0,4,0,1,1,1,0,3,"A","N","2010-06-09","201006090PHI"
"PHI",0,1,1,1,0,3,1,1,2,0,0,4,"H","N","2010-06-09","201006090PHI"
"CHI",0,1,1,1,0,3,1,1,2,0,0,4,"A","N","2010-10-07","201010070COL"
"COL",1,1,2,0,0,4,0,1,1,1,0,3,"H","N","2010-10-07","201010070COL"
"CGY",0,0,0,0,0,0,0,1,0,3,0,4,"A","N","2010-10-07","201010070EDM"
"EDM",0,1,0,3,0,4,0,0,0,0,0,0,"H","N","2010-10-07","201010070EDM"
"CAR",0,1,3,0,0,4,0,1,1,1,0,3,"A","N","2010-10-07","201010070MIN"
"MIN",0,1,1,1,0,3,0,1,3,0,0,4,"H","N","2010-10-07","201010070MIN"
"PHI",0,0,2,1,0,3,0,0,0,2,0,2,"A","N","2010-10-07","201010070PIT"
"PIT",0,0,0,2,0,2,0,0,2,1,0,3,"H","N","2010-10-07","201010070PIT"
"MTL",0,1,0,1,0,2,0,2,0,1,0,3,"A","N","2010-10-07","201010070TOR"
"TOR",0,2,0,1,0,3,0,1,0,1,0,2,"H","N","2010-10-07","201010070TOR"
"ATL",0,1,2,1,0,4,0,1,0,1,0,2,"H","N","2010-10-08","201010080ATL"
"WSH",0,1,0,1,0,2,0,1,2,1,0,4,"A","N","2010-10-08","201010080ATL"
"CAR",0,0,1,0,1,2,0,1,0,0,0,1,"H","Y","2010-10-08","201010080CAR"
"MIN",0,1,0,0,0,1,0,0,1,0,1,2,"A","Y","2010-10-08","201010080CAR"
"CBJ",0,2,0,0,0,2,0,2,0,1,0,3,"H","N","2010-10-08","201010080CBJ"
"SJS",0,2,0,1,0,3,0,2,0,0,0,2,"A","N","2010-10-08","201010080CBJ"
"ANA",0,0,0,0,0,0,0,2,2,0,0,4,"A","N","2010-10-08","201010080DET"
"DET",0,2,2,0,0,4,0,0,0,0,0,0,"H","N","2010-10-08","201010080DET"
"DAL",1,1,2,0,0,4,0,2,1,0,0,3,"A","N","2010-10-08","201010080NJD"
"NJD",0,2,1,0,0,3,1,1,2,0,0,4,"H","N","2010-10-08","201010080NJD"
"BUF",0,1,0,1,0,2,0,0,1,0,0,1,"A","N","2010-10-08","201010080OTT"
"OTT",0,0,1,0,0,1,0,1,0,1,0,2,"H","N","2010-10-08","201010080OTT"
"BOS",0,0,0,2,0,2,0,1,3,1,0,5,"H","N","2010-10-09","201010090BOS"
"PHX",0,1,3,1,0,5,0,0,0,2,0,2,"A","N","2010-10-09","201010090BOS"
"BUF",0,0,1,2,0,3,0,2,2,2,0,6,"H","N","2010-10-09","201010090BUF"
"NYR",0,2,2,2,0,6,0,0,1,2,0,3,"A","N","2010-10-09","201010090BUF"
"CHI",0,1,1,0,0,2,0,1,1,1,0,3,"H","N","2010-10-09","201010090CHI"
"DET",0,1,1,1,0,3,0,1,1,0,0,2,"A","N","2010-10-09","201010090CHI"
"ANA",0,0,1,0,0,1,0,0,3,1,0,4,"A","N","2010-10-09","201010090NSH"
"NSH",0,0,3,1,0,4,0,0,1,0,0,1,"H","N","2010-10-09","201010090NSH"
"DAL",0,2,1,1,1,5,0,0,2,2,0,4,"A","Y","2010-10-09","201010090NYI"
"NYI",0,0,2,2,0,4,0,2,1,1,1,5,"H","Y","2010-10-09","201010090NYI"
"MTL",0,1,0,2,0,3,0,0,1,1,0,2,"A","N","2010-10-09","201010090PIT"
"PIT",0,0,1,1,0,2,0,1,0,2,0,3,"H","N","2010-10-09","201010090PIT"
"CBJ",1,1,0,1,0,3,0,1,0,1,0,2,"A","N","2010-10-09","201010090SJS"
"SJS",0,1,0,1,0,2,1,1,0,1,0,3,"H","N","2010-10-09","201010090SJS"
"PHI",0,0,0,1,0,1,1,1,0,0,0,2,"A","N","2010-10-09","201010090STL"
"STL",1,1,0,0,0,2,0,0,0,1,0,1,"H","N","2010-10-09","201010090STL"
"ATL",0,0,2,1,0,3,0,2,2,1,0,5,"A","N","2010-10-09","201010090TBL"
"TBL",0,2,2,1,0,5,0,0,2,1,0,3,"H","N","2010-10-09","201010090TBL"
"OTT",0,0,0,1,0,1,0,2,1,2,0,5,"A","N","2010-10-09","201010090TOR"
"TOR",0,2,1,2,0,5,0,0,0,1,0,1,"H","N","2010-10-09","201010090TOR"
"LAK",0,0,0,1,1,2,0,0,1,0,0,1,"A","Y","2010-10-09","201010090VAN"
"VAN",0,0,1,0,0,1,0,0,0,1,1,2,"H","Y","2010-10-09","201010090VAN"
"NJD",0,2,0,0,0,2,0,1,4,2,0,7,"A","N","2010-10-09","201010090WSH"
"WSH",0,1,4,2,0,7,0,2,0,0,0,2,"H","N","2010-10-09","201010090WSH"
"CGY",0,0,1,2,0,3,0,0,0,1,0,1,"H","N","2010-10-10","201010100CGY"
"LAK",0,0,0,1,0,1,0,0,1,2,0,3,"A","N","2010-10-10","201010100CGY"
"EDM",0,0,3,0,0,3,0,0,2,0,0,2,"H","N","2010-10-10","201010100EDM"
"FLA",0,0,2,0,0,2,0,0,3,0,0,3,"A","N","2010-10-10","201010100EDM"
"BOS",0,0,2,1,0,3,0,0,0,0,0,0,"A","N","2010-10-10","201010100PHX"
"PHX",0,0,0,0,0,0,0,0,2,1,0,3,"H","N","2010-10-10","201010100PHX"
"BUF",0,2,0,1,0,3,0,1,2,1,0,4,"H","N","2010-10-11","201010110BUF"
"CHI",0,1,2,1,0,4,0,2,0,1,0,3,"A","N","2010-10-11","201010110BUF"
"NJD",0,0,0,1,0,1,0,1,1,1,0,3,"H","N","2010-10-11","201010110NJD"
"PIT",0,1,1,1,0,3,0,0,0,1,0,1,"A","N","2010-10-11","201010110NJD"
"NYI",0,2,1,3,0,6,0,1,2,1,0,4,"H","N","2010-10-11","201010110NYI"
"NYR",0,1,2,1,0,4,0,2,1,3,0,6,"A","N","2010-10-11","201010110NYI"
"COL",0,0,1,1,0,2,0,2,0,2,0,4,"A","N","2010-10-11","201010110PHI"
"PHI",0,2,0,2,0,4,0,0,1,1,0,2,"H","N","2010-10-11","201010110PHI"
"ANA",0,0,1,0,0,1,0,2,2,1,0,5,"A","N","2010-10-11","201010110STL"
"STL",0,2,2,1,0,5,0,0,1,0,0,1,"H","N","2010-10-11","201010110STL"
"FLA",0,0,1,0,0,1,0,1,0,1,0,2,"A","N","2010-10-11","201010110VAN"
"VAN",0,1,0,1,0,2,0,0,1,0,0,1,"H","N","2010-10-11","201010110VAN"
"OTT",0,0,1,1,0,2,1,1,1,0,0,3,"A","N","2010-10-11","201010110WSH"
"WSH",1,1,1,0,0,3,0,0,1,1,0,2,"H","N","2010-10-11","201010110WSH"
"COL",0,1,1,2,1,5,0,1,2,1,0,4,"A","Y","2010-10-12","201010120DET"
"DET",0,1,2,1,0,4,0,1,1,2,1,5,"H","Y","2010-10-12","201010120DET"
"ATL",0,0,1,0,0,1,0,0,0,3,0,3,"A","N","2010-10-12","201010120LAK"
"LAK",0,0,0,3,0,3,0,0,1,0,0,1,"H","N","2010-10-12","201010120LAK"
"ANA",0,1,1,2,0,4,0,2,0,1,0,3,"H","N","2010-10-13","201010130ANA"
"VAN",0,2,0,1,0,3,0,1,1,2,0,4,"A","N","2010-10-13","201010130ANA"
"BUF",0,0,0,0,0,0,1,0,0,0,0,1,"H","N","2010-10-13","201010130BUF"
"NJD",1,0,0,0,0,1,0,0,0,0,0,0,"A","N","2010-10-13","201010130BUF"
"CHI",0,2,0,0,0,2,0,1,0,2,0,3,"H","N","2010-10-13","201010130CHI"
"NSH",0,1,0,2,0,3,0,2,0,0,0,2,"A","N","2010-10-13","201010130CHI"
"MTL",0,2,0,1,0,3,1,0,1,2,0,4,"H","N","2010-10-13","201010130MTL"
"TBL",1,0,1,2,0,4,0,2,0,1,0,3,"A","N","2010-10-13","201010130MTL"
"PIT",0,2,1,0,0,3,0,1,3,0,0,4,"H","N","2010-10-13","201010130PIT"
"TOR",0,1,3,0,0,4,0,2,1,0,0,3,"A","N","2010-10-13","201010130PIT"
"NYI",0,1,0,0,0,1,0,0,1,1,0,2,"A","N","2010-10-13","201010130WSH"
"WSH",0,0,1,1,0,2,0,1,0,0,0,1,"H","N","2010-10-13","201010130WSH"
"CGY",0,0,0,0,0,0,0,2,0,1,0,3,"H","N","2010-10-14","201010140CGY"
"FLA",0,2,0,1,0,3,0,0,0,0,0,0,"A","N","2010-10-14","201010140CGY"
"DAL",0,1,3,0,0,4,0,0,0,1,0,1,"H","N","2010-10-14","201010140DAL"
"DET",0,0,0,1,0,1,0,1,3,0,0,4,"A","N","2010-10-14","201010140DAL"
"EDM",0,0,2,0,0,2,0,1,2,1,0,4,"A","N","2010-10-14","201010140MIN"
"MIN",0,1,2,1,0,4,0,0,2,0,0,2,"H","N","2010-10-14","201010140MIN"
"NSH",0,3,1,0,0,4,0,1,1,1,0,3,"H","N","2010-10-14","201010140NSH"
"STL",0,1,1,1,0,3,0,3,1,0,0,4,"A","N","2010-10-14","201010140NSH"
"CAR",0,0,0,2,0,2,0,1,1,1,0,3,"A","N","2010-10-14","201010140OTT"
"OTT",0,1,1,1,0,3,0,0,0,2,0,2,"H","N","2010-10-14","201010140OTT"
"PHI",0,1,0,1,0,2,0,1,1,1,0,3,"H","N","2010-10-14","201010140PHI"
"TBL",0,1,1,1,0,3,0,1,0,1,0,2,"A","N","2010-10-14","201010140PHI"
"ANA",0,1,2,1,0,4,0,1,1,2,1,5,"H","Y","2010-10-15","201010150ANA"
"ATL",0,1,1,2,1,5,0,1,2,1,0,4,"A","Y","2010-10-15","201010150ANA"
"BUF",0,0,0,1,0,1,0,0,2,0,0,2,"H","N","2010-10-15","201010150BUF"
"MTL",0,0,2,0,0,2,0,0,0,1,0,1,"A","N","2010-10-15","201010150BUF"
"CBJ",0,0,1,1,0,2,0,2,2,1,0,5,"H","N","2010-10-15","201010150CBJ"
"CHI",0,2,2,1,0,5,0,0,1,1,0,2,"A","N","2010-10-15","201010150CBJ"
"LAK",0,1,1,2,0,4,0,0,0,1,0,1,"H","N","2010-10-15","201010150LAK"
"VAN",0,0,0,1,0,1,0,1,1,2,0,4,"A","N","2010-10-15","201010150LAK"
"COL",0,1,1,1,0,3,0,0,1,1,0,2,"A","N","2010-10-15","201010150NJD"
"NJD",0,0,1,1,0,2,0,1,1,1,0,3,"H","N","2010-10-15","201010150NJD"
"NYR",0,1,0,2,0,3,1,0,3,0,0,4,"H","N","2010-10-15","201010150NYR"
"TOR",1,0,3,0,0,4,0,1,0,2,0,3,"A","N","2010-10-15","201010150NYR"
"NYI",0,0,2,0,0,2,1,0,2,0,0,3,"A","N","2010-10-15","201010150PIT"
"PIT",1,0,2,0,0,3,0,0,2,0,0,2,"H","N","2010-10-15","201010150PIT"
"CGY",0,1,1,3,0,5,0,1,2,0,0,3,"H","N","2010-10-16","201010160CGY"
"EDM",0,1,2,0,0,3,0,1,1,3,0,5,"A","N","2010-10-16","201010160CGY"
"BUF",0,2,1,0,0,3,0,1,1,2,0,4,"A","N","2010-10-16","201010160CHI"
"CHI",0,1,1,2,0,4,0,2,1,0,0,3,"H","N","2010-10-16","201010160CHI"
"DAL",0,1,1,0,1,3,0,2,0,0,0,2,"H","Y","2010-10-16","201010160DAL"
"STL",0,2,0,0,0,2,0,1,1,0,1,3,"A","Y","2010-10-16","201010160DAL"
"FLA",0,4,0,2,0,6,0,0,0,0,0,0,"H","N","2010-10-16","201010160FLA"
"TBL",0,0,0,0,0,0,0,4,0,2,0,6,"A","N","2010-10-16","201010160FLA"
"CBJ",0,1,1,1,0,3,0,0,2,0,0,2,"A","N","2010-10-16","201010160MIN"
"MIN",0,0,2,0,0,2,0,1,1,1,0,3,"H","N","2010-10-16","201010160MIN"
"MTL",0,1,2,1,0,4,0,1,2,0,0,3,"H","N","2010-10-16","201010160MTL"
"OTT",0,1,2,0,0,3,0,1,2,1,0,4,"A","N","2010-10-16","201010160MTL"
"BOS",0,0,4,0,0,4,0,0,1,0,0,1,"A","N","2010-10-16","201010160NJD"
"NJD",0,0,1,0,0,1,0,0,4,0,0,4,"H","N","2010-10-16","201010160NJD"
"NSH",0,1,1,0,0,2,1,0,0,2,0,3,"H","N","2010-10-16","201010160NSH"
"WSH",1,0,0,2,0,3,0,1,1,0,0,2,"A","N","2010-10-16","201010160NSH"
"COL",0,0,0,2,0,2,0,0,3,2,0,5,"A","N","2010-10-16","201010160NYI"
"NYI",0,0,3,2,0,5,0,0,0,2,0,2,"H","N","2010-10-16","201010160NYI"
"PHI",0,1,0,0,0,1,0,1,1,3,0,5,"H","N","2010-10-16","201010160PHI"
"PIT",0,1,1,3,0,5,0,1,0,0,0,1,"A","N","2010-10-16","201010160PHI"
"DET",1,0,1,0,0,2,0,1,0,0,0,1,"A","N","2010-10-16","201010160PHX"
"PHX",0,1,0,0,0,1,1,0,1,0,0,2,"H","N","2010-10-16","201010160PHX"
"ATL",0,0,2,2,0,4,0,2,0,0,0,2,"A","N","2010-10-16","201010160SJS"
"SJS",0,2,0,0,0,2,0,0,2,2,0,4,"H","N","2010-10-16","201010160SJS"
"ANA",0,0,2,1,0,3,0,0,0,2,0,2,"H","N","2010-10-17","201010170ANA"
"PHX",0,0,0,2,0,2,0,0,2,1,0,3,"A","N","2010-10-17","201010170ANA"
"CAR",0,0,1,0,0,1,0,2,1,2,0,5,"A","N","2010-10-17","201010170VAN"
"VAN",0,2,1,2,0,5,0,0,1,0,0,1,"H","N","2010-10-17","201010170VAN"
"CHI",1,0,0,2,0,3,0,0,1,1,0,2,"H","N","2010-10-18","201010180CHI"
"STL",0,0,1,1,0,2,1,0,0,2,0,3,"A","N","2010-10-18","201010180CHI"
"COL",0,1,0,2,0,3,0,1,0,0,0,1,"A","N","2010-10-18","201010180NYR"
"NYR",0,1,0,0,0,1,0,1,0,2,0,3,"H","N","2010-10-18","201010180NYR"
"OTT",0,0,1,1,0,2,0,3,2,0,0,5,"A","N","2010-10-18","201010180PIT"
"PIT",0,3,2,0,0,5,0,0,1,1,0,2,"H","N","2010-10-18","201010180PIT"
"DAL",0,1,1,2,0,4,0,2,2,1,0,5,"A","N","2010-10-18","201010180TBL"
"TBL",0,2,2,1,0,5,0,1,1,2,0,4,"H","N","2010-10-18","201010180TBL"
"NYI",1,0,1,0,0,2,0,0,0,1,0,1,"A","N","2010-10-18","201010180TOR"
"TOR",0,0,0,1,0,1,1,0,1,0,0,2,"H","N","2010-10-18","201010180TOR"
"MIN",0,3,3,0,0,6,0,1,0,1,0,2,"H","N","2010-10-19","201010190MIN"
"VAN",0,1,0,1,0,2,0,3,3,0,0,6,"A","N","2010-10-19","201010190MIN"
"CGY",1,0,0,0,0,1,0,0,0,0,0,0,"A","N","2010-10-19","201010190NSH"
"NSH",0,0,0,0,0,0,1,0,0,0,0,1,"H","N","2010-10-19","201010190NSH"
"CAR",0,2,1,2,0,5,0,0,2,0,0,2,"A","N","2010-10-19","201010190SJS"
"SJS",0,0,2,0,0,2,0,2,1,2,0,5,"H","N","2010-10-19","201010190SJS"
"BOS",0,2,0,1,0,3,0,0,1,0,0,1,"A","N","2010-10-19","201010190WSH"
"WSH",0,0,1,0,0,1,0,2,0,1,0,3,"H","N","2010-10-19","201010190WSH"
"ATL",0,0,0,1,0,1,0,1,2,1,0,4,"H","N","2010-10-20","201010200ATL"
"BUF",0,1,2,1,0,4,0,0,0,1,0,1,"A","N","2010-10-20","201010200ATL"
"ANA",0,0,0,1,0,1,0,0,2,1,0,3,"A","N","2010-10-20","201010200CBJ"
"CBJ",0,0,2,1,0,3,0,0,0,1,0,1,"H","N","2010-10-20","201010200CBJ"
"CHI",0,1,0,0,1,2,0,0,0,1,0,1,"H","Y","2010-10-20","201010200CHI"
"VAN",0,0,0,1,0,1,0,1,0,0,1,2,"A","Y","2010-10-20","201010200CHI"
"CAR",0,2,1,0,0,3,0,2,1,1,0,4,"A","N","2010-10-20","201010200LAK"
"LAK",0,2,1,1,0,4,0,2,1,0,0,3,"H","N","2010-10-20","201010200LAK"
"BOS",0,1,2,1,0,4,0,0,0,1,0,1,"H","N","2010-10-21","201010210BOS"
"WSH",0,0,0,1,0,1,0,1,2,1,0,4,"A","N","2010-10-21","201010210BOS"
"COL",0,1,0,1,0,2,0,1,2,1,0,4,"H","N","2010-10-21","201010210COL"
"SJS",0,1,2,1,0,4,0,1,0,1,0,2,"A","N","2010-10-21","201010210COL"
"CGY",0,2,0,0,0,2,0,1,1,2,0,4,"A","N","2010-10-21","201010210DET"
"DET",0,1,1,2,0,4,0,2,0,0,0,2,"H","N","2010-10-21","201010210DET"
"EDM",0,1,0,1,0,2,0,3,0,1,0,4,"H","N","2010-10-21","201010210EDM"
"MIN",0,3,0,1,0,4,0,1,0,1,0,2,"A","N","2010-10-21","201010210EDM"
"DAL",0,2,2,0,0,4,0,0,0,1,0,1,"A","N","2010-10-21","201010210FLA"
"FLA",0,0,0,1,0,1,0,2,2,0,0,4,"H","N","2010-10-21","201010210FLA"
"MTL",0,0,0,0,0,0,0,1,1,1,0,3,"H","N","2010-10-21","201010210MTL"
"NJD",0,1,1,1,0,3,0,0,0,0,0,0,"A","N","2010-10-21","201010210MTL"
"NSH",0,1,1,1,0,3,1,0,2,1,0,4,"H","N","2010-10-21","201010210NSH"
"PIT",1,0,2,1,0,4,0,1,1,1,0,3,"A","N","2010-10-21","201010210NSH"
"ANA",0,2,0,1,0,3,0,1,1,0,0,2,"A","N","2010-10-21","201010210PHI"
"PHI",0,1,1,0,0,2,0,2,0,1,0,3,"H","N","2010-10-21","201010210PHI"
"LAK",0,0,1,1,0,2,0,2,1,1,0,4,"A","N","2010-10-21","201010210PHX"
"PHX",0,2,1,1,0,4,0,0,1,1,0,2,"H","N","2010-10-21","201010210PHX"
"NYI",1,1,1,0,0,3,0,1,1,0,0,2,"A","N","2010-10-21","201010210TBL"
"TBL",0,1,1,0,0,2,1,1,1,0,0,3,"H","N","2010-10-21","201010210TBL"
"NYR",0,2,0,0,0,2,0,0,0,1,0,1,"A","N","2010-10-21","201010210TOR"
"TOR",0,0,0,1,0,1,0,2,0,0,0,2,"H","N","2010-10-21","201010210TOR"
"ATL",0,0,1,1,0,2,0,3,1,1,0,5,"H","N","2010-10-22","201010220ATL"
"TBL",0,3,1,1,0,5,0,0,1,1,0,2,"A","N","2010-10-22","201010220ATL"
"BUF",0,1,1,0,0,2,0,1,2,1,0,4,"H","N","2010-10-22","201010220BUF"
"OTT",0,1,2,1,0,4,0,1,1,0,0,2,"A","N","2010-10-22","201010220BUF"
"CBJ",0,1,0,1,0,2,0,3,1,2,0,6,"H","N","2010-10-22","201010220CBJ"
"CGY",0,3,1,2,0,6,0,1,0,1,0,2,"A","N","2010-10-22","201010220CBJ"
"CHI",0,1,1,0,0,2,0,1,1,2,0,4,"A","N","2010-10-22","201010220STL"
"STL",0,1,1,2,0,4,0,1,1,0,0,2,"H","N","2010-10-22","201010220STL"
"MIN",0,0,0,1,0,1,0,1,1,3,0,5,"A","N","2010-10-22","201010220VAN"
"VAN",0,1,1,3,0,5,0,0,0,1,0,1,"H","N","2010-10-22","201010220VAN"
"BOS",0,1,1,0,0,2,0,2,1,0,0,3,"H","N","2010-10-23","201010230BOS"
"NYR",0,2,1,0,0,3,0,1,1,0,0,2,"A","N","2010-10-23","201010230BOS"
"CBJ",0,0,1,2,0,3,0,2,0,0,0,2,"A","N","2010-10-23","201010230CHI"
"CHI",0,2,0,0,0,2,0,0,1,2,0,3,"H","N","2010-10-23","201010230CHI"
"COL",0,2,1,1,0,4,0,2,2,2,0,6,"H","N","2010-10-23","201010230COL"
"LAK",0,2,2,2,0,6,0,2,1,1,0,4,"A","N","2010-10-23","201010230COL"
"DAL",0,0,0,0,0,0,0,1,0,0,0,1,"H","N","2010-10-23","201010230DAL"
"NSH",0,1,0,0,0,1,0,0,0,0,0,0,"A","N","2010-10-23","201010230DAL"
"ANA",0,1,2,1,0,4,0,1,2,2,0,5,"A","N","2010-10-23","201010230DET"
"DET",0,1,2,2,0,5,0,1,2,1,0,4,"H","N","2010-10-23","201010230DET"
"EDM",0,1,0,0,0,1,0,1,2,3,0,6,"H","N","2010-10-23","201010230EDM"
"SJS",0,1,2,3,0,6,0,1,0,0,0,1,"A","N","2010-10-23","201010230EDM"
"FLA",0,2,1,1,0,4,0,1,2,0,0,3,"H","N","2010-10-23","201010230FLA"
"NYI",0,1,2,0,0,3,0,2,1,1,0,4,"A","N","2010-10-23","201010230FLA"
"BUF",0,2,3,1,0,6,0,0,0,1,0,1,"A","N","2010-10-23","201010230NJD"
"NJD",0,0,0,1,0,1,0,2,3,1,0,6,"H","N","2010-10-23","201010230NJD"
"MTL",0,1,2,0,0,3,0,0,0,0,0,0,"A","N","2010-10-23","201010230OTT"
"OTT",0,0,0,0,0,0,0,1,2,0,0,3,"H","N","2010-10-23","201010230OTT"
"PHI",0,2,1,2,0,5,0,0,2,0,0,2,"H","N","2010-10-23","201010230PHI"
"TOR",0,0,2,0,0,2,0,2,1,2,0,5,"A","N","2010-10-23","201010230PHI"
"CAR",1,0,2,1,0,4,0,0,0,3,0,3,"A","N","2010-10-23","201010230PHX"
"PHX",0,0,0,3,0,3,1,0,2,1,0,4,"H","N","2010-10-23","201010230PHX"
"PIT",0,0,0,0,0,0,1,0,0,0,0,1,"A","N","2010-10-23","201010230STL"
"STL",1,0,0,0,0,1,0,0,0,0,0,0,"H","N","2010-10-23","201010230STL"
"ATL",0,1,1,1,0,3,1,0,1,2,0,4,"A","N","2010-10-23","201010230WSH"
"WSH",1,0,1,2,0,4,0,1,1,1,0,3,"H","N","2010-10-23","201010230WSH"
"CGY",0,4,0,0,0,4,0,0,0,0,0,0,"H","N","2010-10-24","201010240CGY"
"SJS",0,0,0,0,0,0,0,4,0,0,0,4,"A","N","2010-10-24","201010240CGY"
"NJD",0,0,0,1,0,1,0,0,2,1,0,3,"A","N","2010-10-24","201010240NYR"
"NYR",0,0,2,1,0,3,0,0,0,1,0,1,"H","N","2010-10-24","201010240NYR"
"NSH",0,2,1,1,0,4,0,1,0,2,0,3,"A","N","2010-10-24","201010240TBL"
"TBL",0,1,0,2,0,3,0,2,1,1,0,4,"H","N","2010-10-24","201010240TBL"
"CBJ",0,1,1,0,0,2,0,0,0,1,0,1,"H","N","2010-10-25","201010250CBJ"
"PHI",0,0,0,1,0,1,0,1,1,0,0,2,"A","N","2010-10-25","201010250CBJ"
"LAK",0,1,1,0,1,3,0,2,0,0,0,2,"A","Y","2010-10-25","201010250MIN"
"MIN",0,2,0,0,0,2,0,1,1,0,1,3,"H","Y","2010-10-25","201010250MIN"
"MTL",1,0,2,0,0,3,0,0,1,1,0,2,"H","N","2010-10-25","201010250MTL"
"PHX",0,0,1,1,0,2,1,0,2,0,0,3,"A","N","2010-10-25","201010250MTL"
"CGY",0,2,2,0,1,5,0,1,1,2,0,4,"H","Y","2010-10-26","201010260CGY"
"EDM",0,1,1,2,0,4,0,2,2,0,1,5,"A","Y","2010-10-26","201010260CGY"
"ANA",0,0,3,2,0,5,0,1,0,1,0,2,"A","N","2010-10-26","201010260DAL"
"DAL",0,1,0,1,0,2,0,0,3,2,0,5,"H","N","2010-10-26","201010260DAL"
"OTT",0,3,0,2,0,5,0,0,1,1,0,2,"H","N","2010-10-26","201010260OTT"
"PHX",0,0,1,1,0,2,0,3,0,2,0,5,"A","N","2010-10-26","201010260OTT"
"BUF",0,1,0,2,0,3,0,1,3,2,0,6,"A","N","2010-10-26","201010260PHI"
"PHI",0,1,3,2,0,6,0,1,0,2,0,3,"H","N","2010-10-26","201010260PHI"
"FLA",0,0,1,0,0,1,0,1,0,2,0,3,"A","N","2010-10-26","201010260TOR"
"TOR",0,1,0,2,0,3,0,0,1,0,0,1,"H","N","2010-10-26","201010260TOR"
"COL",0,1,1,1,0,3,1,1,1,1,0,4,"A","N","2010-10-26","201010260VAN"
"VAN",1,1,1,1,0,4,0,1,1,1,0,3,"H","N","2010-10-26","201010260VAN"
"CAR",0,0,0,0,0,0,0,1,0,2,0,3,"H","N","2010-10-27","201010270CAR"
"WSH",0,1,0,2,0,3,0,0,0,0,0,0,"A","N","2010-10-27","201010270CAR"
"CHI",0,1,1,1,0,3,0,1,0,0,0,1,"H","N","2010-10-27","201010270CHI"
"LAK",0,1,0,0,0,1,0,1,1,1,0,3,"A","N","2010-10-27","201010270CHI"
"MTL",0,2,1,2,0,5,0,1,0,2,0,3,"H","N","2010-10-27","201010270MTL"
"NYI",0,1,0,2,0,3,0,2,1,2,0,5,"A","N","2010-10-27","201010270MTL"
"ATL",0,1,2,3,0,6,0,1,1,2,0,4,"A","N","2010-10-27","201010270NYR"
"NYR",0,1,1,2,0,4,0,1,2,3,0,6,"H","N","2010-10-27","201010270NYR"
"NJD",0,0,1,1,0,2,0,3,1,1,0,5,"A","N","2010-10-27","201010270SJS"
"SJS",0,3,1,1,0,5,0,0,1,1,0,2,"H","N","2010-10-27","201010270SJS"
"PIT",0,3,0,0,0,3,0,2,1,2,0,5,"A","N","2010-10-27","201010270TBL"
"TBL",0,2,1,2,0,5,0,3,0,0,0,3,"H","N","2010-10-27","201010270TBL"
"BOS",0,1,1,0,0,2,0,0,0,0,0,0,"H","N","2010-10-28","201010280BOS"
"TOR",0,0,0,0,0,0,0,1,1,0,0,2,"A","N","2010-10-28","201010280BOS"
"CBJ",0,2,0,0,1,3,0,1,0,1,0,2,"H","Y","2010-10-28","201010280CBJ"
"EDM",0,1,0,1,0,2,0,2,0,0,1,3,"A","Y","2010-10-28","201010280CBJ"
"CGY",0,2,2,1,0,5,0,1,2,3,0,6,"H","N","2010-10-28","201010280CGY"
"COL",0,1,2,3,0,6,0,2,2,1,0,5,"A","N","2010-10-28","201010280CGY"
"DAL",0,1,0,1,0,2,0,1,2,2,0,5,"H","N","2010-10-28","201010280DAL"
"LAK",0,1,2,2,0,5,0,1,0,1,0,2,"A","N","2010-10-28","201010280DAL"
"DET",0,0,1,1,0,2,0,3,0,1,0,4,"H","N","2010-10-28","201010280DET"
"PHX",0,3,0,1,0,4,0,0,1,1,0,2,"A","N","2010-10-28","201010280DET"
"MIN",0,1,1,0,0,2,0,0,0,1,0,1,"H","N","2010-10-28","201010280MIN"
"WSH",0,0,0,1,0,1,0,1,1,0,0,2,"A","N","2010-10-28","201010280MIN"
"NSH",0,0,0,0,0,0,0,0,1,2,0,3,"H","N","2010-10-28","201010280NSH"
"STL",0,0,1,2,0,3,0,0,0,0,0,0,"A","N","2010-10-28","201010280NSH"
"FLA",0,1,0,2,0,3,0,0,3,2,0,5,"A","N","2010-10-28","201010280OTT"
"OTT",0,0,3,2,0,5,0,1,0,2,0,3,"H","N","2010-10-28","201010280OTT"
"ANA",0,0,1,0,0,1,0,0,1,1,0,2,"H","N","2010-10-29","201010290ANA"
"NJD",0,0,1,1,0,2,0,0,1,0,0,1,"A","N","2010-10-29","201010290ANA"
"ATL",1,0,2,1,0,4,0,2,0,1,0,3,"H","N","2010-10-29","201010290ATL"
"BUF",0,2,0,1,0,3,1,0,2,1,0,4,"A","N","2010-10-29","201010290ATL"
"CHI",0,2,1,1,0,4,0,4,2,1,0,7,"H","N","2010-10-29","201010290CHI"
"EDM",0,4,2,1,0,7,0,2,1,1,0,4,"A","N","2010-10-29","201010290CHI"
"MTL",0,1,0,2,0,3,0,0,1,0,0,1,"A","N","2010-10-29","201010290NYI"
"NYI",0,0,1,0,0,1,0,1,0,2,0,3,"H","N","2010-10-29","201010290NYI"
"CAR",0,1,2,1,0,4,0,0,3,0,0,3,"A","N","2010-10-29","201010290NYR"
"NYR",0,0,3,0,0,3,0,1,2,1,0,4,"H","N","2010-10-29","201010290NYR"
"PHI",0,0,2,1,0,3,0,1,0,1,0,2,"A","N","2010-10-29","201010290PIT"
"PIT",0,1,0,1,0,2,0,0,2,1,0,3,"H","N","2010-10-29","201010290PIT"
"CAR",0,0,0,0,0,0,0,1,1,1,0,3,"H","N","2010-10-30","201010300CAR"
"PIT",0,1,1,1,0,3,0,0,0,0,0,0,"A","N","2010-10-30","201010300CAR"
"CGY",0,2,0,0,0,2,0,1,6,0,0,7,"H","N","2010-10-30","201010300CGY"
"WSH",0,1,6,0,0,7,0,2,0,0,0,2,"A","N","2010-10-30","201010300CGY"
"CBJ",0,0,0,1,0,1,0,1,3,1,0,5,"A","N","2010-10-30","201010300COL"
"COL",0,1,3,1,0,5,0,0,0,1,0,1,"H","N","2010-10-30","201010300COL"
"BUF",0,0,0,0,0,0,0,1,1,2,0,4,"A","N","2010-10-30","201010300DAL"
"DAL",0,1,1,2,0,4,0,0,0,0,0,0,"H","N","2010-10-30","201010300DAL"
"DET",0,2,1,2,0,5,0,0,1,1,0,2,"H","N","2010-10-30","201010300DET"
"NSH",0,0,1,1,0,2,0,2,1,2,0,5,"A","N","2010-10-30","201010300DET"
"LAK",0,1,2,0,0,3,0,0,1,0,0,1,"H","N","2010-10-30","201010300LAK"
"NJD",0,0,1,0,0,1,0,1,2,0,0,3,"A","N","2010-10-30","201010300LAK"
"CHI",0,0,1,2,0,3,0,0,0,1,0,1,"A","N","2010-10-30","201010300MIN"
"MIN",0,0,0,1,0,1,0,0,1,2,0,3,"H","N","2010-10-30","201010300MIN"
"FLA",0,1,1,1,0,3,0,0,1,0,0,1,"A","N","2010-10-30","201010300MTL"
"MTL",0,0,1,0,0,1,0,1,1,1,0,3,"H","N","2010-10-30","201010300MTL"
"BOS",0,1,2,1,0,4,0,0,0,0,0,0,"A","N","2010-10-30","201010300OTT"
"OTT",0,0,0,0,0,0,0,1,2,1,0,4,"H","N","2010-10-30","201010300OTT"
"NYI",0,0,1,0,0,1,0,2,4,0,0,6,"A","N","2010-10-30","201010300PHI"
"PHI",0,2,4,0,0,6,0,0,1,0,0,1,"H","N","2010-10-30","201010300PHI"
"PHX",0,0,0,0,0,0,0,0,1,2,0,3,"H","N","2010-10-30","201010300PHX"
"TBL",0,0,1,2,0,3,0,0,0,0,0,0,"A","N","2010-10-30","201010300PHX"
"ANA",0,0,0,2,0,2,0,2,3,0,0,5,"A","N","2010-10-30","201010300SJS"
"SJS",0,2,3,0,0,5,0,0,0,2,0,2,"H","N","2010-10-30","201010300SJS"
"ATL",0,3,0,0,0,3,0,1,0,2,1,4,"A","Y","2010-10-30","201010300STL"
"STL",0,1,0,2,1,4,0,3,0,0,0,3,"H","Y","2010-10-30","201010300STL"
"NYR",0,1,1,0,0,2,0,0,0,0,0,0,"A","N","2010-10-30","201010300TOR"
"TOR",0,0,0,0,0,0,0,1,1,0,0,2,"H","N","2010-10-30","201010300TOR"
"CHI",0,1,0,1,0,2,0,1,0,2,0,3,"A","N","2010-11-01","201011010NYR"
"NYR",0,1,0,2,0,3,0,1,0,1,0,2,"H","N","2010-11-01","201011010NYR"
"CAR",0,0,1,1,0,2,0,1,1,1,0,3,"A","N","2010-11-01","201011010PHI"
"PHI",0,1,1,1,0,3,0,0,1,1,0,2,"H","N","2010-11-01","201011010PHI"
"NJD",0,0,0,0,0,0,0,1,1,1,0,3,"A","N","2010-11-01","201011010VAN"
"VAN",0,1,1,1,0,3,0,0,0,0,0,0,"H","N","2010-11-01","201011010VAN"
"CBJ",0,2,0,1,0,3,0,0,0,0,0,0,"H","N","2010-11-02","201011020CBJ"
"MTL",0,0,0,0,0,0,0,2,0,1,0,3,"A","N","2010-11-02","201011020CBJ"
"EDM",0,0,1,2,0,3,0,3,0,1,0,4,"H","N","2010-11-02","201011020EDM"
"VAN",0,3,0,1,0,4,0,0,1,2,0,3,"A","N","2010-11-02","201011020EDM"
"MIN",0,0,1,0,0,1,0,0,0,0,0,0,"H","N","2010-11-02","201011020MIN"
"SJS",0,0,0,0,0,0,0,0,1,0,0,1,"A","N","2010-11-02","201011020MIN"
"OTT",0,1,2,0,0,3,0,0,0,2,0,2,"A","N","2010-11-02","201011020TOR"
"TOR",0,0,0,2,0,2,0,1,2,0,0,3,"H","N","2010-11-02","201011020TOR"
"ANA",1,1,0,1,0,3,0,0,1,1,0,2,"H","N","2010-11-03","201011030ANA"
"TBL",0,0,1,1,0,2,1,1,0,1,0,3,"A","N","2010-11-03","201011030ANA"
"BOS",0,3,1,1,0,5,0,0,1,1,0,2,"A","N","2010-11-03","201011030BUF"
"BUF",0,0,1,1,0,2,0,3,1,1,0,5,"H","N","2010-11-03","201011030BUF"
"CAR",0,3,2,2,0,7,0,0,0,2,0,2,"H","N","2010-11-03","201011030CAR"
"NYI",0,0,0,2,0,2,0,3,2,2,0,7,"A","N","2010-11-03","201011030CAR"
"CGY",0,1,0,0,0,1,0,0,2,0,0,2,"H","N","2010-11-03","201011030CGY"
"DET",0,0,2,0,0,2,0,1,0,0,0,1,"A","N","2010-11-03","201011030CGY"
"CHI",0,0,1,2,0,3,0,1,1,3,0,5,"H","N","2010-11-03","201011030CHI"
"NJD",0,1,1,3,0,5,0,0,1,2,0,3,"A","N","2010-11-03","201011030CHI"
"DAL",0,2,2,1,0,5,0,0,1,1,0,2,"H","N","2010-11-03","201011030DAL"
"PIT",0,0,1,1,0,2,0,2,2,1,0,5,"A","N","2010-11-03","201011030DAL"
"ATL",0,1,1,2,0,4,0,1,1,1,0,3,"A","N","2010-11-03","201011030FLA"
"FLA",0,1,1,1,0,3,0,1,1,2,0,4,"H","N","2010-11-03","201011030FLA"
"NSH",0,2,1,0,0,3,0,1,1,2,0,4,"A","N","2010-11-03","201011030PHX"
"PHX",0,1,1,2,0,4,0,2,1,0,0,3,"H","N","2010-11-03","201011030PHX"
"TOR",0,1,0,3,0,4,0,0,3,1,1,5,"A","Y","2010-11-03","201011030WSH"
"WSH",0,0,3,1,1,5,0,1,0,3,0,4,"H","Y","2010-11-03","201011030WSH"
"ATL",0,0,0,0,0,0,0,0,1,2,0,3,"H","N","2010-11-04","201011040ATL"
"CBJ",0,0,1,2,0,3,0,0,0,0,0,0,"A","N","2010-11-04","201011040ATL"
"COL",0,0,0,1,0,1,0,1,1,1,0,3,"H","N","2010-11-04","201011040COL"
"VAN",0,1,1,1,0,3,0,0,0,1,0,1,"A","N","2010-11-04","201011040COL"
"LAK",0,0,0,1,0,1,0,0,0,0,0,0,"H","N","2010-11-04","201011040LAK"
"TBL",0,0,0,0,0,0,0,0,0,1,0,1,"A","N","2010-11-04","201011040LAK"
"NYI",0,0,0,1,0,1,0,1,2,1,0,4,"A","N","2010-11-04","201011040OTT"
"OTT",0,1,2,1,0,4,0,0,0,1,0,1,"H","N","2010-11-04","201011040OTT"
"NYR",0,0,1,0,0,1,0,0,3,1,0,4,"A","N","2010-11-04","201011040PHI"
"PHI",0,0,3,1,0,4,0,0,1,0,0,1,"H","N","2010-11-04","201011040PHI"
"SJS",0,0,0,0,0,0,0,1,1,0,0,2,"A","N","2010-11-04","201011040STL"
"STL",0,1,1,0,0,2,0,0,0,0,0,0,"H","N","2010-11-04","201011040STL"
"ANA",0,0,3,0,0,3,0,0,1,1,0,2,"H","N","2010-11-05","201011050ANA"
"PIT",0,0,1,1,0,2,0,0,3,0,0,3,"A","N","2010-11-05","201011050ANA"
"BUF",0,1,1,0,0,2,0,1,2,0,0,3,"H","N","2010-11-05","201011050BUF"
"MTL",0,1,2,0,0,3,0,1,1,0,0,2,"A","N","2010-11-05","201011050BUF"
"DAL",0,1,4,1,0,6,0,0,1,2,0,3,"H","N","2010-11-05","201011050DAL"
"PHX",0,0,1,2,0,3,0,1,4,1,0,6,"A","N","2010-11-05","201011050DAL"
"DET",0,1,1,1,0,3,0,0,1,0,0,1,"A","N","2010-11-05","201011050EDM"
"EDM",0,0,1,0,0,1,0,1,1,1,0,3,"H","N","2010-11-05","201011050EDM"
"CAR",0,3,0,1,0,4,0,3,1,3,0,7,"A","N","2010-11-05","201011050FLA"
"FLA",0,3,1,3,0,7,0,3,0,1,0,4,"H","N","2010-11-05","201011050FLA"
"CGY",0,1,0,0,0,1,0,1,0,1,0,2,"A","N","2010-11-05","201011050MIN"
"MIN",0,1,0,1,0,2,0,1,0,0,0,1,"H","N","2010-11-05","201011050MIN"
"NJD",0,0,0,0,0,0,0,1,1,1,0,3,"H","N","2010-11-05","201011050NJD"
"NYR",0,1,1,1,0,3,0,0,0,0,0,0,"A","N","2010-11-05","201011050NJD"
"BOS",0,0,0,3,0,3,0,0,3,2,0,5,"A","N","2010-11-05","201011050WSH"
"WSH",0,0,3,2,0,5,0,0,0,3,0,3,"H","N","2010-11-05","201011050WSH"
"ATL",0,1,3,0,0,4,0,2,2,0,1,5,"H","Y","2010-11-06","201011060ATL"
"CHI",0,2,2,0,1,5,0,1,3,0,0,4,"A","Y","2010-11-06","201011060ATL"
"BOS",0,0,0,1,0,1,0,1,0,0,1,2,"H","Y","2010-11-06","201011060BOS"
"STL",0,1,0,0,1,2,0,0,0,1,0,1,"A","Y","2010-11-06","201011060BOS"
"CAR",0,0,1,2,0,3,0,0,0,2,0,2,"H","N","2010-11-06","201011060CAR"
"FLA",0,0,0,2,0,2,0,0,1,2,0,3,"A","N","2010-11-06","201011060CAR"
"CBJ",0,1,1,0,0,2,0,1,1,1,0,3,"H","N","2010-11-06","201011060CBJ"
"MIN",0,1,1,1,0,3,0,1,1,0,0,2,"A","N","2010-11-06","201011060CBJ"
"COL",0,1,2,2,0,5,0,0,0,0,0,0,"H","N","2010-11-06","201011060COL"
"DAL",0,0,0,0,0,0,0,1,2,2,0,5,"A","N","2010-11-06","201011060COL"
"LAK",0,2,2,0,0,4,0,0,0,1,0,1,"H","N","2010-11-06","201011060LAK"
"NSH",0,0,0,1,0,1,0,2,2,0,0,4,"A","N","2010-11-06","201011060LAK"
"MTL",0,0,1,1,0,2,0,1,1,1,0,3,"H","N","2010-11-06","201011060MTL"
"OTT",0,1,1,1,0,3,0,0,1,1,0,2,"A","N","2010-11-06","201011060MTL"
"NYI",0,0,1,0,0,1,0,1,0,1,0,2,"H","N","2010-11-06","201011060NYI"
"PHI",0,1,0,1,0,2,0,0,1,0,0,1,"A","N","2010-11-06","201011060NYI"
"PHX",0,2,1,0,0,3,0,0,3,0,1,4,"H","Y","2010-11-06","201011060PHX"
"PIT",0,0,3,0,1,4,0,2,1,0,0,3,"A","Y","2010-11-06","201011060PHX"
"SJS",0,2,2,1,0,5,0,1,0,1,0,2,"H","N","2010-11-06","201011060SJS"
"TBL",0,1,0,1,0,2,0,2,2,1,0,5,"A","N","2010-11-06","201011060SJS"
"BUF",0,0,1,1,1,3,0,1,1,0,0,2,"A","Y","2010-11-06","201011060TOR"
"TOR",0,1,1,0,0,2,0,0,1,1,1,3,"H","Y","2010-11-06","201011060TOR"
"DET",0,0,3,1,0,4,0,1,2,3,0,6,"A","N","2010-11-06","201011060VAN"
"VAN",0,1,2,3,0,6,0,0,3,1,0,4,"H","N","2010-11-06","201011060VAN"
"ANA",0,2,0,3,0,5,0,2,0,2,0,4,"H","N","2010-11-07","201011070ANA"
"NSH",0,2,0,2,0,4,0,2,0,3,0,5,"A","N","2010-11-07","201011070ANA"
"CHI",0,1,0,0,0,1,0,0,0,2,0,2,"H","N","2010-11-07","201011070CHI"
"EDM",0,0,0,2,0,2,0,1,0,0,0,1,"A","N","2010-11-07","201011070CHI"
"NYR",0,0,0,0,0,0,0,0,1,1,0,2,"H","N","2010-11-07","201011070NYR"
"STL",0,0,1,1,0,2,0,0,0,0,0,0,"A","N","2010-11-07","201011070NYR"
"PHI",0,1,1,0,0,2,1,1,1,0,0,3,"A","N","2010-11-07","201011070WSH"
"WSH",1,1,1,0,0,3,0,1,1,0,0,2,"H","N","2010-11-07","201011070WSH"
"DET",1,1,0,1,0,3,0,1,1,0,0,2,"H","N","2010-11-08","201011080DET"
"PHX",0,1,1,0,0,2,1,1,0,1,0,3,"A","N","2010-11-08","201011080DET"
"CAR",0,4,1,2,0,7,0,0,0,1,0,1,"H","N","2010-11-09","201011090CAR"
"EDM",0,0,0,1,0,1,0,4,1,2,0,7,"A","N","2010-11-09","201011090CAR"
"CGY",0,0,1,3,0,4,0,1,0,1,0,2,"A","N","2010-11-09","201011090COL"
"COL",0,1,0,1,0,2,0,0,1,3,0,4,"H","N","2010-11-09","201011090COL"
"MTL",0,1,0,1,0,2,0,0,0,0,0,0,"H","N","2010-11-09","201011090MTL"
"VAN",0,0,0,0,0,0,0,1,0,1,0,2,"A","N","2010-11-09","201011090MTL"
"NYR",0,2,1,0,0,3,0,1,2,2,0,5,"H","N","2010-11-09","201011090NYR"
"WSH",0,1,2,2,0,5,0,2,1,0,0,3,"A","N","2010-11-09","201011090NYR"
"ATL",0,1,0,1,0,2,0,2,2,1,0,5,"A","N","2010-11-09","201011090OTT"
"OTT",0,2,2,1,0,5,0,1,0,1,0,2,"H","N","2010-11-09","201011090OTT"
"ANA",1,1,1,0,0,3,0,1,0,1,0,2,"A","N","2010-11-09","201011090SJS"
"SJS",0,1,0,1,0,2,1,1,1,0,0,3,"H","N","2010-11-09","201011090SJS"
"TBL",0,3,0,1,0,4,0,0,0,0,0,0,"H","N","2010-11-09","201011090TBL"
"TOR",0,0,0,0,0,0,0,3,0,1,0,4,"A","N","2010-11-09","201011090TBL"
"ANA",0,0,0,1,0,1,0,0,0,0,0,0,"H","N","2010-11-10","201011100ANA"
"NYI",0,0,0,0,0,0,0,0,0,1,0,1,"A","N","2010-11-10","201011100ANA"
"CBJ",0,3,3,2,0,8,0,0,1,0,0,1,"H","N","2010-11-10","201011100CBJ"
"STL",0,0,1,0,0,1,0,3,3,2,0,8,"A","N","2010-11-10","201011100CBJ"
"CHI",0,1,0,0,0,1,0,0,2,0,0,2,"H","N","2010-11-10","201011100CHI"
"PHX",0,0,2,0,0,2,0,1,0,0,0,1,"A","N","2010-11-10","201011100CHI"
"FLA",0,1,1,2,0,4,0,0,0,1,0,1,"H","N","2010-11-10","201011100FLA"
"TOR",0,0,0,1,0,1,0,1,1,2,0,4,"A","N","2010-11-10","201011100FLA"
"BUF",0,0,3,1,1,5,0,1,3,0,0,4,"A","Y","2010-11-10","201011100NJD"
"NJD",0,1,3,0,0,4,0,0,3,1,1,5,"H","Y","2010-11-10","201011100NJD"
"BOS",0,2,0,5,0,7,0,2,2,0,0,4,"A","N","2010-11-10","201011100PIT"
"PIT",0,2,2,0,0,4,0,2,0,5,0,7,"H","N","2010-11-10","201011100PIT"
"ATL",0,2,1,2,0,5,0,0,0,1,0,1,"H","N","2010-11-11","201011110ATL"
"MIN",0,0,0,1,0,1,0,2,1,2,0,5,"A","N","2010-11-11","201011110ATL"
"BOS",0,1,0,0,0,1,0,1,0,2,0,3,"H","N","2010-11-11","201011110BOS"
"MTL",0,1,0,2,0,3,0,1,0,0,0,1,"A","N","2010-11-11","201011110BOS"
"CAR",0,0,0,1,0,1,0,2,2,4,0,8,"H","N","2010-11-11","201011110CAR"
"PHI",0,2,2,4,0,8,0,0,0,1,0,1,"A","N","2010-11-11","201011110CAR"
"DET",0,3,2,1,0,6,0,0,0,2,0,2,"H","N","2010-11-11","201011110DET"
"EDM",0,0,0,2,0,2,0,3,2,1,0,6,"A","N","2010-11-11","201011110DET"
"DAL",0,1,0,0,0,1,0,1,0,2,0,3,"A","N","2010-11-11","201011110LAK"
"LAK",0,1,0,2,0,3,0,1,0,0,0,1,"H","N","2010-11-11","201011110LAK"
"BUF",0,0,2,0,0,2,1,1,1,0,0,3,"A","N","2010-11-11","201011110NYR"
"NYR",1,1,1,0,0,3,0,0,2,0,0,2,"H","N","2010-11-11","201011110NYR"
"OTT",0,1,0,1,0,2,0,1,1,4,0,6,"H","N","2010-11-11","201011110OTT"
"VAN",0,1,1,4,0,6,0,1,0,1,0,2,"A","N","2010-11-11","201011110OTT"
"NYI",0,0,1,0,0,1,0,0,1,0,1,2,"A","Y","2010-11-11","201011110SJS"
"SJS",0,0,1,0,1,2,0,0,1,0,0,1,"H","Y","2010-11-11","201011110SJS"
"NSH",0,0,1,1,1,3,0,1,0,1,0,2,"A","Y","2010-11-11","201011110STL"
"STL",0,1,0,1,0,2,0,0,1,1,1,3,"H","Y","2010-11-11","201011110STL"
"TBL",0,1,0,2,0,3,0,0,2,4,0,6,"A","N","2010-11-11","201011110WSH"
"WSH",0,0,2,4,0,6,0,1,0,2,0,3,"H","N","2010-11-11","201011110WSH"
"ANA",0,1,0,3,0,4,0,1,0,1,0,2,"H","N","2010-11-12","201011120ANA"
"DAL",0,1,0,1,0,2,0,1,0,3,0,4,"A","N","2010-11-12","201011120ANA"
"CBJ",0,1,0,0,0,1,0,1,3,1,0,5,"H","N","2010-11-12","201011120CBJ"
"COL",0,1,3,1,0,5,0,1,0,0,0,1,"A","N","2010-11-12","201011120CBJ"
"FLA",0,2,0,0,0,2,0,1,0,0,0,1,"H","N","2010-11-12","201011120FLA"
"MIN",0,1,0,0,0,1,0,2,0,0,0,2,"A","N","2010-11-12","201011120FLA"
"EDM",0,2,1,0,0,3,1,1,1,1,0,4,"A","N","2010-11-12","201011120NJD"
"NJD",1,1,1,1,0,4,0,2,1,0,0,3,"H","N","2010-11-12","201011120NJD"
"CGY",0,1,1,2,0,4,0,0,3,2,0,5,"A","N","2010-11-12","201011120PHX"
"PHX",0,0,3,2,0,5,0,1,1,2,0,4,"H","N","2010-11-12","201011120PHX"
"PIT",0,0,2,3,0,5,0,0,0,1,0,1,"H","N","2010-11-12","201011120PIT"
"TBL",0,0,0,1,0,1,0,0,2,3,0,5,"A","N","2010-11-12","201011120PIT"
"ATL",0,1,0,1,0,2,0,0,1,3,0,4,"H","N","2010-11-13","201011130ATL"
"PIT",0,0,1,3,0,4,0,1,0,1,0,2,"A","N","2010-11-13","201011130ATL"
"BOS",0,0,0,0,0,0,0,1,0,1,0,2,"H","N","2010-11-13","201011130BOS"
"OTT",0,1,0,1,0,2,0,0,0,0,0,0,"A","N","2010-11-13","201011130BOS"
"BUF",1,0,2,0,0,3,0,1,0,1,0,2,"H","N","2010-11-13","201011130BUF"
"WSH",0,1,0,1,0,2,1,0,2,0,0,3,"A","N","2010-11-13","201011130BUF"
"COL",0,0,0,1,0,1,0,1,2,0,0,3,"A","N","2010-11-13","201011130DET"
"DET",0,1,2,0,0,3,0,0,0,1,0,1,"H","N","2010-11-13","201011130DET"
"LAK",0,2,1,2,0,5,0,1,0,0,0,1,"H","N","2010-11-13","201011130LAK"
"NYI",0,1,0,0,0,1,0,2,1,2,0,5,"A","N","2010-11-13","201011130LAK"
"CAR",0,0,2,0,0,2,0,2,3,2,0,7,"A","N","2010-11-13","201011130MTL"
"MTL",0,2,3,2,0,7,0,0,2,0,0,2,"H","N","2010-11-13","201011130MTL"
"CHI",0,1,2,0,0,3,0,0,2,1,1,4,"A","Y","2010-11-13","201011130NSH"
"NSH",0,0,2,1,1,4,0,1,2,0,0,3,"H","Y","2010-11-13","201011130NSH"
"FLA",0,0,1,1,0,2,0,2,3,0,0,5,"A","N","2010-11-13","201011130PHI"
"PHI",0,2,3,0,0,5,0,0,1,1,0,2,"H","N","2010-11-13","201011130PHI"
"PHX",0,1,3,1,0,5,0,1,1,1,0,3,"H","N","2010-11-13","201011130PHX"
"STL",0,1,1,1,0,3,0,1,3,1,0,5,"A","N","2010-11-13","201011130PHX"
"CGY",0,0,1,2,0,3,0,2,1,1,0,4,"A","N","2010-11-13","201011130SJS"
"SJS",0,2,1,1,0,4,0,0,1,2,0,3,"H","N","2010-11-13","201011130SJS"
"TOR",0,2,1,0,0,3,0,2,1,2,0,5,"H","N","2010-11-13","201011130TOR"
"VAN",0,2,1,2,0,5,0,2,1,0,0,3,"A","N","2010-11-13","201011130TOR"
"ANA",0,1,0,1,0,2,1,1,1,0,0,3,"A","N","2010-11-14","201011140CHI"
"CHI",1,1,1,0,0,3,0,1,0,1,0,2,"H","N","2010-11-14","201011140CHI"
"EDM",0,0,2,0,0,2,0,1,4,3,0,8,"A","N","2010-11-14","201011140NYR"
"NYR",0,1,4,3,0,8,0,0,2,0,0,2,"H","N","2010-11-14","201011140NYR"
"MIN",0,3,0,1,0,4,0,1,0,0,0,1,"A","N","2010-11-14","201011140TBL"
"TBL",0,1,0,0,0,1,0,3,0,1,0,4,"H","N","2010-11-14","201011140TBL"
"ATL",0,1,3,0,0,4,0,3,1,2,0,6,"A","N","2010-11-14","201011140WSH"
"WSH",0,3,1,2,0,6,0,1,3,0,0,4,"H","N","2010-11-14","201011140WSH"
"BOS",0,1,1,1,0,3,0,0,0,0,0,0,"H","N","2010-11-15","201011150BOS"
"NJD",0,0,0,0,0,0,0,1,1,1,0,3,"A","N","2010-11-15","201011150BOS"
"BUF",1,2,1,0,0,4,0,0,1,2,0,3,"H","N","2010-11-15","201011150BUF"
"VAN",0,0,1,2,0,3,1,2,1,0,0,4,"A","N","2010-11-15","201011150BUF"
"COL",0,3,2,1,0,6,0,1,1,1,0,3,"H","N","2010-11-15","201011150COL"
"STL",0,1,1,1,0,3,0,3,2,1,0,6,"A","N","2010-11-15","201011150COL"
"OTT",0,1,0,0,0,1,0,2,1,2,0,5,"A","N","2010-11-15","201011150PHI"
"PHI",0,2,1,2,0,5,0,1,0,0,0,1,"H","N","2010-11-15","201011150PHI"
"NYR",1,0,1,1,0,3,0,0,0,2,0,2,"A","N","2010-11-15","201011150PIT"
"PIT",0,0,0,2,0,2,1,0,1,1,0,3,"H","N","2010-11-15","201011150PIT"
"LAK",0,1,1,1,0,3,0,2,1,3,0,6,"A","N","2010-11-15","201011150SJS"
"SJS",0,2,1,3,0,6,0,1,1,1,0,3,"H","N","2010-11-15","201011150SJS"
"ANA",0,0,1,0,0,1,0,1,0,1,0,2,"A","N","2010-11-16","201011160DAL"
"DAL",0,1,0,1,0,2,0,0,1,0,0,1,"H","N","2010-11-16","201011160DAL"
"MTL",0,1,1,1,0,3,0,0,0,0,0,0,"H","N","2010-11-16","201011160MTL"
"PHI",0,0,0,0,0,0,0,1,1,1,0,3,"A","N","2010-11-16","201011160MTL"
"NSH",0,3,1,0,0,4,0,1,4,0,0,5,"A","N","2010-11-16","201011160TOR"
"TOR",0,1,4,0,0,5,0,3,1,0,0,4,"H","N","2010-11-16","201011160TOR"
"ATL",0,1,0,0,0,1,0,0,2,0,0,2,"H","N","2010-11-17","201011170ATL"
"FLA",0,0,2,0,0,2,0,1,0,0,0,1,"A","N","2010-11-17","201011170ATL"
"CAR",0,4,0,3,0,7,0,0,0,1,0,1,"H","N","2010-11-17","201011170CAR"
"OTT",0,0,0,1,0,1,0,4,0,3,0,7,"A","N","2010-11-17","201011170CAR"
"CGY",0,0,0,1,0,1,0,0,2,1,0,3,"H","N","2010-11-17","201011170CGY"
"PHX",0,0,2,1,0,3,0,0,0,1,0,1,"A","N","2010-11-17","201011170CGY"
"COL",1,1,0,2,0,4,0,1,2,0,0,3,"H","N","2010-11-17","201011170COL"
"SJS",0,1,2,0,0,3,1,1,0,2,0,4,"A","N","2010-11-17","201011170COL"
"DET",0,1,2,4,0,7,0,1,2,0,0,3,"H","N","2010-11-17","201011170DET"
"STL",0,1,2,0,0,3,0,1,2,4,0,7,"A","N","2010-11-17","201011170DET"
"CHI",0,2,2,1,0,5,0,0,0,0,0,0,"A","N","2010-11-17","201011170EDM"
"EDM",0,0,0,0,0,0,0,2,2,1,0,5,"H","N","2010-11-17","201011170EDM"
"CBJ",0,1,1,3,0,5,0,1,1,1,0,3,"A","N","2010-11-17","201011170LAK"
"LAK",0,1,1,1,0,3,0,1,1,3,0,5,"H","N","2010-11-17","201011170LAK"
"ANA",0,0,1,0,0,1,1,0,1,0,0,2,"A","N","2010-11-17","201011170MIN"
"MIN",1,0,1,0,0,2,0,0,1,0,0,1,"H","N","2010-11-17","201011170MIN"
"NYI",0,0,1,1,0,2,0,1,1,2,0,4,"H","N","2010-11-17","201011170NYI"
"TBL",0,1,1,2,0,4,0,0,1,1,0,2,"A","N","2010-11-17","201011170NYI"
"BOS",0,0,2,1,0,3,0,0,1,1,0,2,"A","N","2010-11-17","201011170NYR"
"NYR",0,0,1,1,0,2,0,0,2,1,0,3,"H","N","2010-11-17","201011170NYR"
"PIT",0,1,2,0,0,3,0,0,1,0,0,1,"H","N","2010-11-17","201011170PIT"
"VAN",0,0,1,0,0,1,0,1,2,0,0,3,"A","N","2010-11-17","201011170PIT"
"BUF",0,0,2,0,0,2,0,2,1,1,0,4,"A","N","2010-11-17","201011170WSH"
"WSH",0,2,1,1,0,4,0,0,2,0,0,2,"H","N","2010-11-17","201011170WSH"
"BOS",0,1,0,3,0,4,0,0,0,0,0,0,"H","N","2010-11-18","201011180BOS"
"FLA",0,0,0,0,0,0,0,1,0,3,0,4,"A","N","2010-11-18","201011180BOS"
"DAL",1,2,0,2,0,5,0,1,2,1,0,4,"H","N","2010-11-18","201011180DAL"
"SJS",0,1,2,1,0,4,1,2,0,2,0,5,"A","N","2010-11-18","201011180DAL"
"MTL",0,0,0,0,0,0,0,0,1,2,0,3,"H","N","2010-11-18","201011180MTL"
"NSH",0,0,1,2,0,3,0,0,0,0,0,0,"A","N","2010-11-18","201011180MTL"
"PHI",0,5,2,0,0,7,0,4,3,1,0,8,"H","N","2010-11-18","201011180PHI"
"TBL",0,4,3,1,0,8,0,5,2,0,0,7,"A","N","2010-11-18","201011180PHI"
"NJD",0,0,1,0,0,1,0,0,2,1,0,3,"A","N","2010-11-18","201011180TOR"
"TOR",0,0,2,1,0,3,0,0,1,0,0,1,"H","N","2010-11-18","201011180TOR"
"ANA",0,0,2,1,0,3,0,1,3,0,0,4,"H","N","2010-11-19","201011190ANA"
"CBJ",0,1,3,0,0,4,0,0,2,1,0,3,"A","N","2010-11-19","201011190ANA"
"ATL",0,3,1,1,0,5,0,0,0,0,0,0,"H","N","2010-11-19","201011190ATL"
"WSH",0,0,0,0,0,0,0,3,1,1,0,5,"A","N","2010-11-19","201011190ATL"
"BUF",0,0,2,2,0,4,0,1,1,0,0,2,"H","N","2010-11-19","201011190BUF"
"LAK",0,1,1,0,0,2,0,0,2,2,0,4,"A","N","2010-11-19","201011190BUF"
"CGY",0,2,2,3,0,7,0,1,0,1,0,2,"H","N","2010-11-19","201011190CGY"
"CHI",0,1,0,1,0,2,0,2,2,3,0,7,"A","N","2010-11-19","201011190CGY"
"COL",0,0,4,1,0,5,0,0,0,1,0,1,"H","N","2010-11-19","201011190COL"
"NYR",0,0,0,1,0,1,0,0,4,1,0,5,"A","N","2010-11-19","201011190COL"
"DET",0,0,1,2,0,3,1,1,1,1,0,4,"H","N","2010-11-19","201011190DET"
"MIN",1,1,1,1,0,4,0,0,1,2,0,3,"A","N","2010-11-19","201011190DET"
"EDM",0,1,2,0,0,3,0,0,2,1,1,4,"H","Y","2010-11-19","201011190EDM"
"PHX",0,0,2,1,1,4,0,1,2,0,0,3,"A","Y","2010-11-19","201011190EDM"
"CAR",0,2,1,1,0,4,0,2,1,1,1,5,"A","Y","2010-11-19","201011190PIT"
"PIT",0,2,1,1,1,5,0,2,1,1,0,4,"H","Y","2010-11-19","201011190PIT"
"OTT",0,1,0,1,0,2,0,0,3,2,0,5,"A","N","2010-11-19","201011190STL"
"STL",0,0,3,2,0,5,0,1,0,1,0,2,"H","N","2010-11-19","201011190STL"
"BOS",0,0,2,1,0,3,0,2,1,0,1,4,"H","Y","2010-11-20","201011200BOS"
"LAK",0,2,1,0,1,4,0,0,2,1,0,3,"A","Y","2010-11-20","201011200BOS"
"BUF",0,1,0,0,0,1,0,1,1,0,0,2,"H","N","2010-11-20","201011200BUF"
"TBL",0,1,1,0,0,2,0,1,0,0,0,1,"A","N","2010-11-20","201011200BUF"
"CAR",0,1,0,0,0,1,0,0,1,0,1,2,"H","Y","2010-11-20","201011200CAR"
"NSH",0,0,1,0,1,2,0,1,0,0,0,1,"A","Y","2010-11-20","201011200CAR"
"COL",0,1,2,0,1,4,0,0,2,1,0,3,"A","Y","2010-11-20","201011200DAL"
"DAL",0,0,2,1,0,3,0,1,2,0,1,4,"H","Y","2010-11-20","201011200DAL"
"MIN",0,0,0,2,0,2,0,0,3,2,0,5,"H","N","2010-11-20","201011200MIN"
"NYR",0,0,3,2,0,5,0,0,0,2,0,2,"A","N","2010-11-20","201011200MIN"
"MTL",0,0,1,1,0,2,0,0,0,0,0,0,"H","N","2010-11-20","201011200MTL"
"TOR",0,0,0,0,0,0,0,0,1,1,0,2,"A","N","2010-11-20","201011200MTL"
"FLA",0,0,4,0,0,4,0,1,0,0,0,1,"A","N","2010-11-20","201011200NYI"
"NYI",0,1,0,0,0,1,0,0,4,0,0,4,"H","N","2010-11-20","201011200NYI"
"CBJ",0,1,1,1,0,3,0,0,0,0,0,0,"A","N","2010-11-20","201011200SJS"
"SJS",0,0,0,0,0,0,0,1,1,1,0,3,"H","N","2010-11-20","201011200SJS"
"NJD",0,1,1,0,0,2,0,1,1,1,0,3,"A","N","2010-11-20","201011200STL"
"STL",0,1,1,1,0,3,0,1,1,0,0,2,"H","N","2010-11-20","201011200STL"
"CHI",0,0,4,3,0,7,0,0,0,1,0,1,"A","N","2010-11-20","201011200VAN"
"VAN",0,0,0,1,0,1,0,0,4,3,0,7,"H","N","2010-11-20","201011200VAN"
"PHI",0,0,2,2,1,5,0,1,0,3,0,4,"A","Y","2010-11-20","201011200WSH"
"WSH",0,1,0,3,0,4,0,0,2,2,1,5,"H","Y","2010-11-20","201011200WSH"
"ANA",0,0,2,0,0,2,0,0,2,2,0,4,"H","N","2010-11-21","201011210ANA"
"EDM",0,0,2,2,0,4,0,0,2,0,0,2,"A","N","2010-11-21","201011210ANA"
"ATL",1,0,0,1,0,2,0,0,1,0,0,1,"H","N","2010-11-21","201011210ATL"
"NYI",0,0,1,0,0,1,1,0,0,1,0,2,"A","N","2010-11-21","201011210ATL"
"CGY",0,1,2,1,0,4,1,1,0,3,0,5,"A","N","2010-11-21","201011210DET"
"DET",1,1,0,3,0,5,0,1,2,1,0,4,"H","N","2010-11-21","201011210DET"
"PHX",0,0,2,1,0,3,0,0,2,0,0,2,"A","N","2010-11-21","201011210VAN"
"VAN",0,0,2,0,0,2,0,0,2,1,0,3,"H","N","2010-11-21","201011210VAN"
"CBJ",0,1,1,0,0,2,0,0,0,0,0,0,"H","N","2010-11-22","201011220CBJ"
"NSH",0,0,0,0,0,0,0,1,1,0,0,2,"A","N","2010-11-22","201011220CBJ"
"FLA",0,1,1,0,0,2,0,2,0,1,0,3,"H","N","2010-11-22","201011220FLA"
"PIT",0,2,0,1,0,3,0,1,1,0,0,2,"A","N","2010-11-22","201011220FLA"
"NJD",0,3,2,0,0,5,0,0,0,0,0,0,"H","N","2010-11-22","201011220NJD"
"WSH",0,0,0,0,0,0,0,3,2,0,0,5,"A","N","2010-11-22","201011220NJD"
"CGY",0,0,1,0,0,1,0,0,2,0,0,2,"A","N","2010-11-22","201011220NYR"
"NYR",0,0,2,0,0,2,0,0,1,0,0,1,"H","N","2010-11-22","201011220NYR"
"LAK",0,1,1,0,0,2,0,1,1,1,0,3,"A","N","2010-11-22","201011220OTT"
"OTT",0,1,1,1,0,3,0,1,1,0,0,2,"H","N","2010-11-22","201011220OTT"
"MTL",0,2,0,0,0,2,0,0,1,2,0,3,"A","N","2010-11-22","201011220PHI"
"PHI",0,0,1,2,0,3,0,2,0,0,0,2,"H","N","2010-11-22","201011220PHI"
"BOS",0,0,0,1,0,1,0,0,3,0,0,3,"A","N","2010-11-22","201011220TBL"
"TBL",0,0,3,0,0,3,0,0,0,1,0,1,"H","N","2010-11-22","201011220TBL"
"DAL",0,0,1,0,0,1,0,1,2,1,0,4,"A","N","2010-11-22","201011220TOR"
"TOR",0,1,2,1,0,4,0,0,1,0,0,1,"H","N","2010-11-22","201011220TOR"
"EDM",0,0,0,0,0,0,0,1,2,2,0,5,"A","N","2010-11-23","201011230PHX"
"PHX",0,1,2,2,0,5,0,0,0,0,0,0,"H","N","2010-11-23","201011230PHX"
"ATL",0,2,2,1,0,5,0,1,0,0,0,1,"H","N","2010-11-24","201011240ATL"
"DET",0,1,0,0,0,1,0,2,2,1,0,5,"A","N","2010-11-24","201011240ATL"
"BUF",0,0,0,0,0,0,0,1,0,0,0,1,"H","N","2010-11-24","201011240BUF"
"PIT",0,1,0,0,0,1,0,0,0,0,0,0,"A","N","2010-11-24","201011240BUF"
"CAR",0,0,0,2,0,2,0,1,1,1,0,3,"H","N","2010-11-24","201011240CAR"
"WSH",0,1,1,1,0,3,0,0,0,2,0,2,"A","N","2010-11-24","201011240CAR"
"BOS",0,0,0,3,0,3,0,0,1,0,0,1,"A","N","2010-11-24","201011240FLA"
"FLA",0,0,1,0,0,1,0,0,0,3,0,3,"H","N","2010-11-24","201011240FLA"
"MIN",0,0,1,0,0,1,0,2,1,3,0,6,"H","N","2010-11-24","201011240MIN"
"PHI",0,2,1,3,0,6,0,0,1,0,0,1,"A","N","2010-11-24","201011240MIN"
"LAK",0,0,1,0,0,1,0,2,2,0,0,4,"A","N","2010-11-24","201011240MTL"
"MTL",0,2,2,0,0,4,0,0,1,0,0,1,"H","N","2010-11-24","201011240MTL"
"CGY",0,0,0,1,0,1,0,1,0,0,1,2,"A","Y","2010-11-24","201011240NJD"
"NJD",0,1,0,0,1,2,0,0,0,1,0,1,"H","Y","2010-11-24","201011240NJD"
"NSH",0,0,1,0,0,1,0,1,0,0,1,2,"H","Y","2010-11-24","201011240NSH"
"STL",0,1,0,0,1,2,0,0,1,0,0,1,"A","Y","2010-11-24","201011240NSH"
"CBJ",1,2,1,0,0,4,0,1,2,0,0,3,"A","N","2010-11-24","201011240NYI"
"NYI",0,1,2,0,0,3,1,2,1,0,0,4,"H","N","2010-11-24","201011240NYI"
"DAL",0,0,1,1,0,2,0,0,1,0,0,1,"A","N","2010-11-24","201011240OTT"
"OTT",0,0,1,0,0,1,0,0,1,1,0,2,"H","N","2010-11-24","201011240OTT"
"CHI",0,0,1,1,0,2,0,1,2,2,0,5,"A","N","2010-11-24","201011240SJS"
"SJS",0,1,2,2,0,5,0,0,1,1,0,2,"H","N","2010-11-24","201011240SJS"
"NYR",0,0,0,3,0,3,0,2,3,0,0,5,"A","N","2010-11-24","201011240TBL"
"TBL",0,2,3,0,0,5,0,0,0,3,0,3,"H","N","2010-11-24","201011240TBL"
"COL",0,0,1,1,0,2,0,1,1,2,0,4,"A","N","2010-11-24","201011240VAN"
"VAN",0,1,1,2,0,4,0,0,1,1,0,2,"H","N","2010-11-24","201011240VAN"
"COL",0,1,1,0,0,2,0,2,0,1,0,3,"A","N","2010-11-25","201011250EDM"
"EDM",0,2,0,1,0,3,0,1,1,0,0,2,"H","N","2010-11-25","201011250EDM"
"ANA",0,1,0,0,0,1,0,0,1,3,0,4,"H","N","2010-11-26","201011260ANA"
"CHI",0,0,1,3,0,4,0,1,0,0,0,1,"A","N","2010-11-26","201011260ANA"
"ATL",0,1,2,0,0,3,0,0,0,0,0,0,"H","N","2010-11-26","201011260ATL"
"MTL",0,0,0,0,0,0,0,1,2,0,0,3,"A","N","2010-11-26","201011260ATL"
"BOS",0,0,0,0,0,0,0,1,1,1,0,3,"H","N","2010-11-26","201011260BOS"
"CAR",0,1,1,1,0,3,0,0,0,0,0,0,"A","N","2010-11-26","201011260BOS"
"BUF",0,2,0,1,0,3,0,0,0,1,0,1,"H","N","2010-11-26","201011260BUF"
"TOR",0,0,0,1,0,1,0,2,0,1,0,3,"A","N","2010-11-26","201011260BUF"
"CBJ",0,0,0,1,0,1,0,0,1,1,0,2,"H","N","2010-11-26","201011260CBJ"
"DET",0,0,1,1,0,2,0,0,0,1,0,1,"A","N","2010-11-26","201011260CBJ"
"DAL",0,0,1,2,0,3,0,1,1,0,0,2,"H","N","2010-11-26","201011260DAL"
"STL",0,1,1,0,0,2,0,0,1,2,0,3,"A","N","2010-11-26","201011260DAL"
"FLA",0,0,0,0,0,0,0,1,0,2,0,3,"H","N","2010-11-26","201011260FLA"
"NYR",0,1,0,2,0,3,0,0,0,0,0,0,"A","N","2010-11-26","201011260FLA"
"MIN",0,3,1,1,0,5,0,0,0,2,0,2,"H","N","2010-11-26","201011260MIN"
"NSH",0,0,0,2,0,2,0,3,1,1,0,5,"A","N","2010-11-26","201011260MIN"
"NJD",0,0,0,0,0,0,0,1,1,0,0,2,"A","N","2010-11-26","201011260NYI"
"NYI",0,1,1,0,0,2,0,0,0,0,0,0,"H","N","2010-11-26","201011260NYI"
"CGY",0,0,1,1,1,3,0,0,2,0,0,2,"A","Y","2010-11-26","201011260PHI"
"PHI",0,0,2,0,0,2,0,0,1,1,1,3,"H","Y","2010-11-26","201011260PHI"
"OTT",0,1,0,0,0,1,0,0,1,1,0,2,"A","N","2010-11-26","201011260PIT"
"PIT",0,0,1,1,0,2,0,1,0,0,0,1,"H","N","2010-11-26","201011260PIT"
"SJS",0,1,0,0,0,1,0,1,2,3,0,6,"A","N","2010-11-26","201011260VAN"
"VAN",0,1,2,3,0,6,0,1,0,0,0,1,"H","N","2010-11-26","201011260VAN"
"TBL",0,0,0,0,0,0,0,1,4,1,0,6,"A","N","2010-11-26","201011260WSH"
"WSH",0,1,4,1,0,6,0,0,0,0,0,0,"H","N","2010-11-26","201011260WSH"
"COL",0,1,4,2,0,7,0,2,1,1,0,4,"H","N","2010-11-27","201011270COL"
"MIN",0,2,1,1,0,4,0,1,4,2,0,7,"A","N","2010-11-27","201011270COL"
"EDM",0,1,0,2,0,3,0,1,2,1,0,4,"H","N","2010-11-27","201011270EDM"
"SJS",0,1,2,1,0,4,0,1,0,2,0,3,"A","N","2010-11-27","201011270EDM"
"CHI",0,0,1,1,0,2,0,0,0,1,0,1,"A","N","2010-11-27","201011270LAK"
"LAK",0,0,0,1,0,1,0,0,1,1,0,2,"H","N","2010-11-27","201011270LAK"
"BUF",0,0,0,1,0,1,0,1,2,0,0,3,"A","N","2010-11-27","201011270MTL"
"MTL",0,1,2,0,0,3,0,0,0,1,0,1,"H","N","2010-11-27","201011270MTL"
"NJD",0,1,0,0,1,2,0,0,0,1,0,1,"H","Y","2010-11-27","201011270NJD"
"PHI",0,0,0,1,0,1,0,1,0,0,1,2,"A","Y","2010-11-27","201011270NJD"
"NSH",0,1,0,0,0,1,0,0,0,1,1,2,"H","Y","2010-11-27","201011270NSH"
"NYR",0,0,0,1,1,2,0,1,0,0,0,1,"A","Y","2010-11-27","201011270NSH"
"OTT",0,1,2,0,0,3,0,0,0,0,0,0,"H","N","2010-11-27","201011270OTT"
"TOR",0,0,0,0,0,0,0,1,2,0,0,3,"A","N","2010-11-27","201011270OTT"
"ANA",0,1,2,3,0,6,0,1,2,1,0,4,"A","N","2010-11-27","201011270PHX"
"PHX",0,1,2,1,0,4,0,1,2,3,0,6,"H","N","2010-11-27","201011270PHX"
"CGY",0,0,0,1,0,1,0,0,2,2,0,4,"A","N","2010-11-27","201011270PIT"
"PIT",0,0,2,2,0,4,0,0,0,1,0,1,"H","N","2010-11-27","201011270PIT"
"DAL",0,0,0,2,0,2,0,0,1,0,0,1,"A","N","2010-11-27","201011270STL"
"STL",0,0,1,0,0,1,0,0,0,2,0,2,"H","N","2010-11-27","201011270STL"
"FLA",0,0,1,2,1,4,0,1,1,1,0,3,"A","Y","2010-11-27","201011270TBL"
"TBL",0,1,1,1,0,3,0,0,1,2,1,4,"H","Y","2010-11-27","201011270TBL"
"ATL",0,3,1,0,0,4,0,0,1,0,0,1,"H","N","2010-11-28","201011280ATL"
"BOS",0,0,1,0,0,1,0,3,1,0,0,4,"A","N","2010-11-28","201011280ATL"
"CBJ",0,1,0,1,0,2,0,0,2,2,0,4,"A","N","2010-11-28","201011280DET"
"DET",0,0,2,2,0,4,0,1,0,1,0,2,"H","N","2010-11-28","201011280DET"
"CAR",0,0,1,1,0,2,0,2,0,0,1,3,"A","Y","2010-11-28","201011280WSH"
"WSH",0,2,0,0,1,3,0,0,1,1,0,2,"H","Y","2010-11-28","201011280WSH"
"ANA",0,0,1,1,0,2,0,0,0,0,0,0,"H","N","2010-11-29","201011290ANA"
"LAK",0,0,0,0,0,0,0,0,1,1,0,2,"A","N","2010-11-29","201011290ANA"
"CAR",0,0,1,0,0,1,0,1,2,1,0,4,"H","N","2010-11-29","201011290CAR"
"DAL",0,1,2,1,0,4,0,0,1,0,0,1,"A","N","2010-11-29","201011290CAR"
"CGY",0,0,2,1,0,3,0,0,0,0,0,0,"H","N","2010-11-29","201011290CGY"
"MIN",0,0,0,0,0,0,0,0,2,1,0,3,"A","N","2010-11-29","201011290CGY"
"NYR",0,0,1,0,0,1,0,1,2,0,0,3,"H","N","2010-11-29","201011290NYR"
"PIT",0,1,2,0,0,3,0,0,1,0,0,1,"A","N","2010-11-29","201011290NYR"
"EDM",0,0,1,3,0,4,0,1,0,0,0,1,"A","N","2010-11-29","201011290OTT"
"OTT",0,1,0,0,0,1,0,0,1,3,0,4,"H","N","2010-11-29","201011290OTT"
"CHI",0,2,3,2,0,7,0,1,1,3,0,5,"H","N","2010-11-30","201011300CHI"
"STL",0,1,1,3,0,5,0,2,3,2,0,7,"A","N","2010-11-30","201011300CHI"
"ATL",1,1,0,1,0,3,0,0,0,2,0,2,"A","N","2010-11-30","201011300COL"
"COL",0,0,0,2,0,2,1,1,0,1,0,3,"H","N","2010-11-30","201011300COL"
"NSH",0,1,1,1,0,3,0,0,0,0,0,0,"H","N","2010-11-30","201011300NSH"
"PHX",0,0,0,0,0,0,0,1,1,1,0,3,"A","N","2010-11-30","201011300NSH"
"DET",0,2,2,1,0,5,0,1,1,1,0,3,"A","N","2010-11-30","201011300SJS"
"SJS",0,1,1,1,0,3,0,2,2,1,0,5,"H","N","2010-11-30","201011300SJS"
"TBL",1,0,1,2,0,4,0,1,1,1,0,3,"A","N","2010-11-30","201011300TOR"
"TOR",0,1,1,1,0,3,1,0,1,2,0,4,"H","N","2010-11-30","201011300TOR"
"ANA",0,1,2,2,0,5,0,0,1,2,0,3,"H","N","2010-12-01","201012010ANA"
"FLA",0,0,1,2,0,3,0,1,2,2,0,5,"A","N","2010-12-01","201012010ANA"
"CBJ",0,0,1,2,0,3,0,1,1,1,1,4,"H","Y","2010-12-01","201012010CBJ"
"NSH",0,1,1,1,1,4,0,0,1,2,0,3,"A","Y","2010-12-01","201012010CBJ"
"CGY",0,1,1,0,0,2,0,2,1,4,0,7,"H","N","2010-12-01","201012010CGY"
"VAN",0,2,1,4,0,7,0,1,1,0,0,2,"A","N","2010-12-01","201012010CGY"
"MIN",0,0,0,2,0,2,0,1,1,2,0,4,"H","N","2010-12-01","201012010MIN"
"PHX",0,1,1,2,0,4,0,0,0,2,0,2,"A","N","2010-12-01","201012010MIN"
"EDM",1,1,0,2,0,4,0,1,2,0,0,3,"A","N","2010-12-01","201012010MTL"
"MTL",0,1,2,0,0,3,1,1,0,2,0,4,"H","N","2010-12-01","201012010MTL"
"BOS",0,2,0,1,0,3,0,0,0,0,0,0,"A","N","2010-12-01","201012010PHI"
"PHI",0,0,0,0,0,0,0,2,0,1,0,3,"H","N","2010-12-01","201012010PHI"
"STL",0,0,1,0,0,1,0,1,1,2,0,4,"H","N","2010-12-01","201012010STL"
"WSH",0,1,1,2,0,4,0,0,1,0,0,1,"A","N","2010-12-01","201012010STL"
"BOS",0,2,2,4,0,8,0,0,1,0,0,1,"H","N","2010-12-02","201012020BOS"
"TBL",0,0,1,0,0,1,0,2,2,4,0,8,"A","N","2010-12-02","201012020BOS"
"DAL",0,0,1,1,0,2,0,0,0,1,0,1,"H","N","2010-12-02","201012020DAL"
"WSH",0,0,0,1,0,1,0,0,1,1,0,2,"A","N","2010-12-02","201012020DAL"
"FLA",0,1,1,0,0,2,0,1,0,2,0,3,"A","N","2010-12-02","201012020LAK"
"LAK",0,1,0,2,0,3,0,1,1,0,0,2,"H","N","2010-12-02","201012020LAK"
"MTL",0,2,3,0,0,5,0,0,0,1,0,1,"A","N","2010-12-02","201012020NJD"
"NJD",0,0,0,1,0,1,0,2,3,0,0,5,"H","N","2010-12-02","201012020NJD"
"NYI",0,1,2,2,0,5,0,2,2,2,0,6,"H","N","2010-12-02","201012020NYI"
"NYR",0,2,2,2,0,6,0,1,2,2,0,5,"A","N","2010-12-02","201012020NYI"
"OTT",0,0,0,0,0,0,0,1,1,2,0,4,"H","N","2010-12-02","201012020OTT"
"SJS",0,1,1,2,0,4,0,0,0,0,0,0,"A","N","2010-12-02","201012020OTT"
"ATL",0,1,1,0,0,2,0,1,2,0,0,3,"A","N","2010-12-02","201012020PIT"
"PIT",0,1,2,0,0,3,0,1,1,0,0,2,"H","N","2010-12-02","201012020PIT"
"EDM",0,1,2,2,0,5,0,0,0,0,0,0,"A","N","2010-12-02","201012020TOR"
"TOR",0,0,0,0,0,0,0,1,2,2,0,5,"H","N","2010-12-02","201012020TOR"
"ANA",0,0,0,0,0,0,0,1,2,1,0,4,"H","N","2010-12-03","201012030ANA"
"DET",0,1,2,1,0,4,0,0,0,0,0,0,"A","N","2010-12-03","201012030ANA"
"BUF",0,2,1,2,0,5,0,0,0,0,0,0,"H","N","2010-12-03","201012030BUF"
"CBJ",0,0,0,0,0,0,0,2,1,2,0,5,"A","N","2010-12-03","201012030BUF"
"CAR",1,0,0,1,0,2,0,0,0,1,0,1,"H","N","2010-12-03","201012030CAR"
"COL",0,0,0,1,0,1,1,0,0,1,0,2,"A","N","2010-12-03","201012030CAR"
"CHI",0,0,0,0,0,0,0,0,1,2,0,3,"H","N","2010-12-03","201012030CHI"
"VAN",0,0,1,2,0,3,0,0,0,0,0,0,"A","N","2010-12-03","201012030CHI"
"CGY",0,0,1,1,1,3,0,0,1,1,0,2,"A","Y","2010-12-03","201012030MIN"
"MIN",0,0,1,1,0,2,0,0,1,1,1,3,"H","Y","2010-12-03","201012030MIN"
"NYI",0,0,0,0,0,0,0,0,1,1,0,2,"A","N","2010-12-03","201012030NYR"
"NYR",0,0,1,1,0,2,0,0,0,0,0,0,"H","N","2010-12-03","201012030NYR"
"CBJ",0,0,1,1,0,2,0,4,3,0,0,7,"H","N","2010-12-04","201012040CBJ"
"PIT",0,4,3,0,0,7,0,0,1,1,0,2,"A","N","2010-12-04","201012040CBJ"
"DAL",1,1,1,1,0,4,0,0,1,2,0,3,"H","N","2010-12-04","201012040DAL"
"MIN",0,0,1,2,0,3,1,1,1,1,0,4,"A","N","2010-12-04","201012040DAL"
"EDM",1,0,0,1,0,2,0,0,0,1,0,1,"H","N","2010-12-04","201012040EDM"
"STL",0,0,0,1,0,1,1,0,0,1,0,2,"A","N","2010-12-04","201012040EDM"
"DET",0,1,1,0,0,2,1,0,2,0,0,3,"A","N","2010-12-04","201012040LAK"
"LAK",1,0,2,0,0,3,0,1,1,0,0,2,"H","N","2010-12-04","201012040LAK"
"MTL",0,1,1,1,0,3,0,1,0,0,0,1,"H","N","2010-12-04","201012040MTL"
"SJS",0,1,0,0,0,1,0,1,1,1,0,3,"A","N","2010-12-04","201012040MTL"
"CAR",0,1,1,0,0,2,0,3,0,2,0,5,"A","N","2010-12-04","201012040NSH"
"NSH",0,3,0,2,0,5,0,1,1,0,0,2,"H","N","2010-12-04","201012040NSH"
"BUF",0,0,0,0,1,1,0,0,0,0,0,0,"A","Y","2010-12-04","201012040OTT"
"OTT",0,0,0,0,0,0,0,0,0,0,1,1,"H","Y","2010-12-04","201012040OTT"
"NJD",0,2,0,1,0,3,0,1,1,3,0,5,"A","N","2010-12-04","201012040PHI"
"PHI",0,1,1,3,0,5,0,2,0,1,0,3,"H","N","2010-12-04","201012040PHI"
"FLA",0,0,1,0,1,2,0,0,1,0,0,1,"A","Y","2010-12-04","201012040PHX"
"PHX",0,0,1,0,0,1,0,0,1,0,1,2,"H","Y","2010-12-04","201012040PHX"
"COL",0,1,1,3,0,5,0,1,3,2,0,6,"A","N","2010-12-04","201012040TBL"
"TBL",0,1,3,2,0,6,0,1,1,3,0,5,"H","N","2010-12-04","201012040TBL"
"BOS",0,1,0,1,0,2,0,1,0,1,1,3,"A","Y","2010-12-04","201012040TOR"
"TOR",0,1,0,1,1,3,0,1,0,1,0,2,"H","Y","2010-12-04","201012040TOR"
"ATL",0,0,2,1,0,3,0,0,1,0,0,1,"A","N","2010-12-04","201012040WSH"
"WSH",0,0,1,0,0,1,0,0,2,1,0,3,"H","N","2010-12-04","201012040WSH"
"ANA",0,0,0,0,0,0,0,1,1,1,0,3,"H","N","2010-12-05","201012050ANA"
"PHX",0,1,1,1,0,3,0,0,0,0,0,0,"A","N","2010-12-05","201012050ANA"
"CGY",0,2,0,0,0,2,0,3,0,1,0,4,"A","N","2010-12-05","201012050CHI"
"CHI",0,3,0,1,0,4,0,2,0,0,0,2,"H","N","2010-12-05","201012050CHI"
"NYI",0,0,0,2,0,2,0,1,0,2,0,3,"H","N","2010-12-05","201012050NYI"
"PHI",0,1,0,2,0,3,0,0,0,2,0,2,"A","N","2010-12-05","201012050NYI"
"NYR",0,0,1,0,0,1,0,0,1,2,0,3,"H","N","2010-12-05","201012050NYR"
"OTT",0,0,1,2,0,3,0,0,1,0,0,1,"A","N","2010-12-05","201012050NYR"
"STL",0,1,1,1,0,3,0,1,1,0,0,2,"A","N","2010-12-05","201012050VAN"
"VAN",0,1,1,0,0,2,0,1,1,1,0,3,"H","N","2010-12-05","201012050VAN"
"ATL",1,0,1,1,0,3,0,2,0,0,0,2,"H","N","2010-12-06","201012060ATL"
"NSH",0,2,0,0,0,2,1,0,1,1,0,3,"A","N","2010-12-06","201012060ATL"
"CBJ",0,1,0,1,1,3,0,0,1,1,0,2,"H","Y","2010-12-06","201012060CBJ"
"DAL",0,0,1,1,0,2,0,1,0,1,1,3,"A","Y","2010-12-06","201012060CBJ"
"DET",0,2,0,0,0,2,0,1,3,1,0,5,"H","N","2010-12-06","201012060DET"
"SJS",0,1,3,1,0,5,0,2,0,0,0,2,"A","N","2010-12-06","201012060DET"
"NJD",0,1,0,0,0,1,0,1,1,0,0,2,"A","N","2010-12-06","201012060PIT"
"PIT",0,1,1,0,0,2,0,1,0,0,0,1,"H","N","2010-12-06","201012060PIT"
"TOR",0,1,0,3,1,5,0,2,2,0,0,4,"A","Y","2010-12-06","201012060WSH"
"WSH",0,2,2,0,0,4,0,1,0,3,1,5,"H","Y","2010-12-06","201012060WSH"
"BOS",1,1,0,1,0,3,0,0,1,1,0,2,"H","N","2010-12-07","201012070BOS"
"BUF",0,0,1,1,0,2,1,1,0,1,0,3,"A","N","2010-12-07","201012070BOS"
"CGY",0,2,1,1,0,4,0,0,2,0,0,2,"H","N","2010-12-07","201012070CGY"
"TBL",0,0,2,0,0,2,0,2,1,1,0,4,"A","N","2010-12-07","201012070CGY"
"ANA",0,0,1,1,1,3,0,0,0,2,0,2,"A","Y","2010-12-07","201012070EDM"
"EDM",0,0,0,2,0,2,0,0,1,1,1,3,"H","Y","2010-12-07","201012070EDM"
"COL",0,0,2,1,0,3,1,1,1,1,0,4,"A","N","2010-12-07","201012070FLA"
"FLA",1,1,1,1,0,4,0,0,2,1,0,3,"H","N","2010-12-07","201012070FLA"
"MTL",0,1,0,3,0,4,0,1,0,0,0,1,"H","N","2010-12-07","201012070MTL"
"OTT",0,1,0,0,0,1,0,1,0,3,0,4,"A","N","2010-12-07","201012070MTL"
"CHI",0,2,2,1,0,5,0,0,3,0,0,3,"H","N","2010-12-08","201012080CHI"
"DAL",0,0,3,0,0,3,0,2,2,1,0,5,"A","N","2010-12-08","201012080CHI"
"DET",0,0,1,1,0,2,0,1,1,1,0,3,"H","N","2010-12-08","201012080DET"
"NSH",0,1,1,1,0,3,0,0,1,1,0,2,"A","N","2010-12-08","201012080DET"
"PHI",0,0,3,1,0,4,0,1,0,3,1,5,"H","Y","2010-12-08","201012080PHI"
"SJS",0,1,0,3,1,5,0,0,3,1,0,4,"A","Y","2010-12-08","201012080PHI"
"PIT",0,1,3,1,0,5,0,0,0,2,0,2,"H","N","2010-12-08","201012080PIT"
"TOR",0,0,0,2,0,2,0,1,3,1,0,5,"A","N","2010-12-08","201012080PIT"
"ANA",0,1,2,1,0,4,0,2,0,2,1,5,"A","Y","2010-12-08","201012080VAN"
"VAN",0,2,0,2,1,5,0,1,2,1,0,4,"H","Y","2010-12-08","201012080VAN"
"BOS",0,1,1,3,0,5,0,0,1,1,0,2,"H","N","2010-12-09","201012090BOS"
"NYI",0,0,1,1,0,2,0,1,1,3,0,5,"A","N","2010-12-09","201012090BOS"
"BUF",0,1,2,3,0,6,0,0,2,1,0,3,"H","N","2010-12-09","201012090BUF"
"SJS",0,0,2,1,0,3,0,1,2,3,0,6,"A","N","2010-12-09","201012090BUF"
"CGY",0,0,0,1,0,1,0,1,0,1,0,2,"A","N","2010-12-09","201012090LAK"
"LAK",0,1,0,1,0,2,0,0,0,1,0,1,"H","N","2010-12-09","201012090LAK"
"NYR",0,1,1,3,0,5,0,1,2,0,0,3,"A","N","2010-12-09","201012090OTT"
"OTT",0,1,2,0,0,3,0,1,1,3,0,5,"H","N","2010-12-09","201012090OTT"
"MIN",0,2,0,1,0,3,0,1,0,1,0,2,"A","N","2010-12-09","201012090PHX"
"PHX",0,1,0,1,0,2,0,2,0,1,0,3,"H","N","2010-12-09","201012090PHX"
"CBJ",0,0,0,1,0,1,0,2,1,1,0,4,"A","N","2010-12-09","201012090STL"
"STL",0,2,1,1,0,4,0,0,0,1,0,1,"H","N","2010-12-09","201012090STL"
"PHI",0,2,2,0,0,4,0,0,1,0,0,1,"A","N","2010-12-09","201012090TOR"
"TOR",0,0,1,0,0,1,0,2,2,0,0,4,"H","N","2010-12-09","201012090TOR"
"FLA",0,0,1,2,0,3,0,0,0,0,0,0,"A","N","2010-12-09","201012090WSH"
"WSH",0,0,0,0,0,0,0,0,1,2,0,3,"H","N","2010-12-09","201012090WSH"
"ANA",0,1,1,0,1,3,0,0,0,2,0,2,"H","Y","2010-12-10","201012100ANA"
"CGY",0,0,0,2,0,2,0,1,1,0,1,3,"A","Y","2010-12-10","201012100ANA"
"ATL",0,1,1,0,0,2,0,0,2,2,0,4,"H","N","2010-12-10","201012100ATL"
"COL",0,0,2,2,0,4,0,1,1,0,0,2,"A","N","2010-12-10","201012100ATL"
"CAR",0,0,1,0,0,1,0,1,0,0,1,2,"A","Y","2010-12-10","201012100DAL"
"DAL",0,1,0,0,1,2,0,0,1,0,0,1,"H","Y","2010-12-10","201012100DAL"
"DET",0,1,2,1,0,4,0,1,0,1,0,2,"H","N","2010-12-10","201012100DET"
"MTL",0,1,0,1,0,2,0,1,2,1,0,4,"A","N","2010-12-10","201012100DET"
"EDM",0,1,2,0,1,4,0,2,0,1,0,3,"H","Y","2010-12-10","201012100EDM"
"TBL",0,2,0,1,0,3,0,1,2,0,1,4,"A","Y","2010-12-10","201012100EDM"
"NJD",0,0,2,0,0,2,0,1,2,0,0,3,"A","N","2010-12-10","201012100OTT"
"OTT",0,1,2,0,0,3,0,0,2,0,0,2,"H","N","2010-12-10","201012100OTT"
"BOS",0,0,0,1,0,1,1,0,1,0,0,2,"H","N","2010-12-11","201012110BOS"
"PHI",1,0,1,0,0,2,0,0,0,1,0,1,"A","N","2010-12-11","201012110BOS"
"BUF",0,1,0,1,0,2,0,2,0,3,0,5,"H","N","2010-12-11","201012110BUF"
"PIT",0,2,0,3,0,5,0,1,0,1,0,2,"A","N","2010-12-11","201012110BUF"
"CBJ",0,0,1,2,0,3,0,0,1,0,0,1,"H","N","2010-12-11","201012110CBJ"
"NYR",0,0,1,0,0,1,0,0,1,2,0,3,"A","N","2010-12-11","201012110CBJ"
"LAK",0,0,1,1,0,2,1,1,1,0,0,3,"H","N","2010-12-11","201012110LAK"
"MIN",1,1,1,0,0,3,0,0,1,1,0,2,"A","N","2010-12-11","201012110LAK"
"DET",0,2,1,1,0,4,0,0,0,1,0,1,"A","N","2010-12-11","201012110NJD"
"NJD",0,0,0,1,0,1,0,2,1,1,0,4,"H","N","2010-12-11","201012110NJD"
"FLA",0,0,0,0,0,0,0,2,0,1,0,3,"A","N","2010-12-11","201012110NSH"
"NSH",0,2,0,1,0,3,0,0,0,0,0,0,"H","N","2010-12-11","201012110NSH"
"ATL",0,0,1,4,0,5,0,1,1,2,0,4,"A","N","2010-12-11","201012110NYI"
"NYI",0,1,1,2,0,4,0,0,1,4,0,5,"H","N","2010-12-11","201012110NYI"
"DAL",0,0,1,1,0,2,0,3,0,2,0,5,"A","N","2010-12-11","201012110PHX"
"PHX",0,3,0,2,0,5,0,0,1,1,0,2,"H","N","2010-12-11","201012110PHX"
"CHI",0,1,0,0,0,1,1,1,0,0,0,2,"A","N","2010-12-11","201012110SJS"
"SJS",1,1,0,0,0,2,0,1,0,0,0,1,"H","N","2010-12-11","201012110SJS"
"CAR",0,0,0,1,1,2,0,0,0,1,0,1,"A","Y","2010-12-11","201012110STL"
"STL",0,0,0,1,0,1,0,0,0,1,1,2,"H","Y","2010-12-11","201012110STL"
"MTL",0,0,1,0,0,1,0,2,0,1,0,3,"A","N","2010-12-11","201012110TOR"
"TOR",0,2,0,1,0,3,0,0,1,0,0,1,"H","N","2010-12-11","201012110TOR"
"TBL",1,1,3,0,0,5,0,1,1,2,0,4,"A","N","2010-12-11","201012110VAN"
"VAN",0,1,1,2,0,4,1,1,3,0,0,5,"H","N","2010-12-11","201012110VAN"
"COL",0,2,1,0,0,3,0,1,0,1,0,2,"A","N","2010-12-11","201012110WSH"
"WSH",0,1,0,1,0,2,0,2,1,0,0,3,"H","N","2010-12-11","201012110WSH"
"ANA",0,2,3,1,0,6,0,1,1,0,0,2,"H","N","2010-12-12","201012120ANA"
"MIN",0,1,1,0,0,2,0,2,3,1,0,6,"A","N","2010-12-12","201012120ANA"
"EDM",0,0,0,1,0,1,0,1,1,0,0,2,"H","N","2010-12-12","201012120EDM"
"VAN",0,1,1,0,0,2,0,0,0,1,0,1,"A","N","2010-12-12","201012120EDM"
"NYR",0,1,4,2,0,7,0,0,0,0,0,0,"H","N","2010-12-12","201012120NYR"
"WSH",0,0,0,0,0,0,0,1,4,2,0,7,"A","N","2010-12-12","201012120NYR"
"CBJ",0,0,1,1,0,2,1,2,0,0,0,3,"A","N","2010-12-13","201012130CGY"
"CGY",1,2,0,0,0,3,0,0,1,1,0,2,"H","N","2010-12-13","201012130CGY"
"CHI",0,3,1,1,0,5,0,3,1,3,0,7,"A","N","2010-12-13","201012130COL"
"COL",0,3,1,3,0,7,0,3,1,1,0,5,"H","N","2010-12-13","201012130COL"
"DET",0,0,0,0,0,0,0,1,1,3,0,5,"H","N","2010-12-13","201012130DET"
"LAK",0,1,1,3,0,5,0,0,0,0,0,0,"A","N","2010-12-13","201012130DET"
"NSH",0,1,2,2,0,5,0,0,0,0,0,0,"H","N","2010-12-13","201012130NSH"
"NYI",0,0,0,0,0,0,0,1,2,2,0,5,"A","N","2010-12-13","201012130NSH"
"ATL",1,2,1,0,0,4,0,0,1,2,0,3,"A","N","2010-12-13","201012130OTT"
"OTT",0,0,1,2,0,3,1,2,1,0,0,4,"H","N","2010-12-13","201012130OTT"
"DAL",0,1,1,0,1,3,0,0,2,0,0,2,"A","Y","2010-12-13","201012130SJS"
"SJS",0,0,2,0,0,2,0,1,1,0,1,3,"H","Y","2010-12-13","201012130SJS"
"EDM",0,1,0,0,0,1,0,1,2,1,0,4,"H","N","2010-12-14","201012140EDM"
"TOR",0,1,2,1,0,4,0,1,0,0,0,1,"A","N","2010-12-14","201012140EDM"
"PHI",0,1,1,1,0,3,0,0,1,1,0,2,"H","N","2010-12-14","201012140PHI"
"PIT",0,0,1,1,0,2,0,1,1,1,0,3,"A","N","2010-12-14","201012140PHI"
"BOS",0,1,0,1,0,2,0,1,0,2,0,3,"A","N","2010-12-15","201012150BUF"
"BUF",0,1,0,2,0,3,0,1,0,1,0,2,"H","N","2010-12-15","201012150BUF"
"CHI",0,0,1,2,0,3,0,1,0,3,0,4,"H","N","2010-12-15","201012150CHI"
"COL",0,1,0,3,0,4,0,0,1,2,0,3,"A","N","2010-12-15","201012150CHI"
"DET",0,0,3,2,0,5,0,0,1,1,0,2,"H","N","2010-12-15","201012150DET"
"STL",0,0,1,1,0,2,0,0,3,2,0,5,"A","N","2010-12-15","201012150DET"
"CAR",0,0,1,3,0,4,0,3,0,0,0,3,"A","N","2010-12-15","201012150FLA"
"FLA",0,3,0,0,0,3,0,0,1,3,0,4,"H","N","2010-12-15","201012150FLA"
"MTL",0,0,1,2,0,3,0,1,1,3,0,5,"H","N","2010-12-15","201012150MTL"
"PHI",0,1,1,3,0,5,0,0,1,2,0,3,"A","N","2010-12-15","201012150MTL"
"NJD",0,2,0,1,0,3,0,0,0,0,0,0,"H","N","2010-12-15","201012150NJD"
"PHX",0,0,0,0,0,0,0,2,0,1,0,3,"A","N","2010-12-15","201012150NJD"
"NSH",0,0,1,2,0,3,0,1,1,0,0,2,"H","N","2010-12-15","201012150NSH"
"SJS",0,1,1,0,0,2,0,0,1,2,0,3,"A","N","2010-12-15","201012150NSH"
"NYR",0,0,0,4,0,4,0,1,0,0,0,1,"A","N","2010-12-15","201012150PIT"
"PIT",0,1,0,0,0,1,0,0,0,4,0,4,"H","N","2010-12-15","201012150PIT"
"ATL",0,1,0,0,0,1,0,0,1,0,1,2,"A","Y","2010-12-15","201012150TBL"
"TBL",0,0,1,0,1,2,0,1,0,0,0,1,"H","Y","2010-12-15","201012150TBL"
"CBJ",0,0,1,1,0,2,1,1,1,0,0,3,"A","N","2010-12-15","201012150VAN"
"VAN",1,1,1,0,0,3,0,0,1,1,0,2,"H","N","2010-12-15","201012150VAN"
"ANA",1,0,1,0,0,2,0,1,0,0,0,1,"A","N","2010-12-15","201012150WSH"
"WSH",0,1,0,0,0,1,1,0,1,0,0,2,"H","N","2010-12-15","201012150WSH"
"ATL",0,0,2,0,0,2,0,0,0,2,1,3,"H","Y","2010-12-16","201012160ATL"
"CAR",0,0,0,2,1,3,0,0,2,0,0,2,"A","Y","2010-12-16","201012160ATL"
"CGY",0,1,3,1,0,5,0,1,0,1,0,2,"H","N","2010-12-16","201012160CGY"
"TOR",0,1,0,1,0,2,0,1,3,1,0,5,"A","N","2010-12-16","201012160CGY"
"DAL",0,1,1,1,0,3,1,1,2,0,0,4,"H","N","2010-12-16","201012160DAL"
"SJS",1,1,2,0,0,4,0,1,1,1,0,3,"A","N","2010-12-16","201012160DAL"
"CBJ",0,2,0,1,0,3,0,3,3,0,0,6,"A","N","2010-12-16","201012160EDM"
"EDM",0,3,3,0,0,6,0,2,0,1,0,3,"H","N","2010-12-16","201012160EDM"
"MIN",0,1,0,0,0,1,0,0,2,1,0,3,"H","N","2010-12-16","201012160MIN"
"OTT",0,0,2,1,0,3,0,1,0,0,0,1,"A","N","2010-12-16","201012160MIN"
"BOS",0,1,1,1,0,3,0,3,1,0,0,4,"A","N","2010-12-16","201012160MTL"
"MTL",0,3,1,0,0,4,0,1,1,1,0,3,"H","N","2010-12-16","201012160MTL"
"ANA",0,0,1,1,0,2,0,3,0,0,0,3,"A","N","2010-12-16","201012160NYI"
"NYI",0,3,0,0,0,3,0,0,1,1,0,2,"H","N","2010-12-16","201012160NYI"
"NYR",0,1,1,1,1,4,0,2,1,0,0,3,"H","Y","2010-12-16","201012160NYR"
"PHX",0,2,1,0,0,3,0,1,1,1,1,4,"A","Y","2010-12-16","201012160NYR"
"LAK",0,1,3,0,0,4,0,1,3,2,0,6,"A","N","2010-12-16","201012160STL"
"STL",0,1,3,2,0,6,0,1,3,0,0,4,"H","N","2010-12-16","201012160STL"
"CHI",0,2,1,1,0,4,0,1,0,0,0,1,"H","N","2010-12-17","201012170CHI"
"DET",0,1,0,0,0,1,0,2,1,1,0,4,"A","N","2010-12-17","201012170CHI"
"COL",1,1,2,2,0,6,0,2,1,2,0,5,"H","N","2010-12-17","201012170COL"
"OTT",0,2,1,2,0,5,1,1,2,2,0,6,"A","N","2010-12-17","201012170COL"
"BUF",0,0,1,1,0,2,0,4,1,1,0,6,"A","N","2010-12-17","201012170FLA"
"FLA",0,4,1,1,0,6,0,0,1,1,0,2,"H","N","2010-12-17","201012170FLA"
"NJD",0,0,0,1,0,1,0,1,1,1,0,3,"H","N","2010-12-17","201012170NJD"
"NSH",0,1,1,1,0,3,0,0,0,1,0,1,"A","N","2010-12-17","201012170NJD"
"ATL",0,3,1,3,0,7,0,0,1,0,0,1,"H","N","2010-12-18","201012180ATL"
"NJD",0,0,1,0,0,1,0,3,1,3,0,7,"A","N","2010-12-18","201012180ATL"
"BOS",0,3,0,0,0,3,0,0,1,1,0,2,"H","N","2010-12-18","201012180BOS"
"WSH",0,0,1,1,0,2,0,3,0,0,0,3,"A","N","2010-12-18","201012180BOS"
"ANA",0,1,0,1,0,2,0,2,1,1,0,4,"A","N","2010-12-18","201012180CAR"
"CAR",0,2,1,1,0,4,0,1,0,1,0,2,"H","N","2010-12-18","201012180CAR"
"CBJ",0,1,0,0,0,1,0,1,0,1,0,2,"H","N","2010-12-18","201012180CBJ"
"DAL",0,1,0,1,0,2,0,1,0,0,0,1,"A","N","2010-12-18","201012180CBJ"
"CGY",0,0,0,1,0,1,0,0,2,1,0,3,"H","N","2010-12-18","201012180CGY"
"MIN",0,0,2,1,0,3,0,0,0,1,0,1,"A","N","2010-12-18","201012180CGY"
"LAK",0,4,2,0,0,6,0,1,0,0,0,1,"A","N","2010-12-18","201012180NSH"
"NSH",0,1,0,0,0,1,0,4,2,0,0,6,"H","N","2010-12-18","201012180NSH"
"NYI",0,0,2,1,0,3,0,1,0,2,1,4,"H","Y","2010-12-18","201012180NYI"
"PHX",0,1,0,2,1,4,0,0,2,1,0,3,"A","Y","2010-12-18","201012180NYI"
"NYR",0,0,0,1,0,1,0,0,1,3,0,4,"A","N","2010-12-18","201012180PHI"
"PHI",0,0,1,3,0,4,0,0,0,1,0,1,"H","N","2010-12-18","201012180PHI"
"SJS",0,2,1,1,0,4,0,0,1,0,0,1,"A","N","2010-12-18","201012180STL"
"STL",0,0,1,0,0,1,0,2,1,1,0,4,"H","N","2010-12-18","201012180STL"
"BUF",0,0,1,0,0,1,0,0,2,1,0,3,"A","N","2010-12-18","201012180TBL"
"TBL",0,0,2,1,0,3,0,0,1,0,0,1,"H","N","2010-12-18","201012180TBL"
"TOR",0,0,0,1,0,1,0,1,1,2,0,4,"A","N","2010-12-18","201012180VAN"
"VAN",0,1,1,2,0,4,0,0,0,1,0,1,"H","N","2010-12-18","201012180VAN"
"CHI",0,1,2,0,0,3,0,0,1,1,0,2,"H","N","2010-12-19","201012190CHI"
"LAK",0,0,1,1,0,2,0,1,2,0,0,3,"A","N","2010-12-19","201012190CHI"
"COL",0,1,2,0,0,3,0,1,1,0,0,2,"H","N","2010-12-19","201012190COL"
"MTL",0,1,1,0,0,2,0,1,2,0,0,3,"A","N","2010-12-19","201012190COL"
"DAL",1,2,0,1,0,4,0,2,1,0,0,3,"A","N","2010-12-19","201012190DET"
"DET",0,2,1,0,0,3,1,2,0,1,0,4,"H","N","2010-12-19","201012190DET"
"OTT",0,2,0,0,0,2,0,0,3,0,0,3,"H","N","2010-12-19","201012190OTT"
"WSH",0,0,3,0,0,3,0,2,0,0,0,2,"A","N","2010-12-19","201012190OTT"
"ANA",0,1,2,0,0,3,0,0,0,0,0,0,"A","N","2010-12-20","201012200BOS"
"BOS",0,0,0,0,0,0,0,1,2,0,0,3,"H","N","2010-12-20","201012200BOS"
"CGY",0,0,1,0,0,1,0,1,0,3,0,4,"A","N","2010-12-20","201012200MIN"
"MIN",0,1,0,3,0,4,0,0,1,0,0,1,"H","N","2010-12-20","201012200MIN"
"FLA",0,2,2,1,0,5,0,0,0,0,0,0,"A","N","2010-12-20","201012200PHI"
"PHI",0,0,0,0,0,0,0,2,2,1,0,5,"H","N","2010-12-20","201012200PHI"
"PHX",0,0,0,1,0,1,0,2,3,1,0,6,"A","N","2010-12-20","201012200PIT"
"PIT",0,2,3,1,0,6,0,0,0,1,0,1,"H","N","2010-12-20","201012200PIT"
"STL",0,0,1,0,0,1,0,0,2,1,0,3,"H","N","2010-12-20","201012200STL"
"VAN",0,0,2,1,0,3,0,0,1,0,0,1,"A","N","2010-12-20","201012200STL"
"CAR",0,1,0,0,0,1,0,2,3,0,0,5,"A","N","2010-12-20","201012200TBL"
"TBL",0,2,3,0,0,5,0,1,0,0,0,1,"H","N","2010-12-20","201012200TBL"
"ATL",0,2,1,3,0,6,0,0,1,2,0,3,"A","N","2010-12-20","201012200TOR"
"TOR",0,0,1,2,0,3,0,2,1,3,0,6,"H","N","2010-12-20","201012200TOR"
"ATL",0,1,0,1,0,2,0,1,1,2,0,4,"H","N","2010-12-21","201012210ATL"
"STL",0,1,1,2,0,4,0,1,0,1,0,2,"A","N","2010-12-21","201012210ATL"
"ANA",0,0,0,2,0,2,0,3,1,1,0,5,"A","N","2010-12-21","201012210BUF"
"BUF",0,3,1,1,0,5,0,0,0,2,0,2,"H","N","2010-12-21","201012210BUF"
"CBJ",0,1,1,1,0,3,0,0,1,0,0,1,"H","N","2010-12-21","201012210CBJ"
"CGY",0,0,1,0,0,1,0,1,1,1,0,3,"A","N","2010-12-21","201012210CBJ"
"COL",0,0,0,0,0,0,0,1,1,3,0,5,"H","N","2010-12-21","201012210COL"
"LAK",0,1,1,3,0,5,0,0,0,0,0,0,"A","N","2010-12-21","201012210COL"
"DAL",0,2,2,1,0,5,0,0,1,1,0,2,"H","N","2010-12-21","201012210DAL"
"MTL",0,0,1,1,0,2,0,2,2,1,0,5,"A","N","2010-12-21","201012210DAL"
"EDM",0,0,0,1,0,1,0,0,2,0,0,2,"A","N","2010-12-21","201012210SJS"
"SJS",0,0,2,0,0,2,0,0,0,1,0,1,"H","N","2010-12-21","201012210SJS"
"NJD",0,0,1,0,0,1,0,1,3,1,0,5,"A","N","2010-12-21","201012210WSH"
"WSH",0,1,3,1,0,5,0,0,1,0,0,1,"H","N","2010-12-21","201012210WSH"
"CHI",0,1,1,2,0,4,0,0,0,1,0,1,"H","N","2010-12-22","201012220CHI"
"NSH",0,0,0,1,0,1,0,1,1,2,0,4,"A","N","2010-12-22","201012220CHI"
"DET",1,1,1,2,0,5,0,0,3,1,0,4,"H","N","2010-12-22","201012220DET"
"VAN",0,0,3,1,0,4,1,1,1,2,0,5,"A","N","2010-12-22","201012220DET"
"NYI",1,0,1,0,0,2,0,1,0,0,0,1,"H","N","2010-12-22","201012220NYI"
"TBL",0,1,0,0,0,1,1,0,1,0,0,2,"A","N","2010-12-22","201012220NYI"
"FLA",0,1,0,1,0,2,0,3,1,1,0,5,"A","N","2010-12-22","201012220PIT"
"PIT",0,3,1,1,0,5,0,1,0,1,0,2,"H","N","2010-12-22","201012220PIT"
"ATL",0,0,1,0,0,1,0,1,2,1,0,4,"A","N","2010-12-23","201012230BOS"
"BOS",0,1,2,1,0,4,0,0,1,0,0,1,"H","N","2010-12-23","201012230BOS"
"BUF",0,0,3,0,0,3,0,3,0,1,0,4,"H","N","2010-12-23","201012230BUF"
"FLA",0,3,0,1,0,4,0,0,3,0,0,3,"A","N","2010-12-23","201012230BUF"
"CAR",0,0,2,0,0,2,0,0,3,0,0,3,"H","N","2010-12-23","201012230CAR"
"MTL",0,0,3,0,0,3,0,0,2,0,0,2,"A","N","2010-12-23","201012230CAR"
"CBJ",0,0,1,2,0,3,0,3,3,1,0,7,"H","N","2010-12-23","201012230CBJ"
"VAN",0,3,3,1,0,7,0,0,1,2,0,3,"A","N","2010-12-23","201012230CBJ"
"COL",0,1,0,0,0,1,0,2,1,0,0,3,"H","N","2010-12-23","201012230COL"
"MIN",0,2,1,0,0,3,0,1,0,0,0,1,"A","N","2010-12-23","201012230COL"
"CGY",0,1,0,1,1,3,0,1,0,1,0,2,"A","Y","2010-12-23","201012230DAL"
"DAL",0,1,0,1,0,2,0,1,0,1,1,3,"H","Y","2010-12-23","201012230DAL"
"EDM",0,0,1,1,0,2,0,0,1,1,1,3,"A","Y","2010-12-23","201012230LAK"
"LAK",0,0,1,1,1,3,0,0,1,1,0,2,"H","Y","2010-12-23","201012230LAK"
"NJD",0,0,1,0,0,1,0,3,1,1,0,5,"H","N","2010-12-23","201012230NJD"
"NYI",0,3,1,1,0,5,0,0,1,0,0,1,"A","N","2010-12-23","201012230NJD"
"NSH",0,0,1,0,0,1,0,1,1,0,0,2,"H","N","2010-12-23","201012230NSH"
"OTT",0,1,1,0,0,2,0,0,1,0,0,1,"A","N","2010-12-23","201012230NSH"
"NYR",0,2,0,1,0,3,0,2,1,0,1,4,"H","Y","2010-12-23","201012230NYR"
"TBL",0,2,1,0,1,4,0,2,0,1,0,3,"A","Y","2010-12-23","201012230NYR"
"PHX",0,0,1,0,0,1,0,0,2,2,0,4,"A","N","2010-12-23","201012230SJS"
"SJS",0,0,2,2,0,4,0,0,1,0,0,1,"H","N","2010-12-23","201012230SJS"
"DET",0,1,2,0,0,3,0,3,1,0,0,4,"A","N","2010-12-23","201012230STL"
"STL",0,3,1,0,0,4,0,1,2,0,0,3,"H","N","2010-12-23","201012230STL"
"PIT",0,1,0,1,1,3,0,0,1,1,0,2,"A","Y","2010-12-23","201012230WSH"
"WSH",0,0,1,1,0,2,0,1,0,1,1,3,"H","Y","2010-12-23","201012230WSH"
"ATL",0,0,1,1,0,2,1,1,1,0,0,3,"H","N","2010-12-26","201012260ATL"
"TBL",1,1,1,0,0,3,0,0,1,1,0,2,"A","N","2010-12-26","201012260ATL"
"CAR",0,0,1,1,0,2,0,1,2,0,0,3,"H","N","2010-12-26","201012260CAR"
"WSH",0,1,2,0,0,3,0,0,1,1,0,2,"A","N","2010-12-26","201012260CAR"
"CBJ",0,0,0,1,0,1,0,1,0,3,0,4,"A","N","2010-12-26","201012260CHI"
"CHI",0,1,0,3,0,4,0,0,0,1,0,1,"H","N","2010-12-26","201012260CHI"
"DAL",0,0,0,0,0,0,0,0,1,0,0,1,"H","N","2010-12-26","201012260DAL"
"PHX",0,0,1,0,0,1,0,0,0,0,0,0,"A","N","2010-12-26","201012260DAL"
"ANA",0,0,1,0,0,1,0,0,4,0,0,4,"A","N","2010-12-26","201012260LAK"
"LAK",0,0,4,0,0,4,0,0,1,0,0,1,"H","N","2010-12-26","201012260LAK"
"DET",0,2,2,0,0,4,0,0,0,1,0,1,"A","N","2010-12-26","201012260MIN"
"MIN",0,0,0,1,0,1,0,2,2,0,0,4,"H","N","2010-12-26","201012260MIN"
"NJD",0,0,0,1,0,1,0,1,2,1,0,4,"H","N","2010-12-26","201012260NJD"
"TOR",0,1,2,1,0,4,0,0,0,1,0,1,"A","N","2010-12-26","201012260NJD"
"MTL",0,0,0,1,0,1,0,1,1,2,0,4,"A","N","2010-12-26","201012260NYI"
"NYI",0,1,1,2,0,4,0,0,0,1,0,1,"H","N","2010-12-26","201012260NYI"
"OTT",0,2,1,0,0,3,0,0,0,1,0,1,"H","N","2010-12-26","201012260OTT"
"PIT",0,0,0,1,0,1,0,2,1,0,0,3,"A","N","2010-12-26","201012260OTT"
"NSH",0,0,0,0,0,0,0,0,1,1,0,2,"A","N","2010-12-26","201012260STL"
"STL",0,0,1,1,0,2,0,0,0,0,0,0,"H","N","2010-12-26","201012260STL"
"EDM",0,0,2,0,0,2,0,0,1,2,0,3,"A","N","2010-12-26","201012260VAN"
"VAN",0,0,1,2,0,3,0,0,2,0,0,2,"H","N","2010-12-26","201012260VAN"
"CBJ",0,0,1,2,1,4,0,1,1,1,0,3,"H","Y","2010-12-27","201012270CBJ"
"MIN",0,1,1,1,0,3,0,0,1,2,1,4,"A","Y","2010-12-27","201012270CBJ"
"BUF",0,1,0,1,0,2,0,0,2,3,0,5,"A","N","2010-12-27","201012270CGY"
"CGY",0,0,2,3,0,5,0,1,0,1,0,2,"H","N","2010-12-27","201012270CGY"
"COL",0,2,0,1,0,3,1,2,0,1,0,4,"H","N","2010-12-27","201012270COL"
"DET",1,2,0,1,0,4,0,2,0,1,0,3,"A","N","2010-12-27","201012270COL"
"BOS",0,0,1,1,1,3,0,0,2,0,0,2,"A","Y","2010-12-27","201012270FLA"
"FLA",0,0,2,0,0,2,0,0,1,1,1,3,"H","Y","2010-12-27","201012270FLA"
"NYI",0,2,0,0,0,2,0,2,2,3,0,7,"A","N","2010-12-27","201012270NYR"
"NYR",0,2,2,3,0,7,0,2,0,0,0,2,"H","N","2010-12-27","201012270NYR"
"LAK",0,0,0,4,0,4,0,0,0,0,0,0,"A","N","2010-12-27","201012270SJS"
"SJS",0,0,0,0,0,0,0,0,0,4,0,4,"H","N","2010-12-27","201012270SJS"
"BUF",0,1,1,2,0,4,0,1,0,1,0,2,"A","N","2010-12-28","201012280EDM"
"EDM",0,1,0,1,0,2,0,1,1,2,0,4,"H","N","2010-12-28","201012280EDM"
"DAL",0,0,1,3,0,4,0,0,1,1,0,2,"A","N","2010-12-28","201012280NSH"
"NSH",0,0,1,1,0,2,0,0,1,3,0,4,"H","N","2010-12-28","201012280NSH"
"ANA",0,3,0,0,0,3,0,0,1,0,0,1,"A","N","2010-12-28","201012280PHX"
"PHX",0,0,1,0,0,1,0,3,0,0,0,3,"H","N","2010-12-28","201012280PHX"
"ATL",0,2,0,1,0,3,0,2,1,3,0,6,"A","N","2010-12-28","201012280PIT"
"PIT",0,2,1,3,0,6,0,2,0,1,0,3,"H","N","2010-12-28","201012280PIT"
"CHI",0,1,0,0,0,1,0,0,1,2,0,3,"A","N","2010-12-28","201012280STL"
"STL",0,0,1,2,0,3,0,1,0,0,0,1,"H","N","2010-12-28","201012280STL"
"BOS",0,1,1,2,0,4,0,1,1,1,0,3,"A","N","2010-12-28","201012280TBL"
"TBL",0,1,1,1,0,3,0,1,1,2,0,4,"H","N","2010-12-28","201012280TBL"
"CAR",0,3,0,1,0,4,0,2,1,0,0,3,"A","N","2010-12-28","201012280TOR"
"TOR",0,2,1,0,0,3,0,3,0,1,0,4,"H","N","2010-12-28","201012280TOR"
"PHI",0,0,1,1,0,2,0,1,3,2,0,6,"A","N","2010-12-28","201012280VAN"
"VAN",0,1,3,2,0,6,0,0,1,1,0,2,"H","N","2010-12-28","201012280VAN"
"MTL",0,0,0,0,0,0,0,2,0,1,0,3,"A","N","2010-12-28","201012280WSH"
"WSH",0,2,0,1,0,3,0,0,0,0,0,0,"H","N","2010-12-28","201012280WSH"
"DAL",0,0,3,0,0,3,0,1,2,4,0,7,"H","N","2010-12-29","201012290DAL"
"DET",0,1,2,4,0,7,0,0,3,0,0,3,"A","N","2010-12-29","201012290DAL"
"MIN",0,1,1,3,0,5,0,1,2,0,0,3,"H","N","2010-12-29","201012290MIN"
"SJS",0,1,2,0,0,3,0,1,1,3,0,5,"A","N","2010-12-29","201012290MIN"
"NJD",0,1,0,0,0,1,0,1,1,1,0,3,"H","N","2010-12-29","201012290NJD"
"NYR",0,1,1,1,0,3,0,1,0,0,0,1,"A","N","2010-12-29","201012290NJD"
"NYI",0,0,1,0,1,2,0,0,1,0,0,1,"H","Y","2010-12-29","201012290NYI"
"PIT",0,0,1,0,0,1,0,0,1,0,1,2,"A","Y","2010-12-29","201012290NYI"
"CAR",0,2,1,1,0,4,0,0,0,0,0,0,"A","N","2010-12-29","201012290OTT"
"OTT",0,0,0,0,0,0,0,2,1,1,0,4,"H","N","2010-12-29","201012290OTT"
"LAK",0,3,0,0,0,3,0,4,2,0,0,6,"A","N","2010-12-29","201012290PHX"
"PHX",0,4,2,0,0,6,0,3,0,0,0,3,"H","N","2010-12-29","201012290PHX"
"ATL",0,1,1,0,1,3,0,1,1,0,0,2,"H","Y","2010-12-30","201012300ATL"
"BOS",0,1,1,0,0,2,0,1,1,0,1,3,"A","Y","2010-12-30","201012300ATL"
"CHI",0,1,2,0,0,3,0,1,2,2,0,5,"H","N","2010-12-30","201012300CHI"
"SJS",0,1,2,2,0,5,0,1,2,0,0,3,"A","N","2010-12-30","201012300CHI"
"COL",0,3,0,0,1,4,0,0,1,2,0,3,"A","Y","2010-12-30","201012300EDM"
"EDM",0,0,1,2,0,3,0,3,0,0,1,4,"H","Y","2010-12-30","201012300EDM"
"LAK",0,2,2,0,0,4,0,2,4,1,0,7,"H","N","2010-12-30","201012300LAK"
"PHI",0,2,4,1,0,7,0,2,2,0,0,4,"A","N","2010-12-30","201012300LAK"
"MTL",0,1,0,0,0,1,0,0,2,2,0,4,"A","N","2010-12-30","201012300TBL"
"TBL",0,0,2,2,0,4,0,1,0,0,0,1,"H","N","2010-12-30","201012300TBL"
"CBJ",0,1,1,1,0,3,0,2,0,0,0,2,"A","N","2010-12-30","201012300TOR"
"TOR",0,2,0,0,0,2,0,1,1,1,0,3,"H","N","2010-12-30","201012300TOR"
"ANA",0,1,2,2,0,5,0,0,1,1,0,2,"H","N","2010-12-31","201012310ANA"
"PHI",0,0,1,1,0,2,0,1,2,2,0,5,"A","N","2010-12-31","201012310ANA"
"CBJ",1,1,2,0,0,4,0,0,1,2,0,3,"H","N","2010-12-31","201012310CBJ"
"OTT",0,0,1,2,0,3,1,1,2,0,0,4,"A","N","2010-12-31","201012310CBJ"
"CGY",0,0,3,0,0,3,0,0,0,2,0,2,"H","N","2010-12-31","201012310CGY"
"COL",0,0,0,2,0,2,0,0,3,0,0,3,"A","N","2010-12-31","201012310CGY"
"DAL",0,0,0,1,0,1,0,2,2,0,0,4,"H","N","2010-12-31","201012310DAL"
"VAN",0,2,2,0,0,4,0,0,0,1,0,1,"A","N","2010-12-31","201012310DAL"
"DET",0,1,1,1,0,3,1,2,1,0,0,4,"H","N","2010-12-31","201012310DET"
"NYI",1,2,1,0,0,4,0,1,1,1,0,3,"A","N","2010-12-31","201012310DET"
"FLA",0,0,2,0,0,2,1,0,2,0,0,3,"H","N","2010-12-31","201012310FLA"
"MTL",1,0,2,0,0,3,0,0,2,0,0,2,"A","N","2010-12-31","201012310FLA"
"MIN",0,0,0,1,0,1,0,1,1,2,0,4,"H","N","2010-12-31","201012310MIN"
"NSH",0,1,1,2,0,4,0,0,0,1,0,1,"A","N","2010-12-31","201012310MIN"
"ATL",0,0,0,1,0,1,0,1,1,1,0,3,"A","N","2010-12-31","201012310NJD"
"NJD",0,1,1,1,0,3,0,0,0,1,0,1,"H","N","2010-12-31","201012310NJD"
"PHX",0,0,0,3,0,3,0,1,2,1,0,4,"A","N","2010-12-31","201012310STL"
"STL",0,1,2,1,0,4,0,0,0,3,0,3,"H","N","2010-12-31","201012310STL"
"BOS",0,4,0,2,0,6,0,3,2,1,1,7,"A","Y","2011-01-01","201101010BUF"
"BUF",0,3,2,1,1,7,0,4,0,2,0,6,"H","Y","2011-01-01","201101010BUF"
"CAR",0,4,1,1,0,6,0,1,1,1,0,3,"H","N","2011-01-01","201101010CAR"
"NJD",0,1,1,1,0,3,0,4,1,1,0,6,"A","N","2011-01-01","201101010CAR"
"CGY",0,1,1,0,0,2,0,0,1,0,0,1,"A","N","2011-01-01","201101010EDM"
"EDM",0,0,1,0,0,1,0,1,1,0,0,2,"H","N","2011-01-01","201101010EDM"
"LAK",0,0,0,0,0,0,0,0,1,0,0,1,"H","N","2011-01-01","201101010LAK"
"SJS",0,0,1,0,0,1,0,0,0,0,0,0,"A","N","2011-01-01","201101010LAK"
"OTT",0,0,1,0,0,1,0,3,2,0,0,5,"H","N","2011-01-01","201101010OTT"
"TOR",0,3,2,0,0,5,0,0,1,0,0,1,"A","N","2011-01-01","201101010OTT"
"PIT",0,0,1,0,0,1,0,0,2,1,0,3,"H","N","2011-01-01","201101010PIT"
"WSH",0,0,2,1,0,3,0,0,1,0,0,1,"A","N","2011-01-01","201101010PIT"
"NYR",0,0,0,1,0,1,1,1,0,0,0,2,"A","N","2011-01-01","201101010TBL"
"TBL",1,1,0,0,0,2,0,0,0,1,0,1,"H","N","2011-01-01","201101010TBL"
"ANA",0,1,1,0,0,2,0,1,0,0,0,1,"H","N","2011-01-02","201101020ANA"
"CHI",0,1,0,0,0,1,0,1,1,0,0,2,"A","N","2011-01-02","201101020ANA"
"COL",0,0,0,1,0,1,0,1,0,1,0,2,"H","N","2011-01-02","201101020COL"
"VAN",0,1,0,1,0,2,0,0,0,1,0,1,"A","N","2011-01-02","201101020COL"
"DET",0,0,0,2,0,2,0,0,3,0,0,3,"H","N","2011-01-02","201101020DET"
"PHI",0,0,3,0,0,3,0,0,0,2,0,2,"A","N","2011-01-02","201101020DET"
"FLA",0,0,1,2,0,3,0,0,0,0,0,0,"H","N","2011-01-02","201101020FLA"
"NYR",0,0,0,0,0,0,0,0,1,2,0,3,"A","N","2011-01-02","201101020FLA"
"MIN",1,1,2,2,0,6,0,1,0,4,0,5,"H","N","2011-01-02","201101020MIN"
"PHX",0,1,0,4,0,5,1,1,2,2,0,6,"A","N","2011-01-02","201101020MIN"
"ATL",1,1,2,0,0,4,0,1,1,1,0,3,"A","N","2011-01-02","201101020MTL"
"MTL",0,1,1,1,0,3,1,1,2,0,0,4,"H","N","2011-01-02","201101020MTL"
"CBJ",0,1,0,0,0,1,0,0,3,1,0,4,"A","N","2011-01-02","201101020NSH"
"NSH",0,0,3,1,0,4,0,1,0,0,0,1,"H","N","2011-01-02","201101020NSH"
"DAL",0,1,0,3,0,4,0,2,0,0,0,2,"A","N","2011-01-02","201101020STL"
"STL",0,2,0,0,0,2,0,1,0,3,0,4,"H","N","2011-01-02","201101020STL"
"CAR",0,1,0,2,0,3,1,1,1,1,0,4,"H","N","2011-01-03","201101030CAR"
"FLA",1,1,1,1,0,4,0,1,0,2,0,3,"A","N","2011-01-03","201101030CAR"
"CGY",0,1,1,0,0,2,0,3,1,1,0,5,"H","N","2011-01-03","201101030CGY"
"NYI",0,3,1,1,0,5,0,1,1,0,0,2,"A","N","2011-01-03","201101030CGY"
"CHI",0,1,1,2,0,4,0,1,1,1,0,3,"A","N","2011-01-03","201101030LAK"
"LAK",0,1,1,1,0,3,0,1,1,2,0,4,"H","N","2011-01-03","201101030LAK"
"SJS",0,0,3,0,0,3,0,1,2,1,0,4,"H","N","2011-01-03","201101030SJS"
"VAN",0,1,2,1,0,4,0,0,3,0,0,3,"A","N","2011-01-03","201101030SJS"
"BOS",0,0,2,0,0,2,0,1,0,0,0,1,"A","N","2011-01-03","201101030TOR"
"TOR",0,1,0,0,0,1,0,0,2,0,0,2,"H","N","2011-01-03","201101030TOR"
"BUF",0,1,0,2,0,3,1,2,0,1,0,4,"A","N","2011-01-04","201101040COL"
"COL",1,2,0,1,0,4,0,1,0,2,0,3,"H","N","2011-01-04","201101040COL"
"DET",0,1,2,2,0,5,0,1,0,2,0,3,"A","N","2011-01-04","201101040EDM"
"EDM",0,1,0,2,0,3,0,1,2,2,0,5,"H","N","2011-01-04","201101040EDM"
"MIN",0,1,0,1,0,2,0,0,1,0,0,1,"A","N","2011-01-04","201101040NJD"
"NJD",0,0,1,0,0,1,0,1,0,1,0,2,"H","N","2011-01-04","201101040NJD"
"CBJ",0,0,1,1,0,2,0,0,2,2,0,4,"A","N","2011-01-04","201101040PHX"
"PHX",0,0,2,2,0,4,0,0,1,1,0,2,"H","N","2011-01-04","201101040PHX"
"TBL",1,0,0,0,0,1,0,0,0,0,0,0,"A","N","2011-01-04","201101040WSH"
"WSH",0,0,0,0,0,0,1,0,0,0,0,1,"H","N","2011-01-04","201101040WSH"
"ANA",0,0,0,1,0,1,0,1,1,2,0,4,"H","N","2011-01-05","201101050ANA"
"NSH",0,1,1,2,0,4,0,0,0,1,0,1,"A","N","2011-01-05","201101050ANA"
"CHI",0,0,2,0,0,2,0,2,0,2,0,4,"H","N","2011-01-05","201101050CHI"
"DAL",0,2,0,2,0,4,0,0,2,0,0,2,"A","N","2011-01-05","201101050CHI"
"ATL",0,2,1,0,0,3,0,1,0,1,0,2,"A","N","2011-01-05","201101050FLA"
"FLA",0,1,0,1,0,2,0,2,1,0,0,3,"H","N","2011-01-05","201101050FLA"
"CAR",0,0,0,1,0,1,1,0,0,1,0,2,"A","N","2011-01-05","201101050NYR"
"NYR",1,0,0,1,0,2,0,0,0,1,0,1,"H","N","2011-01-05","201101050NYR"
"PIT",0,5,2,1,0,8,0,0,0,1,0,1,"H","N","2011-01-05","201101050PIT"
"TBL",0,0,0,1,0,1,0,5,2,1,0,8,"A","N","2011-01-05","201101050PIT"
"CGY",0,0,0,1,0,1,0,2,1,0,0,3,"A","N","2011-01-05","201101050VAN"
"VAN",0,2,1,0,0,3,0,0,0,1,0,1,"H","N","2011-01-05","201101050VAN"
"BOS",0,0,1,0,0,1,0,0,1,2,0,3,"H","N","2011-01-06","201101060BOS"
"MIN",0,0,1,2,0,3,0,0,1,0,0,1,"A","N","2011-01-06","201101060BOS"
"COL",0,0,0,0,0,0,0,1,0,1,0,2,"H","N","2011-01-06","201101060COL"
"PHX",0,1,0,1,0,2,0,0,0,0,0,0,"A","N","2011-01-06","201101060COL"
"EDM",0,2,0,0,0,2,0,0,1,0,0,1,"H","N","2011-01-06","201101060EDM"
"NYI",0,0,1,0,0,1,0,2,0,0,0,2,"A","N","2011-01-06","201101060EDM"
"LAK",0,0,2,0,0,2,0,0,3,2,0,5,"H","N","2011-01-06","201101060LAK"
"NSH",0,0,3,2,0,5,0,0,2,0,0,2,"A","N","2011-01-06","201101060LAK"
"MTL",0,0,1,0,1,2,0,1,0,0,0,1,"H","Y","2011-01-06","201101060MTL"
"PIT",0,1,0,0,0,1,0,0,1,0,1,2,"A","Y","2011-01-06","201101060MTL"
"NJD",0,1,1,0,0,2,0,0,2,2,0,4,"H","N","2011-01-06","201101060NJD"
"PHI",0,0,2,2,0,4,0,1,1,0,0,2,"A","N","2011-01-06","201101060NJD"
"BUF",0,2,1,0,0,3,0,0,0,0,0,0,"A","N","2011-01-06","201101060SJS"
"SJS",0,0,0,0,0,0,0,2,1,0,0,3,"H","N","2011-01-06","201101060SJS"
"STL",0,2,0,3,0,5,0,1,3,1,1,6,"A","Y","2011-01-06","201101060TOR"
"TOR",0,1,3,1,1,6,0,2,0,3,0,5,"H","Y","2011-01-06","201101060TOR"
"ANA",0,1,2,3,0,6,0,0,0,0,0,0,"H","N","2011-01-07","201101070ANA"
"CBJ",0,0,0,0,0,0,0,1,2,3,0,6,"A","N","2011-01-07","201101070ANA"
"ATL",0,1,0,2,0,3,0,2,6,1,0,9,"H","N","2011-01-07","201101070ATL"
"TOR",0,2,6,1,0,9,0,1,0,2,0,3,"A","N","2011-01-07","201101070ATL"
"CGY",0,2,2,0,0,4,0,1,2,1,1,5,"H","Y","2011-01-07","201101070CGY"
"DET",0,1,2,1,1,5,0,2,2,0,0,4,"A","Y","2011-01-07","201101070CGY"
"CHI",0,0,1,1,1,3,0,0,1,1,0,2,"H","Y","2011-01-07","201101070CHI"
"OTT",0,0,1,1,0,2,0,0,1,1,1,3,"A","Y","2011-01-07","201101070CHI"
"DAL",0,1,1,0,0,2,0,0,1,1,1,3,"H","Y","2011-01-07","201101070DAL"
"NYR",0,0,1,1,1,3,0,1,1,0,0,2,"A","Y","2011-01-07","201101070DAL"
"CAR",0,0,2,3,0,5,0,2,0,1,0,3,"A","N","2011-01-07","201101070FLA"
"FLA",0,2,0,1,0,3,0,0,2,3,0,5,"H","N","2011-01-07","201101070FLA"
"EDM",0,0,1,0,0,1,0,0,3,3,0,6,"A","N","2011-01-07","201101070VAN"
"VAN",0,0,3,3,0,6,0,0,1,0,0,1,"H","N","2011-01-07","201101070VAN"
"COL",0,2,0,1,0,3,1,2,1,0,0,4,"H","N","2011-01-08","201101080COL"
"NYI",1,2,1,0,0,4,0,2,0,1,0,3,"A","N","2011-01-08","201101080COL"
"CBJ",0,0,1,3,0,4,0,3,1,2,0,6,"A","N","2011-01-08","201101080LAK"
"LAK",0,3,1,2,0,6,0,0,1,3,0,4,"H","N","2011-01-08","201101080LAK"
"BOS",0,0,2,0,0,2,1,0,0,2,0,3,"A","N","2011-01-08","201101080MTL"
"MTL",1,0,0,2,0,3,0,0,2,0,0,2,"H","N","2011-01-08","201101080MTL"
"OTT",0,0,1,0,0,1,0,0,0,2,0,2,"H","N","2011-01-08","201101080OTT"
"TBL",0,0,0,2,0,2,0,0,1,0,0,1,"A","N","2011-01-08","201101080OTT"
"NJD",0,0,1,0,0,1,0,2,0,0,0,2,"A","N","2011-01-08","201101080PHI"
"PHI",0,2,0,0,0,2,0,0,1,0,0,1,"H","N","2011-01-08","201101080PHI"
"BUF",1,0,1,0,0,2,0,0,1,0,0,1,"A","N","2011-01-08","201101080PHX"
"PHX",0,0,1,0,0,1,1,0,1,0,0,2,"H","N","2011-01-08","201101080PHX"
"MIN",0,2,0,2,0,4,0,0,0,0,0,0,"A","N","2011-01-08","201101080PIT"
"PIT",0,0,0,0,0,0,0,2,0,2,0,4,"H","N","2011-01-08","201101080PIT"
"NSH",0,1,0,1,0,2,0,0,1,0,0,1,"A","N","2011-01-08","201101080SJS"
"SJS",0,0,1,0,0,1,0,1,0,1,0,2,"H","N","2011-01-08","201101080SJS"
"NYR",0,0,2,0,0,2,0,0,1,0,0,1,"A","N","2011-01-08","201101080STL"
"STL",0,0,1,0,0,1,0,0,2,0,0,2,"H","N","2011-01-08","201101080STL"
"DET",0,0,0,1,1,2,0,0,1,0,0,1,"A","Y","2011-01-08","201101080VAN"
"VAN",0,0,1,0,0,1,0,0,0,1,1,2,"H","Y","2011-01-08","201101080VAN"
"FLA",0,1,0,1,0,2,0,0,1,2,0,3,"A","N","2011-01-08","201101080WSH"
"WSH",0,0,1,2,0,3,0,1,0,1,0,2,"H","N","2011-01-08","201101080WSH"
"ANA",0,0,1,0,0,1,0,0,0,0,0,0,"H","N","2011-01-09","201101090ANA"
"SJS",0,0,0,0,0,0,0,0,1,0,0,1,"A","N","2011-01-09","201101090ANA"
"ATL",0,1,1,1,0,3,1,1,2,0,0,4,"A","N","2011-01-09","201101090CAR"
"CAR",1,1,2,0,0,4,0,1,1,1,0,3,"H","N","2011-01-09","201101090CAR"
"CHI",0,1,4,0,0,5,0,0,0,0,0,0,"H","N","2011-01-09","201101090CHI"
"NYI",0,0,0,0,0,0,0,1,4,0,0,5,"A","N","2011-01-09","201101090CHI"
"DAL",0,2,0,2,0,4,0,0,0,0,0,0,"A","N","2011-01-09","201101090MIN"
"MIN",0,0,0,0,0,0,0,2,0,2,0,4,"H","N","2011-01-09","201101090MIN"
"NJD",0,1,0,5,0,6,0,2,0,1,0,3,"H","N","2011-01-09","201101090NJD"
"TBL",0,2,0,1,0,3,0,1,0,5,0,6,"A","N","2011-01-09","201101090NJD"
"COL",0,4,1,0,0,5,0,2,1,1,0,4,"H","N","2011-01-10","201101100COL"
"DET",0,2,1,1,0,4,0,4,1,0,0,5,"A","N","2011-01-10","201101100COL"
"LAK",0,1,1,0,0,2,0,0,2,1,0,3,"H","N","2011-01-10","201101100LAK"
"TOR",0,0,2,1,0,3,0,1,1,0,0,2,"A","N","2011-01-10","201101100LAK"
"BOS",0,0,0,4,0,4,0,0,2,0,0,2,"A","N","2011-01-10","201101100PIT"
"PIT",0,0,2,0,0,2,0,0,0,4,0,4,"H","N","2011-01-10","201101100PIT"
"PHX",0,0,2,2,0,4,0,1,0,2,0,3,"A","N","2011-01-10","201101100STL"
"STL",0,1,0,2,0,3,0,0,2,2,0,4,"H","N","2011-01-10","201101100STL"
"BOS",0,2,3,1,0,6,0,0,0,0,0,0,"H","N","2011-01-11","201101110BOS"
"OTT",0,0,0,0,0,0,0,2,3,1,0,6,"A","N","2011-01-11","201101110BOS"
"BUF",0,2,0,0,0,2,0,1,1,3,0,5,"H","N","2011-01-11","201101110BUF"
"PHI",0,1,1,3,0,5,0,2,0,0,0,2,"A","N","2011-01-11","201101110BUF"
"CAR",0,2,3,0,1,6,0,2,1,2,0,5,"H","Y","2011-01-11","201101110CAR"
"CGY",0,2,1,2,0,5,0,2,3,0,1,6,"A","Y","2011-01-11","201101110CAR"
"CBJ",0,2,1,0,0,3,0,0,2,2,0,4,"H","N","2011-01-11","201101110CBJ"
"PHX",0,0,2,2,0,4,0,2,1,0,0,3,"A","N","2011-01-11","201101110CBJ"
"DAL",0,1,1,1,0,3,0,0,0,2,0,2,"H","N","2011-01-11","201101110DAL"
"EDM",0,0,0,2,0,2,0,1,1,1,0,3,"A","N","2011-01-11","201101110DAL"
"FLA",1,2,1,0,0,4,0,0,2,1,0,3,"H","N","2011-01-11","201101110FLA"
"WSH",0,0,2,1,0,3,1,2,1,0,0,4,"A","N","2011-01-11","201101110FLA"
"MIN",0,1,0,0,0,1,0,1,1,3,0,5,"A","N","2011-01-11","201101110NSH"
"NSH",0,1,1,3,0,5,0,1,0,0,0,1,"H","N","2011-01-11","201101110NSH"
"NYI",0,0,1,2,0,3,0,1,1,1,1,4,"H","Y","2011-01-11","201101110NYI"
"VAN",0,1,1,1,1,4,0,0,1,2,0,3,"A","Y","2011-01-11","201101110NYI"
"MTL",0,0,1,1,0,2,0,1,0,0,0,1,"A","N","2011-01-11","201101110NYR"
"NYR",0,1,0,0,0,1,0,0,1,1,0,2,"H","N","2011-01-11","201101110NYR"
"SJS",0,1,0,1,0,2,0,0,0,4,0,4,"H","N","2011-01-11","201101110SJS"
"TOR",0,0,0,4,0,4,0,1,0,1,0,2,"A","N","2011-01-11","201101110SJS"
"ANA",0,3,0,4,0,7,0,0,2,2,0,4,"H","N","2011-01-12","201101120ANA"
"STL",0,0,2,2,0,4,0,3,0,4,0,7,"A","N","2011-01-12","201101120ANA"
"CHI",0,2,1,1,0,4,0,0,0,0,0,0,"H","N","2011-01-12","201101120CHI"
"COL",0,0,0,0,0,0,0,2,1,1,0,4,"A","N","2011-01-12","201101120CHI"
"MTL",0,1,1,0,0,2,0,1,2,2,0,5,"H","N","2011-01-12","201101120MTL"
"PIT",0,1,2,2,0,5,0,1,1,0,0,2,"A","N","2011-01-12","201101120MTL"
"TBL",0,2,1,0,0,3,0,0,0,0,0,0,"H","N","2011-01-12","201101120TBL"
"WSH",0,0,0,0,0,0,0,2,1,0,0,3,"A","N","2011-01-12","201101120TBL"
"BOS",0,1,1,5,0,7,0,1,2,2,0,5,"H","N","2011-01-13","201101130BOS"
"PHI",0,1,2,2,0,5,0,1,1,5,0,7,"A","N","2011-01-13","201101130BOS"
"BUF",0,1,1,1,0,3,0,0,1,1,0,2,"H","N","2011-01-13","201101130BUF"
"CAR",0,0,1,1,0,2,0,1,1,1,0,3,"A","N","2011-01-13","201101130BUF"
"FLA",0,1,0,2,0,3,0,1,0,1,0,2,"H","N","2011-01-13","201101130FLA"
"NSH",0,1,0,1,0,2,0,1,0,2,0,3,"A","N","2011-01-13","201101130FLA"
"LAK",0,0,1,0,0,1,0,1,2,0,0,3,"H","N","2011-01-13","201101130LAK"
"STL",0,1,2,0,0,3,0,0,1,0,0,1,"A","N","2011-01-13","201101130LAK"
"NYI",0,1,1,2,0,4,0,2,4,0,0,6,"H","N","2011-01-13","201101130NYI"
"OTT",0,2,4,0,0,6,0,1,1,2,0,4,"A","N","2011-01-13","201101130NYI"
"NYR",0,0,1,0,0,1,0,0,0,0,0,0,"H","N","2011-01-13","201101130NYR"
"VAN",0,0,0,0,0,0,0,0,1,0,0,1,"A","N","2011-01-13","201101130NYR"
"PHX",0,1,0,4,0,5,0,0,0,1,0,1,"H","N","2011-01-13","201101130PHX"
"TOR",0,0,0,1,0,1,0,1,0,4,0,5,"A","N","2011-01-13","201101130PHX"
"EDM",0,1,2,2,0,5,0,0,0,2,0,2,"A","N","2011-01-13","201101130SJS"
"SJS",0,0,0,2,0,2,0,1,2,2,0,5,"H","N","2011-01-13","201101130SJS"
"ATL",0,0,2,0,0,2,0,0,2,3,0,5,"H","N","2011-01-14","201101140ATL"
"PHI",0,0,2,3,0,5,0,0,2,0,0,2,"A","N","2011-01-14","201101140ATL"
"CBJ",0,2,0,0,1,3,0,0,2,0,0,2,"H","Y","2011-01-14","201101140CBJ"
"DET",0,0,2,0,0,2,0,2,0,0,1,3,"A","Y","2011-01-14","201101140CBJ"
"COL",0,2,1,1,0,4,0,0,0,1,0,1,"A","N","2011-01-14","201101140MIN"
"MIN",0,0,0,1,0,1,0,2,1,1,0,4,"H","N","2011-01-14","201101140MIN"
"CGY",0,0,3,0,0,3,0,0,0,2,0,2,"A","N","2011-01-14","201101140OTT"
"OTT",0,0,0,2,0,2,0,0,3,0,0,3,"H","N","2011-01-14","201101140OTT"
"NJD",0,4,0,1,0,5,0,1,1,0,0,2,"A","N","2011-01-14","201101140TBL"
"TBL",0,1,1,0,0,2,0,4,0,1,0,5,"H","N","2011-01-14","201101140TBL"
"VAN",0,1,2,1,0,4,0,1,0,1,0,2,"A","N","2011-01-14","201101140WSH"
"WSH",0,1,0,1,0,2,0,1,2,1,0,4,"H","N","2011-01-14","201101140WSH"
"BOS",0,0,2,0,0,2,0,1,1,1,0,3,"H","N","2011-01-15","201101150BOS"
"PIT",0,1,1,1,0,3,0,0,2,0,0,2,"A","N","2011-01-15","201101150BOS"
"CAR",0,2,3,1,0,6,0,2,1,1,0,4,"H","N","2011-01-15","201101150CAR"
"TBL",0,2,1,1,0,4,0,2,3,1,0,6,"A","N","2011-01-15","201101150CAR"
"ATL",0,0,1,0,0,1,0,1,2,3,0,6,"A","N","2011-01-15","201101150DAL"
"DAL",0,1,2,3,0,6,0,0,1,0,0,1,"H","N","2011-01-15","201101150DAL"
"CBJ",0,2,1,2,0,5,1,2,2,1,0,6,"A","N","2011-01-15","201101150DET"
"DET",1,2,2,1,0,6,0,2,1,2,0,5,"H","N","2011-01-15","201101150DET"
"FLA",1,1,1,0,0,3,0,1,0,1,0,2,"H","N","2011-01-15","201101150FLA"
"NJD",0,1,0,1,0,2,1,1,1,0,0,3,"A","N","2011-01-15","201101150FLA"
"EDM",0,2,0,0,0,2,0,2,1,2,0,5,"A","N","2011-01-15","201101150LAK"
"LAK",0,2,1,2,0,5,0,2,0,0,0,2,"H","N","2011-01-15","201101150LAK"
"MTL",0,3,0,0,0,3,0,1,0,1,0,2,"H","N","2011-01-15","201101150MTL"
"NYR",0,1,0,1,0,2,0,3,0,0,0,3,"A","N","2011-01-15","201101150MTL"
"CHI",0,1,1,0,0,2,0,0,0,2,1,3,"A","Y","2011-01-15","201101150NSH"
"NSH",0,0,0,2,1,3,0,1,1,0,0,2,"H","Y","2011-01-15","201101150NSH"
"BUF",0,0,1,2,0,3,0,0,4,1,0,5,"A","N","2011-01-15","201101150NYI"
"NYI",0,0,4,1,0,5,0,0,1,2,0,3,"H","N","2011-01-15","201101150NYI"
"ANA",0,1,0,1,0,2,0,1,3,2,0,6,"A","N","2011-01-15","201101150PHX"
"PHX",0,1,3,2,0,6,0,1,0,1,0,2,"H","N","2011-01-15","201101150PHX"
"SJS",0,1,1,2,0,4,0,1,1,0,0,2,"H","N","2011-01-15","201101150SJS"
"STL",0,1,1,0,0,2,0,1,1,2,0,4,"A","N","2011-01-15","201101150SJS"
"CGY",0,0,0,1,1,2,0,0,0,1,0,1,"A","Y","2011-01-15","201101150TOR"
"TOR",0,0,0,1,0,1,0,0,0,1,1,2,"H","Y","2011-01-15","201101150TOR"
"ANA",0,2,1,0,0,3,0,0,2,0,0,2,"H","N","2011-01-16","201101160ANA"
"EDM",0,0,2,0,0,2,0,2,1,0,0,3,"A","N","2011-01-16","201101160ANA"
"CHI",0,1,1,4,0,6,0,2,0,1,0,3,"H","N","2011-01-16","201101160CHI"
"NSH",0,2,0,1,0,3,0,1,1,4,0,6,"A","N","2011-01-16","201101160CHI"
"MIN",0,0,2,2,0,4,0,0,0,0,0,0,"H","N","2011-01-16","201101160MIN"
"VAN",0,0,0,0,0,0,0,0,2,2,0,4,"A","N","2011-01-16","201101160MIN"
"NYR",0,0,0,2,0,2,0,2,1,0,0,3,"H","N","2011-01-16","201101160NYR"
"PHI",0,2,1,0,0,3,0,0,0,2,0,2,"A","N","2011-01-16","201101160NYR"
"OTT",0,1,0,0,0,1,0,0,0,3,0,3,"A","N","2011-01-16","201101160WSH"
"WSH",0,0,0,3,0,3,0,1,0,0,0,1,"H","N","2011-01-16","201101160WSH"
"BOS",0,3,2,2,0,7,0,0,0,0,0,0,"H","N","2011-01-17","201101170BOS"
"CAR",0,0,0,0,0,0,0,3,2,2,0,7,"A","N","2011-01-17","201101170BOS"
"DAL",0,0,2,0,0,2,0,1,0,0,0,1,"H","N","2011-01-17","201101170DAL"
"LAK",0,1,0,0,0,1,0,0,2,0,0,2,"A","N","2011-01-17","201101170DAL"
"ATL",0,0,0,2,1,3,0,0,0,2,0,2,"A","Y","2011-01-17","201101170FLA"
"FLA",0,0,0,2,0,2,0,0,0,2,1,3,"H","Y","2011-01-17","201101170FLA"
"CGY",0,0,2,2,0,4,1,2,2,0,0,5,"A","N","2011-01-17","201101170MTL"
"MTL",1,2,2,0,0,5,0,0,2,2,0,4,"H","N","2011-01-17","201101170MTL"
"NJD",0,2,3,0,0,5,0,0,2,0,0,2,"A","N","2011-01-17","201101170NYI"
"NYI",0,0,2,0,0,2,0,2,3,0,0,5,"H","N","2011-01-17","201101170NYI"
"PHX",0,1,0,1,0,2,0,1,2,1,0,4,"H","N","2011-01-17","201101170PHX"
"SJS",0,1,2,1,0,4,0,1,0,1,0,2,"A","N","2011-01-17","201101170PHX"
"BUF",1,0,1,0,0,2,0,1,0,0,0,1,"H","N","2011-01-18","201101180BUF"
"MTL",0,1,0,0,0,1,1,0,1,0,0,2,"A","N","2011-01-18","201101180BUF"
"BOS",0,1,0,2,0,3,0,1,0,1,0,2,"A","N","2011-01-18","201101180CAR"
"CAR",0,1,0,1,0,2,0,1,0,2,0,3,"H","N","2011-01-18","201101180CAR"
"COL",1,1,2,0,0,4,0,1,2,0,0,3,"H","N","2011-01-18","201101180COL"
"VAN",0,1,2,0,0,3,1,1,2,0,0,4,"A","N","2011-01-18","201101180COL"
"EDM",0,0,0,1,0,1,0,2,0,2,0,4,"H","N","2011-01-18","201101180EDM"
"MIN",0,2,0,2,0,4,0,0,0,1,0,1,"A","N","2011-01-18","201101180EDM"
"ANA",0,1,0,0,1,2,0,0,1,0,0,1,"A","Y","2011-01-18","201101180OTT"
"OTT",0,0,1,0,0,1,0,1,0,0,1,2,"H","Y","2011-01-18","201101180OTT"
"PHI",1,1,1,0,0,3,0,0,0,2,0,2,"H","N","2011-01-18","201101180PHI"
"WSH",0,0,0,2,0,2,1,1,1,0,0,3,"A","N","2011-01-18","201101180PHI"
"NSH",0,2,2,1,0,5,0,2,0,0,0,2,"A","N","2011-01-18","201101180PHX"
"PHX",0,2,0,0,0,2,0,2,2,1,0,5,"H","N","2011-01-18","201101180PHX"
"DET",0,0,1,0,0,1,0,2,1,1,0,4,"A","N","2011-01-18","201101180PIT"
"PIT",0,2,1,1,0,4,0,0,1,0,0,1,"H","N","2011-01-18","201101180PIT"
"LAK",0,0,1,0,0,1,0,1,0,1,0,2,"A","N","2011-01-18","201101180STL"
"STL",0,1,0,1,0,2,0,0,1,0,0,1,"H","N","2011-01-18","201101180STL"
"CBJ",0,1,1,0,0,2,0,1,1,0,1,3,"A","Y","2011-01-18","201101180TBL"
"TBL",0,1,1,0,1,3,0,1,1,0,0,2,"H","Y","2011-01-18","201101180TBL"
"CGY",0,0,0,0,0,0,0,2,1,3,0,6,"H","N","2011-01-19","201101190CGY"
"MIN",0,2,1,3,0,6,0,0,0,0,0,0,"A","N","2011-01-19","201101190CGY"
"CBJ",1,1,0,1,0,3,0,2,0,0,0,2,"A","N","2011-01-19","201101190FLA"
"FLA",0,2,0,0,0,2,1,1,0,1,0,3,"H","N","2011-01-19","201101190FLA"
"NYR",0,4,2,1,0,7,0,0,0,0,0,0,"H","N","2011-01-19","201101190NYR"
"TOR",0,0,0,0,0,0,0,4,2,1,0,7,"A","N","2011-01-19","201101190NYR"
"ATL",0,1,1,0,0,2,0,1,0,1,1,3,"H","Y","2011-01-20","201101200ATL"
"TBL",0,1,0,1,1,3,0,1,1,0,0,2,"A","Y","2011-01-20","201101200ATL"
"BOS",0,1,1,0,0,2,0,0,2,2,0,4,"H","N","2011-01-20","201101200BOS"
"BUF",0,0,2,2,0,4,0,1,1,0,0,2,"A","N","2011-01-20","201101200BOS"
"CAR",0,2,1,1,0,4,0,0,0,1,0,1,"H","N","2011-01-20","201101200CAR"
"NYR",0,0,0,1,0,1,0,2,1,1,0,4,"A","N","2011-01-20","201101200CAR"
"COL",0,0,0,1,0,1,0,2,0,3,0,5,"H","N","2011-01-20","201101200COL"
"NSH",0,2,0,3,0,5,0,0,0,1,0,1,"A","N","2011-01-20","201101200COL"
"DAL",0,1,2,1,0,4,0,1,1,0,0,2,"A","N","2011-01-20","201101200EDM"
"EDM",0,1,1,0,0,2,0,1,2,1,0,4,"H","N","2011-01-20","201101200EDM"
"LAK",0,0,0,0,0,0,0,0,2,0,0,2,"H","N","2011-01-20","201101200LAK"
"PHX",0,0,2,0,0,2,0,0,0,0,0,0,"A","N","2011-01-20","201101200LAK"
"NJD",0,2,0,0,0,2,0,0,0,0,0,0,"H","N","2011-01-20","201101200NJD"
"PIT",0,0,0,0,0,0,0,2,0,0,0,2,"A","N","2011-01-20","201101200NJD"
"NYI",0,0,1,0,0,1,0,1,1,0,0,2,"H","N","2011-01-20","201101200NYI"
"WSH",0,1,1,0,0,2,0,0,1,0,0,1,"A","N","2011-01-20","201101200NYI"
"OTT",0,0,2,0,0,2,0,2,1,3,0,6,"A","N","2011-01-20","201101200PHI"
"PHI",0,2,1,3,0,6,0,0,2,0,0,2,"H","N","2011-01-20","201101200PHI"
"DET",1,1,2,0,0,4,0,0,1,2,0,3,"A","N","2011-01-20","201101200STL"
"STL",0,0,1,2,0,3,1,1,2,0,0,4,"H","N","2011-01-20","201101200STL"
"ANA",0,1,1,0,0,2,0,1,2,2,0,5,"A","N","2011-01-20","201101200TOR"
"TOR",0,1,2,2,0,5,0,1,1,0,0,2,"H","N","2011-01-20","201101200TOR"
"SJS",0,0,1,0,1,2,0,1,0,0,0,1,"A","Y","2011-01-20","201101200VAN"
"VAN",0,1,0,0,0,1,0,0,1,0,1,2,"H","Y","2011-01-20","201101200VAN"
"BUF",0,0,0,2,0,2,0,2,1,2,0,5,"H","N","2011-01-21","201101210BUF"
"NYI",0,2,1,2,0,5,0,0,0,2,0,2,"A","N","2011-01-21","201101210BUF"
"CGY",0,2,3,2,0,7,0,2,1,1,0,4,"H","N","2011-01-21","201101210CGY"
"DAL",0,2,1,1,0,4,0,2,3,2,0,7,"A","N","2011-01-21","201101210CGY"
"FLA",0,1,0,0,0,1,0,1,0,0,1,2,"H","Y","2011-01-21","201101210FLA"
"TBL",0,1,0,0,1,2,0,1,0,0,0,1,"A","Y","2011-01-21","201101210FLA"
"MTL",0,2,3,2,0,7,0,1,0,0,0,1,"A","N","2011-01-21","201101210OTT"
"OTT",0,1,0,0,0,1,0,2,3,2,0,7,"H","N","2011-01-21","201101210OTT"
"ATL",0,1,1,0,0,2,0,0,1,1,1,3,"H","Y","2011-01-22","201101220ATL"
"NYR",0,0,1,1,1,3,0,1,1,0,0,2,"A","Y","2011-01-22","201101220ATL"
"BOS",0,2,2,2,0,6,0,1,0,1,0,2,"A","N","2011-01-22","201101220COL"
"COL",0,1,0,1,0,2,0,2,2,2,0,6,"H","N","2011-01-22","201101220COL"
"CHI",0,1,2,1,0,4,0,1,0,0,0,1,"A","N","2011-01-22","201101220DET"
"DET",0,1,0,0,0,1,0,1,2,1,0,4,"H","N","2011-01-22","201101220DET"
"ANA",0,1,2,0,1,4,0,0,1,2,0,3,"A","Y","2011-01-22","201101220MTL"
"MTL",0,0,1,2,0,3,0,1,2,0,1,4,"H","Y","2011-01-22","201101220MTL"
"NJD",0,2,0,1,0,3,0,0,1,0,0,1,"A","N","2011-01-22","201101220PHI"
"PHI",0,0,1,0,0,1,0,2,0,1,0,3,"H","N","2011-01-22","201101220PHI"
"LAK",0,3,0,1,0,4,0,1,2,0,0,3,"A","N","2011-01-22","201101220PHX"
"PHX",0,1,2,0,0,3,0,3,0,1,0,4,"H","N","2011-01-22","201101220PHX"
"CAR",0,0,0,2,0,2,0,0,1,2,0,3,"A","N","2011-01-22","201101220PIT"
"PIT",0,0,1,2,0,3,0,0,0,2,0,2,"H","N","2011-01-22","201101220PIT"
"MIN",0,1,1,1,0,3,0,1,2,1,0,4,"A","N","2011-01-22","201101220SJS"
"SJS",0,1,2,1,0,4,0,1,1,1,0,3,"H","N","2011-01-22","201101220SJS"
"CBJ",0,1,1,3,0,5,0,2,0,0,0,2,"A","N","2011-01-22","201101220STL"
"STL",0,2,0,0,0,2,0,1,1,3,0,5,"H","N","2011-01-22","201101220STL"
"TOR",0,0,0,1,0,1,0,1,0,3,0,4,"H","N","2011-01-22","201101220TOR"
"WSH",0,1,0,3,0,4,0,0,0,1,0,1,"A","N","2011-01-22","201101220TOR"
"CGY",0,2,0,1,1,4,0,1,1,1,0,3,"A","Y","2011-01-22","201101220VAN"
"VAN",0,1,1,1,0,3,0,2,0,1,1,4,"H","Y","2011-01-22","201101220VAN"
"CHI",0,0,0,1,0,1,0,0,1,3,0,4,"H","N","2011-01-23","201101230CHI"
"PHI",0,0,1,3,0,4,0,0,0,1,0,1,"A","N","2011-01-23","201101230CHI"
"EDM",0,0,0,2,0,2,0,1,0,1,1,3,"H","Y","2011-01-23","201101230EDM"
"NSH",0,1,0,1,1,3,0,0,0,2,0,2,"A","Y","2011-01-23","201101230EDM"
"FLA",0,0,1,1,0,2,0,2,2,1,0,5,"A","N","2011-01-23","201101230NJD"
"NJD",0,2,2,1,0,5,0,0,1,1,0,2,"H","N","2011-01-23","201101230NJD"
"BUF",0,1,1,3,0,5,0,0,2,1,0,3,"A","N","2011-01-23","201101230NYI"
"NYI",0,0,2,1,0,3,0,1,1,3,0,5,"H","N","2011-01-23","201101230NYI"
"ATL",0,0,0,1,0,1,0,0,5,2,0,7,"A","N","2011-01-23","201101230TBL"
"TBL",0,0,5,2,0,7,0,0,0,1,0,1,"H","N","2011-01-23","201101230TBL"
"CAR",0,1,1,4,0,6,0,1,0,3,0,4,"H","N","2011-01-24","201101240CAR"
"TOR",0,1,0,3,0,4,0,1,1,4,0,6,"A","N","2011-01-24","201101240CAR"
"CGY",0,1,1,1,0,3,0,0,1,0,0,1,"H","N","2011-01-24","201101240CGY"
"NSH",0,0,1,0,0,1,0,1,1,1,0,3,"A","N","2011-01-24","201101240CGY"
"COL",0,0,2,2,0,4,0,0,2,1,0,3,"H","N","2011-01-24","201101240COL"
"STL",0,0,2,1,0,3,0,0,2,2,0,4,"A","N","2011-01-24","201101240COL"
"BOS",0,0,0,0,0,0,0,1,0,1,0,2,"A","N","2011-01-24","201101240LAK"
"LAK",0,1,0,1,0,2,0,0,0,0,0,0,"H","N","2011-01-24","201101240LAK"
"DAL",0,1,0,0,0,1,0,3,2,2,0,7,"A","N","2011-01-24","201101240VAN"
"VAN",0,3,2,2,0,7,0,1,0,0,0,1,"H","N","2011-01-24","201101240VAN"
"NYR",0,0,0,1,1,2,0,0,1,0,0,1,"A","Y","2011-01-24","201101240WSH"
"WSH",0,0,1,0,0,1,0,0,0,1,1,2,"H","Y","2011-01-24","201101240WSH"
"ANA",0,2,0,1,0,3,0,1,0,1,0,2,"A","N","2011-01-25","201101250CBJ"
"CBJ",0,1,0,1,0,2,0,2,0,1,0,3,"H","N","2011-01-25","201101250CBJ"
"CHI",0,2,0,0,0,2,0,1,2,1,0,4,"H","N","2011-01-25","201101250CHI"
"MIN",0,1,2,1,0,4,0,2,0,0,0,2,"A","N","2011-01-25","201101250CHI"
"FLA",0,1,2,1,0,4,0,0,1,2,0,3,"A","N","2011-01-25","201101250NYR"
"NYR",0,0,1,2,0,3,0,1,2,1,0,4,"H","N","2011-01-25","201101250NYR"
"BUF",1,2,0,0,0,3,0,1,0,1,0,2,"A","N","2011-01-25","201101250OTT"
"OTT",0,1,0,1,0,2,1,2,0,0,0,3,"H","N","2011-01-25","201101250OTT"
"MTL",0,0,1,1,0,2,0,2,2,1,0,5,"A","N","2011-01-25","201101250PHI"
"PHI",0,2,2,1,0,5,0,0,1,1,0,2,"H","N","2011-01-25","201101250PHI"
"EDM",0,0,1,3,0,4,0,1,1,1,0,3,"A","N","2011-01-25","201101250PHX"
"PHX",0,1,1,1,0,3,0,0,1,3,0,4,"H","N","2011-01-25","201101250PHX"
"NYI",0,0,0,0,0,0,0,0,0,1,0,1,"A","N","2011-01-25","201101250PIT"
"PIT",0,0,0,1,0,1,0,0,0,0,0,0,"H","N","2011-01-25","201101250PIT"
"TBL",0,2,0,0,0,2,0,0,0,0,0,0,"H","N","2011-01-25","201101250TBL"
"TOR",0,0,0,0,0,0,0,2,0,0,0,2,"A","N","2011-01-25","201101250TBL"
"ATL",0,0,1,0,0,1,0,0,0,0,0,0,"H","N","2011-01-26","201101260ATL"
"WSH",0,0,0,0,0,0,0,0,1,0,0,1,"A","N","2011-01-26","201101260ATL"
"BOS",0,1,1,0,0,2,0,0,0,1,0,1,"H","N","2011-01-26","201101260BOS"
"FLA",0,0,0,1,0,1,0,1,1,0,0,2,"A","N","2011-01-26","201101260BOS"
"CGY",0,1,2,1,0,4,0,0,0,1,0,1,"H","N","2011-01-26","201101260CGY"
"STL",0,0,0,1,0,1,0,1,2,1,0,4,"A","N","2011-01-26","201101260CGY"
"COL",0,1,0,1,0,2,0,2,1,2,0,5,"H","N","2011-01-26","201101260COL"
"PHX",0,2,1,2,0,5,0,1,0,1,0,2,"A","N","2011-01-26","201101260COL"
"DAL",0,1,2,0,0,3,0,0,1,0,0,1,"H","N","2011-01-26","201101260DAL"
"EDM",0,0,1,0,0,1,0,1,2,0,0,3,"A","N","2011-01-26","201101260DAL"
"DET",0,1,0,2,0,3,0,1,0,0,0,1,"H","N","2011-01-26","201101260DET"
"NJD",0,1,0,0,0,1,0,1,0,2,0,3,"A","N","2011-01-26","201101260DET"
"LAK",0,0,1,1,1,3,0,0,2,0,0,2,"H","Y","2011-01-26","201101260LAK"
"SJS",0,0,2,0,0,2,0,0,1,1,1,3,"A","Y","2011-01-26","201101260LAK"
"CAR",0,1,2,1,0,4,0,0,1,1,0,2,"A","N","2011-01-26","201101260NYI"
"NYI",0,0,1,1,0,2,0,1,2,1,0,4,"H","N","2011-01-26","201101260NYI"
"NSH",0,0,0,1,0,1,0,0,0,2,0,2,"A","N","2011-01-26","201101260VAN"
"VAN",0,0,0,2,0,2,0,0,0,1,0,1,"H","N","2011-01-26","201101260VAN"
"ATL",0,1,0,0,0,1,0,0,3,1,0,4,"H","N","2011-02-01","201102010ATL"
"NYI",0,0,3,1,0,4,0,1,0,0,0,1,"A","N","2011-02-01","201102010ATL"
"BOS",0,0,1,2,0,3,0,0,1,1,0,2,"A","N","2011-02-01","201102010CAR"
"CAR",0,0,1,1,0,2,0,0,1,2,0,3,"H","N","2011-02-01","201102010CAR"
"CBJ",0,1,2,1,0,4,0,2,3,2,0,7,"H","N","2011-02-01","201102010CBJ"
"CHI",0,2,3,2,0,7,0,1,2,1,0,4,"A","N","2011-02-01","201102010CBJ"
"DAL",0,0,1,0,0,1,0,0,3,1,0,4,"H","N","2011-02-01","201102010DAL"
"VAN",0,0,3,1,0,4,0,0,1,0,0,1,"A","N","2011-02-01","201102010DAL"
"LAK",0,0,0,0,0,0,0,0,0,0,1,1,"A","Y","2011-02-01","201102010MIN"
"MIN",0,0,0,0,1,1,0,0,0,0,0,0,"H","Y","2011-02-01","201102010MIN"
"NJD",0,0,1,1,0,2,0,0,1,0,0,1,"H","N","2011-02-01","201102010NJD"
"OTT",0,0,1,0,0,1,0,0,1,1,0,2,"A","N","2011-02-01","201102010NJD"
"CGY",0,0,0,2,1,3,0,1,0,1,0,2,"A","Y","2011-02-01","201102010NSH"
"NSH",0,1,0,1,0,2,0,0,0,2,1,3,"H","Y","2011-02-01","201102010NSH"
"NYR",0,1,2,0,0,3,0,0,3,0,1,4,"H","Y","2011-02-01","201102010NYR"
"PIT",0,0,3,0,1,4,0,1,2,0,0,3,"A","Y","2011-02-01","201102010NYR"
"PHX",0,2,1,0,0,3,0,0,1,4,0,5,"A","N","2011-02-01","201102010SJS"
"SJS",0,0,1,4,0,5,0,2,1,0,0,3,"H","N","2011-02-01","201102010SJS"
"PHI",0,0,0,0,0,0,0,3,0,1,0,4,"A","N","2011-02-01","201102010TBL"
"TBL",0,3,0,1,0,4,0,0,0,0,0,0,"H","N","2011-02-01","201102010TBL"
"FLA",0,1,1,1,0,3,0,2,1,0,1,4,"A","Y","2011-02-01","201102010TOR"
"TOR",0,2,1,0,1,4,0,1,1,1,0,3,"H","Y","2011-02-01","201102010TOR"
"MTL",0,0,2,0,1,3,0,2,0,0,0,2,"A","Y","2011-02-01","201102010WSH"
"WSH",0,2,0,0,0,2,0,0,2,0,1,3,"H","Y","2011-02-01","201102010WSH"
"ANA",0,0,2,1,0,3,0,3,1,0,0,4,"H","N","2011-02-02","201102020ANA"
"SJS",0,3,1,0,0,4,0,0,2,1,0,3,"A","N","2011-02-02","201102020ANA"
"EDM",0,0,1,0,0,1,0,0,2,1,0,3,"H","N","2011-02-02","201102020EDM"
"LAK",0,0,2,1,0,3,0,0,1,0,0,1,"A","N","2011-02-02","201102020EDM"
"FLA",0,1,0,1,0,2,0,0,1,2,0,3,"A","N","2011-02-02","201102020MTL"
"MTL",0,0,1,2,0,3,0,1,0,1,0,2,"H","N","2011-02-02","201102020MTL"
"DET",0,2,2,3,0,7,0,3,1,1,0,5,"A","N","2011-02-02","201102020OTT"
"OTT",0,3,1,1,0,5,0,2,2,3,0,7,"H","N","2011-02-02","201102020OTT"
"PHX",0,0,0,0,0,0,0,1,2,3,0,6,"H","N","2011-02-02","201102020PHX"
"VAN",0,1,2,3,0,6,0,0,0,0,0,0,"A","N","2011-02-02","201102020PHX"
"NYI",0,0,0,0,0,0,0,2,0,1,0,3,"A","N","2011-02-02","201102020PIT"
"PIT",0,2,0,1,0,3,0,0,0,0,0,0,"H","N","2011-02-02","201102020PIT"
"ATL",0,0,2,0,0,2,0,1,1,2,0,4,"H","N","2011-02-03","201102030ATL"
"CGY",0,1,1,2,0,4,0,0,2,0,0,2,"A","N","2011-02-03","201102030ATL"
"BOS",0,4,0,2,0,6,0,0,1,2,0,3,"H","N","2011-02-03","201102030BOS"
"DAL",0,0,1,2,0,3,0,4,0,2,0,6,"A","N","2011-02-03","201102030BOS"
"COL",0,0,1,2,0,3,0,2,1,1,0,4,"H","N","2011-02-03","201102030COL"
"MIN",0,2,1,1,0,4,0,0,1,2,0,3,"A","N","2011-02-03","201102030COL"
"NJD",0,1,2,0,0,3,0,0,1,1,0,2,"A","N","2011-02-03","201102030NYR"
"NYR",0,0,1,1,0,2,0,1,2,0,0,3,"H","N","2011-02-03","201102030NYR"
"NSH",0,1,0,1,0,2,0,1,0,2,0,3,"A","N","2011-02-03","201102030PHI"
"PHI",0,1,0,2,0,3,0,1,0,1,0,2,"H","N","2011-02-03","201102030PHI"
"CAR",0,0,0,0,0,0,0,0,2,1,0,3,"A","N","2011-02-03","201102030TOR"
"TOR",0,0,2,1,0,3,0,0,0,0,0,0,"H","N","2011-02-03","201102030TOR"
"CBJ",0,1,1,1,0,3,0,0,0,0,0,0,"A","N","2011-02-04","201102040DET"
"DET",0,0,0,0,0,0,0,1,1,1,0,3,"H","N","2011-02-04","201102040DET"
"FLA",1,2,0,1,0,4,0,2,1,0,0,3,"A","N","2011-02-04","201102040NJD"
"NJD",0,2,1,0,0,3,1,2,0,1,0,4,"H","N","2011-02-04","201102040NJD"
"BUF",0,2,0,0,0,2,0,0,3,0,0,3,"A","N","2011-02-04","201102040PIT"
"PIT",0,0,3,0,0,3,0,2,0,0,0,2,"H","N","2011-02-04","201102040PIT"
"EDM",0,1,2,0,0,3,0,2,2,1,0,5,"A","N","2011-02-04","201102040STL"
"STL",0,2,2,1,0,5,0,1,2,0,0,3,"H","N","2011-02-04","201102040STL"
"TBL",0,1,1,0,0,2,0,1,2,2,0,5,"H","N","2011-02-04","201102040TBL"
"WSH",0,1,2,2,0,5,0,1,1,0,0,2,"A","N","2011-02-04","201102040TBL"
"CHI",0,0,2,1,0,3,0,1,1,2,0,4,"A","N","2011-02-04","201102040VAN"
"VAN",0,1,1,2,0,4,0,0,2,1,0,3,"H","N","2011-02-04","201102040VAN"
"BOS",0,0,0,0,0,0,0,1,0,1,0,2,"H","N","2011-02-05","201102050BOS"
"SJS",0,1,0,1,0,2,0,0,0,0,0,0,"A","N","2011-02-05","201102050BOS"
"BUF",0,2,3,1,0,6,0,0,1,1,0,2,"H","N","2011-02-05","201102050BUF"
"TOR",0,0,1,1,0,2,0,2,3,1,0,6,"A","N","2011-02-05","201102050BUF"
"ATL",0,1,0,2,0,3,1,0,1,2,0,4,"A","N","2011-02-05","201102050CAR"
"CAR",1,0,1,2,0,4,0,1,0,2,0,3,"H","N","2011-02-05","201102050CAR"
"CBJ",0,1,1,2,0,4,0,2,0,1,0,3,"H","N","2011-02-05","201102050CBJ"
"EDM",0,2,0,1,0,3,0,1,1,2,0,4,"A","N","2011-02-05","201102050CBJ"
"CGY",0,1,1,1,0,3,0,2,1,0,1,4,"H","Y","2011-02-05","201102050CGY"
"LAK",0,2,1,0,1,4,0,1,1,1,0,3,"A","Y","2011-02-05","201102050CGY"
"ANA",0,1,0,2,0,3,0,0,0,0,0,0,"A","N","2011-02-05","201102050COL"
"COL",0,0,0,0,0,0,0,1,0,2,0,3,"H","N","2011-02-05","201102050COL"
"MTL",0,0,1,1,0,2,0,0,0,0,0,0,"H","N","2011-02-05","201102050MTL"
"NYR",0,0,0,0,0,0,0,0,1,1,0,2,"A","N","2011-02-05","201102050MTL"
"DET",0,0,0,0,0,0,0,1,1,1,0,3,"A","N","2011-02-05","201102050NSH"
"NSH",0,1,1,1,0,3,0,0,0,0,0,0,"H","N","2011-02-05","201102050NSH"
"NYI",0,3,0,2,0,5,0,3,0,0,0,3,"H","N","2011-02-05","201102050NYI"
"OTT",0,3,0,0,0,3,0,3,0,2,0,5,"A","N","2011-02-05","201102050NYI"
"DAL",0,0,1,0,0,1,0,1,1,1,0,3,"A","N","2011-02-05","201102050PHI"
"PHI",0,1,1,1,0,3,0,0,1,0,0,1,"H","N","2011-02-05","201102050PHI"
"MIN",0,0,0,0,0,0,0,0,0,1,0,1,"A","N","2011-02-05","201102050PHX"
"PHX",0,0,0,1,0,1,0,0,0,0,0,0,"H","N","2011-02-05","201102050PHX"
"MTL",0,0,1,0,0,1,0,2,1,1,0,4,"H","N","2011-02-06","201102060MTL"
"NJD",0,2,1,1,0,4,0,0,1,0,0,1,"A","N","2011-02-06","201102060MTL"
"STL",0,0,3,0,0,3,1,1,2,0,0,4,"A","N","2011-02-06","201102060TBL"
"TBL",1,1,2,0,0,4,0,0,3,0,0,3,"H","N","2011-02-06","201102060TBL"
"PIT",0,0,0,0,0,0,0,1,1,1,0,3,"A","N","2011-02-06","201102060WSH"
"WSH",0,1,1,1,0,3,0,0,0,0,0,0,"H","N","2011-02-06","201102060WSH"
"CGY",0,1,0,2,0,3,0,0,1,0,0,1,"H","N","2011-02-07","201102070CGY"
"CHI",0,0,1,0,0,1,0,1,0,2,0,3,"A","N","2011-02-07","201102070CGY"
"DET",0,0,1,2,0,3,0,0,0,2,0,2,"H","N","2011-02-07","201102070DET"
"NYR",0,0,0,2,0,2,0,0,1,2,0,3,"A","N","2011-02-07","201102070DET"
"EDM",0,1,1,2,0,4,0,0,0,0,0,0,"A","N","2011-02-07","201102070NSH"
"NSH",0,0,0,0,0,0,0,1,1,2,0,4,"H","N","2011-02-07","201102070NSH"
"COL",0,0,0,0,0,0,0,1,1,1,0,3,"A","N","2011-02-07","201102070PHX"
"PHX",0,1,1,1,0,3,0,0,0,0,0,0,"H","N","2011-02-07","201102070PHX"
"ATL",0,2,1,1,0,4,0,0,3,2,0,5,"A","N","2011-02-07","201102070TOR"
"TOR",0,0,3,2,0,5,0,2,1,1,0,4,"H","N","2011-02-07","201102070TOR"
"OTT",0,0,2,0,0,2,0,2,1,1,0,4,"A","N","2011-02-07","201102070VAN"
"VAN",0,2,1,1,0,4,0,0,2,0,0,2,"H","N","2011-02-07","201102070VAN"
"FLA",0,1,0,0,0,1,0,0,1,1,0,2,"H","N","2011-02-08","201102080FLA"
"STL",0,0,1,1,0,2,0,1,0,0,0,1,"A","N","2011-02-08","201102080FLA"
"CAR",0,0,1,1,0,2,1,0,1,1,0,3,"A","N","2011-02-08","201102080NJD"
"NJD",1,0,1,1,0,3,0,0,1,1,0,2,"H","N","2011-02-08","201102080NJD"
"NYI",0,1,1,1,0,3,0,2,0,3,0,5,"H","N","2011-02-08","201102080NYI"
"TOR",0,2,0,3,0,5,0,1,1,1,0,3,"A","N","2011-02-08","201102080NYI"
"CBJ",0,1,2,1,0,4,0,0,0,1,0,1,"A","N","2011-02-08","201102080PIT"
"PIT",0,0,0,1,0,1,0,1,2,1,0,4,"H","N","2011-02-08","201102080PIT"
"BUF",0,1,1,5,0,7,0,1,2,1,0,4,"A","N","2011-02-08","201102080TBL"
"TBL",0,1,2,1,0,4,0,1,1,5,0,7,"H","N","2011-02-08","201102080TBL"
"SJS",0,0,0,2,0,2,0,0,0,0,0,0,"A","N","2011-02-08","201102080WSH"
"WSH",0,0,0,0,0,0,0,0,0,2,0,2,"H","N","2011-02-08","201102080WSH"
"BOS",0,2,4,2,0,8,0,0,4,2,0,6,"H","N","2011-02-09","201102090BOS"
"MTL",0,0,4,2,0,6,0,2,4,2,0,8,"A","N","2011-02-09","201102090BOS"
"CBJ",0,2,0,0,0,2,0,0,2,1,0,3,"H","N","2011-02-09","201102090CBJ"
"SJS",0,0,2,1,0,3,0,2,0,0,0,2,"A","N","2011-02-09","201102090CBJ"
"CGY",0,1,2,2,0,5,0,2,0,0,0,2,"H","N","2011-02-09","201102090CGY"
"OTT",0,2,0,0,0,2,0,1,2,2,0,5,"A","N","2011-02-09","201102090CGY"
"DAL",0,1,1,0,0,2,1,1,0,1,0,3,"H","N","2011-02-09","201102090DAL"
"PHX",1,1,0,1,0,3,0,1,1,0,0,2,"A","N","2011-02-09","201102090DAL"
"DET",0,0,1,0,0,1,0,2,2,0,0,4,"H","N","2011-02-09","201102090DET"
"NSH",0,2,2,0,0,4,0,0,1,0,0,1,"A","N","2011-02-09","201102090DET"
"CHI",0,1,1,2,0,4,0,0,0,1,0,1,"A","N","2011-02-09","201102090EDM"
"EDM",0,0,0,1,0,1,0,1,1,2,0,4,"H","N","2011-02-09","201102090EDM"
"COL",0,1,0,1,0,2,0,2,1,0,0,3,"A","N","2011-02-09","201102090MIN"
"MIN",0,2,1,0,0,3,0,1,0,1,0,2,"H","N","2011-02-09","201102090MIN"
"ANA",0,1,2,1,0,4,0,0,1,2,0,3,"A","N","2011-02-09","201102090VAN"
"VAN",0,0,1,2,0,3,0,1,2,1,0,4,"H","N","2011-02-09","201102090VAN"
"BUF",1,0,1,1,0,3,0,0,1,1,0,2,"A","N","2011-02-10","201102100FLA"
"FLA",0,0,1,1,0,2,1,0,1,1,0,3,"H","N","2011-02-10","201102100FLA"
"MTL",0,1,2,0,0,3,0,1,1,1,1,4,"H","Y","2011-02-10","201102100MTL"
"NYI",0,1,1,1,1,4,0,1,2,0,0,3,"A","Y","2011-02-10","201102100MTL"
"CAR",0,0,0,1,0,1,0,0,0,2,0,2,"A","N","2011-02-10","201102100PHI"
"PHI",0,0,0,2,0,2,0,0,0,1,0,1,"H","N","2011-02-10","201102100PHI"
"LAK",0,1,0,0,0,1,1,1,0,0,0,2,"A","N","2011-02-10","201102100PIT"
"PIT",1,1,0,0,0,2,0,1,0,0,0,1,"H","N","2011-02-10","201102100PIT"
"NJD",1,0,0,1,0,2,0,0,1,0,0,1,"A","N","2011-02-10","201102100TOR"
"TOR",0,0,1,0,0,1,1,0,0,1,0,2,"H","N","2011-02-10","201102100TOR"
"ATL",0,1,0,2,0,3,0,0,1,1,0,2,"H","N","2011-02-11","201102110ATL"
"NYR",0,0,1,1,0,2,0,1,0,2,0,3,"A","N","2011-02-11","201102110ATL"
"BOS",0,1,0,0,0,1,0,2,3,1,0,6,"H","N","2011-02-11","201102110BOS"
"DET",0,2,3,1,0,6,0,1,0,0,0,1,"A","N","2011-02-11","201102110BOS"
"CBJ",0,0,2,1,0,3,0,1,0,0,0,1,"H","N","2011-02-11","201102110CBJ"
"COL",0,1,0,0,0,1,0,0,2,1,0,3,"A","N","2011-02-11","201102110CBJ"
"ANA",1,1,2,1,0,5,0,0,2,2,0,4,"A","N","2011-02-11","201102110CGY"
"CGY",0,0,2,2,0,4,1,1,2,1,0,5,"H","N","2011-02-11","201102110CGY"
"CHI",0,3,0,0,0,3,0,0,2,1,1,4,"A","Y","2011-02-11","201102110DAL"
"DAL",0,0,2,1,1,4,0,3,0,0,0,3,"H","Y","2011-02-11","201102110DAL"
"NJD",0,0,0,2,0,2,0,0,0,1,0,1,"H","N","2011-02-11","201102110NJD"
"SJS",0,0,0,1,0,1,0,0,0,2,0,2,"A","N","2011-02-11","201102110NJD"
"NYI",0,4,4,1,0,9,0,0,2,1,0,3,"H","N","2011-02-11","201102110NYI"
"PIT",0,0,2,1,0,3,0,4,4,1,0,9,"A","N","2011-02-11","201102110NYI"
"MIN",0,1,1,2,1,5,0,2,0,2,0,4,"A","Y","2011-02-11","201102110STL"
"STL",0,2,0,2,0,4,0,1,1,2,1,5,"H","Y","2011-02-11","201102110STL"
"EDM",0,1,1,1,0,3,0,2,0,3,0,5,"H","N","2011-02-12","201102120EDM"
"OTT",0,2,0,3,0,5,0,1,1,1,0,3,"A","N","2011-02-12","201102120EDM"
"MIN",0,1,2,0,0,3,0,0,1,0,0,1,"H","N","2011-02-12","201102120MIN"
"STL",0,0,1,0,0,1,0,1,2,0,0,3,"A","N","2011-02-12","201102120MIN"
"MTL",0,0,2,1,0,3,0,0,0,0,0,0,"H","N","2011-02-12","201102120MTL"
"TOR",0,0,0,0,0,0,0,0,2,1,0,3,"A","N","2011-02-12","201102120MTL"
"COL",0,1,1,1,0,3,0,1,1,3,0,5,"A","N","2011-02-12","201102120NSH"
"NSH",0,1,1,3,0,5,0,1,1,1,0,3,"H","N","2011-02-12","201102120NSH"
"CHI",0,0,1,1,0,2,0,1,1,0,1,3,"A","Y","2011-02-12","201102120PHX"
"PHX",0,1,1,0,1,3,0,0,1,1,0,2,"H","Y","2011-02-12","201102120PHX"
"CAR",0,0,1,2,0,3,1,0,2,1,0,4,"A","N","2011-02-12","201102120TBL"
"TBL",1,0,2,1,0,4,0,0,1,2,0,3,"H","N","2011-02-12","201102120TBL"
"CGY",0,0,2,0,0,2,0,1,2,1,0,4,"A","N","2011-02-12","201102120VAN"
"VAN",0,1,2,1,0,4,0,0,2,0,0,2,"H","N","2011-02-12","201102120VAN"
"LAK",0,0,1,3,0,4,0,1,0,0,0,1,"A","N","2011-02-12","201102120WSH"
"WSH",0,1,0,0,0,1,0,0,1,3,0,4,"H","N","2011-02-12","201102120WSH"
"ATL",0,0,1,1,0,2,0,1,1,1,0,3,"H","N","2011-02-13","201102130ATL"
"CAR",0,1,1,1,0,3,0,0,1,1,0,2,"A","N","2011-02-13","201102130ATL"
"BUF",0,3,1,2,0,6,1,2,1,3,0,7,"H","N","2011-02-13","201102130BUF"
"NYI",1,2,1,3,0,7,0,3,1,2,0,6,"A","N","2011-02-13","201102130BUF"
"CBJ",0,1,1,0,0,2,0,1,0,0,0,1,"A","N","2011-02-13","201102130DAL"
"DAL",0,1,0,0,0,1,0,1,1,0,0,2,"H","N","2011-02-13","201102130DAL"
"BOS",0,2,0,0,0,2,0,1,2,1,0,4,"A","N","2011-02-13","201102130DET"
"DET",0,1,2,1,0,4,0,2,0,0,0,2,"H","N","2011-02-13","201102130DET"
"ANA",0,1,2,1,0,4,0,0,0,0,0,0,"A","N","2011-02-13","201102130EDM"
"EDM",0,0,0,0,0,0,0,1,2,1,0,4,"H","N","2011-02-13","201102130EDM"
"FLA",0,0,1,2,0,3,0,1,0,1,0,2,"H","N","2011-02-13","201102130FLA"
"SJS",0,1,0,1,0,2,0,0,1,2,0,3,"A","N","2011-02-13","201102130FLA"
"NYR",0,2,3,0,0,5,0,2,0,1,0,3,"H","N","2011-02-13","201102130NYR"
"PIT",0,2,0,1,0,3,0,2,3,0,0,5,"A","N","2011-02-13","201102130NYR"
"LAK",0,0,1,0,0,1,0,0,0,0,0,0,"A","N","2011-02-13","201102130PHI"
"PHI",0,0,0,0,0,0,0,0,1,0,0,1,"H","N","2011-02-13","201102130PHI"
"CGY",0,5,0,4,0,9,0,0,1,0,0,1,"A","N","2011-02-14","201102140COL"
"COL",0,0,1,0,0,1,0,5,0,4,0,9,"H","N","2011-02-14","201102140COL"
"PHX",0,0,2,1,0,3,0,0,1,1,0,2,"H","N","2011-02-14","201102140PHX"
"WSH",0,0,1,1,0,2,0,0,2,1,0,3,"A","N","2011-02-14","201102140PHX"
"STL",0,2,1,0,0,3,0,1,0,1,0,2,"H","N","2011-02-14","201102140STL"
"VAN",0,1,0,1,0,2,0,2,1,0,0,3,"A","N","2011-02-14","201102140STL"
"BOS",0,1,1,1,0,3,0,1,1,2,0,4,"H","N","2011-02-15","201102150BOS"
"TOR",0,1,1,2,0,4,0,1,1,1,0,3,"A","N","2011-02-15","201102150BOS"
"DAL",0,0,1,0,0,1,0,1,2,1,0,4,"A","N","2011-02-15","201102150EDM"
"EDM",0,1,2,1,0,4,0,0,1,0,0,1,"H","N","2011-02-15","201102150EDM"
"MIN",0,1,0,0,0,1,0,1,2,1,0,4,"H","N","2011-02-15","201102150MIN"
"VAN",0,1,2,1,0,4,0,1,0,0,0,1,"A","N","2011-02-15","201102150MIN"
"BUF",0,0,1,1,1,3,0,1,1,0,0,2,"A","Y","2011-02-15","201102150MTL"
"MTL",0,1,1,0,0,2,0,0,1,1,1,3,"H","Y","2011-02-15","201102150MTL"
"NSH",0,1,0,0,0,1,1,0,1,0,0,2,"H","N","2011-02-15","201102150NSH"
"SJS",1,0,1,0,0,2,0,1,0,0,0,1,"A","N","2011-02-15","201102150NSH"
"NYI",0,0,1,2,1,4,0,1,1,1,0,3,"A","Y","2011-02-15","201102150OTT"
"OTT",0,1,1,1,0,3,0,0,1,2,1,4,"H","Y","2011-02-15","201102150OTT"
"PHI",0,1,2,0,1,4,0,0,3,0,0,3,"A","Y","2011-02-15","201102150TBL"
"TBL",0,0,3,0,0,3,0,1,2,0,1,4,"H","Y","2011-02-15","201102150TBL"
"ANA",0,3,2,1,0,6,0,2,2,3,0,7,"H","N","2011-02-16","201102160ANA"
"WSH",0,2,2,3,0,7,0,3,2,1,0,6,"A","N","2011-02-16","201102160ANA"
"BUF",0,0,0,1,0,1,0,0,1,1,0,2,"H","N","2011-02-16","201102160BUF"
"TOR",0,0,1,1,0,2,0,0,0,1,0,1,"A","N","2011-02-16","201102160BUF"
"CBJ",0,1,1,1,0,3,0,1,1,1,1,4,"H","Y","2011-02-16","201102160CBJ"
"LAK",0,1,1,1,1,4,0,1,1,1,0,3,"A","Y","2011-02-16","201102160CBJ"
"CGY",0,1,1,2,0,4,0,0,2,0,0,2,"H","N","2011-02-16","201102160CGY"
"DAL",0,0,2,0,0,2,0,1,1,2,0,4,"A","N","2011-02-16","201102160CGY"
"CHI",0,1,0,2,0,3,0,0,0,1,0,1,"H","N","2011-02-16","201102160CHI"
"MIN",0,0,0,1,0,1,0,1,0,2,0,3,"A","N","2011-02-16","201102160CHI"
"COL",0,0,2,0,0,2,1,1,1,0,0,3,"H","N","2011-02-16","201102160COL"
"PIT",1,1,1,0,0,3,0,0,2,0,0,2,"A","N","2011-02-16","201102160COL"
"FLA",0,0,0,2,0,2,0,2,1,1,0,4,"H","N","2011-02-16","201102160FLA"
"PHI",0,2,1,1,0,4,0,0,0,2,0,2,"A","N","2011-02-16","201102160FLA"
"CAR",0,0,0,2,0,2,0,0,1,2,0,3,"A","N","2011-02-16","201102160NJD"
"NJD",0,0,1,2,0,3,0,0,0,2,0,2,"H","N","2011-02-16","201102160NJD"
"EDM",0,1,0,3,0,4,0,0,1,0,0,1,"H","N","2011-02-17","201102170EDM"
"MTL",0,0,1,0,0,1,0,1,0,3,0,4,"A","N","2011-02-17","201102170EDM"
"NSH",0,0,3,0,0,3,0,0,1,0,0,1,"H","N","2011-02-17","201102170NSH"
"VAN",0,0,1,0,0,1,0,0,3,0,0,3,"A","N","2011-02-17","201102170NSH"
"BOS",0,3,3,0,0,6,0,0,2,1,0,3,"A","N","2011-02-17","201102170NYI"
"NYI",0,0,2,1,0,3,0,3,3,0,0,6,"H","N","2011-02-17","201102170NYI"
"LAK",0,1,0,2,0,3,0,0,1,2,1,4,"A","Y","2011-02-17","201102170NYR"
"NYR",0,0,1,2,1,4,0,1,0,2,0,3,"H","Y","2011-02-17","201102170NYR"
"ATL",0,1,2,0,0,3,0,2,2,0,0,4,"A","N","2011-02-17","201102170PHX"
"PHX",0,2,2,0,0,4,0,1,2,0,0,3,"H","N","2011-02-17","201102170PHX"
"SJS",0,1,0,2,0,3,0,1,0,1,0,2,"H","N","2011-02-17","201102170SJS"
"WSH",0,1,0,1,0,2,0,1,0,2,0,3,"A","N","2011-02-17","201102170SJS"
"DET",0,2,2,2,0,6,0,0,2,0,0,2,"A","N","2011-02-17","201102170TBL"
"TBL",0,0,2,0,0,2,0,2,2,2,0,6,"H","N","2011-02-17","201102170TBL"
"BUF",0,0,0,0,0,0,0,0,2,1,0,3,"H","N","2011-02-18","201102180BUF"
"STL",0,0,2,1,0,3,0,0,0,0,0,0,"A","N","2011-02-18","201102180BUF"
"CAR",0,2,0,1,0,3,0,0,1,1,0,2,"H","N","2011-02-18","201102180CAR"
"PHI",0,0,1,1,0,2,0,2,0,1,0,3,"A","N","2011-02-18","201102180CAR"
"CBJ",0,1,3,0,0,4,0,2,1,0,0,3,"A","N","2011-02-18","201102180CHI"
"CHI",0,2,1,0,0,3,0,1,3,0,0,4,"H","N","2011-02-18","201102180CHI"
"DET",0,2,1,1,0,4,0,1,1,1,0,3,"A","N","2011-02-18","201102180FLA"
"FLA",0,1,1,1,0,3,0,2,1,1,0,4,"H","N","2011-02-18","201102180FLA"
"ANA",0,1,0,0,0,1,0,2,2,1,0,5,"A","N","2011-02-18","201102180MIN"
"MIN",0,2,2,1,0,5,0,1,0,0,0,1,"H","N","2011-02-18","201102180MIN"
"NJD",0,0,1,0,0,1,0,0,0,0,0,0,"H","N","2011-02-18","201102180NJD"
"NYR",0,0,0,0,0,0,0,0,1,0,0,1,"A","N","2011-02-18","201102180NJD"
"BOS",0,0,1,3,0,4,0,0,1,1,0,2,"A","N","2011-02-18","201102180OTT"
"OTT",0,0,1,1,0,2,0,0,1,3,0,4,"H","N","2011-02-18","201102180OTT"
"CAR",0,0,0,1,0,1,0,3,0,1,0,4,"H","N","2011-02-19","201102190CAR"
"NJD",0,3,0,1,0,4,0,0,0,1,0,1,"A","N","2011-02-19","201102190CAR"
"ATL",0,1,1,1,0,3,0,0,1,4,0,5,"A","N","2011-02-19","201102190EDM"
"EDM",0,0,1,4,0,5,0,1,1,1,0,3,"H","N","2011-02-19","201102190EDM"
"NSH",0,0,1,1,0,2,0,0,2,1,0,3,"H","N","2011-02-19","201102190NSH"
"PHX",0,0,2,1,0,3,0,0,1,1,0,2,"A","N","2011-02-19","201102190NSH"
"LAK",0,0,0,0,0,0,0,1,1,1,0,3,"A","N","2011-02-19","201102190NYI"
"NYI",0,1,1,1,0,3,0,0,0,0,0,0,"H","N","2011-02-19","201102190NYI"
"COL",0,0,0,0,0,0,0,3,0,1,0,4,"A","N","2011-02-19","201102190SJS"
"SJS",0,3,0,1,0,4,0,0,0,0,0,0,"H","N","2011-02-19","201102190SJS"
"ANA",0,3,0,0,0,3,0,4,4,1,0,9,"A","N","2011-02-19","201102190STL"
"STL",0,4,4,1,0,9,0,3,0,0,0,3,"H","N","2011-02-19","201102190STL"
"FLA",0,0,1,1,1,3,0,1,0,1,0,2,"A","Y","2011-02-19","201102190TBL"
"TBL",0,1,0,1,0,2,0,0,1,1,1,3,"H","Y","2011-02-19","201102190TBL"
"OTT",0,0,0,0,1,1,0,0,0,0,0,0,"A","Y","2011-02-19","201102190TOR"
"TOR",0,0,0,0,0,0,0,0,0,0,1,1,"H","Y","2011-02-19","201102190TOR"
"DAL",0,1,0,1,0,2,0,1,1,3,0,5,"A","N","2011-02-19","201102190VAN"
"VAN",0,1,1,3,0,5,0,1,0,1,0,2,"H","N","2011-02-19","201102190VAN"
"BUF",0,0,1,0,0,1,0,0,1,1,0,2,"H","N","2011-02-20","201102200BUF"
"WSH",0,0,1,1,0,2,0,0,1,0,0,1,"A","N","2011-02-20","201102200BUF"
"CGY",0,1,2,1,0,4,0,0,0,0,0,0,"H","N","2011-02-20","201102200CGY"
"MTL",0,0,0,0,0,0,0,1,2,1,0,4,"A","N","2011-02-20","201102200CGY"
"CHI",0,1,0,1,1,3,0,0,1,1,0,2,"H","Y","2011-02-20","201102200CHI"
"PIT",0,0,1,1,0,2,0,1,0,1,1,3,"A","Y","2011-02-20","201102200CHI"
"DET",0,0,0,1,1,2,0,0,0,1,0,1,"A","Y","2011-02-20","201102200MIN"
"MIN",0,0,0,1,0,1,0,0,0,1,1,2,"H","Y","2011-02-20","201102200MIN"
"NYR",0,1,0,1,0,2,0,1,2,1,0,4,"H","N","2011-02-20","201102200NYR"
"PHI",0,1,2,1,0,4,0,1,0,1,0,2,"A","N","2011-02-20","201102200NYR"
"FLA",0,0,0,1,0,1,0,2,2,1,0,5,"A","N","2011-02-21","201102210NYI"
"NYI",0,2,2,1,0,5,0,0,0,1,0,1,"H","N","2011-02-21","201102210NYI"
"PIT",0,0,0,0,0,0,0,0,1,0,0,1,"H","N","2011-02-21","201102210PIT"
"WSH",0,0,1,0,0,1,0,0,0,0,0,0,"A","N","2011-02-21","201102210PIT"
"CHI",0,0,4,1,0,5,0,2,0,1,0,3,"A","N","2011-02-21","201102210STL"
"STL",0,2,0,1,0,3,0,0,4,1,0,5,"H","N","2011-02-21","201102210STL"
"CAR",0,1,0,2,0,3,0,1,1,1,1,4,"H","Y","2011-02-22","201102220CAR"
"NYR",0,1,1,1,1,4,0,1,0,2,0,3,"A","Y","2011-02-22","201102220CAR"
"CBJ",0,0,0,4,0,4,0,0,0,0,0,0,"H","N","2011-02-22","201102220CBJ"
"NSH",0,0,0,0,0,0,0,0,0,4,0,4,"A","N","2011-02-22","201102220CBJ"
"BOS",0,1,0,2,0,3,0,0,0,1,0,1,"A","N","2011-02-22","201102220CGY"
"CGY",0,0,0,1,0,1,0,1,0,2,0,3,"H","N","2011-02-22","201102220CGY"
"DAL",0,0,0,0,0,0,0,0,0,1,0,1,"H","N","2011-02-22","201102220DAL"
"NJD",0,0,0,1,0,1,0,0,0,0,0,0,"A","N","2011-02-22","201102220DAL"
"DET",0,0,2,1,0,3,0,1,2,1,0,4,"H","N","2011-02-22","201102220DET"
"SJS",0,1,2,1,0,4,0,0,2,1,0,3,"A","N","2011-02-22","201102220DET"
"EDM",0,0,1,0,0,1,0,0,1,3,0,4,"A","N","2011-02-22","201102220MIN"
"MIN",0,0,1,3,0,4,0,0,1,0,0,1,"H","N","2011-02-22","201102220MIN"
"PHI",0,1,0,1,0,2,1,0,0,2,0,3,"H","N","2011-02-22","201102220PHI"
"PHX",1,0,0,2,0,3,0,1,0,1,0,2,"A","N","2011-02-22","201102220PHI"
"COL",0,2,0,2,0,4,0,1,1,1,0,3,"A","N","2011-02-22","201102220STL"
"STL",0,1,1,1,0,3,0,2,0,2,0,4,"H","N","2011-02-22","201102220STL"
"NYI",0,0,1,0,0,1,0,1,0,1,0,2,"A","N","2011-02-22","201102220TOR"
"TOR",0,1,0,1,0,2,0,0,1,0,0,1,"H","N","2011-02-22","201102220TOR"
"MTL",0,2,1,0,0,3,0,0,1,1,0,2,"A","N","2011-02-22","201102220VAN"
"VAN",0,0,1,1,0,2,0,2,1,0,0,3,"H","N","2011-02-22","201102220VAN"
"ANA",0,1,1,0,0,2,0,2,0,1,0,3,"H","N","2011-02-23","201102230ANA"
"LAK",0,2,0,1,0,3,0,1,1,0,0,2,"A","N","2011-02-23","201102230ANA"
"ATL",0,0,1,0,0,1,0,1,2,1,0,4,"A","N","2011-02-23","201102230BUF"
"BUF",0,1,2,1,0,4,0,0,1,0,0,1,"H","N","2011-02-23","201102230BUF"
"COL",0,0,1,0,0,1,0,1,2,2,0,5,"H","N","2011-02-23","201102230COL"
"EDM",0,1,2,2,0,5,0,0,1,0,0,1,"A","N","2011-02-23","201102230COL"
"FLA",0,0,1,0,0,1,0,1,2,2,0,5,"A","N","2011-02-23","201102230OTT"
"OTT",0,1,2,2,0,5,0,0,1,0,0,1,"H","N","2011-02-23","201102230OTT"
"PIT",0,1,0,1,0,2,1,0,1,1,0,3,"H","N","2011-02-23","201102230PIT"
"SJS",1,0,1,1,0,3,0,1,0,1,0,2,"A","N","2011-02-23","201102230PIT"
"PHX",0,0,1,2,0,3,0,5,2,1,0,8,"A","N","2011-02-23","201102230TBL"
"TBL",0,5,2,1,0,8,0,0,1,2,0,3,"H","N","2011-02-23","201102230TBL"
"DAL",0,2,1,1,0,4,0,0,0,1,0,1,"A","N","2011-02-24","201102240DET"
"DET",0,0,0,1,0,1,0,2,1,1,0,4,"H","N","2011-02-24","201102240DET"
"LAK",0,1,1,2,0,4,0,0,2,0,0,2,"H","N","2011-02-24","201102240LAK"
"MIN",0,0,2,0,0,2,0,1,1,2,0,4,"A","N","2011-02-24","201102240LAK"
"MTL",0,1,2,1,0,4,0,3,1,1,0,5,"H","N","2011-02-24","201102240MTL"
"TOR",0,3,1,1,0,5,0,1,2,1,0,4,"A","N","2011-02-24","201102240MTL"
"CHI",0,1,0,2,0,3,0,0,0,0,0,0,"A","N","2011-02-24","201102240NSH"
"NSH",0,0,0,0,0,0,0,1,0,2,0,3,"H","N","2011-02-24","201102240NSH"
"NYI",0,1,0,2,0,3,1,0,2,1,0,4,"A","N","2011-02-24","201102240PHI"
"PHI",1,0,2,1,0,4,0,1,0,2,0,3,"H","N","2011-02-24","201102240PHI"
"STL",0,0,2,0,0,2,0,2,0,1,0,3,"A","N","2011-02-24","201102240VAN"
"VAN",0,2,0,1,0,3,0,0,2,0,0,2,"H","N","2011-02-24","201102240VAN"
"ANA",0,0,1,1,0,2,1,1,0,1,0,3,"H","N","2011-02-25","201102250ANA"
"MIN",1,1,0,1,0,3,0,0,1,1,0,2,"A","N","2011-02-25","201102250ANA"
"ATL",0,0,1,0,0,1,0,1,0,0,1,2,"H","Y","2011-02-25","201102250ATL"
"FLA",0,1,0,0,1,2,0,0,1,0,0,1,"A","Y","2011-02-25","201102250ATL"
"BUF",0,1,1,2,0,4,0,0,1,1,0,2,"H","N","2011-02-25","201102250BUF"
"OTT",0,0,1,1,0,2,0,1,1,2,0,4,"A","N","2011-02-25","201102250BUF"
"CAR",0,2,1,1,0,4,0,0,1,0,0,1,"H","N","2011-02-25","201102250CAR"
"PIT",0,0,1,0,0,1,0,2,1,1,0,4,"A","N","2011-02-25","201102250CAR"
"CBJ",0,2,2,1,0,5,0,2,0,1,0,3,"H","N","2011-02-25","201102250CBJ"
"PHX",0,2,0,1,0,3,0,2,2,1,0,5,"A","N","2011-02-25","201102250CBJ"
"CGY",0,1,2,0,0,3,0,1,1,1,1,4,"H","Y","2011-02-25","201102250CGY"
"SJS",0,1,1,1,1,4,0,1,2,0,0,3,"A","Y","2011-02-25","201102250CGY"
"EDM",0,0,0,0,0,0,0,2,1,2,0,5,"H","N","2011-02-25","201102250EDM"
"STL",0,2,1,2,0,5,0,0,0,0,0,0,"A","N","2011-02-25","201102250EDM"
"NJD",0,0,0,1,0,1,0,0,2,0,0,2,"A","N","2011-02-25","201102250TBL"
"TBL",0,0,2,0,0,2,0,0,0,1,0,1,"H","N","2011-02-25","201102250TBL"
"NYR",0,2,2,2,0,6,0,0,0,0,0,0,"A","N","2011-02-25","201102250WSH"
"WSH",0,0,0,0,0,0,0,2,2,2,0,6,"H","N","2011-02-25","201102250WSH"
"BUF",0,2,0,0,0,2,0,0,1,1,1,3,"H","Y","2011-02-26","201102260BUF"
"DET",0,0,1,1,1,3,0,2,0,0,0,2,"A","Y","2011-02-26","201102260BUF"
"DAL",0,1,0,2,0,3,0,0,2,0,0,2,"H","N","2011-02-26","201102260DAL"
"NSH",0,0,2,0,0,2,0,1,0,2,0,3,"A","N","2011-02-26","201102260DAL"
"COL",0,0,0,3,0,3,0,1,2,1,0,4,"A","N","2011-02-26","201102260LAK"
"LAK",0,1,2,1,0,4,0,0,0,3,0,3,"H","N","2011-02-26","201102260LAK"
"CAR",0,1,2,0,0,3,0,2,1,1,0,4,"A","N","2011-02-26","201102260MTL"
"MTL",0,2,1,1,0,4,0,1,2,0,0,3,"H","N","2011-02-26","201102260MTL"
"NYI",0,1,1,0,0,2,0,0,1,2,0,3,"H","N","2011-02-26","201102260NYI"
"WSH",0,0,1,2,0,3,0,1,1,0,0,2,"A","N","2011-02-26","201102260NYI"
"OTT",0,0,2,2,0,4,0,1,0,0,0,1,"H","N","2011-02-26","201102260OTT"
"PHI",0,1,0,0,0,1,0,0,2,2,0,4,"A","N","2011-02-26","201102260OTT"
"PIT",0,1,2,2,1,6,0,1,1,3,0,5,"A","Y","2011-02-26","201102260TOR"
"TOR",0,1,1,3,0,5,0,1,2,2,1,6,"H","Y","2011-02-26","201102260TOR"
"BOS",0,0,1,2,0,3,0,1,0,0,0,1,"A","N","2011-02-26","201102260VAN"
"VAN",0,1,0,0,0,1,0,0,1,2,0,3,"H","N","2011-02-26","201102260VAN"
"ANA",0,0,2,1,0,3,0,1,0,1,0,2,"H","N","2011-02-27","201102270ANA"
"COL",0,1,0,1,0,2,0,0,2,1,0,3,"A","N","2011-02-27","201102270ANA"
"ATL",1,0,0,2,0,3,0,2,0,0,0,2,"H","N","2011-02-27","201102270ATL"
"TOR",0,2,0,0,0,2,1,0,0,2,0,3,"A","N","2011-02-27","201102270ATL"
"CGY",0,0,0,1,0,1,0,0,0,0,0,0,"H","N","2011-02-27","201102270CGY"
"STL",0,0,0,0,0,0,0,0,0,1,0,1,"A","N","2011-02-27","201102270CGY"
"CHI",0,2,1,0,1,4,0,0,3,0,0,3,"H","Y","2011-02-27","201102270CHI"
"PHX",0,0,3,0,0,3,0,2,1,0,1,4,"A","Y","2011-02-27","201102270CHI"
"BOS",0,2,1,0,0,3,0,1,0,1,0,2,"A","N","2011-02-27","201102270EDM"
"EDM",0,1,0,1,0,2,0,2,1,0,0,3,"H","N","2011-02-27","201102270EDM"
"FLA",0,0,0,1,0,1,0,0,2,0,0,2,"H","N","2011-02-27","201102270FLA"
"NJD",0,0,2,0,0,2,0,0,0,1,0,1,"A","N","2011-02-27","201102270FLA"
"CBJ",0,0,1,1,0,2,0,0,0,3,0,3,"A","N","2011-02-27","201102270NSH"
"NSH",0,0,0,3,0,3,0,0,1,1,0,2,"H","N","2011-02-27","201102270NSH"
"NYR",0,0,1,0,0,1,0,1,0,1,0,2,"H","N","2011-02-27","201102270NYR"
"TBL",0,1,0,1,0,2,0,0,1,0,0,1,"A","N","2011-02-27","201102270NYR"
"DET",0,3,1,3,0,7,0,1,0,3,0,4,"A","N","2011-02-28","201102280LAK"
"LAK",0,1,0,3,0,4,0,3,1,3,0,7,"H","N","2011-02-28","201102280LAK"
"CHI",0,0,3,1,0,4,0,0,0,2,0,2,"A","N","2011-02-28","201102280MIN"
"MIN",0,0,0,2,0,2,0,0,3,1,0,4,"H","N","2011-02-28","201102280MIN"
"ATL",0,0,0,1,0,1,0,1,1,1,0,3,"H","N","2011-03-01","201103010ATL"
"MTL",0,1,1,1,0,3,0,0,0,1,0,1,"A","N","2011-03-01","201103010ATL"
"CAR",0,2,0,0,0,2,0,0,1,0,0,1,"H","N","2011-03-01","201103010CAR"
"FLA",0,0,1,0,0,1,0,2,0,0,0,2,"A","N","2011-03-01","201103010CAR"
"EDM",0,1,0,0,1,2,0,1,0,0,0,1,"H","Y","2011-03-01","201103010EDM"
"NSH",0,1,0,0,0,1,0,1,0,0,1,2,"A","Y","2011-03-01","201103010EDM"
"BUF",0,1,1,1,0,3,0,0,1,1,0,2,"A","N","2011-03-01","201103010NYR"
"NYR",0,0,1,1,0,2,0,1,1,1,0,3,"H","N","2011-03-01","201103010NYR"
"BOS",0,0,0,1,0,1,0,0,0,0,0,0,"A","N","2011-03-01","201103010OTT"
"OTT",0,0,0,0,0,0,0,0,0,1,0,1,"H","N","2011-03-01","201103010OTT"
"DAL",0,1,0,2,0,3,0,0,0,2,0,2,"A","N","2011-03-01","201103010PHX"
"PHX",0,0,0,2,0,2,0,1,0,2,0,3,"H","N","2011-03-01","201103010PHX"
"COL",0,0,0,1,0,1,0,0,0,1,1,2,"A","Y","2011-03-01","201103010SJS"
"SJS",0,0,0,1,1,2,0,0,0,1,0,1,"H","Y","2011-03-01","201103010SJS"
"CGY",0,1,0,5,0,6,0,0,0,0,0,0,"A","N","2011-03-01","201103010STL"
"STL",0,0,0,0,0,0,0,1,0,5,0,6,"H","N","2011-03-01","201103010STL"
"CBJ",0,0,1,0,0,1,0,1,0,0,1,2,"A","Y","2011-03-01","201103010VAN"
"VAN",0,1,0,0,1,2,0,0,1,0,0,1,"H","Y","2011-03-01","201103010VAN"
"NYI",0,0,1,0,0,1,1,0,0,1,0,2,"A","N","2011-03-01","201103010WSH"
"WSH",1,0,0,1,0,2,0,0,1,0,0,1,"H","N","2011-03-01","201103010WSH"
"ANA",1,0,0,1,0,2,0,0,1,0,0,1,"H","N","2011-03-02","201103020ANA"
"DET",0,0,1,0,0,1,1,0,0,1,0,2,"A","N","2011-03-02","201103020ANA"
"CGY",0,1,0,3,0,4,0,2,2,2,0,6,"A","N","2011-03-02","201103020CHI"
"CHI",0,2,2,2,0,6,0,1,0,3,0,4,"H","N","2011-03-02","201103020CHI"
"NJD",0,0,1,1,0,2,0,0,1,0,0,1,"H","N","2011-03-02","201103020NJD"
"TBL",0,0,1,0,0,1,0,0,1,1,0,2,"A","N","2011-03-02","201103020NJD"
"MIN",0,0,0,1,0,1,0,2,2,0,0,4,"A","N","2011-03-02","201103020NYI"
"NYI",0,2,2,0,0,4,0,0,0,1,0,1,"H","N","2011-03-02","201103020NYI"
"PIT",0,1,1,0,0,2,1,1,0,1,0,3,"A","N","2011-03-02","201103020TOR"
"TOR",1,1,0,1,0,3,0,1,1,0,0,2,"H","N","2011-03-02","201103020TOR"
"ATL",0,0,0,1,0,1,0,1,0,2,0,3,"H","N","2011-03-03","201103030ATL"
"OTT",0,1,0,2,0,3,0,0,0,1,0,1,"A","N","2011-03-03","201103030ATL"
"BOS",0,0,1,1,0,2,0,0,1,0,0,1,"H","N","2011-03-03","201103030BOS"
"TBL",0,0,1,0,0,1,0,0,1,1,0,2,"A","N","2011-03-03","201103030BOS"
"BUF",0,0,2,0,0,2,1,0,2,0,0,3,"A","N","2011-03-03","201103030CAR"
"CAR",1,0,2,0,0,3,0,0,2,0,0,2,"H","N","2011-03-03","201103030CAR"
"CBJ",0,0,1,1,0,2,0,2,1,1,0,4,"A","N","2011-03-03","201103030EDM"
"EDM",0,2,1,1,0,4,0,0,1,1,0,2,"H","N","2011-03-03","201103030EDM"
"FLA",0,0,0,0,0,0,0,2,1,1,0,4,"H","N","2011-03-03","201103030FLA"
"MTL",0,2,1,1,0,4,0,0,0,0,0,0,"A","N","2011-03-03","201103030FLA"
"LAK",0,0,0,1,0,1,0,0,0,0,0,0,"H","N","2011-03-03","201103030LAK"
"PHX",0,0,0,0,0,0,0,0,0,1,0,1,"A","N","2011-03-03","201103030LAK"
"MIN",0,0,2,1,0,3,0,1,0,0,0,1,"A","N","2011-03-03","201103030NYR"
"NYR",0,1,0,0,0,1,0,0,2,1,0,3,"H","N","2011-03-03","201103030NYR"
"PHI",0,1,1,0,0,2,0,1,1,1,0,3,"H","N","2011-03-03","201103030PHI"
"TOR",0,1,1,1,0,3,0,1,1,0,0,2,"A","N","2011-03-03","201103030PHI"
"DET",0,1,0,0,0,1,0,1,1,1,0,3,"A","N","2011-03-03","201103030SJS"
"SJS",0,1,1,1,0,3,0,1,0,0,0,1,"H","N","2011-03-03","201103030SJS"
"NSH",0,0,0,3,0,3,0,0,0,0,0,0,"A","N","2011-03-03","201103030VAN"
"VAN",0,0,0,0,0,0,0,0,0,3,0,3,"H","N","2011-03-03","201103030VAN"
"STL",0,1,1,0,0,2,0,0,2,1,0,3,"A","N","2011-03-03","201103030WSH"
"WSH",0,0,2,1,0,3,0,1,1,0,0,2,"H","N","2011-03-03","201103030WSH"
"ANA",1,1,0,2,0,4,0,0,3,0,0,3,"H","N","2011-03-04","201103040ANA"
"DAL",0,0,3,0,0,3,1,1,0,2,0,4,"A","N","2011-03-04","201103040ANA"
"CBJ",0,1,1,1,0,3,0,2,2,0,0,4,"A","N","2011-03-04","201103040CGY"
"CGY",0,2,2,0,0,4,0,1,1,1,0,3,"H","N","2011-03-04","201103040CGY"
"CAR",0,1,0,1,0,2,0,2,0,3,0,5,"A","N","2011-03-04","201103040CHI"
"CHI",0,2,0,3,0,5,0,1,0,1,0,2,"H","N","2011-03-04","201103040CHI"
"NJD",1,0,1,0,0,2,0,0,1,0,0,1,"H","N","2011-03-04","201103040NJD"
"PIT",0,0,1,0,0,1,1,0,1,0,0,2,"A","N","2011-03-04","201103040NJD"
"NYR",0,1,2,1,0,4,0,0,0,1,0,1,"A","N","2011-03-04","201103040OTT"
"OTT",0,0,0,1,0,1,0,1,2,1,0,4,"H","N","2011-03-04","201103040OTT"
"ATL",1,0,1,2,0,4,0,1,0,2,0,3,"H","N","2011-03-05","201103050ATL"
"FLA",0,1,0,2,0,3,1,0,1,2,0,4,"A","N","2011-03-05","201103050ATL"
"BOS",0,0,1,1,0,2,1,0,2,0,0,3,"H","N","2011-03-05","201103050BOS"
"PIT",1,0,2,0,0,3,0,0,1,1,0,2,"A","N","2011-03-05","201103050BOS"
"COL",0,0,1,0,0,1,0,2,2,1,0,5,"H","N","2011-03-05","201103050COL"
"EDM",0,2,2,1,0,5,0,0,1,0,0,1,"A","N","2011-03-05","201103050COL"
"LAK",0,1,0,0,0,1,0,1,0,2,0,3,"H","N","2011-03-05","201103050LAK"
"VAN",0,1,0,2,0,3,0,1,0,0,0,1,"A","N","2011-03-05","201103050LAK"
"NYI",0,2,1,2,0,5,0,0,0,2,0,2,"H","N","2011-03-05","201103050NYI"
"STL",0,0,0,2,0,2,0,2,1,2,0,5,"A","N","2011-03-05","201103050NYI"
"BUF",0,0,3,2,0,5,0,2,1,0,0,3,"A","N","2011-03-05","201103050PHI"
"PHI",0,2,1,0,0,3,0,0,3,2,0,5,"H","N","2011-03-05","201103050PHI"
"DET",0,2,2,0,0,4,0,1,0,3,1,5,"A","Y","2011-03-05","201103050PHX"
"PHX",0,1,0,3,1,5,0,2,2,0,0,4,"H","Y","2011-03-05","201103050PHX"
"DAL",0,1,0,2,0,3,0,1,1,0,0,2,"A","N","2011-03-05","201103050SJS"
"SJS",0,1,1,0,0,2,0,1,0,2,0,3,"H","N","2011-03-05","201103050SJS"
"MTL",0,2,1,1,0,4,0,0,1,1,0,2,"A","N","2011-03-05","201103050TBL"
"TBL",0,0,1,1,0,2,0,2,1,1,0,4,"H","N","2011-03-05","201103050TBL"
"CHI",0,3,2,0,0,5,0,0,1,2,0,3,"A","N","2011-03-05","201103050TOR"
"TOR",0,0,1,2,0,3,0,3,2,0,0,5,"H","N","2011-03-05","201103050TOR"
"ANA",0,0,0,0,0,0,0,1,1,1,0,3,"H","N","2011-03-06","201103060ANA"
"VAN",0,1,1,1,0,3,0,0,0,0,0,0,"A","N","2011-03-06","201103060ANA"
"CGY",0,1,1,1,0,3,0,2,0,0,0,2,"H","N","2011-03-06","201103060CGY"
"NSH",0,2,0,0,0,2,0,1,1,1,0,3,"A","N","2011-03-06","201103060CGY"
"FLA",0,1,0,1,0,2,1,1,1,0,0,3,"H","N","2011-03-06","201103060FLA"
"WSH",1,1,1,0,0,3,0,1,0,1,0,2,"A","N","2011-03-06","201103060FLA"
"BUF",1,1,1,0,0,3,0,0,2,0,0,2,"A","N","2011-03-06","201103060MIN"
"MIN",0,0,2,0,0,2,1,1,1,0,0,3,"H","N","2011-03-06","201103060MIN"
"NJD",0,0,1,1,1,3,0,0,1,1,0,2,"A","Y","2011-03-06","201103060NYI"
"NYI",0,0,1,1,0,2,0,0,1,1,1,3,"H","Y","2011-03-06","201103060NYI"
"NYR",0,2,2,3,0,7,0,0,0,0,0,0,"H","N","2011-03-06","201103060NYR"
"PHI",0,0,0,0,0,0,0,2,2,3,0,7,"A","N","2011-03-06","201103060NYR"
"DAL",1,0,1,2,0,4,0,1,1,1,0,3,"A","N","2011-03-07","201103070LAK"
"LAK",0,1,1,1,0,3,1,0,1,2,0,4,"H","N","2011-03-07","201103070LAK"
"CBJ",0,3,1,0,0,4,0,3,1,0,1,5,"A","Y","2011-03-07","201103070STL"
"STL",0,3,1,0,1,5,0,3,1,0,0,4,"H","Y","2011-03-07","201103070STL"
"TBL",0,1,0,0,0,1,0,0,0,1,1,2,"H","Y","2011-03-07","201103070TBL"
"WSH",0,0,0,1,1,2,0,1,0,0,0,1,"A","Y","2011-03-07","201103070TBL"
"CHI",0,0,2,0,0,2,0,3,0,0,0,3,"A","N","2011-03-08","201103080FLA"
"FLA",0,3,0,0,0,3,0,0,2,0,0,2,"H","N","2011-03-08","201103080FLA"
"COL",0,0,2,0,0,2,0,1,1,3,0,5,"A","N","2011-03-08","201103080MIN"
"MIN",0,1,1,3,0,5,0,0,2,0,0,2,"H","N","2011-03-08","201103080MIN"
"BOS",0,0,0,1,0,1,0,2,2,0,0,4,"A","N","2011-03-08","201103080MTL"
"MTL",0,2,2,0,0,4,0,0,0,1,0,1,"H","N","2011-03-08","201103080MTL"
"NJD",0,0,0,1,0,1,0,0,1,1,0,2,"H","N","2011-03-08","201103080NJD"
"OTT",0,0,1,1,0,2,0,0,0,1,0,1,"A","N","2011-03-08","201103080NJD"
"NYI",1,0,2,1,0,4,0,0,2,1,0,3,"H","N","2011-03-08","201103080NYI"
"TOR",0,0,2,1,0,3,1,0,2,1,0,4,"A","N","2011-03-08","201103080NYI"
"EDM",0,0,1,0,0,1,0,2,1,1,0,4,"A","N","2011-03-08","201103080PHI"
"PHI",0,2,1,1,0,4,0,0,1,0,0,1,"H","N","2011-03-08","201103080PHI"
"PHX",0,2,1,0,0,3,1,1,2,0,0,4,"H","N","2011-03-08","201103080PHX"
"VAN",1,1,2,0,0,4,0,2,1,0,0,3,"A","N","2011-03-08","201103080PHX"
"BUF",0,1,0,0,0,1,0,0,2,1,0,3,"A","N","2011-03-08","201103080PIT"
"PIT",0,0,2,1,0,3,0,1,0,0,0,1,"H","N","2011-03-08","201103080PIT"
"NSH",0,1,1,0,0,2,1,1,1,0,0,3,"A","N","2011-03-08","201103080SJS"
"SJS",1,1,1,0,0,3,0,1,1,0,0,2,"H","N","2011-03-08","201103080SJS"
"ANA",0,3,0,2,0,5,0,1,0,1,0,2,"H","N","2011-03-09","201103090ANA"
"NYR",0,1,0,1,0,2,0,3,0,2,0,5,"A","N","2011-03-09","201103090ANA"
"ATL",1,2,0,0,0,3,0,0,1,1,0,2,"A","N","2011-03-09","201103090CAR"
"CAR",0,0,1,1,0,2,1,2,0,0,0,3,"H","N","2011-03-09","201103090CAR"
"CBJ",0,0,3,0,0,3,1,0,1,2,0,4,"H","N","2011-03-09","201103090CBJ"
"STL",1,0,1,2,0,4,0,0,3,0,0,3,"A","N","2011-03-09","201103090CBJ"
"CGY",0,3,0,0,1,4,0,1,1,1,0,3,"A","Y","2011-03-09","201103090DAL"
"DAL",0,1,1,1,0,3,0,3,0,0,1,4,"H","Y","2011-03-09","201103090DAL"
"DET",0,1,0,0,0,1,0,0,2,0,0,2,"H","N","2011-03-09","201103090DET"
"LAK",0,0,2,0,0,2,0,1,0,0,0,1,"A","N","2011-03-09","201103090DET"
"CHI",0,1,1,1,0,3,0,2,1,0,1,4,"A","Y","2011-03-09","201103090TBL"
"TBL",0,2,1,0,1,4,0,1,1,1,0,3,"H","Y","2011-03-09","201103090TBL"
"EDM",0,0,0,0,0,0,0,0,2,3,0,5,"A","N","2011-03-09","201103090WSH"
"WSH",0,0,2,3,0,5,0,0,0,0,0,0,"H","N","2011-03-09","201103090WSH"
"BOS",0,1,1,1,0,3,1,0,2,1,0,4,"H","N","2011-03-10","201103100BOS"
"BUF",1,0,2,1,0,4,0,1,1,1,0,3,"A","N","2011-03-10","201103100BOS"
"FLA",0,0,0,1,0,1,0,0,0,2,0,2,"H","N","2011-03-10","201103100FLA"
"OTT",0,0,0,2,0,2,0,0,0,1,0,1,"A","N","2011-03-10","201103100FLA"
"MIN",0,0,0,0,0,0,0,3,0,1,0,4,"A","N","2011-03-10","201103100NSH"
"NSH",0,3,0,1,0,4,0,0,0,0,0,0,"H","N","2011-03-10","201103100NSH"
"CGY",0,0,0,0,0,0,0,0,1,2,0,3,"A","N","2011-03-10","201103100PHX"
"PHX",0,0,1,2,0,3,0,0,0,0,0,0,"H","N","2011-03-10","201103100PHX"
"SJS",0,0,2,2,0,4,0,2,1,1,1,5,"H","Y","2011-03-10","201103100SJS"
"VAN",0,2,1,1,1,5,0,0,2,2,0,4,"A","Y","2011-03-10","201103100SJS"
"MTL",0,1,0,0,0,1,0,1,1,2,0,4,"A","N","2011-03-10","201103100STL"
"STL",0,1,1,2,0,4,0,1,0,0,0,1,"H","N","2011-03-10","201103100STL"
"PHI",0,1,2,0,0,3,0,0,1,1,0,2,"A","N","2011-03-10","201103100TOR"
"TOR",0,0,1,1,0,2,0,1,2,0,0,3,"H","N","2011-03-10","201103100TOR"
"ATL",0,0,1,1,0,2,1,0,1,1,0,3,"H","N","2011-03-11","201103110ATL"
"NJD",1,0,1,1,0,3,0,0,1,1,0,2,"A","N","2011-03-11","201103110ATL"
"CBJ",0,1,0,1,0,2,0,2,1,1,0,4,"H","N","2011-03-11","201103110CBJ"
"LAK",0,2,1,1,0,4,0,1,0,1,0,2,"A","N","2011-03-11","201103110CBJ"
"ANA",0,0,4,2,0,6,0,1,1,0,0,2,"A","N","2011-03-11","201103110COL"
"COL",0,1,1,0,0,2,0,0,4,2,0,6,"H","N","2011-03-11","201103110COL"
"DAL",0,1,3,0,0,4,0,0,0,0,0,0,"H","N","2011-03-11","201103110DAL"
"MIN",0,0,0,0,0,0,0,1,3,0,0,4,"A","N","2011-03-11","201103110DAL"
"DET",1,0,0,1,0,2,0,1,0,0,0,1,"H","N","2011-03-11","201103110DET"
"EDM",0,1,0,0,0,1,1,0,0,1,0,2,"A","N","2011-03-11","201103110DET"
"BOS",0,1,1,0,0,2,0,0,1,3,0,4,"A","N","2011-03-11","201103110NYI"
"NYI",0,0,1,3,0,4,0,1,1,0,0,2,"H","N","2011-03-11","201103110NYI"
"OTT",0,1,1,0,0,2,0,0,0,1,0,1,"A","N","2011-03-11","201103110TBL"
"TBL",0,0,0,1,0,1,0,1,1,0,0,2,"H","N","2011-03-11","201103110TBL"
"CAR",0,0,1,0,0,1,0,0,0,2,0,2,"A","N","2011-03-11","201103110WSH"
"WSH",0,0,0,2,0,2,0,0,1,0,0,1,"H","N","2011-03-11","201103110WSH"
"CAR",0,0,0,2,0,2,0,1,1,1,0,3,"H","N","2011-03-12","201103120CAR"
"CBJ",0,1,1,1,0,3,0,0,0,2,0,2,"A","N","2011-03-12","201103120CAR"
"CGY",0,2,1,0,0,3,0,1,3,0,0,4,"H","N","2011-03-12","201103120CGY"
"VAN",0,1,3,0,0,4,0,2,1,0,0,3,"A","N","2011-03-12","201103120CGY"
"FLA",1,0,1,2,0,4,0,0,1,2,0,3,"H","N","2011-03-12","201103120FLA"
"TBL",0,0,1,2,0,3,1,0,1,2,0,4,"A","N","2011-03-12","201103120FLA"
"NJD",1,1,0,1,0,3,0,0,2,0,0,2,"H","N","2011-03-12","201103120NJD"
"NYI",0,0,2,0,0,2,1,1,0,1,0,3,"A","N","2011-03-12","201103120NJD"
"COL",0,0,2,0,0,2,0,2,1,1,0,4,"A","N","2011-03-12","201103120NSH"
"NSH",0,2,1,1,0,4,0,0,2,0,0,2,"H","N","2011-03-12","201103120NSH"
"ATL",1,0,0,4,0,5,0,1,2,1,0,4,"A","N","2011-03-12","201103120PHI"
"PHI",0,1,2,1,0,4,1,0,0,4,0,5,"H","N","2011-03-12","201103120PHI"
"MTL",0,1,2,0,0,3,0,0,0,0,0,0,"A","N","2011-03-12","201103120PIT"
"PIT",0,0,0,0,0,0,0,1,2,0,0,3,"H","N","2011-03-12","201103120PIT"
"NYR",0,1,1,0,1,3,0,1,1,0,0,2,"A","Y","2011-03-12","201103120SJS"
"SJS",0,1,1,0,0,2,0,1,1,0,1,3,"H","Y","2011-03-12","201103120SJS"
"DET",0,2,1,2,0,5,0,1,0,2,0,3,"A","N","2011-03-12","201103120STL"
"STL",0,1,0,2,0,3,0,2,1,2,0,5,"H","N","2011-03-12","201103120STL"
"BUF",0,1,2,0,0,3,0,1,1,2,0,4,"A","N","2011-03-12","201103120TOR"
"TOR",0,1,1,2,0,4,0,1,2,0,0,3,"H","N","2011-03-12","201103120TOR"
"ANA",0,1,1,0,0,2,0,2,2,1,0,5,"H","N","2011-03-13","201103130ANA"
"PHX",0,2,2,1,0,5,0,1,1,0,0,2,"A","N","2011-03-13","201103130ANA"
"BUF",0,2,3,1,0,6,0,2,1,1,0,4,"H","N","2011-03-13","201103130BUF"
"OTT",0,2,1,1,0,4,0,2,3,1,0,6,"A","N","2011-03-13","201103130BUF"
"DAL",0,0,1,1,0,2,0,1,1,1,0,3,"H","N","2011-03-13","201103130DAL"
"LAK",0,1,1,1,0,3,0,0,1,1,0,2,"A","N","2011-03-13","201103130DAL"
"EDM",0,0,0,1,0,1,0,1,2,2,0,5,"A","N","2011-03-13","201103130PIT"
"PIT",0,1,2,2,0,5,0,0,0,1,0,1,"H","N","2011-03-13","201103130PIT"
"CHI",0,1,1,1,0,3,1,2,0,1,0,4,"A","N","2011-03-13","201103130WSH"
"WSH",1,2,0,1,0,4,0,1,1,1,0,3,"H","N","2011-03-13","201103130WSH"
"CHI",0,1,5,0,0,6,0,2,1,0,0,3,"H","N","2011-03-14","201103140CHI"
"SJS",0,2,1,0,0,3,0,1,5,0,0,6,"A","N","2011-03-14","201103140CHI"
"TBL",0,1,3,2,0,6,0,0,2,0,0,2,"A","N","2011-03-14","201103140TOR"
"TOR",0,0,2,0,0,2,0,1,3,2,0,6,"H","N","2011-03-14","201103140TOR"
"MIN",0,0,1,1,0,2,0,3,0,1,0,4,"A","N","2011-03-14","201103140VAN"
"VAN",0,3,0,1,0,4,0,0,1,1,0,2,"H","N","2011-03-14","201103140VAN"
"BUF",0,0,0,0,0,0,0,1,0,0,0,1,"H","N","2011-03-15","201103150BUF"
"CAR",0,1,0,0,0,1,0,0,0,0,0,0,"A","N","2011-03-15","201103150BUF"
"BOS",0,0,1,1,1,3,0,1,0,1,0,2,"A","Y","2011-03-15","201103150CBJ"
"CBJ",0,1,0,1,0,2,0,0,1,1,1,3,"H","Y","2011-03-15","201103150CBJ"
"CGY",0,1,0,2,0,3,0,1,1,2,0,4,"H","N","2011-03-15","201103150CGY"
"PHX",0,1,1,2,0,4,0,1,0,2,0,3,"A","N","2011-03-15","201103150CGY"
"DAL",0,0,2,1,0,3,0,0,2,4,0,6,"H","N","2011-03-15","201103150DAL"
"SJS",0,0,2,4,0,6,0,0,2,1,0,3,"A","N","2011-03-15","201103150DAL"
"FLA",0,2,0,0,0,2,0,1,2,0,0,3,"H","N","2011-03-15","201103150FLA"
"PHI",0,1,2,0,0,3,0,2,0,0,0,2,"A","N","2011-03-15","201103150FLA"
"MTL",0,1,1,0,0,2,0,2,0,2,0,4,"H","N","2011-03-15","201103150MTL"
"WSH",0,2,0,2,0,4,0,1,1,0,0,2,"A","N","2011-03-15","201103150MTL"
"ATL",0,2,0,0,0,2,0,1,1,2,0,4,"A","N","2011-03-15","201103150NJD"
"NJD",0,1,1,2,0,4,0,2,0,0,0,2,"H","N","2011-03-15","201103150NJD"
"LAK",0,1,2,1,0,4,0,1,0,1,0,2,"A","N","2011-03-15","201103150NSH"
"NSH",0,1,0,1,0,2,0,1,2,1,0,4,"H","N","2011-03-15","201103150NSH"
"NYI",0,0,2,1,0,3,0,2,3,1,0,6,"A","N","2011-03-15","201103150NYR"
"NYR",0,2,3,1,0,6,0,0,2,1,0,3,"H","N","2011-03-15","201103150NYR"
"OTT",0,0,1,0,0,1,0,1,3,1,0,5,"H","N","2011-03-15","201103150OTT"
"PIT",0,1,3,1,0,5,0,0,1,0,0,1,"A","N","2011-03-15","201103150OTT"
"ANA",0,0,1,1,0,2,0,0,1,0,0,1,"H","N","2011-03-16","201103160ANA"
"STL",0,0,1,0,0,1,0,0,1,1,0,2,"A","N","2011-03-16","201103160ANA"
"CAR",0,1,0,0,0,1,0,1,2,0,0,3,"H","N","2011-03-16","201103160CAR"
"TOR",0,1,2,0,0,3,0,1,0,0,0,1,"A","N","2011-03-16","201103160CAR"
"DET",0,2,0,1,0,3,0,1,1,0,0,2,"H","N","2011-03-16","201103160DET"
"WSH",0,1,1,0,0,2,0,2,0,1,0,3,"A","N","2011-03-16","201103160DET"
"COL",0,2,0,0,0,2,0,0,1,3,0,4,"A","N","2011-03-16","201103160VAN"
"VAN",0,0,1,3,0,4,0,2,0,0,0,2,"H","N","2011-03-16","201103160VAN"
"ATL",0,1,2,0,1,4,0,1,1,1,0,3,"H","Y","2011-03-17","201103170ATL"
"PHI",0,1,1,1,0,3,0,1,2,0,1,4,"A","Y","2011-03-17","201103170ATL"
"CBJ",0,0,0,0,0,0,0,2,0,0,0,2,"H","N","2011-03-17","201103170CBJ"
"DET",0,2,0,0,0,2,0,0,0,0,0,0,"A","N","2011-03-17","201103170CBJ"
"CGY",0,3,0,2,0,5,0,1,0,1,0,2,"H","N","2011-03-17","201103170CGY"
"COL",0,1,0,1,0,2,0,3,0,2,0,5,"A","N","2011-03-17","201103170CGY"
"CHI",0,0,0,0,0,0,0,1,2,2,0,5,"A","N","2011-03-17","201103170DAL"
"DAL",0,1,2,2,0,5,0,0,0,0,0,0,"H","N","2011-03-17","201103170DAL"
"EDM",0,0,0,1,0,1,0,1,1,1,0,3,"H","N","2011-03-17","201103170EDM"
"PHX",0,1,1,1,0,3,0,0,0,1,0,1,"A","N","2011-03-17","201103170EDM"
"FLA",0,0,3,1,0,4,0,0,0,0,0,0,"H","N","2011-03-17","201103170FLA"
"TOR",0,0,0,0,0,0,0,0,3,1,0,4,"A","N","2011-03-17","201103170FLA"
"LAK",0,0,0,0,0,0,0,1,1,2,0,4,"H","N","2011-03-17","201103170LAK"
"STL",0,1,1,2,0,4,0,0,0,0,0,0,"A","N","2011-03-17","201103170LAK"
"MTL",0,0,1,1,1,3,0,0,1,1,0,2,"H","Y","2011-03-17","201103170MTL"
"TBL",0,0,1,1,0,2,0,0,1,1,1,3,"A","Y","2011-03-17","201103170MTL"
"BOS",0,1,1,1,0,3,1,1,1,1,0,4,"A","N","2011-03-17","201103170NSH"
"NSH",1,1,1,1,0,4,0,1,1,1,0,3,"H","N","2011-03-17","201103170NSH"
"NJD",0,0,0,1,0,1,0,1,0,2,0,3,"A","N","2011-03-17","201103170OTT"
"OTT",0,1,0,2,0,3,0,0,0,1,0,1,"H","N","2011-03-17","201103170OTT"
"MIN",0,1,1,0,0,2,0,1,1,1,0,3,"A","N","2011-03-17","201103170SJS"
"SJS",0,1,1,1,0,3,0,1,1,0,0,2,"H","N","2011-03-17","201103170SJS"
"CAR",1,1,0,1,0,3,0,1,1,0,0,2,"H","N","2011-03-18","201103180CAR"
"NYI",0,1,1,0,0,2,1,1,0,1,0,3,"A","N","2011-03-18","201103180CAR"
"NJD",0,0,0,0,0,0,0,1,1,1,0,3,"H","N","2011-03-18","201103180NJD"
"WSH",0,1,1,1,0,3,0,0,0,0,0,0,"A","N","2011-03-18","201103180NJD"
"MTL",0,1,1,1,0,3,0,5,0,1,0,6,"A","N","2011-03-18","201103180NYR"
"NYR",0,5,0,1,0,6,0,1,1,1,0,3,"H","N","2011-03-18","201103180NYR"
"PHX",0,0,0,3,0,3,0,0,0,1,0,1,"A","N","2011-03-18","201103180VAN"
"VAN",0,0,0,1,0,1,0,0,0,3,0,3,"H","N","2011-03-18","201103180VAN"
"ATL",0,1,1,0,0,2,0,3,2,3,0,8,"A","N","2011-03-19","201103190BUF"
"BUF",0,3,2,3,0,8,0,1,1,0,0,2,"H","N","2011-03-19","201103190BUF"
"DAL",0,0,1,1,0,2,0,1,1,0,1,3,"H","Y","2011-03-19","201103190DAL"
"PHI",0,1,1,0,1,3,0,0,1,1,0,2,"A","Y","2011-03-19","201103190DAL"
"COL",0,1,1,0,1,3,0,0,1,1,0,2,"A","Y","2011-03-19","201103190EDM"
"EDM",0,0,1,1,0,2,0,1,1,0,1,3,"H","Y","2011-03-19","201103190EDM"
"FLA",0,0,2,1,0,3,0,0,1,2,1,4,"H","Y","2011-03-19","201103190FLA"
"NYI",0,0,1,2,1,4,0,0,2,1,0,3,"A","Y","2011-03-19","201103190FLA"
"ANA",1,1,0,0,0,2,0,0,0,1,0,1,"A","N","2011-03-19","201103190LAK"
"LAK",0,0,0,1,0,1,1,1,0,0,0,2,"H","N","2011-03-19","201103190LAK"
"CBJ",1,1,1,2,0,5,0,1,1,2,0,4,"A","N","2011-03-19","201103190MIN"
"MIN",0,1,1,2,0,4,1,1,1,2,0,5,"H","N","2011-03-19","201103190MIN"
"DET",0,1,0,0,0,1,0,0,1,2,0,3,"A","N","2011-03-19","201103190NSH"
"NSH",0,0,1,2,0,3,0,1,0,0,0,1,"H","N","2011-03-19","201103190NSH"
"OTT",1,0,0,2,0,3,0,1,1,0,0,2,"H","N","2011-03-19","201103190OTT"
"TBL",0,1,1,0,0,2,1,0,0,2,0,3,"A","N","2011-03-19","201103190OTT"
"SJS",0,3,2,0,0,5,0,0,1,2,0,3,"H","N","2011-03-19","201103190SJS"
"STL",0,0,1,2,0,3,0,3,2,0,0,5,"A","N","2011-03-19","201103190SJS"
"BOS",0,1,0,1,0,2,0,2,3,0,0,5,"A","N","2011-03-19","201103190TOR"
"TOR",0,2,3,0,0,5,0,1,0,1,0,2,"H","N","2011-03-19","201103190TOR"
"ANA",1,3,0,1,0,5,0,1,2,1,0,4,"H","N","2011-03-20","201103200ANA"
"CGY",0,1,2,1,0,4,1,3,0,1,0,5,"A","N","2011-03-20","201103200ANA"
"BUF",0,0,3,0,0,3,1,1,0,2,0,4,"H","N","2011-03-20","201103200BUF"
"NSH",1,1,0,2,0,4,0,0,3,0,0,3,"A","N","2011-03-20","201103200BUF"
"CBJ",0,0,0,0,0,0,0,1,1,1,0,3,"H","N","2011-03-20","201103200CBJ"
"NJD",0,1,1,1,0,3,0,0,0,0,0,0,"A","N","2011-03-20","201103200CBJ"
"MIN",0,0,0,1,0,1,0,2,4,2,0,8,"H","N","2011-03-20","201103200MIN"
"MTL",0,2,4,2,0,8,0,0,0,1,0,1,"A","N","2011-03-20","201103200MIN"
"CHI",0,1,0,1,0,2,0,0,1,0,0,1,"A","N","2011-03-20","201103200PHX"
"PHX",0,0,1,0,0,1,0,1,0,1,0,2,"H","N","2011-03-20","201103200PHX"
"NYR",0,1,0,4,0,5,0,1,0,1,0,2,"A","N","2011-03-20","201103200PIT"
"PIT",0,1,0,1,0,2,0,1,0,4,0,5,"H","N","2011-03-20","201103200PIT"
"DET",0,0,1,3,0,4,0,2,2,0,1,5,"H","Y","2011-03-21","201103210DET"
"PIT",0,2,2,0,1,5,0,0,1,3,0,4,"A","Y","2011-03-21","201103210DET"
"CGY",0,0,0,1,0,1,0,0,0,1,1,2,"A","Y","2011-03-21","201103210LAK"
"LAK",0,0,0,1,1,2,0,0,0,1,0,1,"H","Y","2011-03-21","201103210LAK"
"BOS",0,1,1,2,0,4,0,1,0,0,0,1,"H","N","2011-03-22","201103220BOS"
"NJD",0,1,0,0,0,1,0,1,1,2,0,4,"A","N","2011-03-22","201103220BOS"
"CAR",0,2,1,1,0,4,0,2,0,1,0,3,"H","N","2011-03-22","201103220CAR"
"OTT",0,2,0,1,0,3,0,2,1,1,0,4,"A","N","2011-03-22","201103220CAR"
"CBJ",0,1,1,2,0,4,0,1,0,3,1,5,"A","Y","2011-03-22","201103220COL"
"COL",0,1,0,3,1,5,0,1,1,2,0,4,"H","Y","2011-03-22","201103220COL"
"MIN",0,0,0,0,0,0,0,1,1,1,0,3,"H","N","2011-03-22","201103220MIN"
"TOR",0,1,1,1,0,3,0,0,0,0,0,0,"A","N","2011-03-22","201103220MIN"
"BUF",0,0,1,1,0,2,0,0,0,0,0,0,"A","N","2011-03-22","201103220MTL"
"MTL",0,0,0,0,0,0,0,0,1,1,0,2,"H","N","2011-03-22","201103220MTL"
"EDM",0,0,1,0,0,1,0,2,1,0,0,3,"A","N","2011-03-22","201103220NSH"
"NSH",0,2,1,0,0,3,0,0,1,0,0,1,"H","N","2011-03-22","201103220NSH"
"FLA",0,0,0,0,0,0,0,0,0,1,0,1,"A","N","2011-03-22","201103220NYR"
"NYR",0,0,0,1,0,1,0,0,0,0,0,0,"H","N","2011-03-22","201103220NYR"
"PHI",0,0,2,2,0,4,0,2,1,1,1,5,"H","Y","2011-03-22","201103220PHI"
"WSH",0,2,1,1,1,5,0,0,2,2,0,4,"A","Y","2011-03-22","201103220PHI"
"PHX",0,0,2,0,0,2,0,1,0,0,0,1,"H","N","2011-03-22","201103220PHX"
"STL",0,1,0,0,0,1,0,0,2,0,0,2,"A","N","2011-03-22","201103220PHX"
"NYI",0,1,2,2,0,5,0,1,0,1,0,2,"A","N","2011-03-22","201103220TBL"
"TBL",0,1,0,1,0,2,0,1,2,2,0,5,"H","N","2011-03-22","201103220TBL"
"CHI",0,0,1,3,0,4,0,0,0,0,0,0,"H","N","2011-03-23","201103230CHI"
"FLA",0,0,0,0,0,0,0,0,1,3,0,4,"A","N","2011-03-23","201103230CHI"
"ANA",1,0,1,2,0,4,0,0,1,2,0,3,"A","N","2011-03-23","201103230DAL"
"DAL",0,0,1,2,0,3,1,0,1,2,0,4,"H","N","2011-03-23","201103230DAL"
"DET",0,0,0,1,0,1,0,0,1,1,0,2,"H","N","2011-03-23","201103230DET"
"VAN",0,0,1,1,0,2,0,0,0,1,0,1,"A","N","2011-03-23","201103230DET"
"CGY",0,2,1,0,0,3,0,4,1,1,0,6,"A","N","2011-03-23","201103230SJS"
"SJS",0,4,1,1,0,6,0,2,1,0,0,3,"H","N","2011-03-23","201103230SJS"
"BOS",0,3,0,4,0,7,0,0,0,0,0,0,"H","N","2011-03-24","201103240BOS"
"MTL",0,0,0,0,0,0,0,3,0,4,0,7,"A","N","2011-03-24","201103240BOS"
"COL",0,1,1,1,0,3,0,2,1,1,0,4,"H","N","2011-03-24","201103240COL"
"TOR",0,2,1,1,0,4,0,1,1,1,0,3,"A","N","2011-03-24","201103240COL"
"LAK",0,0,2,1,1,4,0,0,1,2,0,3,"H","Y","2011-03-24","201103240LAK"
"SJS",0,0,1,2,0,3,0,0,2,1,1,4,"A","Y","2011-03-24","201103240LAK"
"ANA",0,1,0,3,0,4,0,3,1,1,0,5,"A","N","2011-03-24","201103240NSH"
"NSH",0,3,1,1,0,5,0,1,0,3,0,4,"H","N","2011-03-24","201103240NSH"
"ATL",0,1,1,0,0,2,0,0,1,0,0,1,"A","N","2011-03-24","201103240NYI"
"NYI",0,0,1,0,0,1,0,1,1,0,0,2,"H","N","2011-03-24","201103240NYI"
"NYR",0,0,0,1,0,1,0,0,1,0,1,2,"H","Y","2011-03-24","201103240NYR"
"OTT",0,0,1,0,1,2,0,0,0,1,0,1,"A","Y","2011-03-24","201103240NYR"
"PHI",0,1,0,0,0,1,0,0,1,0,1,2,"H","Y","2011-03-24","201103240PHI"
"PIT",0,0,1,0,1,2,0,1,0,0,0,1,"A","Y","2011-03-24","201103240PHI"
"CBJ",0,0,0,0,0,0,0,0,2,1,0,3,"A","N","2011-03-24","201103240PHX"
"PHX",0,0,2,1,0,3,0,0,0,0,0,0,"H","N","2011-03-24","201103240PHX"
"EDM",0,0,0,0,0,0,0,0,1,3,0,4,"A","N","2011-03-24","201103240STL"
"STL",0,0,1,3,0,4,0,0,0,0,0,0,"H","N","2011-03-24","201103240STL"
"ATL",0,0,0,1,0,1,0,0,2,1,0,3,"H","N","2011-03-25","201103250ATL"
"VAN",0,0,2,1,0,3,0,0,0,1,0,1,"A","N","2011-03-25","201103250ATL"
"BUF",0,1,1,2,0,4,0,1,0,1,0,2,"H","N","2011-03-25","201103250BUF"
"FLA",0,1,0,1,0,2,0,1,1,2,0,4,"A","N","2011-03-25","201103250BUF"
"OTT",0,0,1,1,0,2,0,0,0,0,0,0,"H","N","2011-03-25","201103250OTT"
"WSH",0,0,0,0,0,0,0,0,1,1,0,2,"A","N","2011-03-25","201103250OTT"
"NJD",0,0,0,0,0,0,0,0,0,0,1,1,"A","Y","2011-03-25","201103250PIT"
"PIT",0,0,0,0,1,1,0,0,0,0,0,0,"H","Y","2011-03-25","201103250PIT"
"CAR",0,1,1,2,0,4,0,1,0,2,0,3,"A","N","2011-03-25","201103250TBL"
"TBL",0,1,0,2,0,3,0,1,1,2,0,4,"H","N","2011-03-25","201103250TBL"
"BOS",0,0,0,0,0,0,0,1,0,0,0,1,"H","N","2011-03-26","201103260BOS"
"NYR",0,1,0,0,0,1,0,0,0,0,0,0,"A","N","2011-03-26","201103260BOS"
"BUF",0,2,0,0,0,2,0,0,0,0,0,0,"H","N","2011-03-26","201103260BUF"
"NJD",0,0,0,0,0,0,0,2,0,0,0,2,"A","N","2011-03-26","201103260BUF"
"CAR",0,2,0,0,0,2,0,2,1,1,0,4,"H","N","2011-03-26","201103260CAR"
"TBL",0,2,1,1,0,4,0,2,0,0,0,2,"A","N","2011-03-26","201103260CAR"
"ANA",0,0,0,2,0,2,0,1,0,0,0,1,"A","N","2011-03-26","201103260CHI"
"CHI",0,1,0,0,0,1,0,0,0,2,0,2,"H","N","2011-03-26","201103260CHI"
"DET",0,1,1,2,0,4,0,1,0,1,0,2,"H","N","2011-03-26","201103260DET"
"TOR",0,1,0,1,0,2,0,1,1,2,0,4,"A","N","2011-03-26","201103260DET"
"CGY",0,0,1,3,1,5,0,1,2,1,0,4,"A","Y","2011-03-26","201103260EDM"
"EDM",0,1,2,1,0,4,0,0,1,3,1,5,"H","Y","2011-03-26","201103260EDM"
"COL",0,0,1,0,0,1,0,2,0,2,0,4,"A","N","2011-03-26","201103260LAK"
"LAK",0,2,0,2,0,4,0,0,1,0,0,1,"H","N","2011-03-26","201103260LAK"
"MIN",0,2,0,1,0,3,0,2,2,2,0,6,"H","N","2011-03-26","201103260MIN"
"STL",0,2,2,2,0,6,0,2,0,1,0,3,"A","N","2011-03-26","201103260MIN"
"MTL",0,0,0,0,0,0,0,1,0,1,0,2,"H","N","2011-03-26","201103260MTL"
"WSH",0,1,0,1,0,2,0,0,0,0,0,0,"A","N","2011-03-26","201103260MTL"
"DAL",0,1,1,0,0,2,0,1,2,1,0,4,"A","N","2011-03-26","201103260NSH"
"NSH",0,1,2,1,0,4,0,1,1,0,0,2,"H","N","2011-03-26","201103260NSH"
"NYI",0,1,0,0,0,1,0,3,0,1,0,4,"H","N","2011-03-26","201103260NYI"
"PHI",0,3,0,1,0,4,0,1,0,0,0,1,"A","N","2011-03-26","201103260NYI"
"PHX",0,1,0,0,0,1,0,1,2,1,0,4,"H","N","2011-03-26","201103260PHX"
"SJS",0,1,2,1,0,4,0,1,0,0,0,1,"A","N","2011-03-26","201103260PHX"
"ATL",0,1,2,1,1,5,0,1,1,2,0,4,"H","Y","2011-03-27","201103270ATL"
"OTT",0,1,1,2,0,4,0,1,2,1,1,5,"A","Y","2011-03-27","201103270ATL"
"CBJ",0,0,0,1,0,1,0,1,0,3,0,4,"H","N","2011-03-27","201103270CBJ"
"VAN",0,1,0,3,0,4,0,0,0,1,0,1,"A","N","2011-03-27","201103270CBJ"
"BOS",0,0,1,1,0,2,0,1,0,0,0,1,"A","N","2011-03-27","201103270PHI"
"PHI",0,1,0,0,0,1,0,0,1,1,0,2,"H","N","2011-03-27","201103270PHI"
"FLA",0,0,1,0,0,1,0,0,1,0,1,2,"A","Y","2011-03-27","201103270PIT"
"PIT",0,0,1,0,1,2,0,0,1,0,0,1,"H","Y","2011-03-27","201103270PIT"
"ANA",0,0,3,2,0,5,0,2,1,1,0,4,"H","N","2011-03-28","201103280ANA"
"COL",0,2,1,1,0,4,0,0,3,2,0,5,"A","N","2011-03-28","201103280ANA"
"CHI",1,2,0,0,0,3,0,1,0,1,0,2,"A","N","2011-03-28","201103280DET"
"DET",0,1,0,1,0,2,1,2,0,0,0,3,"H","N","2011-03-28","201103280DET"
"BOS",0,0,2,1,0,3,0,0,0,0,0,0,"H","N","2011-03-29","201103290BOS"
"CHI",0,0,0,0,0,0,0,0,2,1,0,3,"A","N","2011-03-29","201103290BOS"
"CBJ",0,1,1,0,1,3,0,0,1,1,0,2,"H","Y","2011-03-29","201103290CBJ"
"FLA",0,0,1,1,0,2,0,1,1,0,1,3,"A","Y","2011-03-29","201103290CBJ"
"EDM",0,0,0,0,0,0,0,0,2,0,0,2,"H","N","2011-03-29","201103290EDM"
"LAK",0,0,2,0,0,2,0,0,0,0,0,0,"A","N","2011-03-29","201103290EDM"
"ATL",0,0,0,1,0,1,0,2,0,1,0,3,"A","N","2011-03-29","201103290MTL"
"MTL",0,2,0,1,0,3,0,0,0,1,0,1,"H","N","2011-03-29","201103290MTL"
"NSH",0,0,1,0,0,1,0,0,0,3,0,3,"H","N","2011-03-29","201103290NSH"
"VAN",0,0,0,3,0,3,0,0,1,0,0,1,"A","N","2011-03-29","201103290NSH"
"DAL",0,0,1,0,0,1,0,0,1,0,1,2,"A","Y","2011-03-29","201103290PHX"
"PHX",0,0,1,0,1,2,0,0,1,0,0,1,"H","Y","2011-03-29","201103290PHX"
"PHI",0,1,2,2,0,5,0,1,1,0,0,2,"A","N","2011-03-29","201103290PIT"
"PIT",0,1,1,0,0,2,0,1,2,2,0,5,"H","N","2011-03-29","201103290PIT"
"MIN",0,1,0,1,1,3,0,1,0,1,0,2,"A","Y","2011-03-29","201103290STL"
"STL",0,1,0,1,0,2,0,1,0,1,1,3,"H","Y","2011-03-29","201103290STL"
"OTT",0,0,0,2,0,2,0,0,2,3,0,5,"A","N","2011-03-29","201103290TBL"
"TBL",0,0,2,3,0,5,0,0,0,2,0,2,"H","N","2011-03-29","201103290TBL"
"BUF",0,1,2,0,0,3,0,2,2,0,0,4,"A","N","2011-03-29","201103290TOR"
"TOR",0,2,2,0,0,4,0,1,2,0,0,3,"H","N","2011-03-29","201103290TOR"
"CAR",0,0,1,1,1,3,0,0,2,0,0,2,"A","Y","2011-03-29","201103290WSH"
"WSH",0,0,2,0,0,2,0,0,1,1,1,3,"H","Y","2011-03-29","201103290WSH"
"BUF",0,0,1,0,0,1,0,0,0,0,0,0,"H","N","2011-03-30","201103300BUF"
"NYR",0,0,0,0,0,0,0,0,1,0,0,1,"A","N","2011-03-30","201103300BUF"
"CAR",0,2,2,2,0,6,0,0,1,1,0,2,"H","N","2011-03-30","201103300CAR"
"MTL",0,0,1,1,0,2,0,2,2,2,0,6,"A","N","2011-03-30","201103300CAR"
"ANA",0,2,1,1,0,4,0,1,0,1,0,2,"A","N","2011-03-30","201103300CGY"
"CGY",0,1,0,1,0,2,0,2,1,1,0,4,"H","N","2011-03-30","201103300CGY"
"DET",0,2,1,0,0,3,0,3,5,2,0,10,"H","N","2011-03-30","201103300DET"
"STL",0,3,5,2,0,10,0,2,1,0,0,3,"A","N","2011-03-30","201103300DET"
"NJD",0,1,1,1,0,3,0,0,0,2,0,2,"H","N","2011-03-30","201103300NJD"
"NYI",0,0,0,2,0,2,0,1,1,1,0,3,"A","N","2011-03-30","201103300NJD"
"BOS",0,0,3,0,0,3,0,1,1,1,1,4,"H","Y","2011-03-31","201103310BOS"
"TOR",0,1,1,1,1,4,0,0,3,0,0,3,"A","Y","2011-03-31","201103310BOS"
"COL",0,0,0,2,0,2,0,1,1,1,0,3,"H","N","2011-03-31","201103310COL"
"NSH",0,1,1,1,0,3,0,0,0,2,0,2,"A","N","2011-03-31","201103310COL"
"FLA",0,0,1,0,0,1,0,1,3,0,0,4,"H","N","2011-03-31","201103310FLA"
"OTT",0,1,3,0,0,4,0,0,1,0,0,1,"A","N","2011-03-31","201103310FLA"
"EDM",0,0,1,1,0,2,0,2,2,0,0,4,"A","N","2011-03-31","201103310MIN"
"MIN",0,2,2,0,0,4,0,0,1,1,0,2,"H","N","2011-03-31","201103310MIN"
"NYI",0,0,4,2,0,6,0,1,0,1,0,2,"H","N","2011-03-31","201103310NYI"
"NYR",0,1,0,1,0,2,0,0,4,2,0,6,"A","N","2011-03-31","201103310NYI"
"ATL",0,0,0,1,0,1,0,0,0,0,0,0,"A","N","2011-03-31","201103310PHI"
"PHI",0,0,0,0,0,0,0,0,0,1,0,1,"H","N","2011-03-31","201103310PHI"
"DAL",0,0,0,0,0,0,0,1,2,3,0,6,"A","N","2011-03-31","201103310SJS"
"SJS",0,1,2,3,0,6,0,0,0,0,0,0,"H","N","2011-03-31","201103310SJS"
"PIT",0,0,0,1,0,1,0,2,0,0,0,2,"A","N","2011-03-31","201103310TBL"
"TBL",0,2,0,0,0,2,0,0,0,1,0,1,"H","N","2011-03-31","201103310TBL"
"LAK",0,1,0,0,0,1,0,0,2,1,0,3,"A","N","2011-03-31","201103310VAN"
"VAN",0,0,2,1,0,3,0,1,0,0,0,1,"H","N","2011-03-31","201103310VAN"
"CBJ",0,0,2,1,0,3,1,1,2,0,0,4,"A","N","2011-03-31","201103310WSH"
"WSH",1,1,2,0,0,4,0,0,2,1,0,3,"H","N","2011-03-31","201103310WSH"
"CBJ",0,1,1,1,0,3,0,2,0,1,1,4,"H","Y","2011-04-01","201104010CBJ"
"CHI",0,2,0,1,1,4,0,1,1,1,0,3,"A","Y","2011-04-01","201104010CBJ"
"NJD",0,0,2,2,0,4,0,1,0,1,0,2,"H","N","2011-04-01","201104010NJD"
"PHI",0,1,0,1,0,2,0,0,2,2,0,4,"A","N","2011-04-01","201104010NJD"
"COL",0,1,1,1,1,4,0,0,1,2,0,3,"A","Y","2011-04-01","201104010PHX"
"PHX",0,0,1,2,0,3,0,1,1,1,1,4,"H","Y","2011-04-01","201104010PHX"
"CGY",0,0,1,2,0,3,0,1,1,0,0,2,"A","N","2011-04-01","201104010STL"
"STL",0,1,1,0,0,2,0,0,1,2,0,3,"H","N","2011-04-01","201104010STL"
"ATL",0,1,1,0,0,2,0,1,1,1,0,3,"A","N","2011-04-02","201104020BOS"
"BOS",0,1,1,1,0,3,0,1,1,0,0,2,"H","N","2011-04-02","201104020BOS"
"FLA",0,2,0,0,0,2,0,1,1,2,0,4,"H","N","2011-04-02","201104020FLA"
"PIT",0,1,1,2,0,4,0,2,0,0,0,2,"A","N","2011-04-02","201104020FLA"
"DAL",0,0,1,0,0,1,0,0,1,2,0,3,"A","N","2011-04-02","201104020LAK"
"LAK",0,0,1,2,0,3,0,0,1,0,0,1,"H","N","2011-04-02","201104020LAK"
"MIN",0,1,0,0,0,1,0,0,2,1,0,3,"H","N","2011-04-02","201104020MIN"
"TBL",0,0,2,1,0,3,0,1,0,0,0,1,"A","N","2011-04-02","201104020MIN"
"MTL",0,1,0,2,0,3,0,0,0,1,0,1,"A","N","2011-04-02","201104020NJD"
"NJD",0,0,0,1,0,1,0,1,0,2,0,3,"H","N","2011-04-02","201104020NJD"
"DET",1,0,2,1,0,4,0,1,2,0,0,3,"A","N","2011-04-02","201104020NSH"
"NSH",0,1,2,0,0,3,1,0,2,1,0,4,"H","N","2011-04-02","201104020NSH"
"CAR",0,1,0,3,0,4,0,1,1,0,0,2,"A","N","2011-04-02","201104020NYI"
"NYI",0,1,1,0,0,2,0,1,0,3,0,4,"H","N","2011-04-02","201104020NYI"
"OTT",0,0,1,1,0,2,0,1,1,2,0,4,"H","N","2011-04-02","201104020OTT"
"TOR",0,1,1,2,0,4,0,0,1,1,0,2,"A","N","2011-04-02","201104020OTT"
"ANA",0,2,0,0,0,2,0,0,2,2,0,4,"A","N","2011-04-02","201104020SJS"
"SJS",0,0,2,2,0,4,0,2,0,0,0,2,"H","N","2011-04-02","201104020SJS"
"EDM",0,1,2,1,0,4,0,0,1,0,0,1,"A","N","2011-04-02","201104020VAN"
"VAN",0,0,1,0,0,1,0,1,2,1,0,4,"H","N","2011-04-02","201104020VAN"
"BUF",0,2,0,2,0,4,1,2,0,2,0,5,"A","N","2011-04-02","201104020WSH"
"WSH",1,2,0,2,0,5,0,2,0,2,0,4,"H","N","2011-04-02","201104020WSH"
"ANA",0,2,1,0,0,3,0,2,2,0,0,4,"H","N","2011-04-03","201104030ANA"
"DAL",0,2,2,0,0,4,0,2,1,0,0,3,"A","N","2011-04-03","201104030ANA"
"BUF",1,1,0,0,0,2,0,0,1,0,0,1,"A","N","2011-04-03","201104030CAR"
"CAR",0,0,1,0,0,1,1,1,0,0,0,2,"H","N","2011-04-03","201104030CAR"
"CBJ",0,1,0,0,0,1,0,2,2,2,0,6,"H","N","2011-04-03","201104030CBJ"
"STL",0,2,2,2,0,6,0,1,0,0,0,1,"A","N","2011-04-03","201104030CBJ"
"CHI",0,0,0,0,0,0,0,1,0,1,0,2,"H","N","2011-04-03","201104030CHI"
"TBL",0,1,0,1,0,2,0,0,0,0,0,0,"A","N","2011-04-03","201104030CHI"
"CGY",0,0,1,1,0,2,0,0,0,1,0,1,"A","N","2011-04-03","201104030COL"
"COL",0,0,0,1,0,1,0,0,1,1,0,2,"H","N","2011-04-03","201104030COL"
"DET",0,2,1,1,0,4,0,0,1,1,0,2,"H","N","2011-04-03","201104030DET"
"MIN",0,0,1,1,0,2,0,2,1,1,0,4,"A","N","2011-04-03","201104030DET"
"NYR",0,1,1,0,1,3,0,1,0,1,0,2,"A","Y","2011-04-03","201104030PHI"
"PHI",0,1,0,1,0,2,0,1,1,0,1,3,"H","Y","2011-04-03","201104030PHI"
"BOS",0,2,1,0,0,3,0,0,2,3,0,5,"A","N","2011-04-04","201104040NYR"
"NYR",0,0,2,3,0,5,0,2,1,0,0,3,"H","N","2011-04-04","201104040NYR"
"LAK",0,0,1,0,0,1,0,2,4,0,0,6,"A","N","2011-04-04","201104040SJS"
"SJS",0,2,4,0,0,6,0,0,1,0,0,1,"H","N","2011-04-04","201104040SJS"
"BUF",0,1,2,1,0,4,0,1,0,1,0,2,"H","N","2011-04-05","201104050BUF"
"TBL",0,1,0,1,0,2,0,1,2,1,0,4,"A","N","2011-04-05","201104050BUF"
"CBJ",0,0,0,0,0,0,0,1,0,2,0,3,"A","N","2011-04-05","201104050DAL"
"DAL",0,1,0,2,0,3,0,0,0,0,0,0,"H","N","2011-04-05","201104050DAL"
"EDM",0,1,0,1,0,2,0,0,0,0,0,0,"H","N","2011-04-05","201104050EDM"
"VAN",0,0,0,0,0,0,0,1,0,1,0,2,"A","N","2011-04-05","201104050EDM"
"CHI",0,0,1,0,0,1,1,0,1,0,0,2,"A","N","2011-04-05","201104050MTL"
"MTL",1,0,1,0,0,2,0,0,1,0,0,1,"H","N","2011-04-05","201104050MTL"
"ATL",0,0,0,3,0,3,0,3,1,2,0,6,"A","N","2011-04-05","201104050NSH"
"NSH",0,3,1,2,0,6,0,0,0,3,0,3,"H","N","2011-04-05","201104050NSH"
"OTT",0,1,2,2,0,5,0,1,1,0,0,2,"H","N","2011-04-05","201104050OTT"
"PHI",0,1,1,0,0,2,0,1,2,2,0,5,"A","N","2011-04-05","201104050OTT"
"NJD",0,0,1,1,0,2,0,1,1,2,0,4,"A","N","2011-04-05","201104050PIT"
"PIT",0,1,1,2,0,4,0,0,1,1,0,2,"H","N","2011-04-05","201104050PIT"
"COL",0,1,0,0,0,1,0,1,1,1,0,3,"A","N","2011-04-05","201104050STL"
"STL",0,1,1,1,0,3,0,1,0,0,0,1,"H","N","2011-04-05","201104050STL"
"TOR",0,1,1,0,0,2,0,1,1,0,1,3,"H","Y","2011-04-05","201104050TOR"
"WSH",0,1,1,0,1,3,0,1,1,0,0,2,"A","Y","2011-04-05","201104050TOR"
"ANA",0,2,4,0,0,6,0,0,1,1,0,2,"H","N","2011-04-06","201104060ANA"
"SJS",0,0,1,1,0,2,0,2,4,0,0,6,"A","N","2011-04-06","201104060ANA"
"BOS",0,1,2,0,0,3,0,0,2,0,0,2,"H","N","2011-04-06","201104060BOS"
"NYI",0,0,2,0,0,2,0,1,2,0,0,3,"A","N","2011-04-06","201104060BOS"
"CAR",0,0,2,1,0,3,0,0,0,0,0,0,"H","N","2011-04-06","201104060CAR"
"DET",0,0,0,0,0,0,0,0,2,1,0,3,"A","N","2011-04-06","201104060CAR"
"CGY",0,0,3,3,0,6,0,0,0,1,0,1,"H","N","2011-04-06","201104060CGY"
"EDM",0,0,0,1,0,1,0,0,3,3,0,6,"A","N","2011-04-06","201104060CGY"
"CHI",1,0,3,0,0,4,0,1,1,1,0,3,"H","N","2011-04-06","201104060CHI"
"STL",0,1,1,1,0,3,1,0,3,0,0,4,"A","N","2011-04-06","201104060CHI"
"LAK",0,1,1,0,1,3,0,2,0,0,0,2,"H","Y","2011-04-06","201104060LAK"
"PHX",0,2,0,0,0,2,0,1,1,0,1,3,"A","Y","2011-04-06","201104060LAK"
"NJD",0,1,2,1,0,4,0,0,0,2,0,2,"H","N","2011-04-06","201104060NJD"
"TOR",0,0,0,2,0,2,0,1,2,1,0,4,"A","N","2011-04-06","201104060NJD"
"FLA",0,0,0,2,0,2,0,2,1,2,0,5,"A","N","2011-04-06","201104060WSH"
"WSH",0,2,1,2,0,5,0,0,0,2,0,2,"H","N","2011-04-06","201104060WSH"
"COL",0,0,1,1,0,2,0,2,0,2,0,4,"A","N","2011-04-07","201104070DAL"
"DAL",0,2,0,2,0,4,0,0,1,1,0,2,"H","N","2011-04-07","201104070DAL"
"ATL",0,0,2,1,0,3,0,0,0,0,0,0,"A","N","2011-04-07","201104070NYR"
"NYR",0,0,0,0,0,0,0,0,2,1,0,3,"H","N","2011-04-07","201104070NYR"
"MTL",0,0,1,1,0,2,1,0,0,2,0,3,"A","N","2011-04-07","201104070OTT"
"OTT",1,0,0,2,0,3,0,0,1,1,0,2,"H","N","2011-04-07","201104070OTT"
"MIN",0,0,0,0,0,0,0,2,2,1,0,5,"A","N","2011-04-07","201104070VAN"
"VAN",0,2,2,1,0,5,0,0,0,0,0,0,"H","N","2011-04-07","201104070VAN"
"ANA",0,0,1,1,0,2,0,1,0,0,0,1,"H","N","2011-04-08","201104080ANA"
"LAK",0,1,0,0,0,1,0,0,1,1,0,2,"A","N","2011-04-08","201104080ANA"
"ATL",0,0,0,1,0,1,0,2,1,3,0,6,"H","N","2011-04-08","201104080ATL"
"CAR",0,2,1,3,0,6,0,0,0,1,0,1,"A","N","2011-04-08","201104080ATL"
"BUF",1,0,2,1,0,4,0,1,2,0,0,3,"H","N","2011-04-08","201104080BUF"
"PHI",0,1,2,0,0,3,1,0,2,1,0,4,"A","N","2011-04-08","201104080BUF"
"COL",0,0,1,1,0,2,0,1,1,1,0,3,"H","N","2011-04-08","201104080COL"
"DAL",0,1,1,1,0,3,0,0,1,1,0,2,"A","N","2011-04-08","201104080COL"
"CHI",0,3,1,0,0,4,0,0,1,1,0,2,"A","N","2011-04-08","201104080DET"
"DET",0,0,1,1,0,2,0,3,1,0,0,4,"H","N","2011-04-08","201104080DET"
"EDM",0,0,1,0,0,1,0,1,1,1,0,3,"H","N","2011-04-08","201104080EDM"
"MIN",0,1,1,1,0,3,0,0,1,0,0,1,"A","N","2011-04-08","201104080EDM"
"CBJ",0,0,1,0,0,1,0,1,2,1,0,4,"A","N","2011-04-08","201104080NSH"
"NSH",0,1,2,1,0,4,0,0,1,0,0,1,"H","N","2011-04-08","201104080NSH"
"NYI",0,0,1,2,0,3,0,1,1,1,1,4,"H","Y","2011-04-08","201104080NYI"
"PIT",0,1,1,1,1,4,0,0,1,2,0,3,"A","Y","2011-04-08","201104080NYI"
"PHX",0,1,2,1,0,4,0,0,1,2,0,3,"H","N","2011-04-08","201104080PHX"
"SJS",0,0,1,2,0,3,0,1,2,1,0,4,"A","N","2011-04-08","201104080PHX"
"FLA",0,1,0,1,0,2,0,2,2,0,0,4,"A","N","2011-04-08","201104080TBL"
"TBL",0,2,2,0,0,4,0,1,0,1,0,2,"H","N","2011-04-08","201104080TBL"
"BOS",0,1,1,1,0,3,0,1,0,0,0,1,"H","N","2011-04-09","201104090BOS"
"OTT",0,1,0,0,0,1,0,1,1,1,0,3,"A","N","2011-04-09","201104090BOS"
"CAR",0,0,1,1,0,2,0,3,1,2,0,6,"H","N","2011-04-09","201104090CAR"
"TBL",0,3,1,2,0,6,0,0,1,1,0,2,"A","N","2011-04-09","201104090CAR"
"BUF",0,0,3,2,0,5,0,0,2,2,0,4,"A","N","2011-04-09","201104090CBJ"
"CBJ",0,0,2,2,0,4,0,0,3,2,0,5,"H","N","2011-04-09","201104090CBJ"
"CGY",0,0,2,0,0,2,1,0,0,2,0,3,"H","N","2011-04-09","201104090CGY"
"VAN",1,0,0,2,0,3,0,0,2,0,0,2,"A","N","2011-04-09","201104090CGY"
"FLA",0,0,0,1,0,1,0,0,0,0,0,0,"H","N","2011-04-09","201104090FLA"
"WSH",0,0,0,0,0,0,0,0,0,1,0,1,"A","N","2011-04-09","201104090FLA"
"ANA",0,2,1,0,0,3,0,0,1,0,0,1,"A","N","2011-04-09","201104090LAK"
"LAK",0,0,1,0,0,1,0,2,1,0,0,3,"H","N","2011-04-09","201104090LAK"
"NJD",0,2,0,0,0,2,0,1,3,1,0,5,"A","N","2011-04-09","201104090NYR"
"NYR",0,1,3,1,0,5,0,2,0,0,0,2,"H","N","2011-04-09","201104090NYR"
"NYI",0,3,1,0,0,4,0,3,2,2,0,7,"A","N","2011-04-09","201104090PHI"
"PHI",0,3,2,2,0,7,0,3,1,0,0,4,"H","N","2011-04-09","201104090PHI"
"PHX",0,0,0,1,0,1,0,0,2,1,0,3,"A","N","2011-04-09","201104090SJS"
"SJS",0,0,2,1,0,3,0,0,0,1,0,1,"H","N","2011-04-09","201104090SJS"
"NSH",0,0,0,0,0,0,0,0,1,1,0,2,"A","N","2011-04-09","201104090STL"
"STL",0,0,1,1,0,2,0,0,0,0,0,0,"H","N","2011-04-09","201104090STL"
"MTL",0,2,1,1,0,4,0,1,0,0,0,1,"A","N","2011-04-09","201104090TOR"
"TOR",0,1,0,0,0,1,0,2,1,1,0,4,"H","N","2011-04-09","201104090TOR"
"ATL",0,1,0,1,0,2,0,0,4,1,0,5,"H","N","2011-04-10","201104100ATL"
"PIT",0,0,4,1,0,5,0,1,0,1,0,2,"A","N","2011-04-10","201104100ATL"
"CHI",0,0,1,2,0,3,0,0,2,2,0,4,"H","N","2011-04-10","201104100CHI"
"DET",0,0,2,2,0,4,0,0,1,2,0,3,"A","N","2011-04-10","201104100CHI"
"COL",1,2,0,1,0,4,0,1,2,0,0,3,"H","N","2011-04-10","201104100COL"
"EDM",0,1,2,0,0,3,1,2,0,1,0,4,"A","N","2011-04-10","201104100COL"
"DAL",0,2,1,0,0,3,0,1,2,2,0,5,"A","N","2011-04-10","201104100MIN"
"MIN",0,1,2,2,0,5,0,2,1,0,0,3,"H","N","2011-04-10","201104100MIN"
"BOS",0,1,0,1,0,2,0,1,0,2,0,3,"A","N","2011-04-10","201104100NJD"
"NJD",0,1,0,2,0,3,0,1,0,1,0,2,"H","N","2011-04-10","201104100NJD"
"ANA",0,0,0,1,0,1,0,1,2,1,0,4,"H","N","2011-04-13","201104130ANA"
"NSH",0,1,2,1,0,4,0,0,0,1,0,1,"A","N","2011-04-13","201104130ANA"
"DET",0,0,3,1,0,4,0,1,0,1,0,2,"H","N","2011-04-13","201104130DET"
"PHX",0,1,0,1,0,2,0,0,3,1,0,4,"A","N","2011-04-13","201104130DET"
"PIT",0,0,0,3,0,3,0,0,0,0,0,0,"H","N","2011-04-13","201104130PIT"
"TBL",0,0,0,0,0,0,0,0,0,3,0,3,"A","N","2011-04-13","201104130PIT"
"CHI",0,0,0,0,0,0,0,2,0,0,0,2,"A","N","2011-04-13","201104130VAN"
"VAN",0,2,0,0,0,2,0,0,0,0,0,0,"H","N","2011-04-13","201104130VAN"
"NYR",0,0,0,1,0,1,1,0,0,1,0,2,"A","N","2011-04-13","201104130WSH"
"WSH",1,0,0,1,0,2,0,0,0,1,0,1,"H","N","2011-04-13","201104130WSH"
"BOS",0,0,0,0,0,0,0,1,0,1,0,2,"H","N","2011-04-14","201104140BOS"
"MTL",0,1,0,1,0,2,0,0,0,0,0,0,"A","N","2011-04-14","201104140BOS"
"BUF",0,0,0,1,0,1,0,0,0,0,0,0,"A","N","2011-04-14","201104140PHI"
"PHI",0,0,0,0,0,0,0,0,0,1,0,1,"H","N","2011-04-14","201104140PHI"
"LAK",0,0,2,0,0,2,1,1,1,0,0,3,"A","N","2011-04-14","201104140SJS"
"SJS",1,1,1,0,0,3,0,0,2,0,0,2,"H","N","2011-04-14","201104140SJS"
"ANA",0,2,2,1,0,5,0,0,1,2,0,3,"H","N","2011-04-15","201104150ANA"
"NSH",0,0,1,2,0,3,0,2,2,1,0,5,"A","N","2011-04-15","201104150ANA"
"PIT",0,0,1,0,0,1,0,3,1,1,0,5,"H","N","2011-04-15","201104150PIT"
"TBL",0,3,1,1,0,5,0,0,1,0,0,1,"A","N","2011-04-15","201104150PIT"
"CHI",0,0,1,2,0,3,0,1,2,1,0,4,"A","N","2011-04-15","201104150VAN"
"VAN",0,1,2,1,0,4,0,0,1,2,0,3,"H","N","2011-04-15","201104150VAN"
"NYR",0,0,0,0,0,0,0,0,2,0,0,2,"A","N","2011-04-15","201104150WSH"
"WSH",0,0,2,0,0,2,0,0,0,0,0,0,"H","N","2011-04-15","201104150WSH"
"BOS",0,0,1,0,0,1,0,2,1,0,0,3,"H","N","2011-04-16","201104160BOS"
"MTL",0,2,1,0,0,3,0,0,1,0,0,1,"A","N","2011-04-16","201104160BOS"
"DET",0,3,1,0,0,4,0,0,1,2,0,3,"H","N","2011-04-16","201104160DET"
"PHX",0,0,1,2,0,3,0,3,1,0,0,4,"A","N","2011-04-16","201104160DET"
"BUF",0,3,0,1,0,4,0,3,2,0,0,5,"A","N","2011-04-16","201104160PHI"
"PHI",0,3,2,0,0,5,0,3,0,1,0,4,"H","N","2011-04-16","201104160PHI"
"LAK",0,2,1,1,0,4,0,0,0,0,0,0,"A","N","2011-04-16","201104160SJS"
"SJS",0,0,0,0,0,0,0,2,1,1,0,4,"H","N","2011-04-16","201104160SJS"
"CHI",0,1,1,0,0,2,0,0,2,1,0,3,"H","N","2011-04-17","201104170CHI"
"VAN",0,0,2,1,0,3,0,1,1,0,0,2,"A","N","2011-04-17","201104170CHI"
"ANA",0,0,2,1,0,3,0,2,0,2,0,4,"A","N","2011-04-17","201104170NSH"
"NSH",0,2,0,2,0,4,0,0,2,1,0,3,"H","N","2011-04-17","201104170NSH"
"NYR",0,0,1,2,0,3,0,0,1,1,0,2,"H","N","2011-04-17","201104170NYR"
"WSH",0,0,1,1,0,2,0,0,1,2,0,3,"A","N","2011-04-17","201104170NYR"
"BUF",0,1,1,0,0,2,0,1,2,1,0,4,"H","N","2011-04-18","201104180BUF"
"PHI",0,1,2,1,0,4,0,1,1,0,0,2,"A","N","2011-04-18","201104180BUF"
"BOS",0,2,1,1,0,4,0,0,1,1,0,2,"A","N","2011-04-18","201104180MTL"
"MTL",0,0,1,1,0,2,0,2,1,1,0,4,"H","N","2011-04-18","201104180MTL"
"DET",0,2,1,1,0,4,0,0,1,1,0,2,"A","N","2011-04-18","201104180PHX"
"PHX",0,0,1,1,0,2,0,2,1,1,0,4,"H","N","2011-04-18","201104180PHX"
"PIT",0,2,0,1,0,3,0,1,0,1,0,2,"A","N","2011-04-18","201104180TBL"
"TBL",0,1,0,1,0,2,0,2,0,1,0,3,"H","N","2011-04-18","201104180TBL"
"CHI",0,1,4,2,0,7,0,1,0,1,0,2,"H","N","2011-04-19","201104190CHI"
"VAN",0,1,0,1,0,2,0,1,4,2,0,7,"A","N","2011-04-19","201104190CHI"
"LAK",0,3,2,0,0,5,1,0,5,0,0,6,"H","N","2011-04-19","201104190LAK"
"SJS",1,0,5,0,0,6,0,3,2,0,0,5,"A","N","2011-04-19","201104190LAK"
"BUF",0,1,0,0,0,1,0,0,0,0,0,0,"H","N","2011-04-20","201104200BUF"
"PHI",0,0,0,0,0,0,0,1,0,0,0,1,"A","N","2011-04-20","201104200BUF"
"ANA",0,2,1,3,0,6,0,1,2,0,0,3,"A","N","2011-04-20","201104200NSH"
"NSH",0,1,2,0,0,3,0,2,1,3,0,6,"H","N","2011-04-20","201104200NSH"
"NYR",0,0,3,0,0,3,1,0,0,3,0,4,"H","N","2011-04-20","201104200NYR"
"WSH",1,0,0,3,0,4,0,0,3,0,0,3,"A","N","2011-04-20","201104200NYR"
"DET",0,2,1,3,0,6,0,2,1,0,0,3,"A","N","2011-04-20","201104200PHX"
"PHX",0,2,1,0,0,3,0,2,1,3,0,6,"H","N","2011-04-20","201104200PHX"
"PIT",1,1,1,0,0,3,0,0,1,1,0,2,"A","N","2011-04-20","201104200TBL"
"TBL",0,0,1,1,0,2,1,1,1,0,0,3,"H","N","2011-04-20","201104200TBL"
"LAK",0,0,2,1,0,3,0,0,3,3,0,6,"H","N","2011-04-21","201104210LAK"
"SJS",0,0,3,3,0,6,0,0,2,1,0,3,"A","N","2011-04-21","201104210LAK"
"BOS",1,0,3,1,0,5,0,1,2,1,0,4,"A","N","2011-04-21","201104210MTL"
"MTL",0,1,2,1,0,4,1,0,3,1,0,5,"H","N","2011-04-21","201104210MTL"
"CHI",0,3,2,0,0,5,0,0,0,0,0,0,"A","N","2011-04-21","201104210VAN"
"VAN",0,0,0,0,0,0,0,3,2,0,0,5,"H","N","2011-04-21","201104210VAN"
"ANA",0,0,1,2,0,3,1,1,0,2,0,4,"H","N","2011-04-22","201104220ANA"
"NSH",1,1,0,2,0,4,0,0,1,2,0,3,"A","N","2011-04-22","201104220ANA"
"BUF",1,3,0,0,0,4,0,0,2,1,0,3,"A","N","2011-04-22","201104220PHI"
"PHI",0,0,2,1,0,3,1,3,0,0,0,4,"H","N","2011-04-22","201104220PHI"
"BOS",1,0,0,1,0,2,0,0,0,1,0,1,"H","N","2011-04-23","201104230BOS"
"MTL",0,0,0,1,0,1,1,0,0,1,0,2,"A","N","2011-04-23","201104230BOS"
"PIT",0,0,0,2,0,2,0,2,3,3,0,8,"H","N","2011-04-23","201104230PIT"
"TBL",0,2,3,3,0,8,0,0,0,2,0,2,"A","N","2011-04-23","201104230PIT"
"LAK",0,3,0,0,0,3,0,0,1,0,0,1,"A","N","2011-04-23","201104230SJS"
"SJS",0,0,1,0,0,1,0,3,0,0,0,3,"H","N","2011-04-23","201104230SJS"
"NYR",0,0,0,1,0,1,0,1,1,1,0,3,"A","N","2011-04-23","201104230WSH"
"WSH",0,1,1,1,0,3,0,0,0,1,0,1,"H","N","2011-04-23","201104230WSH"
"BUF",0,3,1,0,0,4,1,1,2,1,0,5,"H","N","2011-04-24","201104240BUF"
"PHI",1,1,2,1,0,5,0,3,1,0,0,4,"A","N","2011-04-24","201104240BUF"
"CHI",1,1,1,1,0,4,0,2,0,1,0,3,"H","N","2011-04-24","201104240CHI"
"VAN",0,2,0,1,0,3,1,1,1,1,0,4,"A","N","2011-04-24","201104240CHI"
"ANA",0,1,1,0,0,2,0,1,1,2,0,4,"A","N","2011-04-24","201104240NSH"
"NSH",0,1,1,2,0,4,0,1,1,0,0,2,"H","N","2011-04-24","201104240NSH"
"LAK",0,0,1,2,0,3,1,0,2,1,0,4,"H","N","2011-04-25","201104250LAK"
"SJS",1,0,2,1,0,4,0,0,1,2,0,3,"A","N","2011-04-25","201104250LAK"
"PIT",0,1,0,1,0,2,0,1,1,2,0,4,"A","N","2011-04-25","201104250TBL"
"TBL",0,1,1,2,0,4,0,1,0,1,0,2,"H","N","2011-04-25","201104250TBL"
"BOS",0,0,1,0,0,1,0,1,1,0,0,2,"A","N","2011-04-26","201104260MTL"
"MTL",0,1,1,0,0,2,0,0,1,0,0,1,"H","N","2011-04-26","201104260MTL"
"BUF",0,0,0,2,0,2,0,1,2,2,0,5,"A","N","2011-04-26","201104260PHI"
"PHI",0,1,2,2,0,5,0,0,0,2,0,2,"H","N","2011-04-26","201104260PHI"
"CHI",0,0,0,1,0,1,1,1,0,0,0,2,"A","N","2011-04-26","201104260VAN"
"VAN",1,1,0,0,0,2,0,0,0,1,0,1,"H","N","2011-04-26","201104260VAN"
"BOS",1,2,0,1,0,4,0,1,1,1,0,3,"H","N","2011-04-27","201104270BOS"
"MTL",0,1,1,1,0,3,1,2,0,1,0,4,"A","N","2011-04-27","201104270BOS"
"PIT",0,0,0,0,0,0,0,0,1,0,0,1,"H","N","2011-04-27","201104270PIT"
"TBL",0,0,1,0,0,1,0,0,0,0,0,0,"A","N","2011-04-27","201104270PIT"
"NSH",0,0,0,0,0,0,0,0,1,0,0,1,"A","N","2011-04-28","201104280VAN"
"VAN",0,0,1,0,0,1,0,0,0,0,0,0,"H","N","2011-04-28","201104280VAN"
"DET",0,1,0,0,0,1,1,0,0,1,0,2,"A","N","2011-04-29","201104290SJS"
"SJS",1,0,0,1,0,2,0,1,0,0,0,1,"H","N","2011-04-29","201104290SJS"
"TBL",0,1,2,1,0,4,0,1,1,0,0,2,"A","N","2011-04-29","201104290WSH"
"WSH",0,1,1,0,0,2,0,1,2,1,0,4,"H","N","2011-04-29","201104290WSH"
"BOS",0,2,3,2,0,7,0,1,1,1,0,3,"A","N","2011-04-30","201104300PHI"
"PHI",0,1,1,1,0,3,0,2,3,2,0,7,"H","N","2011-04-30","201104300PHI"
"NSH",1,0,0,1,0,2,0,0,1,0,0,1,"A","N","2011-04-30","201104300VAN"
"VAN",0,0,1,0,0,1,1,0,0,1,0,2,"H","N","2011-04-30","201104300VAN"
"DET",0,0,0,1,0,1,0,1,0,1,0,2,"A","N","2011-05-01","201105010SJS"
"SJS",0,1,0,1,0,2,0,0,0,1,0,1,"H","N","2011-05-01","201105010SJS"
"TBL",1,1,0,1,0,3,0,0,1,1,0,2,"A","N","2011-05-01","201105010WSH"
"WSH",0,0,1,1,0,2,1,1,0,1,0,3,"H","N","2011-05-01","201105010WSH"
"BOS",1,2,0,0,0,3,0,2,0,0,0,2,"A","N","2011-05-02","201105020PHI"
"PHI",0,2,0,0,0,2,1,2,0,0,0,3,"H","N","2011-05-02","201105020PHI"
"NSH",0,1,0,1,0,2,1,0,1,1,0,3,"H","N","2011-05-03","201105030NSH"
"VAN",1,0,1,1,0,3,0,1,0,1,0,2,"A","N","2011-05-03","201105030NSH"
"TBL",0,1,1,2,0,4,0,0,3,0,0,3,"H","N","2011-05-03","201105030TBL"
"WSH",0,0,3,0,0,3,0,1,1,2,0,4,"A","N","2011-05-03","201105030TBL"
"BOS",0,2,2,1,0,5,0,0,1,0,0,1,"H","N","2011-05-04","201105040BOS"
"PHI",0,0,1,0,0,1,0,2,2,1,0,5,"A","N","2011-05-04","201105040BOS"
"DET",0,1,2,0,0,3,1,1,1,1,0,4,"H","N","2011-05-04","201105040DET"
"SJS",1,1,1,1,0,4,0,1,2,0,0,3,"A","N","2011-05-04","201105040DET"
"TBL",0,1,2,2,0,5,0,1,1,1,0,3,"H","N","2011-05-04","201105040TBL"
"WSH",0,1,1,1,0,3,0,1,2,2,0,5,"A","N","2011-05-04","201105040TBL"
"NSH",0,1,0,1,0,2,0,1,1,2,0,4,"H","N","2011-05-05","201105050NSH"
"VAN",0,1,1,2,0,4,0,1,0,1,0,2,"A","N","2011-05-05","201105050NSH"
"BOS",0,1,0,4,0,5,0,0,1,0,0,1,"H","N","2011-05-06","201105060BOS"
"PHI",0,0,1,0,0,1,0,1,0,4,0,5,"A","N","2011-05-06","201105060BOS"
"DET",0,3,0,1,0,4,0,1,1,1,0,3,"H","N","2011-05-06","201105060DET"
"SJS",0,1,1,1,0,3,0,3,0,1,0,4,"A","N","2011-05-06","201105060DET"
"NSH",0,1,1,2,0,4,0,2,0,1,0,3,"A","N","2011-05-07","201105070VAN"
"VAN",0,2,0,1,0,3,0,1,1,2,0,4,"H","N","2011-05-07","201105070VAN"
"DET",0,0,1,3,0,4,0,1,1,1,0,3,"A","N","2011-05-08","201105080SJS"
"SJS",0,1,1,1,0,3,0,0,1,3,0,4,"H","N","2011-05-08","201105080SJS"
"NSH",0,0,1,0,0,1,0,2,0,0,0,2,"H","N","2011-05-09","201105090NSH"
"VAN",0,2,0,0,0,2,0,0,1,0,0,1,"A","N","2011-05-09","201105090NSH"
"DET",0,0,0,3,0,3,0,0,0,1,0,1,"H","N","2011-05-10","201105100DET"
"SJS",0,0,0,1,0,1,0,0,0,3,0,3,"A","N","2011-05-10","201105100DET"
"DET",0,0,1,1,0,2,0,2,0,1,0,3,"A","N","2011-05-12","201105120SJS"
"SJS",0,2,0,1,0,3,0,0,1,1,0,2,"H","N","2011-05-12","201105120SJS"
"BOS",0,1,0,1,0,2,0,3,0,2,0,5,"H","N","2011-05-14","201105140BOS"
"TBL",0,3,0,2,0,5,0,1,0,1,0,2,"A","N","2011-05-14","201105140BOS"
"SJS",0,1,1,0,0,2,0,0,1,2,0,3,"A","N","2011-05-15","201105150VAN"
"VAN",0,0,1,2,0,3,0,1,1,0,0,2,"H","N","2011-05-15","201105150VAN"
"BOS",0,1,5,0,0,6,0,2,1,2,0,5,"H","N","2011-05-17","201105170BOS"
"TBL",0,2,1,2,0,5,0,1,5,0,0,6,"A","N","2011-05-17","201105170BOS"
"SJS",0,2,0,1,0,3,0,2,1,4,0,7,"A","N","2011-05-18","201105180VAN"
"VAN",0,2,1,4,0,7,0,2,0,1,0,3,"H","N","2011-05-18","201105180VAN"
"BOS",0,1,0,1,0,2,0,0,0,0,0,0,"A","N","2011-05-19","201105190TBL"
"TBL",0,0,0,0,0,0,0,1,0,1,0,2,"H","N","2011-05-19","201105190TBL"
"SJS",0,3,0,1,0,4,0,0,0,3,0,3,"H","N","2011-05-20","201105200SJS"
"VAN",0,0,0,3,0,3,0,3,0,1,0,4,"A","N","2011-05-20","201105200SJS"
"BOS",0,3,0,0,0,3,0,0,3,2,0,5,"A","N","2011-05-21","201105210TBL"
"TBL",0,0,3,2,0,5,0,3,0,0,0,3,"H","N","2011-05-21","201105210TBL"
"SJS",0,0,0,2,0,2,0,0,3,1,0,4,"H","N","2011-05-22","201105220SJS"
"VAN",0,0,3,1,0,4,0,0,0,2,0,2,"A","N","2011-05-22","201105220SJS"
"BOS",0,0,2,1,0,3,0,1,0,0,0,1,"H","N","2011-05-23","201105230BOS"
"TBL",0,1,0,0,0,1,0,0,2,1,0,3,"A","N","2011-05-23","201105230BOS"
"SJS",0,0,1,1,0,2,1,1,0,1,0,3,"A","N","2011-05-24","201105240VAN"
"VAN",1,1,0,1,0,3,0,0,1,1,0,2,"H","N","2011-05-24","201105240VAN"
"BOS",0,2,0,2,0,4,0,1,2,2,0,5,"A","N","2011-05-25","201105250TBL"
"TBL",0,1,2,2,0,5,0,2,0,2,0,4,"H","N","2011-05-25","201105250TBL"
"BOS",0,0,0,1,0,1,0,0,0,0,0,0,"H","N","2011-05-27","201105270BOS"
"TBL",0,0,0,0,0,0,0,0,0,1,0,1,"A","N","2011-05-27","201105270BOS"
"BOS",0,0,0,0,0,0,0,0,0,1,0,1,"A","N","2011-06-01","201106010VAN"
"VAN",0,0,0,1,0,1,0,0,0,0,0,0,"H","N","2011-06-01","201106010VAN"
"BOS",0,0,2,0,0,2,1,1,0,1,0,3,"A","N","2011-06-04","201106040VAN"
"VAN",1,1,0,1,0,3,0,0,2,0,0,2,"H","N","2011-06-04","201106040VAN"
"BOS",0,0,4,4,0,8,0,0,0,1,0,1,"H","N","2011-06-06","201106060BOS"
"VAN",0,0,0,1,0,1,0,0,4,4,0,8,"A","N","2011-06-06","201106060BOS"
"BOS",0,1,2,1,0,4,0,0,0,0,0,0,"H","N","2011-06-08","201106080BOS"
"VAN",0,0,0,0,0,0,0,1,2,1,0,4,"A","N","2011-06-08","201106080BOS"
"BOS",0,0,0,0,0,0,0,0,0,1,0,1,"A","N","2011-06-10","201106100VAN"
"VAN",0,0,0,1,0,1,0,0,0,0,0,0,"H","N","2011-06-10","201106100VAN"
"BOS",0,4,0,1,0,5,0,0,0,2,0,2,"H","N","2011-06-13","201106130BOS"
"VAN",0,0,0,2,0,2,0,4,0,1,0,5,"A","N","2011-06-13","201106130BOS"
"BOS",0,1,2,1,0,4,0,0,0,0,0,0,"A","N","2011-06-15","201106150VAN"
"VAN",0,0,0,0,0,0,0,1,2,1,0,4,"H","N","2011-06-15","201106150VAN"
"BOS",0,1,0,0,0,1,0,2,0,0,0,2,"H","N","2011-10-06","201110060BOS"
"PHI",0,2,0,0,0,2,0,1,0,0,0,1,"A","N","2011-10-06","201110060BOS"
"MTL",0,0,0,0,0,0,0,0,1,1,0,2,"A","N","2011-10-06","201110060TOR"
"TOR",0,0,1,1,0,2,0,0,0,0,0,0,"H","N","2011-10-06","201110060TOR"
"PIT",0,2,1,0,1,4,0,1,1,1,0,3,"A","Y","2011-10-06","201110060VAN"
"VAN",0,1,1,1,0,3,0,2,1,0,1,4,"H","Y","2011-10-06","201110060VAN"
"ANA",0,0,1,0,0,1,0,2,2,0,0,4,"A","N","2011-10-07","201110070BUF"
"BUF",0,2,2,0,0,4,0,0,1,0,0,1,"H","N","2011-10-07","201110070BUF"
"CAR",0,1,0,0,0,1,0,0,2,3,0,5,"H","N","2011-10-07","201110070CAR"
"TBL",0,0,2,3,0,5,0,1,0,0,0,1,"A","N","2011-10-07","201110070CAR"
"CBJ",0,0,1,1,0,2,0,0,2,1,0,3,"H","N","2011-10-07","201110070CBJ"
"NSH",0,0,2,1,0,3,0,0,1,1,0,2,"A","N","2011-10-07","201110070CBJ"
"CHI",0,0,0,1,0,1,0,0,2,0,0,2,"A","N","2011-10-07","201110070DAL"
"DAL",0,0,2,0,0,2,0,0,0,1,0,1,"H","N","2011-10-07","201110070DAL"
"DET",0,1,3,1,0,5,0,0,0,3,0,3,"H","N","2011-10-07","201110070DET"
"OTT",0,0,0,3,0,3,0,1,3,1,0,5,"A","N","2011-10-07","201110070DET"
"LAK",1,1,0,1,0,3,0,1,0,1,0,2,"H","N","2011-10-07","201110070LAK"
"NYR",0,1,0,1,0,2,1,1,0,1,0,3,"A","N","2011-10-07","201110070LAK"
"ANA",0,1,0,0,1,2,0,0,0,1,0,1,"H","Y","2011-10-08","201110080ANA"
"NYR",0,0,0,1,0,1,0,1,0,0,1,2,"A","Y","2011-10-08","201110080ANA"
"BOS",0,0,2,2,0,4,0,0,1,0,0,1,"H","N","2011-10-08","201110080BOS"
"TBL",0,0,1,0,0,1,0,0,2,2,0,4,"A","N","2011-10-08","201110080BOS"
"CGY",0,1,0,2,0,3,0,0,4,1,0,5,"H","N","2011-10-08","201110080CGY"
"PIT",0,0,4,1,0,5,0,1,0,2,0,3,"A","N","2011-10-08","201110080CGY"
"CHI",0,1,2,2,0,5,0,0,1,1,0,2,"H","N","2011-10-08","201110080CHI"
"DAL",0,0,1,1,0,2,0,1,2,2,0,5,"A","N","2011-10-08","201110080CHI"
"COL",0,0,0,0,0,0,0,0,1,2,0,3,"H","N","2011-10-08","201110080COL"
"DET",0,0,1,2,0,3,0,0,0,0,0,0,"A","N","2011-10-08","201110080COL"
"BUF",0,0,3,1,0,4,0,0,1,1,0,2,"A","N","2011-10-08","201110080LAK"
"LAK",0,0,1,1,0,2,0,0,3,1,0,4,"H","N","2011-10-08","201110080LAK"
"CBJ",0,0,1,1,0,2,0,2,2,0,0,4,"A","N","2011-10-08","201110080MIN"
"MIN",0,2,2,0,0,4,0,0,1,1,0,2,"H","N","2011-10-08","201110080MIN"
"NJD",0,0,0,0,0,0,0,1,0,2,0,3,"H","N","2011-10-08","201110080NJD"
"PHI",0,1,0,2,0,3,0,0,0,0,0,0,"A","N","2011-10-08","201110080NJD"
"FLA",0,2,0,0,0,2,0,0,0,0,0,0,"A","N","2011-10-08","201110080NYI"
"NYI",0,0,0,0,0,0,0,2,0,0,0,2,"H","N","2011-10-08","201110080NYI"
"PHX",0,0,1,2,0,3,0,2,4,0,0,6,"A","N","2011-10-08","201110080SJS"
"SJS",0,2,4,0,0,6,0,0,1,2,0,3,"H","N","2011-10-08","201110080SJS"
"NSH",0,1,0,3,0,4,0,1,0,1,0,2,"A","N","2011-10-08","201110080STL"
"STL",0,1,0,1,0,2,0,1,0,3,0,4,"H","N","2011-10-08","201110080STL"
"OTT",0,0,0,5,0,5,0,2,2,2,0,6,"A","N","2011-10-08","201110080TOR"
"TOR",0,2,2,2,0,6,0,0,0,5,0,5,"H","N","2011-10-08","201110080TOR"
"CAR",0,0,1,2,0,3,1,0,2,1,0,4,"A","N","2011-10-08","201110080WSH"
"WSH",1,0,2,1,0,4,0,0,1,2,0,3,"H","N","2011-10-08","201110080WSH"
"EDM",0,0,0,1,1,2,0,1,0,0,0,1,"H","Y","2011-10-09","201110090EDM"
"PIT",0,1,0,0,0,1,0,0,0,1,1,2,"A","Y","2011-10-09","201110090EDM"
"MTL",0,1,1,3,0,5,0,0,0,1,0,1,"A","N","2011-10-09","201110090WPG"
"WPG",0,0,0,1,0,1,0,1,1,3,0,5,"H","N","2011-10-09","201110090WPG"
"BOS",0,0,0,0,0,0,0,0,0,1,0,1,"H","N","2011-10-10","201110100BOS"
"COL",0,0,0,1,0,1,0,0,0,0,0,0,"A","N","2011-10-10","201110100BOS"
"CBJ",0,1,1,0,0,2,0,1,0,2,0,3,"H","N","2011-10-10","201110100CBJ"
"VAN",0,1,0,2,0,3,0,1,1,0,0,2,"A","N","2011-10-10","201110100CBJ"
"DAL",0,0,0,1,1,2,0,0,0,1,0,1,"H","Y","2011-10-10","201110100DAL"
"PHX",0,0,0,1,0,1,0,0,0,1,1,2,"A","Y","2011-10-10","201110100DAL"
"CAR",0,0,2,0,0,2,0,1,1,2,0,4,"A","N","2011-10-10","201110100NJD"
"NJD",0,1,1,2,0,4,0,0,2,0,0,2,"H","N","2011-10-10","201110100NJD"
"MIN",0,0,0,1,0,1,0,2,0,0,0,2,"A","N","2011-10-10","201110100NYI"
"NYI",0,2,0,0,0,2,0,0,0,1,0,1,"H","N","2011-10-10","201110100NYI"
"CGY",0,1,1,0,0,2,0,1,2,2,0,5,"A","N","2011-10-10","201110100STL"
"STL",0,1,2,2,0,5,0,1,1,0,0,2,"H","N","2011-10-10","201110100STL"
"TBL",0,2,1,2,0,5,0,2,1,2,1,6,"A","Y","2011-10-10","201110100WSH"
"WSH",0,2,1,2,1,6,0,2,1,2,0,5,"H","Y","2011-10-10","201110100WSH"
"MIN",0,2,0,1,0,3,0,0,1,2,1,4,"A","Y","2011-10-11","201110110OTT"
"OTT",0,0,1,2,1,4,0,2,0,1,0,3,"H","Y","2011-10-11","201110110OTT"
"FLA",0,0,1,1,0,2,0,1,2,1,0,4,"A","N","2011-10-11","201110110PIT"
"PIT",0,1,2,1,0,4,0,0,1,1,0,2,"H","N","2011-10-11","201110110PIT"
"BOS",0,0,0,2,0,2,0,0,1,2,0,3,"A","N","2011-10-12","201110120CAR"
"CAR",0,0,1,2,0,3,0,0,0,2,0,2,"H","N","2011-10-12","201110120CAR"
"CBJ",0,0,1,1,0,2,0,1,0,1,1,3,"H","Y","2011-10-12","201110120CBJ"
"COL",0,1,0,1,1,3,0,0,1,1,0,2,"A","Y","2011-10-12","201110120CBJ"
"PHI",0,3,1,1,0,5,0,1,2,1,0,4,"H","N","2011-10-12","201110120PHI"
"VAN",0,1,2,1,0,4,0,3,1,1,0,5,"A","N","2011-10-12","201110120PHI"
"CHI",0,2,2,0,0,4,0,2,1,0,0,3,"H","N","2011-10-13","201110130CHI"
"WPG",0,2,1,0,0,3,0,2,2,0,0,4,"A","N","2011-10-13","201110130CHI"
"DAL",0,1,2,0,0,3,0,0,1,1,0,2,"H","N","2011-10-13","201110130DAL"
"STL",0,0,1,1,0,2,0,1,2,0,0,3,"A","N","2011-10-13","201110130DAL"
"DET",0,0,2,0,0,2,0,0,0,0,0,0,"H","N","2011-10-13","201110130DET"
"VAN",0,0,0,0,0,0,0,0,2,0,0,2,"A","N","2011-10-13","201110130DET"
"EDM",0,1,0,0,0,1,0,0,1,0,1,2,"A","Y","2011-10-13","201110130MIN"
"MIN",0,0,1,0,1,2,0,1,0,0,0,1,"H","Y","2011-10-13","201110130MIN"
"CGY",0,3,1,0,0,4,0,1,0,0,0,1,"A","N","2011-10-13","201110130MTL"
"MTL",0,1,0,0,0,1,0,3,1,0,0,4,"H","N","2011-10-13","201110130MTL"
"LAK",0,1,0,0,0,1,0,1,0,0,1,2,"A","Y","2011-10-13","201110130NJD"
"NJD",0,1,0,0,1,2,0,1,0,0,0,1,"H","Y","2011-10-13","201110130NJD"
"NSH",0,0,1,1,0,2,0,3,1,1,0,5,"H","N","2011-10-13","201110130NSH"
"PHX",0,3,1,1,0,5,0,0,1,1,0,2,"A","N","2011-10-13","201110130NSH"
"NYI",0,4,1,0,0,5,0,1,0,0,0,1,"H","N","2011-10-13","201110130NYI"
"TBL",0,1,0,0,0,1,0,4,1,0,0,5,"A","N","2011-10-13","201110130NYI"
"COL",0,2,1,4,0,7,0,1,0,0,0,1,"A","N","2011-10-13","201110130OTT"
"OTT",0,1,0,0,0,1,0,2,1,4,0,7,"H","N","2011-10-13","201110130OTT"
"PIT",0,1,0,1,0,2,1,0,1,1,0,3,"H","N","2011-10-13","201110130PIT"
"WSH",1,0,1,1,0,3,0,1,0,1,0,2,"A","N","2011-10-13","201110130PIT"
"ANA",0,1,0,0,0,1,0,0,0,0,0,0,"H","N","2011-10-14","201110140ANA"
"SJS",0,0,0,0,0,0,0,1,0,0,0,1,"A","N","2011-10-14","201110140ANA"
"BUF",0,2,0,1,0,3,0,2,1,1,0,4,"H","N","2011-10-14","201110140BUF"
"CAR",0,2,1,1,0,4,0,2,0,1,0,3,"A","N","2011-10-14","201110140BUF"
"BOS",0,0,1,1,1,3,0,1,1,0,0,2,"A","Y","2011-10-15","201110150CHI"
"CHI",0,1,1,0,0,2,0,0,1,1,1,3,"H","Y","2011-10-15","201110150CHI"
"CBJ",0,1,1,0,0,2,0,1,1,2,0,4,"A","N","2011-10-15","201110150DAL"
"DAL",0,1,1,2,0,4,0,1,1,0,0,2,"H","N","2011-10-15","201110150DAL"
"EDM",0,2,1,0,0,3,0,1,2,1,0,4,"H","N","2011-10-15","201110150EDM"
"VAN",0,1,2,1,0,4,0,2,1,0,0,3,"A","N","2011-10-15","201110150EDM"
"FLA",0,1,0,1,1,3,0,0,0,2,0,2,"H","Y","2011-10-15","201110150FLA"
"TBL",0,0,0,2,0,2,0,1,0,1,1,3,"A","Y","2011-10-15","201110150FLA"
"DET",1,0,1,1,0,3,0,1,1,0,0,2,"A","N","2011-10-15","201110150MIN"
"MIN",0,1,1,0,0,2,1,0,1,1,0,3,"H","N","2011-10-15","201110150MIN"
"COL",0,1,3,1,1,6,0,1,2,2,0,5,"A","Y","2011-10-15","201110150MTL"
"MTL",0,1,2,2,0,5,0,1,3,1,1,6,"H","Y","2011-10-15","201110150MTL"
"NJD",0,0,0,2,1,3,0,2,0,0,0,2,"A","Y","2011-10-15","201110150NSH"
"NSH",0,2,0,0,0,2,0,0,0,2,1,3,"H","Y","2011-10-15","201110150NSH"
"NYI",0,1,1,2,0,4,0,0,2,0,0,2,"H","N","2011-10-15","201110150NYI"
"NYR",0,0,2,0,0,2,0,1,1,2,0,4,"A","N","2011-10-15","201110150NYI"
"LAK",1,1,0,1,0,3,0,1,0,1,0,2,"A","N","2011-10-15","201110150PHI"
"PHI",0,1,0,1,0,2,1,1,0,1,0,3,"H","N","2011-10-15","201110150PHI"
"PHX",0,2,1,1,0,4,0,0,1,0,0,1,"H","N","2011-10-15","201110150PHX"
"WPG",0,0,1,0,0,1,0,2,1,1,0,4,"A","N","2011-10-15","201110150PHX"
"BUF",0,2,0,1,0,3,0,0,1,1,0,2,"A","N","2011-10-15","201110150PIT"
"PIT",0,0,1,1,0,2,0,2,0,1,0,3,"H","N","2011-10-15","201110150PIT"
"SJS",0,1,1,0,0,2,0,1,0,3,0,4,"H","N","2011-10-15","201110150SJS"
"STL",0,1,0,3,0,4,0,1,1,0,0,2,"A","N","2011-10-15","201110150SJS"
"CGY",0,2,0,0,0,2,0,0,2,1,0,3,"A","N","2011-10-15","201110150TOR"
"TOR",0,0,2,1,0,3,0,2,0,0,0,2,"H","N","2011-10-15","201110150TOR"
"OTT",0,1,0,0,0,1,0,2,0,0,0,2,"A","N","2011-10-15","201110150WSH"
"WSH",0,2,0,0,0,2,0,1,0,0,0,1,"H","N","2011-10-15","201110150WSH"
"ANA",0,1,0,3,0,4,0,0,1,1,0,2,"H","N","2011-10-16","201110160ANA"
"STL",0,0,1,1,0,2,0,1,0,3,0,4,"A","N","2011-10-16","201110160ANA"
"EDM",0,0,0,3,0,3,0,0,1,0,0,1,"H","N","2011-10-17","201110170EDM"
"NSH",0,0,1,0,0,1,0,0,0,3,0,3,"A","N","2011-10-17","201110170EDM"
"ANA",0,2,0,1,0,3,0,0,1,1,0,2,"A","N","2011-10-17","201110170SJS"
"SJS",0,0,1,1,0,2,0,2,0,1,0,3,"H","N","2011-10-17","201110170SJS"
"FLA",0,2,2,3,0,7,0,2,1,1,0,4,"A","N","2011-10-17","201110170TBL"
"TBL",0,2,1,1,0,4,0,2,2,3,0,7,"H","N","2011-10-17","201110170TBL"
"COL",1,0,2,0,0,3,0,0,1,1,0,2,"A","N","2011-10-17","201110170TOR"
"TOR",0,0,1,1,0,2,1,0,2,0,0,3,"H","N","2011-10-17","201110170TOR"
"PIT",0,0,1,0,0,1,0,2,0,0,0,2,"A","N","2011-10-17","201110170WPG"
"WPG",0,2,0,0,0,2,0,0,1,0,0,1,"H","N","2011-10-17","201110170WPG"
"BOS",0,0,0,1,0,1,0,1,1,2,0,4,"H","N","2011-10-18","201110180BOS"
"CAR",0,1,1,2,0,4,0,0,0,1,0,1,"A","N","2011-10-18","201110180BOS"
"CBJ",0,0,0,2,0,2,0,0,1,2,0,3,"H","N","2011-10-18","201110180CBJ"
"DAL",0,0,1,2,0,3,0,0,0,2,0,2,"A","N","2011-10-18","201110180CBJ"
"CGY",0,0,0,2,0,2,0,1,0,0,0,1,"H","N","2011-10-18","201110180CGY"
"EDM",0,1,0,0,0,1,0,0,0,2,0,2,"A","N","2011-10-18","201110180CGY"
"LAK",0,1,2,2,0,5,0,0,0,0,0,0,"H","N","2011-10-18","201110180LAK"
"STL",0,0,0,0,0,0,0,1,2,2,0,5,"A","N","2011-10-18","201110180LAK"
"MIN",0,0,1,1,0,2,0,0,2,2,0,4,"H","N","2011-10-18","201110180MIN"
"PIT",0,0,2,2,0,4,0,0,1,1,0,2,"A","N","2011-10-18","201110180MIN"
"BUF",0,0,2,1,0,3,0,0,1,0,0,1,"A","N","2011-10-18","201110180MTL"
"MTL",0,0,1,0,0,1,0,0,2,1,0,3,"H","N","2011-10-18","201110180MTL"
"OTT",0,0,1,1,0,2,0,4,0,3,0,7,"H","N","2011-10-18","201110180OTT"
"PHI",0,4,0,3,0,7,0,0,1,1,0,2,"A","N","2011-10-18","201110180OTT"
"CHI",0,1,2,2,0,5,0,0,2,0,0,2,"A","N","2011-10-18","201110180PHX"
"PHX",0,0,2,0,0,2,0,1,2,2,0,5,"H","N","2011-10-18","201110180PHX"
"NYR",0,0,0,4,0,4,0,0,0,0,0,0,"A","N","2011-10-18","201110180VAN"
"VAN",0,0,0,0,0,0,0,0,0,4,0,4,"H","N","2011-10-18","201110180VAN"
"FLA",0,0,0,0,0,0,0,1,0,2,0,3,"A","N","2011-10-18","201110180WSH"
"WSH",0,1,0,2,0,3,0,0,0,0,0,0,"H","N","2011-10-18","201110180WSH"
"TOR",0,1,0,2,1,4,0,1,2,0,0,3,"H","Y","2011-10-19","201110190TOR"
"WPG",0,1,2,0,0,3,0,1,0,2,1,4,"A","Y","2011-10-19","201110190TOR"
"BOS",0,3,0,3,0,6,0,1,0,1,0,2,"H","N","2011-10-20","201110200BOS"
"TOR",0,1,0,1,0,2,0,3,0,3,0,6,"A","N","2011-10-20","201110200BOS"
"CGY",0,2,0,0,0,2,1,2,0,0,0,3,"H","N","2011-10-20","201110200CGY"
"NYR",1,2,0,0,0,3,0,2,0,0,0,2,"A","N","2011-10-20","201110200CGY"
"CHI",0,1,0,2,0,3,0,0,1,0,0,1,"A","N","2011-10-20","201110200COL"
"COL",0,0,1,0,0,1,0,1,0,2,0,3,"H","N","2011-10-20","201110200COL"
"EDM",0,1,0,0,0,1,0,0,0,1,1,2,"H","Y","2011-10-20","201110200EDM"
"MIN",0,0,0,1,1,2,0,1,0,0,0,1,"A","Y","2011-10-20","201110200EDM"
"BUF",0,0,2,1,0,3,0,0,0,0,0,0,"A","N","2011-10-20","201110200FLA"
"FLA",0,0,0,0,0,0,0,0,2,1,0,3,"H","N","2011-10-20","201110200FLA"
"OTT",0,0,2,2,0,4,0,1,0,0,0,1,"H","N","2011-10-20","201110200OTT"
"WPG",0,1,0,0,0,1,0,0,2,2,0,4,"A","N","2011-10-20","201110200OTT"
"PHI",0,1,0,1,0,2,0,2,0,3,0,5,"H","N","2011-10-20","201110200PHI"
"WSH",0,2,0,3,0,5,0,1,0,1,0,2,"A","N","2011-10-20","201110200PHI"
"LAK",0,0,2,0,0,2,0,0,0,0,0,0,"A","N","2011-10-20","201110200PHX"
"PHX",0,0,0,0,0,0,0,0,2,0,0,2,"H","N","2011-10-20","201110200PHX"
"MTL",0,0,0,1,0,1,0,1,1,1,0,3,"A","N","2011-10-20","201110200PIT"
"PIT",0,1,1,1,0,3,0,0,0,1,0,1,"H","N","2011-10-20","201110200PIT"
"NYI",0,0,0,1,0,1,0,1,1,2,0,4,"A","N","2011-10-20","201110200TBL"
"TBL",0,1,1,2,0,4,0,0,0,1,0,1,"H","N","2011-10-20","201110200TBL"
"NSH",0,1,0,0,0,1,0,4,0,1,0,5,"A","N","2011-10-20","201110200VAN"
"VAN",0,4,0,1,0,5,0,1,0,0,0,1,"H","N","2011-10-20","201110200VAN"
"ANA",0,0,1,0,0,1,0,2,0,1,0,3,"H","N","2011-10-21","201110210ANA"
"DAL",0,2,0,1,0,3,0,0,1,0,0,1,"A","N","2011-10-21","201110210ANA"
"CBJ",0,1,0,1,0,2,0,2,1,2,0,5,"A","N","2011-10-21","201110210DET"
"DET",0,2,1,2,0,5,0,1,0,1,0,2,"H","N","2011-10-21","201110210DET"
"NJD",0,1,1,1,0,3,0,0,2,1,1,4,"H","Y","2011-10-21","201110210NJD"
"SJS",0,0,2,1,1,4,0,1,1,1,0,3,"A","Y","2011-10-21","201110210NJD"
"CAR",0,1,1,0,0,2,1,0,2,0,0,3,"A","N","2011-10-21","201110210STL"
"STL",1,0,2,0,0,3,0,1,1,0,0,2,"H","N","2011-10-21","201110210STL"
"BOS",0,0,0,2,0,2,0,1,1,2,0,4,"H","N","2011-10-22","201110220BOS"
"SJS",0,1,1,2,0,4,0,0,0,2,0,2,"A","N","2011-10-22","201110220BOS"
"CGY",0,0,0,0,0,0,0,0,1,1,0,2,"H","N","2011-10-22","201110220CGY"
"NSH",0,0,1,1,0,2,0,0,0,0,0,0,"A","N","2011-10-22","201110220CGY"
"CHI",0,0,2,2,0,4,0,1,2,1,1,5,"H","Y","2011-10-22","201110220CHI"
"COL",0,1,2,1,1,5,0,0,2,2,0,4,"A","Y","2011-10-22","201110220CHI"
"EDM",0,0,1,1,0,2,0,0,0,0,0,0,"H","N","2011-10-22","201110220EDM"
"NYR",0,0,0,0,0,0,0,0,1,1,0,2,"A","N","2011-10-22","201110220EDM"
"FLA",0,1,1,2,0,4,0,1,1,0,0,2,"H","N","2011-10-22","201110220FLA"
"NYI",0,1,1,0,0,2,0,1,1,2,0,4,"A","N","2011-10-22","201110220FLA"
"DAL",0,0,0,0,0,0,0,0,0,1,0,1,"A","N","2011-10-22","201110220LAK"
"LAK",0,0,0,1,0,1,0,0,0,0,0,0,"H","N","2011-10-22","201110220LAK"
"MTL",0,1,1,2,0,4,1,1,2,1,0,5,"H","N","2011-10-22","201110220MTL"
"TOR",1,1,2,1,0,5,0,1,1,2,0,4,"A","N","2011-10-22","201110220MTL"
"CBJ",0,1,1,1,0,3,0,1,1,2,0,4,"A","N","2011-10-22","201110220OTT"
"OTT",0,1,1,2,0,4,0,1,1,1,0,3,"H","N","2011-10-22","201110220OTT"
"PHI",0,0,1,1,0,2,0,2,1,1,0,4,"H","N","2011-10-22","201110220PHI"
"STL",0,2,1,1,0,4,0,0,1,1,0,2,"A","N","2011-10-22","201110220PHI"
"NJD",0,0,0,1,0,1,0,1,0,3,0,4,"A","N","2011-10-22","201110220PIT"
"PIT",0,1,0,3,0,4,0,0,0,1,0,1,"H","N","2011-10-22","201110220PIT"
"BUF",0,0,0,0,0,0,0,0,1,2,0,3,"A","N","2011-10-22","201110220TBL"
"TBL",0,0,1,2,0,3,0,0,0,0,0,0,"H","N","2011-10-22","201110220TBL"
"MIN",0,1,1,0,0,2,1,0,1,1,0,3,"A","N","2011-10-22","201110220VAN"
"VAN",1,0,1,1,0,3,0,1,1,0,0,2,"H","N","2011-10-22","201110220VAN"
"CAR",0,2,0,1,0,3,0,2,3,0,0,5,"A","N","2011-10-22","201110220WPG"
"WPG",0,2,3,0,0,5,0,2,0,1,0,3,"H","N","2011-10-22","201110220WPG"
"DET",0,0,1,0,0,1,0,2,2,3,0,7,"A","N","2011-10-22","201110220WSH"
"WSH",0,2,2,3,0,7,0,0,1,0,0,1,"H","N","2011-10-22","201110220WSH"
"ANA",0,2,1,1,0,4,0,2,3,0,0,5,"H","N","2011-10-23","201110230ANA"
"PHX",0,2,3,0,0,5,0,2,1,1,0,4,"A","N","2011-10-23","201110230ANA"
"FLA",0,1,0,1,0,2,0,1,0,0,0,1,"A","N","2011-10-24","201110240MTL"
"MTL",0,1,0,0,0,1,0,1,0,1,0,2,"H","N","2011-10-24","201110240MTL"
"PHI",0,1,1,2,0,4,0,1,0,1,0,2,"H","N","2011-10-24","201110240PHI"
"TOR",0,1,0,1,0,2,0,1,1,2,0,4,"A","N","2011-10-24","201110240PHI"
"NYR",0,0,1,1,0,2,0,0,1,0,0,1,"A","N","2011-10-24","201110240WPG"
"WPG",0,0,1,0,0,1,0,0,1,1,0,2,"H","N","2011-10-24","201110240WPG"
"BUF",0,2,0,1,0,3,0,2,1,1,0,4,"H","N","2011-10-25","201110250BUF"
"TBL",0,2,1,1,0,4,0,2,0,1,0,3,"A","N","2011-10-25","201110250BUF"
"CAR",0,0,0,2,0,2,0,0,2,0,1,3,"H","Y","2011-10-25","201110250CAR"
"OTT",0,0,2,0,1,3,0,0,0,2,0,2,"A","Y","2011-10-25","201110250CAR"
"CBJ",0,2,1,1,0,4,0,1,0,0,0,1,"H","N","2011-10-25","201110250CBJ"
"DET",0,1,0,0,0,1,0,2,1,1,0,4,"A","N","2011-10-25","201110250CBJ"
"ANA",0,0,2,0,0,2,0,0,1,1,1,3,"A","Y","2011-10-25","201110250CHI"
"CHI",0,0,1,1,1,3,0,0,2,0,0,2,"H","Y","2011-10-25","201110250CHI"
"EDM",0,0,3,0,0,3,0,0,1,1,0,2,"H","N","2011-10-25","201110250EDM"
"VAN",0,0,1,1,0,2,0,0,3,0,0,3,"A","N","2011-10-25","201110250EDM"
"LAK",0,0,0,0,0,0,0,0,3,0,0,3,"H","N","2011-10-25","201110250LAK"
"NJD",0,0,3,0,0,3,0,0,0,0,0,0,"A","N","2011-10-25","201110250LAK"
"NSH",0,0,0,1,0,1,0,1,0,2,0,3,"H","N","2011-10-25","201110250NSH"
"SJS",0,1,0,2,0,3,0,0,0,1,0,1,"A","N","2011-10-25","201110250NSH"
"NYI",0,0,0,0,0,0,0,1,1,1,0,3,"H","N","2011-10-25","201110250NYI"
"PIT",0,1,1,1,0,3,0,0,0,0,0,0,"A","N","2011-10-25","201110250NYI"
"DAL",0,1,0,1,1,3,0,1,0,1,0,2,"A","Y","2011-10-25","201110250PHX"
"PHX",0,1,0,1,0,2,0,1,0,1,1,3,"H","Y","2011-10-25","201110250PHX"
"CGY",0,1,2,1,0,4,0,1,0,1,0,2,"H","N","2011-10-26","201110260CGY"
"COL",0,1,0,1,0,2,0,1,2,1,0,4,"A","N","2011-10-26","201110260CGY"
"MTL",0,1,2,2,0,5,0,1,0,0,0,1,"H","N","2011-10-26","201110260MTL"
"PHI",0,1,0,0,0,1,0,1,2,2,0,5,"A","N","2011-10-26","201110260MTL"
"STL",0,0,1,2,0,3,0,0,0,0,0,0,"A","N","2011-10-26","201110260VAN"
"VAN",0,0,0,0,0,0,0,0,1,2,0,3,"H","N","2011-10-26","201110260VAN"
"BOS",0,1,0,0,0,1,0,0,1,1,0,2,"H","N","2011-10-27","201110270BOS"
"MTL",0,0,1,1,0,2,0,1,0,0,0,1,"A","N","2011-10-27","201110270BOS"
"BUF",0,1,1,2,0,4,0,0,1,1,0,2,"H","N","2011-10-27","201110270BUF"
"CBJ",0,0,1,1,0,2,0,1,1,2,0,4,"A","N","2011-10-27","201110270BUF"
"DAL",0,1,0,2,0,3,0,0,3,2,0,5,"H","N","2011-10-27","201110270DAL"
"LAK",0,0,3,2,0,5,0,1,0,2,0,3,"A","N","2011-10-27","201110270DAL"
"EDM",0,1,1,0,0,2,0,1,0,0,0,1,"H","N","2011-10-27","201110270EDM"
"WSH",0,1,0,0,0,1,0,1,1,0,0,2,"A","N","2011-10-27","201110270EDM"
"ANA",0,1,1,1,0,3,0,0,1,1,0,2,"A","N","2011-10-27","201110270MIN"
"MIN",0,0,1,1,0,2,0,1,1,1,0,3,"H","N","2011-10-27","201110270MIN"
"NSH",0,2,3,0,0,5,0,2,0,1,0,3,"H","N","2011-10-27","201110270NSH"
"TBL",0,2,0,1,0,3,0,2,3,0,0,5,"A","N","2011-10-27","201110270NSH"
"NYR",0,1,0,1,0,2,0,0,1,3,0,4,"H","N","2011-10-27","201110270NYR"
"TOR",0,0,1,3,0,4,0,1,0,1,0,2,"A","N","2011-10-27","201110270NYR"
"FLA",0,1,1,1,0,3,0,0,2,2,0,4,"A","N","2011-10-27","201110270OTT"
"OTT",0,0,2,2,0,4,0,1,1,1,0,3,"H","N","2011-10-27","201110270OTT"
"PHI",0,1,3,4,0,8,0,3,3,3,0,9,"H","N","2011-10-27","201110270PHI"
"WPG",0,3,3,3,0,9,0,1,3,4,0,8,"A","N","2011-10-27","201110270PHI"
"NJD",0,1,1,1,0,3,0,1,2,2,0,5,"A","N","2011-10-27","201110270PHX"
"PHX",0,1,2,2,0,5,0,1,1,1,0,3,"H","N","2011-10-27","201110270PHX"
"NYI",0,1,0,1,0,2,0,0,0,2,1,3,"A","Y","2011-10-27","201110270PIT"
"PIT",0,0,0,2,1,3,0,1,0,1,0,2,"H","Y","2011-10-27","201110270PIT"
"CAR",0,1,0,2,0,3,0,0,0,0,0,0,"H","N","2011-10-28","201110280CAR"
"CHI",0,0,0,0,0,0,0,1,0,2,0,3,"A","N","2011-10-28","201110280CAR"
"CGY",0,0,1,2,0,3,0,0,0,1,0,1,"H","N","2011-10-28","201110280CGY"
"STL",0,0,0,1,0,1,0,0,1,2,0,3,"A","N","2011-10-28","201110280CGY"
"COL",0,0,0,1,0,1,0,0,2,1,0,3,"H","N","2011-10-28","201110280COL"
"EDM",0,0,2,1,0,3,0,0,0,1,0,1,"A","N","2011-10-28","201110280COL"
"DET",0,1,1,0,0,2,0,0,3,1,0,4,"H","N","2011-10-28","201110280DET"
"SJS",0,0,3,1,0,4,0,1,1,0,0,2,"A","N","2011-10-28","201110280DET"
"BUF",0,0,1,1,0,2,0,0,1,2,0,3,"H","N","2011-10-29","201110290BUF"
"FLA",0,0,1,2,0,3,0,0,1,1,0,2,"A","N","2011-10-29","201110290BUF"
"CBJ",0,1,1,0,0,2,0,2,0,3,0,5,"A","N","2011-10-29","201110290CHI"
"CHI",0,2,0,3,0,5,0,1,1,0,0,2,"H","N","2011-10-29","201110290CHI"
"DAL",0,1,0,2,0,3,0,0,1,0,0,1,"H","N","2011-10-29","201110290DAL"
"NJD",0,0,1,0,0,1,0,1,0,2,0,3,"A","N","2011-10-29","201110290DAL"
"DET",0,0,0,0,0,0,0,1,0,0,0,1,"A","N","2011-10-29","201110290MIN"
"MIN",0,1,0,0,0,1,0,0,0,0,0,0,"H","N","2011-10-29","201110290MIN"
"BOS",0,0,1,1,0,2,0,2,1,1,0,4,"A","N","2011-10-29","201110290MTL"
"MTL",0,2,1,1,0,4,0,0,1,1,0,2,"H","N","2011-10-29","201110290MTL"
"ANA",0,0,0,0,0,0,0,2,0,1,0,3,"A","N","2011-10-29","201110290NSH"
"NSH",0,2,0,1,0,3,0,0,0,0,0,0,"H","N","2011-10-29","201110290NSH"
"NYI",0,0,2,0,0,2,1,1,1,0,0,3,"H","N","2011-10-29","201110290NYI"
"SJS",1,1,1,0,0,3,0,0,2,0,0,2,"A","N","2011-10-29","201110290NYI"
"NYR",0,0,2,2,0,4,0,1,0,3,1,5,"H","Y","2011-10-29","201110290NYR"
"OTT",0,1,0,3,1,5,0,0,2,2,0,4,"A","Y","2011-10-29","201110290NYR"
"CAR",0,0,1,0,0,1,0,1,0,4,0,5,"A","N","2011-10-29","201110290PHI"
"PHI",0,1,0,4,0,5,0,0,1,0,0,1,"H","N","2011-10-29","201110290PHI"
"LAK",0,0,1,1,0,2,1,0,2,0,0,3,"A","N","2011-10-29","201110290PHX"
"PHX",1,0,2,0,0,3,0,0,1,1,0,2,"H","N","2011-10-29","201110290PHX"
"TBL",0,0,1,0,0,1,0,0,0,0,0,0,"H","N","2011-10-29","201110290TBL"
"WPG",0,0,0,0,0,0,0,0,1,0,0,1,"A","N","2011-10-29","201110290TBL"
"PIT",0,0,2,1,0,3,0,1,1,2,0,4,"A","N","2011-10-29","201110290TOR"
"TOR",0,1,1,2,0,4,0,0,2,1,0,3,"H","N","2011-10-29","201110290TOR"
"VAN",0,3,1,3,0,7,0,1,3,0,0,4,"H","N","2011-10-29","201110290VAN"
"WSH",0,1,3,0,0,4,0,3,1,3,0,7,"A","N","2011-10-29","201110290VAN"
"ANA",0,1,0,0,0,1,0,1,2,0,0,3,"A","N","2011-10-30","201110300CBJ"
"CBJ",0,1,2,0,0,3,0,1,0,0,0,1,"H","N","2011-10-30","201110300CBJ"
"COL",0,1,1,1,0,3,0,1,1,0,0,2,"H","N","2011-10-30","201110300COL"
"LAK",0,1,1,0,0,2,0,1,1,1,0,3,"A","N","2011-10-30","201110300COL"
"EDM",0,1,3,0,0,4,0,0,1,1,0,2,"H","N","2011-10-30","201110300EDM"
"STL",0,0,1,1,0,2,0,1,3,0,0,4,"A","N","2011-10-30","201110300EDM"
"OTT",0,1,1,1,0,3,0,1,0,1,0,2,"H","N","2011-10-30","201110300OTT"
"TOR",0,1,0,1,0,2,0,1,1,1,0,3,"A","N","2011-10-30","201110300OTT"
"CHI",1,1,1,2,0,5,0,1,2,1,0,4,"H","N","2011-10-31","201110310CHI"
"NSH",0,1,2,1,0,4,1,1,1,2,0,5,"A","N","2011-10-31","201110310CHI"
"FLA",0,1,0,2,0,3,0,2,0,1,1,4,"H","Y","2011-10-31","201110310FLA"
"WPG",0,2,0,1,1,4,0,1,0,2,0,3,"A","Y","2011-10-31","201110310FLA"
"NYR",0,2,3,0,0,5,0,1,1,0,0,2,"H","N","2011-10-31","201110310NYR"
"SJS",0,1,1,0,0,2,0,2,3,0,0,5,"A","N","2011-10-31","201110310NYR"
"BOS",0,1,2,2,0,5,0,2,0,1,0,3,"H","N","2011-11-01","201111010BOS"
"OTT",0,2,0,1,0,3,0,1,2,2,0,5,"A","N","2011-11-01","201111010BOS"
"CAR",0,1,2,1,0,4,0,1,0,1,0,2,"H","N","2011-11-01","201111010CAR"
"TBL",0,1,0,1,0,2,0,1,2,1,0,4,"A","N","2011-11-01","201111010CAR"
"CGY",0,0,0,1,0,1,0,3,2,0,0,5,"H","N","2011-11-01","201111010CGY"
"VAN",0,3,2,0,0,5,0,0,0,1,0,1,"A","N","2011-11-01","201111010CGY"
"DET",0,1,0,0,0,1,1,0,0,1,0,2,"H","N","2011-11-01","201111010DET"
"MIN",1,0,0,1,0,2,0,1,0,0,0,1,"A","N","2011-11-01","201111010DET"
"ANA",0,2,1,1,0,4,1,0,2,2,0,5,"A","N","2011-11-01","201111010WSH"
"WSH",1,0,2,2,0,5,0,2,1,1,0,4,"H","N","2011-11-01","201111010WSH"
"BUF",0,0,1,1,0,2,0,3,0,0,0,3,"H","N","2011-11-02","201111020BUF"
"PHI",0,3,0,0,0,3,0,0,1,1,0,2,"A","N","2011-11-02","201111020BUF"
"COL",0,0,1,0,0,1,0,1,1,2,0,4,"H","N","2011-11-02","201111020COL"
"PHX",0,1,1,2,0,4,0,0,1,0,0,1,"A","N","2011-11-02","201111020COL"
"NJD",0,1,2,0,0,3,0,2,3,0,0,5,"H","N","2011-11-02","201111020NJD"
"TOR",0,2,3,0,0,5,0,1,2,0,0,3,"A","N","2011-11-02","201111020NJD"
"CBJ",0,0,1,0,0,1,0,2,2,0,0,4,"H","N","2011-11-03","201111030CBJ"
"TOR",0,2,2,0,0,4,0,0,1,0,0,1,"A","N","2011-11-03","201111030CBJ"
"CGY",0,1,1,2,0,4,0,0,1,0,0,1,"A","N","2011-11-03","201111030DET"
"DET",0,0,1,0,0,1,0,1,1,2,0,4,"H","N","2011-11-03","201111030DET"
"CHI",0,1,1,0,1,3,0,0,1,1,0,2,"A","Y","2011-11-03","201111030FLA"
"FLA",0,0,1,1,0,2,0,1,1,0,1,3,"H","Y","2011-11-03","201111030FLA"
"EDM",0,0,2,1,0,3,0,0,0,0,0,0,"A","N","2011-11-03","201111030LAK"
"LAK",0,0,0,0,0,0,0,0,2,1,0,3,"H","N","2011-11-03","201111030LAK"
"MIN",0,0,3,2,0,5,0,1,0,0,0,1,"H","N","2011-11-03","201111030MIN"
"VAN",0,1,0,0,0,1,0,0,3,2,0,5,"A","N","2011-11-03","201111030MIN"
"NYI",0,0,0,0,0,0,0,1,0,2,0,3,"H","N","2011-11-03","201111030NYI"
"WPG",0,1,0,2,0,3,0,0,0,0,0,0,"A","N","2011-11-03","201111030NYI"
"ANA",0,0,1,0,0,1,0,1,0,0,1,2,"A","Y","2011-11-03","201111030NYR"
"NYR",0,1,0,0,1,2,0,0,1,0,0,1,"H","Y","2011-11-03","201111030NYR"
"NJD",0,0,2,1,1,4,0,0,2,1,0,3,"A","Y","2011-11-03","201111030PHI"
"PHI",0,0,2,1,0,3,0,0,2,1,1,4,"H","Y","2011-11-03","201111030PHI"
"NSH",0,0,2,1,0,3,0,0,0,0,0,0,"A","N","2011-11-03","201111030PHX"
"PHX",0,0,0,0,0,0,0,0,2,1,0,3,"H","N","2011-11-03","201111030PHX"
"PIT",0,2,1,0,0,3,0,0,1,2,1,4,"A","Y","2011-11-03","201111030SJS"
"SJS",0,0,1,2,1,4,0,2,1,0,0,3,"H","Y","2011-11-03","201111030SJS"
"BUF",0,1,0,1,0,2,0,0,0,1,0,1,"H","N","2011-11-04","201111040BUF"
"CGY",0,0,0,1,0,1,0,1,0,1,0,2,"A","N","2011-11-04","201111040BUF"
"CAR",0,1,0,0,0,1,0,0,2,3,0,5,"H","N","2011-11-04","201111040CAR"
"WSH",0,0,2,3,0,5,0,1,0,0,0,1,"A","N","2011-11-04","201111040CAR"
"COL",0,2,2,2,0,6,1,0,4,2,0,7,"A","N","2011-11-04","201111040DAL"
"DAL",1,0,4,2,0,7,0,2,2,2,0,6,"H","N","2011-11-04","201111040DAL"
"MTL",0,0,2,0,0,2,0,0,0,1,0,1,"A","N","2011-11-04","201111040OTT"
"OTT",0,0,0,1,0,1,0,0,2,0,0,2,"H","N","2011-11-04","201111040OTT"
"STL",0,1,1,1,0,3,0,1,0,1,0,2,"H","N","2011-11-04","201111040STL"
"VAN",0,1,0,1,0,2,0,1,1,1,0,3,"A","N","2011-11-04","201111040STL"
"CHI",0,0,4,0,0,4,1,0,4,0,0,5,"A","N","2011-11-04","201111040TBL"
"TBL",1,0,4,0,0,5,0,0,4,0,0,4,"H","N","2011-11-04","201111040TBL"
"ANA",0,0,0,0,0,0,0,1,2,2,0,5,"A","N","2011-11-05","201111050DET"
"DET",0,1,2,2,0,5,0,0,0,0,0,0,"H","N","2011-11-05","201111050DET"
"LAK",0,0,1,1,0,2,0,1,0,1,1,3,"H","Y","2011-11-05","201111050LAK"
"PIT",0,1,0,1,1,3,0,0,1,1,0,2,"A","Y","2011-11-05","201111050LAK"
"MIN",0,0,2,0,0,2,0,0,0,1,0,1,"H","N","2011-11-05","201111050MIN"
"STL",0,0,0,1,0,1,0,0,2,0,0,2,"A","N","2011-11-05","201111050MIN"
"NJD",1,0,2,0,0,3,0,0,0,2,0,2,"H","N","2011-11-05","201111050NJD"
"WPG",0,0,0,2,0,2,1,0,2,0,0,3,"A","N","2011-11-05","201111050NJD"
"NYI",0,0,2,3,0,5,0,2,0,1,0,3,"H","N","2011-11-05","201111050NYI"
"WSH",0,2,0,1,0,3,0,0,2,3,0,5,"A","N","2011-11-05","201111050NYI"
"MTL",0,0,2,1,0,3,0,3,1,1,0,5,"A","N","2011-11-05","201111050NYR"
"NYR",0,3,1,1,0,5,0,0,2,1,0,3,"H","N","2011-11-05","201111050NYR"
"BUF",0,0,2,0,1,3,0,1,1,0,0,2,"A","Y","2011-11-05","201111050OTT"
"OTT",0,1,1,0,0,2,0,0,2,0,1,3,"H","Y","2011-11-05","201111050OTT"
"CBJ",0,0,0,2,0,2,0,5,3,1,0,9,"A","N","2011-11-05","201111050PHI"
"PHI",0,5,3,1,0,9,0,0,0,2,0,2,"H","N","2011-11-05","201111050PHI"
"EDM",0,0,0,2,0,2,0,0,2,2,0,4,"A","N","2011-11-05","201111050PHX"
"PHX",0,0,2,2,0,4,0,0,0,2,0,2,"H","N","2011-11-05","201111050PHX"
"NSH",1,0,1,2,0,4,0,0,2,1,0,3,"A","N","2011-11-05","201111050SJS"
"SJS",0,0,2,1,0,3,1,0,1,2,0,4,"H","N","2011-11-05","201111050SJS"
"BOS",0,1,4,2,0,7,0,0,0,0,0,0,"A","N","2011-11-05","201111050TOR"
"TOR",0,0,0,0,0,0,0,1,4,2,0,7,"H","N","2011-11-05","201111050TOR"
"CAR",0,1,0,1,0,2,0,3,2,0,0,5,"H","N","2011-11-06","201111060CAR"
"DAL",0,3,2,0,0,5,0,1,0,1,0,2,"A","N","2011-11-06","201111060CAR"
"CHI",0,1,1,0,0,2,0,1,4,1,0,6,"H","N","2011-11-06","201111060CHI"
"VAN",0,1,4,1,0,6,0,1,1,0,0,2,"A","N","2011-11-06","201111060CHI"
"CGY",0,1,1,0,0,2,0,1,0,0,0,1,"A","N","2011-11-06","201111060COL"
"COL",0,1,0,0,0,1,0,1,1,0,0,2,"H","N","2011-11-06","201111060COL"
"FLA",0,3,0,0,0,3,0,0,2,1,1,4,"H","Y","2011-11-06","201111060FLA"
"TBL",0,0,2,1,1,4,0,3,0,0,0,3,"A","Y","2011-11-06","201111060FLA"
"NYR",0,0,1,2,0,3,0,0,0,0,0,0,"H","N","2011-11-06","201111060NYR"
"WPG",0,0,0,0,0,0,0,0,1,2,0,3,"A","N","2011-11-06","201111060NYR"
"BOS",0,3,0,3,0,6,0,2,0,0,0,2,"H","N","2011-11-07","201111070BOS"
"NYI",0,2,0,0,0,2,0,3,0,3,0,6,"A","N","2011-11-07","201111070BOS"
"LAK",0,0,1,1,0,2,0,0,3,1,0,4,"A","N","2011-11-07","201111070SJS"
"SJS",0,0,3,1,0,4,0,0,1,1,0,2,"H","N","2011-11-07","201111070SJS"
"BUF",1,3,1,1,0,6,0,3,1,1,0,5,"H","N","2011-11-08","201111080BUF"
"WPG",0,3,1,1,0,5,1,3,1,1,0,6,"A","N","2011-11-08","201111080BUF"
"CGY",0,0,0,0,0,0,0,1,1,1,0,3,"H","N","2011-11-08","201111080CGY"
"MIN",0,1,1,1,0,3,0,0,0,0,0,0,"A","N","2011-11-08","201111080CGY"
"COL",0,0,1,1,0,2,0,1,2,2,0,5,"A","N","2011-11-08","201111080DET"
"DET",0,1,2,2,0,5,0,0,1,1,0,2,"H","N","2011-11-08","201111080DET"
"LAK",0,2,2,0,0,4,0,2,0,1,0,3,"H","N","2011-11-08","201111080LAK"
"NSH",0,2,0,1,0,3,0,2,2,0,0,4,"A","N","2011-11-08","201111080LAK"
"EDM",0,0,1,2,0,3,0,0,0,1,0,1,"A","N","2011-11-08","201111080MTL"
"MTL",0,0,0,1,0,1,0,0,1,2,0,3,"H","N","2011-11-08","201111080MTL"
"CAR",0,1,0,1,0,2,0,0,1,2,0,3,"A","N","2011-11-08","201111080NJD"
"NJD",0,0,1,2,0,3,0,1,0,1,0,2,"H","N","2011-11-08","201111080NJD"
"CHI",0,0,0,0,0,0,0,1,1,1,0,3,"A","N","2011-11-08","201111080STL"
"STL",0,1,1,1,0,3,0,0,0,0,0,0,"H","N","2011-11-08","201111080STL"
"FLA",0,1,2,2,0,5,0,0,0,1,0,1,"A","N","2011-11-08","201111080TOR"
"TOR",0,0,0,1,0,1,0,1,2,2,0,5,"H","N","2011-11-08","201111080TOR"
"DAL",0,2,0,3,0,5,0,1,1,0,0,2,"A","N","2011-11-08","201111080WSH"
"WSH",0,1,1,0,0,2,0,2,0,3,0,5,"H","N","2011-11-08","201111080WSH"
"ANA",0,1,1,0,0,2,0,2,1,1,0,4,"H","N","2011-11-09","201111090ANA"
"NSH",0,2,1,1,0,4,0,1,1,0,0,2,"A","N","2011-11-09","201111090ANA"
"NYR",0,0,2,1,0,3,0,0,1,1,0,2,"A","N","2011-11-09","201111090OTT"
"OTT",0,0,1,1,0,2,0,0,2,1,0,3,"H","N","2011-11-09","201111090OTT"
"PHI",0,0,1,0,0,1,1,0,0,1,0,2,"A","N","2011-11-09","201111090TBL"
"TBL",1,0,0,1,0,2,0,0,1,0,0,1,"H","N","2011-11-09","201111090TBL"
"BOS",0,2,2,2,0,6,0,2,0,1,0,3,"H","N","2011-11-10","201111100BOS"
"EDM",0,2,0,1,0,3,0,2,2,2,0,6,"A","N","2011-11-10","201111100BOS"
"CBJ",0,1,0,2,0,3,0,2,3,1,0,6,"H","N","2011-11-10","201111100CBJ"
"CHI",0,2,3,1,0,6,0,1,0,2,0,3,"A","N","2011-11-10","201111100CBJ"
"COL",1,0,1,2,0,4,0,1,2,0,0,3,"H","N","2011-11-10","201111100COL"
"NYI",0,1,2,0,0,3,1,0,1,2,0,4,"A","N","2011-11-10","201111100COL"
"LAK",0,0,1,1,0,2,0,3,0,0,0,3,"H","N","2011-11-10","201111100LAK"
"VAN",0,3,0,0,0,3,0,0,1,1,0,2,"A","N","2011-11-10","201111100LAK"
"MTL",1,0,2,0,0,3,0,1,0,1,0,2,"A","N","2011-11-10","201111100PHX"
"PHX",0,1,0,1,0,2,1,0,2,0,0,3,"H","N","2011-11-10","201111100PHX"
"MIN",0,0,0,1,0,1,0,0,3,0,0,3,"A","N","2011-11-10","201111100SJS"
"SJS",0,0,3,0,0,3,0,0,0,1,0,1,"H","N","2011-11-10","201111100SJS"
"STL",0,0,1,1,0,2,0,2,0,0,1,3,"H","Y","2011-11-10","201111100STL"
"TOR",0,2,0,0,1,3,0,0,1,1,0,2,"A","Y","2011-11-10","201111100STL"
"FLA",0,2,2,1,0,5,0,0,0,2,0,2,"A","N","2011-11-10","201111100WPG"
"WPG",0,0,0,2,0,2,0,2,2,1,0,5,"H","N","2011-11-10","201111100WPG"
"ANA",0,0,4,0,0,4,0,0,0,3,0,3,"H","N","2011-11-11","201111110ANA"
"VAN",0,0,0,3,0,3,0,0,4,0,0,4,"A","N","2011-11-11","201111110ANA"
"BUF",0,3,0,2,0,5,0,1,0,0,0,1,"H","N","2011-11-11","201111110BUF"
"OTT",0,1,0,0,0,1,0,3,0,2,0,5,"A","N","2011-11-11","201111110BUF"
"CGY",0,0,0,1,0,1,0,1,1,2,0,4,"A","N","2011-11-11","201111110CHI"
"CHI",0,1,1,2,0,4,0,0,0,1,0,1,"H","N","2011-11-11","201111110CHI"
"DET",0,1,1,1,0,3,0,0,0,0,0,0,"H","N","2011-11-11","201111110DET"
"EDM",0,0,0,0,0,0,0,1,1,1,0,3,"A","N","2011-11-11","201111110DET"
"NJD",0,1,0,0,0,1,0,0,1,2,0,3,"H","N","2011-11-11","201111110NJD"
"WSH",0,0,1,2,0,3,0,1,0,0,0,1,"A","N","2011-11-11","201111110NJD"
"CAR",0,0,1,0,0,1,0,1,0,4,0,5,"A","N","2011-11-11","201111110NYR"
"NYR",0,1,0,4,0,5,0,0,1,0,0,1,"H","N","2011-11-11","201111110NYR"
"DAL",0,1,0,0,0,1,0,0,1,2,0,3,"A","N","2011-11-11","201111110PIT"
"PIT",0,0,1,2,0,3,0,1,0,0,0,1,"H","N","2011-11-11","201111110PIT"
"BOS",0,0,3,3,0,6,0,1,0,1,0,2,"H","N","2011-11-12","201111120BOS"
"BUF",0,1,0,1,0,2,0,0,3,3,0,6,"A","N","2011-11-12","201111120BOS"
"CAR",0,1,2,2,0,5,0,0,0,3,0,3,"H","N","2011-11-12","201111120CAR"
"PIT",0,0,0,3,0,3,0,1,2,2,0,5,"A","N","2011-11-12","201111120CAR"
"CBJ",0,1,0,1,0,2,0,0,0,1,0,1,"H","N","2011-11-12","201111120CBJ"
"WPG",0,0,0,1,0,1,0,1,0,1,0,2,"A","N","2011-11-12","201111120CBJ"
"CGY",0,3,1,0,0,4,0,0,1,2,0,3,"A","N","2011-11-12","201111120COL"
"COL",0,0,1,2,0,3,0,3,1,0,0,4,"H","N","2011-11-12","201111120COL"
"DAL",0,1,1,0,0,2,0,1,1,3,0,5,"A","N","2011-11-12","201111120DET"
"DET",0,1,1,3,0,5,0,1,1,0,0,2,"H","N","2011-11-12","201111120DET"
"LAK",0,1,4,0,0,5,0,0,0,2,0,2,"H","N","2011-11-12","201111120LAK"
"MIN",0,0,0,2,0,2,0,1,4,0,0,5,"A","N","2011-11-12","201111120LAK"
"MTL",1,1,0,0,0,2,0,0,1,0,0,1,"A","N","2011-11-12","201111120NSH"
"NSH",0,0,1,0,0,1,1,1,0,0,0,2,"H","N","2011-11-12","201111120NSH"
"PHX",0,2,0,1,0,3,0,0,0,0,0,0,"A","N","2011-11-12","201111120SJS"
"SJS",0,0,0,0,0,0,0,2,0,1,0,3,"H","N","2011-11-12","201111120SJS"
"STL",0,1,1,1,0,3,0,0,0,0,0,0,"H","N","2011-11-12","201111120STL"
"TBL",0,0,0,0,0,0,0,1,1,1,0,3,"A","N","2011-11-12","201111120STL"
"OTT",0,0,2,3,0,5,0,1,0,1,0,2,"A","N","2011-11-12","201111120TOR"
"TOR",0,1,0,1,0,2,0,0,2,3,0,5,"H","N","2011-11-12","201111120TOR"
"NJD",0,0,2,0,1,3,0,2,0,0,0,2,"A","Y","2011-11-12","201111120WSH"
"WSH",0,2,0,0,0,2,0,0,2,0,1,3,"H","Y","2011-11-12","201111120WSH"
"ANA",0,0,1,1,0,2,0,3,0,0,0,3,"H","N","2011-11-13","201111130ANA"
"MIN",0,3,0,0,0,3,0,0,1,1,0,2,"A","N","2011-11-13","201111130ANA"
"CHI",0,3,2,1,0,6,0,1,2,0,0,3,"H","N","2011-11-13","201111130CHI"
"EDM",0,1,2,0,0,3,0,3,2,1,0,6,"A","N","2011-11-13","201111130CHI"
"FLA",0,0,1,1,0,2,0,1,1,1,0,3,"H","N","2011-11-13","201111130FLA"
"PHI",0,1,1,1,0,3,0,0,1,1,0,2,"A","N","2011-11-13","201111130FLA"
"NYI",0,0,1,0,0,1,0,1,1,2,0,4,"A","N","2011-11-13","201111130VAN"
"VAN",0,1,1,2,0,4,0,0,1,0,0,1,"H","N","2011-11-13","201111130VAN"
"CAR",0,1,1,1,0,3,0,2,2,1,0,5,"H","N","2011-11-14","201111140CAR"
"PHI",0,2,2,1,0,5,0,1,1,1,0,3,"A","N","2011-11-14","201111140CAR"
"BUF",0,0,0,2,1,3,0,0,2,0,0,2,"A","Y","2011-11-14","201111140MTL"
"MTL",0,0,2,0,0,2,0,0,0,2,1,3,"H","Y","2011-11-14","201111140MTL"
"TBL",0,0,1,1,0,2,0,2,2,1,0,5,"A","N","2011-11-14","201111140WPG"
"WPG",0,2,2,1,0,5,0,0,1,1,0,2,"H","N","2011-11-14","201111140WPG"
"BOS",0,0,1,3,0,4,0,0,1,2,0,3,"H","N","2011-11-15","201111150BOS"
"NJD",0,0,1,2,0,3,0,0,1,3,0,4,"A","N","2011-11-15","201111150BOS"
"CBJ",0,2,0,0,0,2,0,0,2,2,0,4,"H","N","2011-11-15","201111150CBJ"
"MIN",0,0,2,2,0,4,0,2,0,0,0,2,"A","N","2011-11-15","201111150CBJ"
"CGY",0,0,1,0,0,1,0,0,1,2,0,3,"H","N","2011-11-15","201111150CGY"
"OTT",0,0,1,2,0,3,0,0,1,0,0,1,"A","N","2011-11-15","201111150CGY"
"DAL",0,0,0,0,0,0,0,2,2,2,0,6,"H","N","2011-11-15","201111150DAL"
"FLA",0,2,2,2,0,6,0,0,0,0,0,0,"A","N","2011-11-15","201111150DAL"
"NSH",0,0,0,3,0,3,0,0,0,1,0,1,"H","N","2011-11-15","201111150NSH"
"WSH",0,0,0,1,0,1,0,0,0,3,0,3,"A","N","2011-11-15","201111150NSH"
"NYI",0,1,0,1,0,2,0,1,1,2,0,4,"H","N","2011-11-15","201111150NYI"
"NYR",0,1,1,2,0,4,0,1,0,1,0,2,"A","N","2011-11-15","201111150NYI"
"COL",0,3,0,0,0,3,0,1,1,4,0,6,"A","N","2011-11-15","201111150PIT"
"PIT",0,1,1,4,0,6,0,3,0,0,0,3,"H","N","2011-11-15","201111150PIT"
"DET",0,1,0,0,0,1,0,1,1,0,0,2,"A","N","2011-11-15","201111150STL"
"STL",0,1,1,0,0,2,0,1,0,0,0,1,"H","N","2011-11-15","201111150STL"
"PHX",0,2,0,0,1,3,0,0,0,2,0,2,"A","Y","2011-11-15","201111150TOR"
"TOR",0,0,0,2,0,2,0,2,0,0,1,3,"H","Y","2011-11-15","201111150TOR"
"BUF",0,1,0,2,0,3,0,2,1,2,0,5,"H","N","2011-11-16","201111160BUF"
"NJD",0,2,1,2,0,5,0,1,0,2,0,3,"A","N","2011-11-16","201111160BUF"
"ANA",0,0,0,1,0,1,0,0,1,0,1,2,"A","Y","2011-11-16","201111160LAK"
"LAK",0,0,1,0,1,2,0,0,0,1,0,1,"H","Y","2011-11-16","201111160LAK"
"CAR",0,0,0,0,0,0,0,2,2,0,0,4,"A","N","2011-11-16","201111160MTL"
"MTL",0,2,2,0,0,4,0,0,0,0,0,0,"H","N","2011-11-16","201111160MTL"
"CHI",0,0,2,3,0,5,0,0,1,0,0,1,"A","N","2011-11-16","201111160VAN"
"VAN",0,0,1,0,0,1,0,0,2,3,0,5,"H","N","2011-11-16","201111160VAN"
"ANA",0,0,1,2,0,3,0,0,2,3,0,5,"H","N","2011-11-17","201111170ANA"
"LAK",0,0,2,3,0,5,0,0,1,2,0,3,"A","N","2011-11-17","201111170ANA"
"BOS",0,0,1,0,1,2,0,0,1,0,0,1,"H","Y","2011-11-17","201111170BOS"
"CBJ",0,0,1,0,0,1,0,0,1,0,1,2,"A","Y","2011-11-17","201111170BOS"
"EDM",0,0,1,1,0,2,0,3,1,1,0,5,"H","N","2011-11-17","201111170EDM"
"OTT",0,3,1,1,0,5,0,0,1,1,0,2,"A","N","2011-11-17","201111170EDM"
"COL",0,0,0,0,0,0,0,0,0,1,0,1,"A","N","2011-11-17","201111170MIN"
"MIN",0,0,0,1,0,1,0,0,0,0,0,0,"H","N","2011-11-17","201111170MIN"
"NSH",0,1,1,2,0,4,0,0,1,0,0,1,"H","N","2011-11-17","201111170NSH"
"TOR",0,0,1,0,0,1,0,1,1,2,0,4,"A","N","2011-11-17","201111170NSH"
"MTL",0,0,2,1,0,3,0,0,4,0,0,4,"A","N","2011-11-17","201111170NYI"
"NYI",0,0,4,0,0,4,0,0,2,1,0,3,"H","N","2011-11-17","201111170NYI"
"PHI",0,0,1,1,0,2,0,0,0,1,0,1,"H","N","2011-11-17","201111170PHI"
"PHX",0,0,0,1,0,1,0,0,1,1,0,2,"A","N","2011-11-17","201111170PHI"
"DET",0,1,0,1,0,2,0,1,3,1,0,5,"A","N","2011-11-17","201111170SJS"
"SJS",0,1,3,1,0,5,0,1,0,1,0,2,"H","N","2011-11-17","201111170SJS"
"FLA",0,1,0,0,0,1,0,1,1,2,0,4,"A","N","2011-11-17","201111170STL"
"STL",0,1,1,2,0,4,0,1,0,0,0,1,"H","N","2011-11-17","201111170STL"
"PIT",0,0,0,1,0,1,0,1,1,2,0,4,"A","N","2011-11-17","201111170TBL"
"TBL",0,1,1,2,0,4,0,0,0,1,0,1,"H","N","2011-11-17","201111170TBL"
"WPG",0,1,3,0,0,4,0,1,0,0,0,1,"H","N","2011-11-17","201111170WPG"
"WSH",0,1,0,0,0,1,0,1,3,0,0,4,"A","N","2011-11-17","201111170WPG"
"BUF",0,1,0,0,0,1,0,0,0,0,0,0,"A","N","2011-11-18","201111180CAR"
"CAR",0,0,0,0,0,0,0,1,0,0,0,1,"H","N","2011-11-18","201111180CAR"
"CGY",0,1,3,1,0,5,0,1,1,0,0,2,"H","N","2011-11-18","201111180CGY"
"CHI",0,1,1,0,0,2,0,1,3,1,0,5,"A","N","2011-11-18","201111180CGY"
"COL",0,1,0,2,0,3,0,0,0,0,0,0,"H","N","2011-11-18","201111180COL"
"DAL",0,0,0,0,0,0,0,1,0,2,0,3,"A","N","2011-11-18","201111180COL"
"BUF",0,1,1,0,0,2,0,1,2,1,0,4,"H","N","2011-11-19","201111190BUF"
"PHX",0,1,2,1,0,4,0,1,1,0,0,2,"A","N","2011-11-19","201111190BUF"
"DAL",0,0,0,1,0,1,0,1,2,1,0,4,"H","N","2011-11-19","201111190DAL"
"SJS",0,1,2,1,0,4,0,0,0,1,0,1,"A","N","2011-11-19","201111190DAL"
"CHI",0,1,1,0,0,2,0,5,3,1,0,9,"A","N","2011-11-19","201111190EDM"
"EDM",0,5,3,1,0,9,0,1,1,0,0,2,"H","N","2011-11-19","201111190EDM"
"FLA",0,1,1,1,0,3,0,1,1,0,0,2,"H","N","2011-11-19","201111190FLA"
"PIT",0,1,1,0,0,2,0,1,1,1,0,3,"A","N","2011-11-19","201111190FLA"
"DET",0,1,2,1,0,4,0,1,0,0,0,1,"A","N","2011-11-19","201111190LAK"
"LAK",0,1,0,0,0,1,0,1,2,1,0,4,"H","N","2011-11-19","201111190LAK"
"MIN",0,0,1,1,1,3,0,1,0,1,0,2,"H","Y","2011-11-19","201111190MIN"
"STL",0,1,0,1,0,2,0,0,1,1,1,3,"A","Y","2011-11-19","201111190MIN"
"MTL",0,1,1,2,0,4,0,0,0,0,0,0,"H","N","2011-11-19","201111190MTL"
"NYR",0,0,0,0,0,0,0,1,1,2,0,4,"A","N","2011-11-19","201111190MTL"
"CBJ",1,0,2,1,0,4,0,1,1,1,0,3,"A","N","2011-11-19","201111190NSH"
"NSH",0,1,1,1,0,3,1,0,2,1,0,4,"H","N","2011-11-19","201111190NSH"
"BOS",0,3,0,3,0,6,0,0,0,0,0,0,"A","N","2011-11-19","201111190NYI"
"NYI",0,0,0,0,0,0,0,3,0,3,0,6,"H","N","2011-11-19","201111190NYI"
"NJD",0,0,3,1,0,4,0,0,0,2,0,2,"A","N","2011-11-19","201111190TBL"
"TBL",0,0,0,2,0,2,0,0,3,1,0,4,"H","N","2011-11-19","201111190TBL"
"TOR",0,2,4,1,0,7,0,1,0,0,0,1,"H","N","2011-11-19","201111190TOR"
"WSH",0,1,0,0,0,1,0,2,4,1,0,7,"A","N","2011-11-19","201111190TOR"
"PHI",0,1,1,2,0,4,0,3,2,1,0,6,"A","N","2011-11-19","201111190WPG"
"WPG",0,3,2,1,0,6,0,1,1,2,0,4,"H","N","2011-11-19","201111190WPG"
"ANA",0,0,2,0,0,2,0,1,2,1,0,4,"H","N","2011-11-20","201111200ANA"
"DET",0,1,2,1,0,4,0,0,2,0,0,2,"A","N","2011-11-20","201111200ANA"
"CAR",0,1,1,1,0,3,0,0,0,2,0,2,"H","N","2011-11-20","201111200CAR"
"TOR",0,0,0,2,0,2,0,1,1,1,0,3,"A","N","2011-11-20","201111200CAR"
"COL",0,1,0,0,0,1,0,1,2,1,0,4,"H","N","2011-11-20","201111200COL"
"SJS",0,1,2,1,0,4,0,1,0,0,0,1,"A","N","2011-11-20","201111200COL"
"OTT",0,0,0,1,0,1,1,0,1,0,0,2,"A","N","2011-11-20","201111200VAN"
"VAN",1,0,1,0,0,2,0,0,0,1,0,1,"H","N","2011-11-20","201111200VAN"
"CBJ",0,2,1,1,0,4,0,0,1,0,0,1,"H","N","2011-11-21","201111210CBJ"
"CGY",0,0,1,0,0,1,0,2,1,1,0,4,"A","N","2011-11-21","201111210CBJ"
"DAL",0,1,2,1,0,4,0,0,1,0,0,1,"H","N","2011-11-21","201111210DAL"
"EDM",0,0,1,0,0,1,0,1,2,1,0,4,"A","N","2011-11-21","201111210DAL"
"FLA",0,0,2,2,0,4,0,3,0,0,0,3,"H","N","2011-11-21","201111210FLA"
"NJD",0,3,0,0,0,3,0,0,2,2,0,4,"A","N","2011-11-21","201111210FLA"
"BOS",0,1,0,0,0,1,0,0,0,0,0,0,"A","N","2011-11-21","201111210MTL"
"MTL",0,0,0,0,0,0,0,1,0,0,0,1,"H","N","2011-11-21","201111210MTL"
"CAR",0,2,2,0,0,4,0,0,2,0,0,2,"A","N","2011-11-21","201111210PHI"
"PHI",0,0,2,0,0,2,0,2,2,0,0,4,"H","N","2011-11-21","201111210PHI"
"NYI",0,0,0,0,0,0,0,2,2,1,0,5,"A","N","2011-11-21","201111210PIT"
"PIT",0,2,2,1,0,5,0,0,0,0,0,0,"H","N","2011-11-21","201111210PIT"
"PHX",0,1,1,1,0,3,0,0,2,2,0,4,"A","N","2011-11-21","201111210WSH"
"WSH",0,0,2,2,0,4,0,1,1,1,0,3,"H","N","2011-11-21","201111210WSH"
"EDM",0,3,0,3,0,6,0,0,0,2,0,2,"A","N","2011-11-22","201111220NSH"
"NSH",0,0,0,2,0,2,0,3,0,3,0,6,"H","N","2011-11-22","201111220NSH"
"LAK",0,0,1,2,0,3,0,1,0,1,0,2,"A","N","2011-11-22","201111220STL"
"STL",0,1,0,1,0,2,0,0,1,2,0,3,"H","N","2011-11-22","201111220STL"
"TBL",0,1,0,0,0,1,0,3,1,3,0,7,"H","N","2011-11-22","201111220TBL"
"TOR",0,3,1,3,0,7,0,1,0,0,0,1,"A","N","2011-11-22","201111220TBL"
"BOS",0,0,2,1,1,4,0,2,1,0,0,3,"A","Y","2011-11-23","201111230BUF"
"BUF",0,2,1,0,0,3,0,0,2,1,1,4,"H","Y","2011-11-23","201111230BUF"
"CAR",0,2,0,1,0,3,0,0,1,2,1,4,"H","Y","2011-11-23","201111230CAR"
"MTL",0,0,1,2,1,4,0,2,0,1,0,3,"A","Y","2011-11-23","201111230CAR"
"COL",0,0,0,0,0,0,0,1,1,1,0,3,"H","N","2011-11-23","201111230COL"
"VAN",0,1,1,1,0,3,0,0,0,0,0,0,"A","N","2011-11-23","201111230COL"
"DAL",1,0,0,2,0,3,0,0,2,0,0,2,"H","N","2011-11-23","201111230DAL"
"LAK",0,0,2,0,0,2,1,0,0,2,0,3,"A","N","2011-11-23","201111230DAL"
"CGY",0,0,2,1,0,3,0,1,1,3,0,5,"A","N","2011-11-23","201111230DET"
"DET",0,1,1,3,0,5,0,0,2,1,0,3,"H","N","2011-11-23","201111230DET"
"FLA",0,1,1,0,0,2,0,0,1,0,0,1,"H","N","2011-11-23","201111230FLA"
"NYR",0,0,1,0,0,1,0,1,1,0,0,2,"A","N","2011-11-23","201111230FLA"
"MIN",0,0,0,3,0,3,0,1,0,1,0,2,"H","N","2011-11-23","201111230MIN"
"NSH",0,1,0,1,0,2,0,0,0,3,0,3,"A","N","2011-11-23","201111230MIN"
"CBJ",0,0,0,1,0,1,0,0,1,0,1,2,"A","Y","2011-11-23","201111230NJD"
"NJD",0,0,1,0,1,2,0,0,0,1,0,1,"H","Y","2011-11-23","201111230NJD"
"NYI",0,3,0,0,0,3,1,1,1,1,0,4,"H","N","2011-11-23","201111230NYI"
"PHI",1,1,1,1,0,4,0,3,0,0,0,3,"A","N","2011-11-23","201111230NYI"
"ANA",0,1,0,1,0,2,0,2,1,1,0,4,"A","N","2011-11-23","201111230PHX"
"PHX",0,2,1,1,0,4,0,1,0,1,0,2,"H","N","2011-11-23","201111230PHX"
"PIT",0,0,0,2,0,2,1,1,0,1,0,3,"H","N","2011-11-23","201111230PIT"
"STL",1,1,0,1,0,3,0,0,0,2,0,2,"A","N","2011-11-23","201111230PIT"
"CHI",0,0,0,0,0,0,0,0,1,0,0,1,"A","N","2011-11-23","201111230SJS"
"SJS",0,0,1,0,0,1,0,0,0,0,0,0,"H","N","2011-11-23","201111230SJS"
"WPG",0,2,0,1,0,3,1,2,1,0,0,4,"A","N","2011-11-23","201111230WSH"
"WSH",1,2,1,0,0,4,0,2,0,1,0,3,"H","N","2011-11-23","201111230WSH"
"ANA",0,3,1,1,0,5,0,2,0,4,0,6,"H","N","2011-11-25","201111250ANA"
"CHI",0,2,0,4,0,6,0,3,1,1,0,5,"A","N","2011-11-25","201111250ANA"
"BOS",0,0,1,1,0,2,0,1,1,0,1,3,"H","Y","2011-11-25","201111250BOS"
"DET",0,1,1,0,1,3,0,0,1,1,0,2,"A","Y","2011-11-25","201111250BOS"
"CAR",0,0,1,0,0,1,0,1,1,1,0,3,"H","N","2011-11-25","201111250CAR"
"WPG",0,1,1,1,0,3,0,0,1,0,0,1,"A","N","2011-11-25","201111250CAR"
"BUF",0,0,1,0,0,1,0,2,3,0,0,5,"A","N","2011-11-25","201111250CBJ"
"CBJ",0,2,3,0,0,5,0,0,1,0,0,1,"H","N","2011-11-25","201111250CBJ"
"DAL",0,1,1,1,0,3,0,2,0,1,1,4,"H","Y","2011-11-25","201111250DAL"
"TOR",0,2,0,1,1,4,0,1,1,1,0,3,"A","Y","2011-11-25","201111250DAL"
"FLA",0,0,1,0,0,1,1,0,0,1,0,2,"H","N","2011-11-25","201111250FLA"
"TBL",1,0,0,1,0,2,0,0,1,0,0,1,"A","N","2011-11-25","201111250FLA"
"EDM",0,2,1,2,0,5,0,1,1,0,0,2,"A","N","2011-11-25","201111250MIN"
"MIN",0,1,1,0,0,2,0,2,1,2,0,5,"H","N","2011-11-25","201111250MIN"
"NJD",0,0,1,0,0,1,0,0,0,0,0,0,"A","N","2011-11-25","201111250NYI"
"NYI",0,0,0,0,0,0,0,0,1,0,0,1,"H","N","2011-11-25","201111250NYI"
"MTL",0,1,0,0,0,1,0,0,3,0,0,3,"A","N","2011-11-25","201111250PHI"
"PHI",0,0,3,0,0,3,0,1,0,0,0,1,"H","N","2011-11-25","201111250PHI"
"PHX",0,0,0,0,0,0,0,0,3,2,0,5,"H","N","2011-11-25","201111250PHX"
"VAN",0,0,3,2,0,5,0,0,0,0,0,0,"A","N","2011-11-25","201111250PHX"
"OTT",0,1,1,1,0,3,0,4,1,1,0,6,"A","N","2011-11-25","201111250PIT"
"PIT",0,4,1,1,0,6,0,1,1,1,0,3,"H","N","2011-11-25","201111250PIT"
"CGY",0,0,0,0,0,0,0,1,0,1,0,2,"A","N","2011-11-25","201111250STL"
"STL",0,1,0,1,0,2,0,0,0,0,0,0,"H","N","2011-11-25","201111250STL"
"NYR",0,0,4,2,0,6,0,0,2,1,0,3,"A","N","2011-11-25","201111250WSH"
"WSH",0,0,2,1,0,3,0,0,4,2,0,6,"H","N","2011-11-25","201111250WSH"
"BOS",0,1,2,1,0,4,0,2,0,0,0,2,"H","N","2011-11-26","201111260BOS"
"WPG",0,2,0,0,0,2,0,1,2,1,0,4,"A","N","2011-11-26","201111260BOS"
"BUF",0,2,1,2,0,5,0,0,1,0,0,1,"H","N","2011-11-26","201111260BUF"
"WSH",0,0,1,0,0,1,0,2,1,2,0,5,"A","N","2011-11-26","201111260BUF"
"COL",0,1,0,4,0,5,0,1,1,0,0,2,"H","N","2011-11-26","201111260COL"
"EDM",0,1,1,0,0,2,0,1,0,4,0,5,"A","N","2011-11-26","201111260COL"
"DET",0,1,2,1,0,4,0,0,0,1,0,1,"H","N","2011-11-26","201111260DET"
"NSH",0,0,0,1,0,1,0,1,2,1,0,4,"A","N","2011-11-26","201111260DET"
"CHI",0,1,1,0,0,2,0,0,1,0,0,1,"A","N","2011-11-26","201111260LAK"
"LAK",0,0,1,0,0,1,0,1,1,0,0,2,"H","N","2011-11-26","201111260LAK"
"MTL",0,2,1,0,0,3,1,1,1,1,0,4,"H","N","2011-11-26","201111260MTL"
"PIT",1,1,1,1,0,4,0,2,1,0,0,3,"A","N","2011-11-26","201111260MTL"
"NJD",0,0,1,1,0,2,0,1,1,1,0,3,"H","N","2011-11-26","201111260NJD"
"NYI",0,1,1,1,0,3,0,0,1,1,0,2,"A","N","2011-11-26","201111260NJD"
"NYR",0,0,1,1,0,2,0,0,0,0,0,0,"H","N","2011-11-26","201111260NYR"
"PHI",0,0,0,0,0,0,0,0,1,1,0,2,"A","N","2011-11-26","201111260NYR"
"DAL",0,0,0,0,0,0,0,1,1,1,0,3,"A","N","2011-11-26","201111260PHX"
"PHX",0,1,1,1,0,3,0,0,0,0,0,0,"H","N","2011-11-26","201111260PHX"
"SJS",0,1,0,1,0,2,0,1,2,0,0,3,"H","N","2011-11-26","201111260SJS"
"VAN",0,1,2,0,0,3,0,1,0,1,0,2,"A","N","2011-11-26","201111260SJS"
"FLA",0,0,0,1,0,1,0,1,3,1,0,5,"A","N","2011-11-26","201111260TBL"
"TBL",0,1,3,1,0,5,0,0,0,1,0,1,"H","N","2011-11-26","201111260TBL"
"ANA",0,1,0,1,0,2,0,2,1,2,0,5,"H","N","2011-11-27","201111270ANA"
"TOR",0,2,1,2,0,5,0,1,0,1,0,2,"A","N","2011-11-27","201111270ANA"
"CBJ",0,0,1,0,0,1,0,0,1,1,0,2,"H","N","2011-11-27","201111270CBJ"
"STL",0,0,1,1,0,2,0,0,1,0,0,1,"A","N","2011-11-27","201111270CBJ"
"CGY",0,3,0,2,0,5,0,2,0,0,0,2,"A","N","2011-11-27","201111270MIN"
"MIN",0,2,0,0,0,2,0,3,0,2,0,5,"H","N","2011-11-27","201111270MIN"
"CAR",0,1,0,2,0,3,0,2,1,1,0,4,"A","N","2011-11-27","201111270OTT"
"OTT",0,2,1,1,0,4,0,1,0,2,0,3,"H","N","2011-11-27","201111270OTT"
"COL",0,0,0,1,0,1,0,1,0,2,0,3,"H","N","2011-11-28","201111280COL"
"DAL",0,1,0,2,0,3,0,0,0,1,0,1,"A","N","2011-11-28","201111280COL"
"EDM",0,1,0,0,0,1,0,0,1,1,0,2,"H","N","2011-11-28","201111280EDM"
"NSH",0,0,1,1,0,2,0,1,0,0,0,1,"A","N","2011-11-28","201111280EDM"
"LAK",0,1,1,0,0,2,0,0,0,0,0,0,"H","N","2011-11-28","201111280LAK"
"SJS",0,0,0,0,0,0,0,1,1,0,0,2,"A","N","2011-11-28","201111280LAK"
"MIN",0,0,2,1,0,3,0,0,1,0,0,1,"H","N","2011-11-28","201111280MIN"
"TBL",0,0,1,0,0,1,0,0,2,1,0,3,"A","N","2011-11-28","201111280MIN"
"BUF",0,0,0,1,0,1,0,1,0,1,0,2,"H","N","2011-11-29","201111290BUF"
"NYI",0,1,0,1,0,2,0,0,0,1,0,1,"A","N","2011-11-29","201111290BUF"
"CAR",0,0,1,0,0,1,0,0,1,2,0,3,"H","N","2011-11-29","201111290CAR"
"FLA",0,0,1,2,0,3,0,0,1,0,0,1,"A","N","2011-11-29","201111290CAR"
"CGY",0,1,0,0,0,1,0,0,0,0,0,0,"H","N","2011-11-29","201111290CGY"
"NSH",0,0,0,0,0,0,0,1,0,0,0,1,"A","N","2011-11-29","201111290CGY"
"CHI",0,0,0,1,0,1,0,1,1,2,0,4,"H","N","2011-11-29","201111290CHI"
"PHX",0,1,1,2,0,4,0,0,0,1,0,1,"A","N","2011-11-29","201111290CHI"
"NYR",0,0,4,0,0,4,0,1,1,1,0,3,"H","N","2011-11-29","201111290NYR"
"PIT",0,1,1,1,0,3,0,0,4,0,0,4,"A","N","2011-11-29","201111290NYR"
"CBJ",0,0,0,1,0,1,0,2,0,2,0,4,"A","N","2011-11-29","201111290VAN"
"VAN",0,2,0,2,0,4,0,0,0,1,0,1,"H","N","2011-11-29","201111290VAN"
"OTT",0,1,2,3,0,6,0,0,2,2,0,4,"A","N","2011-11-29","201111290WPG"
"WPG",0,0,2,2,0,4,0,1,2,3,0,6,"H","N","2011-11-29","201111290WPG"
"STL",0,1,1,0,0,2,0,1,0,0,0,1,"A","N","2011-11-29","201111290WSH"
"WSH",0,1,0,0,0,1,0,1,1,0,0,2,"H","N","2011-11-29","201111290WSH"
"ANA",0,1,1,2,0,4,0,1,0,0,0,1,"H","N","2011-11-30","201111300ANA"
"MTL",0,1,0,0,0,1,0,1,1,2,0,4,"A","N","2011-11-30","201111300ANA"
"COL",0,3,0,3,0,6,0,0,1,0,0,1,"H","N","2011-11-30","201111300COL"
"NJD",0,0,1,0,0,1,0,3,0,3,0,6,"A","N","2011-11-30","201111300COL"
"DET",0,2,0,2,0,4,0,0,2,0,0,2,"H","N","2011-11-30","201111300DET"
"TBL",0,0,2,0,0,2,0,2,0,2,0,4,"A","N","2011-11-30","201111300DET"
"EDM",0,1,1,0,0,2,0,0,2,0,1,3,"H","Y","2011-11-30","201111300EDM"
"MIN",0,0,2,0,1,3,0,1,1,0,0,2,"A","Y","2011-11-30","201111300EDM"
"BOS",0,1,2,3,0,6,0,1,1,1,0,3,"A","N","2011-11-30","201111300TOR"
"TOR",0,1,1,1,0,3,0,1,2,3,0,6,"H","N","2011-11-30","201111300TOR"
"CAR",0,2,1,0,0,3,0,1,3,1,0,5,"H","N","2011-12-01","201112010CAR"
"NYR",0,1,3,1,0,5,0,2,1,0,0,3,"A","N","2011-12-01","201112010CAR"
"CBJ",0,1,0,2,1,4,0,1,1,1,0,3,"A","Y","2011-12-01","201112010CGY"
"CGY",0,1,1,1,0,3,0,1,0,2,1,4,"H","Y","2011-12-01","201112010CGY"
"DAL",0,1,0,2,0,3,0,1,0,1,0,2,"H","N","2011-12-01","201112010DAL"
"OTT",0,1,0,1,0,2,0,1,0,2,0,3,"A","N","2011-12-01","201112010DAL"
"FLA",0,0,1,0,0,1,0,1,1,0,0,2,"A","N","2011-12-01","201112010LAK"
"LAK",0,1,1,0,0,2,0,0,1,0,0,1,"H","N","2011-12-01","201112010LAK"
"MTL",0,1,1,1,0,3,0,1,1,1,1,4,"A","Y","2011-12-01","201112010SJS"
"SJS",0,1,1,1,1,4,0,1,1,1,0,3,"H","Y","2011-12-01","201112010SJS"
"NSH",0,3,2,1,0,6,0,1,4,0,0,5,"A","N","2011-12-01","201112010VAN"
"VAN",0,1,4,0,0,5,0,3,2,1,0,6,"H","N","2011-12-01","201112010VAN"
"PHX",0,0,0,0,0,0,0,1,0,0,0,1,"A","N","2011-12-01","201112010WPG"
"WPG",0,1,0,0,0,1,0,0,0,0,0,0,"H","N","2011-12-01","201112010WPG"
"PIT",0,1,0,1,0,2,0,0,1,0,0,1,"A","N","2011-12-01","201112010WSH"
"WSH",0,0,1,0,0,1,0,1,0,1,0,2,"H","N","2011-12-01","201112010WSH"
"ANA",0,2,1,0,0,3,1,0,1,2,0,4,"H","N","2011-12-02","201112020ANA"
"PHI",1,0,1,2,0,4,0,2,1,0,0,3,"A","N","2011-12-02","201112020ANA"
"BUF",0,0,0,1,0,1,0,3,0,1,0,4,"H","N","2011-12-02","201112020BUF"
"DET",0,3,0,1,0,4,0,0,0,1,0,1,"A","N","2011-12-02","201112020BUF"
"CHI",0,1,2,1,1,5,0,2,0,2,0,4,"H","Y","2011-12-02","201112020CHI"
"NYI",0,2,0,2,0,4,0,1,2,1,1,5,"A","Y","2011-12-02","201112020CHI"
"COL",0,1,0,1,1,3,0,1,1,0,0,2,"H","Y","2011-12-02","201112020COL"
"STL",0,1,1,0,0,2,0,1,0,1,1,3,"A","Y","2011-12-02","201112020COL"
"CBJ",0,1,1,1,0,3,0,1,0,5,0,6,"A","N","2011-12-02","201112020EDM"
"EDM",0,1,0,5,0,6,0,1,1,1,0,3,"H","N","2011-12-02","201112020EDM"
"MIN",0,3,0,1,0,4,0,2,0,0,0,2,"H","N","2011-12-02","201112020MIN"
"NJD",0,2,0,0,0,2,0,3,0,1,0,4,"A","N","2011-12-02","201112020MIN"
"BOS",0,0,2,2,0,4,0,0,1,0,0,1,"H","N","2011-12-03","201112030BOS"
"TOR",0,0,1,0,0,1,0,0,2,2,0,4,"A","N","2011-12-03","201112030BOS"
"CAR",0,0,1,1,0,2,0,0,1,2,0,3,"H","N","2011-12-03","201112030CAR"
"PIT",0,0,1,2,0,3,0,0,1,1,0,2,"A","N","2011-12-03","201112030CAR"
"DAL",0,0,4,0,0,4,0,2,3,0,0,5,"H","N","2011-12-03","201112030DAL"
"NYI",0,2,3,0,0,5,0,0,4,0,0,4,"A","N","2011-12-03","201112030DAL"
"CGY",0,2,0,3,0,5,0,2,0,1,0,3,"A","N","2011-12-03","201112030EDM"
"EDM",0,2,0,1,0,3,0,2,0,3,0,5,"H","N","2011-12-03","201112030EDM"
"LAK",0,0,1,0,0,1,0,1,1,0,0,2,"H","N","2011-12-03","201112030LAK"
"MTL",0,1,1,0,0,2,0,0,1,0,0,1,"A","N","2011-12-03","201112030LAK"
"BUF",0,2,0,1,0,3,0,0,0,2,0,2,"A","N","2011-12-03","201112030NSH"
"NSH",0,0,0,2,0,2,0,2,0,1,0,3,"H","N","2011-12-03","201112030NSH"
"PHI",0,4,0,0,0,4,0,0,1,1,0,2,"A","N","2011-12-03","201112030PHX"
"PHX",0,0,1,1,0,2,0,4,0,0,0,4,"H","N","2011-12-03","201112030PHX"
"FLA",0,1,3,1,0,5,0,2,0,1,0,3,"A","N","2011-12-03","201112030SJS"
"SJS",0,2,0,1,0,3,0,1,3,1,0,5,"H","N","2011-12-03","201112030SJS"
"CHI",0,0,3,2,0,5,0,1,1,0,0,2,"A","N","2011-12-03","201112030STL"
"STL",0,1,1,0,0,2,0,0,3,2,0,5,"H","N","2011-12-03","201112030STL"
"NYR",0,0,1,3,0,4,0,1,1,0,0,2,"A","N","2011-12-03","201112030TBL"
"TBL",0,1,1,0,0,2,0,0,1,3,0,4,"H","N","2011-12-03","201112030TBL"
"NJD",0,1,1,0,0,2,0,1,1,2,0,4,"A","N","2011-12-03","201112030WPG"
"WPG",0,1,1,2,0,4,0,1,1,0,0,2,"H","N","2011-12-03","201112030WPG"
"OTT",0,0,1,1,0,2,1,1,0,1,0,3,"A","N","2011-12-03","201112030WSH"
"WSH",1,1,0,1,0,3,0,0,1,1,0,2,"H","N","2011-12-03","201112030WSH"
"ANA",0,2,0,1,0,3,0,1,2,2,0,5,"H","N","2011-12-04","201112040ANA"
"MIN",0,1,2,2,0,5,0,2,0,1,0,3,"A","N","2011-12-04","201112040ANA"
"COL",0,0,2,2,0,4,0,1,0,1,0,2,"H","N","2011-12-04","201112040COL"
"DET",0,1,0,1,0,2,0,0,2,2,0,4,"A","N","2011-12-04","201112040COL"
"CGY",0,1,0,0,0,1,0,0,2,3,0,5,"A","N","2011-12-04","201112040VAN"
"VAN",0,0,2,3,0,5,0,1,0,0,0,1,"H","N","2011-12-04","201112040VAN"
"CHI",0,0,3,0,0,3,0,2,1,0,1,4,"H","Y","2011-12-05","201112050CHI"
"PHX",0,2,1,0,1,4,0,0,3,0,0,3,"A","Y","2011-12-05","201112050CHI"
"FLA",0,3,2,0,0,5,0,1,1,2,0,4,"H","N","2011-12-05","201112050FLA"
"WSH",0,1,1,2,0,4,0,3,2,0,0,5,"A","N","2011-12-05","201112050FLA"
"NYR",0,0,2,0,0,2,0,1,2,1,0,4,"H","N","2011-12-05","201112050NYR"
"TOR",0,1,2,1,0,4,0,0,2,0,0,2,"A","N","2011-12-05","201112050NYR"
"OTT",0,0,1,3,0,4,0,0,1,1,0,2,"H","N","2011-12-05","201112050OTT"
"TBL",0,0,1,1,0,2,0,0,1,3,0,4,"A","N","2011-12-05","201112050OTT"
"BOS",0,0,2,1,0,3,0,0,0,1,0,1,"A","N","2011-12-05","201112050PIT"
"PIT",0,0,0,1,0,1,0,0,2,1,0,3,"H","N","2011-12-05","201112050PIT"
"ANA",0,2,0,1,0,3,0,0,1,1,0,2,"H","N","2011-12-06","201112060ANA"
"LAK",0,0,1,1,0,2,0,2,0,1,0,3,"A","N","2011-12-06","201112060ANA"
"CAR",0,0,2,4,0,6,0,2,2,3,0,7,"A","N","2011-12-06","201112060CGY"
"CGY",0,2,2,3,0,7,0,0,2,4,0,6,"H","N","2011-12-06","201112060CGY"
"CBJ",0,1,1,0,1,3,0,1,0,1,0,2,"A","Y","2011-12-06","201112060MTL"
"MTL",0,1,0,1,0,2,0,1,1,0,1,3,"H","Y","2011-12-06","201112060MTL"
"NSH",0,1,0,1,0,2,0,1,0,2,0,3,"H","N","2011-12-06","201112060NSH"
"PHX",0,1,0,2,0,3,0,1,0,1,0,2,"A","N","2011-12-06","201112060NSH"
"NYI",0,3,0,2,0,5,0,1,0,0,0,1,"H","N","2011-12-06","201112060NYI"
"TBL",0,1,0,0,0,1,0,3,0,2,0,5,"A","N","2011-12-06","201112060NYI"
"MIN",0,2,0,0,0,2,0,1,0,0,0,1,"A","N","2011-12-06","201112060SJS"
"SJS",0,1,0,0,0,1,0,2,0,0,0,2,"H","N","2011-12-06","201112060SJS"
"DET",0,0,1,1,0,2,0,0,1,2,0,3,"A","N","2011-12-06","201112060STL"
"STL",0,0,1,2,0,3,0,0,1,1,0,2,"H","N","2011-12-06","201112060STL"
"NJD",1,2,0,0,0,3,0,0,1,1,0,2,"A","N","2011-12-06","201112060TOR"
"TOR",0,0,1,1,0,2,1,2,0,0,0,3,"H","N","2011-12-06","201112060TOR"
"COL",0,0,0,0,0,0,0,1,1,4,0,6,"A","N","2011-12-06","201112060VAN"
"VAN",0,1,1,4,0,6,0,0,0,0,0,0,"H","N","2011-12-06","201112060VAN"
"BOS",0,0,0,1,0,1,0,1,0,1,0,2,"A","N","2011-12-06","201112060WPG"
"WPG",0,1,0,1,0,2,0,0,0,1,0,1,"H","N","2011-12-06","201112060WPG"
"BUF",0,3,0,1,0,4,1,1,3,0,0,5,"H","N","2011-12-07","201112070BUF"
"PHI",1,1,3,0,0,5,0,3,0,1,0,4,"A","N","2011-12-07","201112070BUF"
"CAR",0,1,3,1,0,5,0,1,1,1,0,3,"A","N","2011-12-07","201112070EDM"
"EDM",0,1,1,1,0,3,0,1,3,1,0,5,"H","N","2011-12-07","201112070EDM"
"OTT",0,0,2,1,0,3,0,0,1,4,0,5,"H","N","2011-12-07","201112070OTT"
"WSH",0,0,1,4,0,5,0,0,2,1,0,3,"A","N","2011-12-07","201112070OTT"
"BOS",0,0,0,0,0,0,0,0,0,2,0,2,"H","N","2011-12-08","201112080BOS"
"FLA",0,0,0,2,0,2,0,0,0,0,0,0,"A","N","2011-12-08","201112080BOS"
"CBJ",0,1,1,1,0,3,1,0,1,2,0,4,"H","N","2011-12-08","201112080CBJ"
"NSH",1,0,1,2,0,4,0,1,1,1,0,3,"A","N","2011-12-08","201112080CBJ"
"CGY",0,0,0,3,0,3,0,0,1,1,0,2,"H","N","2011-12-08","201112080CGY"
"COL",0,0,1,1,0,2,0,0,0,3,0,3,"A","N","2011-12-08","201112080CGY"
"DET",0,5,0,0,0,5,0,0,1,1,0,2,"H","N","2011-12-08","201112080DET"
"PHX",0,0,1,1,0,2,0,5,0,0,0,5,"A","N","2011-12-08","201112080DET"
"LAK",0,0,0,2,0,2,0,1,2,1,0,4,"H","N","2011-12-08","201112080LAK"
"MIN",0,1,2,1,0,4,0,0,0,2,0,2,"A","N","2011-12-08","201112080LAK"
"MTL",0,2,1,0,0,3,0,0,1,2,1,4,"H","Y","2011-12-08","201112080MTL"
"VAN",0,0,1,2,1,4,0,2,1,0,0,3,"A","Y","2011-12-08","201112080MTL"
"NJD",0,0,1,3,1,5,0,2,1,1,0,4,"H","Y","2011-12-08","201112080NJD"
"OTT",0,2,1,1,0,4,0,0,1,3,1,5,"A","Y","2011-12-08","201112080NJD"
"CHI",1,1,1,0,0,3,0,0,1,1,0,2,"A","N","2011-12-08","201112080NYI"
"NYI",0,0,1,1,0,2,1,1,1,0,0,3,"H","N","2011-12-08","201112080NYI"
"NYR",0,1,1,0,0,2,0,0,1,1,1,3,"H","Y","2011-12-08","201112080NYR"
"TBL",0,0,1,1,1,3,0,1,1,0,0,2,"A","Y","2011-12-08","201112080NYR"
"PHI",0,1,2,0,0,3,0,0,1,1,0,2,"H","N","2011-12-08","201112080PHI"
"PIT",0,0,1,1,0,2,0,1,2,0,0,3,"A","N","2011-12-08","201112080PHI"
"DAL",0,1,1,0,0,2,0,2,3,0,0,5,"A","N","2011-12-08","201112080SJS"
"SJS",0,2,3,0,0,5,0,1,1,0,0,2,"H","N","2011-12-08","201112080SJS"
"ANA",0,1,0,1,0,2,0,1,2,1,0,4,"A","N","2011-12-08","201112080STL"
"STL",0,1,2,1,0,4,0,1,0,1,0,2,"H","N","2011-12-08","201112080STL"
"BUF",1,1,0,0,0,2,0,0,1,0,0,1,"H","N","2011-12-09","201112090BUF"
"FLA",0,0,1,0,0,1,1,1,0,0,0,2,"A","N","2011-12-09","201112090BUF"
"COL",0,0,1,0,0,1,0,2,2,0,0,4,"A","N","2011-12-09","201112090EDM"
"EDM",0,2,2,0,0,4,0,0,1,0,0,1,"H","N","2011-12-09","201112090EDM"
"CAR",0,0,0,2,0,2,0,2,2,0,0,4,"A","N","2011-12-09","201112090WPG"
"WPG",0,2,2,0,0,4,0,0,0,2,0,2,"H","N","2011-12-09","201112090WPG"
"TOR",0,0,1,1,0,2,0,1,2,1,0,4,"A","N","2011-12-09","201112090WSH"
"WSH",0,1,2,1,0,4,0,0,1,1,0,2,"H","N","2011-12-09","201112090WSH"
"BUF",0,0,1,0,0,1,0,0,2,2,0,4,"H","N","2011-12-10","201112100BUF"
"NYR",0,0,2,2,0,4,0,0,1,0,0,1,"A","N","2011-12-10","201112100BUF"
"BOS",0,2,1,2,0,5,0,2,1,0,0,3,"A","N","2011-12-10","201112100CBJ"
"CBJ",0,2,1,0,0,3,0,2,1,2,0,5,"H","N","2011-12-10","201112100CBJ"
"CGY",0,0,2,1,0,3,0,0,0,0,0,0,"H","N","2011-12-10","201112100CGY"
"EDM",0,0,0,0,0,0,0,0,2,1,0,3,"A","N","2011-12-10","201112100CGY"
"DET",0,2,4,1,0,7,0,1,0,0,0,1,"H","N","2011-12-10","201112100DET"
"WPG",0,1,0,0,0,1,0,2,4,1,0,7,"A","N","2011-12-10","201112100DET"
"DAL",0,1,1,0,0,2,0,0,1,0,0,1,"A","N","2011-12-10","201112100LAK"
"LAK",0,0,1,0,0,1,0,1,1,0,0,2,"H","N","2011-12-10","201112100LAK"
"MTL",0,0,1,1,0,2,0,0,0,1,0,1,"A","N","2011-12-10","201112100NJD"
"NJD",0,0,0,1,0,1,0,0,1,1,0,2,"H","N","2011-12-10","201112100NJD"
"ANA",0,0,1,1,0,2,0,0,1,2,0,3,"A","N","2011-12-10","201112100NSH"
"NSH",0,0,1,2,0,3,0,0,1,1,0,2,"H","N","2011-12-10","201112100NSH"
"NYI",0,2,1,0,0,3,0,2,2,2,0,6,"H","N","2011-12-10","201112100NYI"
"PIT",0,2,2,2,0,6,0,2,1,0,0,3,"A","N","2011-12-10","201112100NYI"
"OTT",0,0,1,0,0,1,0,2,1,1,0,4,"H","N","2011-12-10","201112100OTT"
"VAN",0,2,1,1,0,4,0,0,1,0,0,1,"A","N","2011-12-10","201112100OTT"
"PHI",0,0,3,2,0,5,0,1,0,1,0,2,"H","N","2011-12-10","201112100PHI"
"TBL",0,1,0,1,0,2,0,0,3,2,0,5,"A","N","2011-12-10","201112100PHI"
"MIN",0,1,2,1,0,4,0,0,0,1,0,1,"A","N","2011-12-10","201112100PHX"
"PHX",0,0,0,1,0,1,0,1,2,1,0,4,"H","N","2011-12-10","201112100PHX"
"SJS",0,0,0,0,0,0,0,1,0,0,0,1,"A","N","2011-12-10","201112100STL"
"STL",0,1,0,0,0,1,0,0,0,0,0,0,"H","N","2011-12-10","201112100STL"
"CHI",1,0,1,1,0,3,0,1,1,0,0,2,"H","N","2011-12-11","201112110CHI"
"SJS",0,1,1,0,0,2,1,0,1,1,0,3,"A","N","2011-12-11","201112110CHI"
"FLA",0,1,0,0,0,1,0,2,4,0,0,6,"A","N","2011-12-11","201112110NYR"
"NYR",0,2,4,0,0,6,0,1,0,0,0,1,"H","N","2011-12-11","201112110NYR"
"NJD",0,2,3,0,0,5,0,2,0,2,0,4,"A","N","2011-12-12","201112120TBL"
"TBL",0,2,0,2,0,4,0,2,3,0,0,5,"H","N","2011-12-12","201112120TBL"
"BOS",0,1,1,1,0,3,0,0,0,0,0,0,"H","N","2011-12-13","201112130BOS"
"LAK",0,0,0,0,0,0,0,1,1,1,0,3,"A","N","2011-12-13","201112130BOS"
"BUF",0,2,0,0,0,2,1,1,0,1,0,3,"H","N","2011-12-13","201112130BUF"
"OTT",1,1,0,1,0,3,0,2,0,0,0,2,"A","N","2011-12-13","201112130BUF"
"CBJ",0,1,0,0,1,2,0,0,0,1,0,1,"H","Y","2011-12-13","201112130CBJ"
"VAN",0,0,0,1,0,1,0,1,0,0,1,2,"A","Y","2011-12-13","201112130CBJ"
"COL",0,1,0,2,1,4,0,0,2,1,0,3,"H","Y","2011-12-13","201112130COL"
"SJS",0,0,2,1,0,3,0,1,0,2,1,4,"A","Y","2011-12-13","201112130COL"
"FLA",0,1,1,0,0,2,0,0,1,1,1,3,"H","Y","2011-12-13","201112130FLA"
"NJD",0,0,1,1,1,3,0,1,1,0,0,2,"A","Y","2011-12-13","201112130FLA"
"MTL",0,2,0,3,0,5,0,1,0,2,0,3,"H","N","2011-12-13","201112130MTL"
"NYI",0,1,0,2,0,3,0,2,0,3,0,5,"A","N","2011-12-13","201112130MTL"
"CGY",0,0,1,0,0,1,0,1,0,1,0,2,"A","N","2011-12-13","201112130NSH"
"NSH",0,1,0,1,0,2,0,0,1,0,0,1,"H","N","2011-12-13","201112130NSH"
"DAL",0,0,0,1,0,1,0,0,0,0,0,0,"A","N","2011-12-13","201112130NYR"
"NYR",0,0,0,0,0,0,0,0,0,1,0,1,"H","N","2011-12-13","201112130NYR"
"DET",0,0,1,3,0,4,0,1,0,0,0,1,"A","N","2011-12-13","201112130PIT"
"PIT",0,1,0,0,0,1,0,0,1,3,0,4,"H","N","2011-12-13","201112130PIT"
"CAR",0,0,0,1,0,1,1,0,0,1,0,2,"A","N","2011-12-13","201112130TOR"
"TOR",1,0,0,1,0,2,0,0,0,1,0,1,"H","N","2011-12-13","201112130TOR"
"MIN",0,0,1,0,0,1,0,0,1,1,0,2,"A","N","2011-12-13","201112130WPG"
"WPG",0,0,1,1,0,2,0,0,1,0,0,1,"H","N","2011-12-13","201112130WPG"
"PHI",0,1,3,1,0,5,0,0,0,1,0,1,"A","N","2011-12-13","201112130WSH"
"WSH",0,0,0,1,0,1,0,1,3,1,0,5,"H","N","2011-12-13","201112130WSH"
"ANA",0,1,2,1,0,4,0,0,1,0,0,1,"H","N","2011-12-14","201112140ANA"
"PHX",0,0,1,0,0,1,0,1,2,1,0,4,"A","N","2011-12-14","201112140ANA"
"CHI",0,0,2,1,1,4,0,0,2,1,0,3,"A","Y","2011-12-14","201112140MIN"
"MIN",0,0,2,1,0,3,0,0,2,1,1,4,"H","Y","2011-12-14","201112140MIN"
"BOS",0,1,1,3,0,5,0,0,1,1,0,2,"A","N","2011-12-14","201112140OTT"
"OTT",0,0,1,1,0,2,0,1,1,3,0,5,"H","N","2011-12-14","201112140OTT"
"CAR",0,0,2,2,0,4,0,1,1,1,0,3,"H","N","2011-12-15","201112150CAR"
"VAN",0,1,1,1,0,3,0,0,2,2,0,4,"A","N","2011-12-15","201112150CAR"
"CBJ",0,0,1,0,0,1,0,0,0,2,0,2,"H","N","2011-12-15","201112150CBJ"
"LAK",0,0,0,2,0,2,0,0,1,0,0,1,"A","N","2011-12-15","201112150CBJ"
"MTL",0,0,3,0,0,3,0,1,2,1,0,4,"H","N","2011-12-15","201112150MTL"
"PHI",0,1,2,1,0,4,0,0,3,0,0,3,"A","N","2011-12-15","201112150MTL"
"DET",0,1,2,0,0,3,0,1,1,2,0,4,"A","N","2011-12-15","201112150NSH"
"NSH",0,1,1,2,0,4,0,1,2,0,0,3,"H","N","2011-12-15","201112150NSH"
"DAL",0,1,0,2,0,3,0,1,1,0,0,2,"A","N","2011-12-15","201112150NYI"
"NYI",0,1,1,0,0,2,0,1,0,2,0,3,"H","N","2011-12-15","201112150NYI"
"EDM",0,0,1,1,0,2,0,1,1,2,0,4,"A","N","2011-12-15","201112150PHX"
"PHX",0,1,1,2,0,4,0,0,1,1,0,2,"H","N","2011-12-15","201112150PHX"
"COL",0,2,2,0,0,4,0,1,1,3,0,5,"A","N","2011-12-15","201112150SJS"
"SJS",0,1,1,3,0,5,0,2,2,0,0,4,"H","N","2011-12-15","201112150SJS"
"NYR",0,0,1,0,0,1,0,2,0,2,0,4,"A","N","2011-12-15","201112150STL"
"STL",0,2,0,2,0,4,0,0,1,0,0,1,"H","N","2011-12-15","201112150STL"
"CGY",0,1,1,2,0,4,1,1,3,0,0,5,"A","N","2011-12-15","201112150TBL"
"TBL",1,1,3,0,0,5,0,1,1,2,0,4,"H","N","2011-12-15","201112150TBL"
"WPG",0,0,0,0,0,0,0,0,0,1,0,1,"H","N","2011-12-15","201112150WPG"
"WSH",0,0,0,1,0,1,0,0,0,0,0,0,"A","N","2011-12-15","201112150WPG"
"BUF",0,0,4,1,0,5,0,0,2,2,0,4,"H","N","2011-12-16","201112160BUF"
"TOR",0,0,2,2,0,4,0,0,4,1,0,5,"A","N","2011-12-16","201112160BUF"
"ANA",0,0,0,1,0,1,0,1,2,1,0,4,"A","N","2011-12-16","201112160CHI"
"CHI",0,1,2,1,0,4,0,0,0,1,0,1,"H","N","2011-12-16","201112160CHI"
"CGY",0,1,0,1,0,2,0,1,0,1,1,3,"A","Y","2011-12-16","201112160FLA"
"FLA",0,1,0,1,1,3,0,1,0,1,0,2,"H","Y","2011-12-16","201112160FLA"
"DAL",0,1,1,1,0,3,0,1,3,2,0,6,"A","N","2011-12-16","201112160NJD"
"NJD",0,1,3,2,0,6,0,1,1,1,0,3,"H","N","2011-12-16","201112160NJD"
"OTT",0,0,5,1,0,6,0,0,3,1,0,4,"H","N","2011-12-16","201112160OTT"
"PIT",0,0,3,1,0,4,0,0,5,1,0,6,"A","N","2011-12-16","201112160OTT"
"CBJ",0,0,2,0,0,2,0,2,1,0,0,3,"H","N","2011-12-17","201112170CBJ"
"TBL",0,2,1,0,0,3,0,0,2,0,0,2,"A","N","2011-12-17","201112170CBJ"
"COL",0,1,1,0,0,2,0,0,1,0,0,1,"H","N","2011-12-17","201112170COL"
"WSH",0,0,1,0,0,1,0,1,1,0,0,2,"A","N","2011-12-17","201112170COL"
"DET",0,4,2,2,0,8,0,1,1,0,0,2,"H","N","2011-12-17","201112170DET"
"LAK",0,1,1,0,0,2,0,4,2,2,0,8,"A","N","2011-12-17","201112170DET"
"MIN",0,0,0,1,0,1,0,0,1,0,1,2,"H","Y","2011-12-17","201112170MIN"
"NYI",0,0,1,0,1,2,0,0,0,1,0,1,"A","Y","2011-12-17","201112170MIN"
"MTL",0,0,3,0,0,3,0,1,2,2,0,5,"H","N","2011-12-17","201112170MTL"
"NJD",0,1,2,2,0,5,0,0,3,0,0,3,"A","N","2011-12-17","201112170MTL"
"NSH",0,0,0,1,1,2,0,0,0,1,0,1,"H","Y","2011-12-17","201112170NSH"
"STL",0,0,0,1,0,1,0,0,0,1,1,2,"A","Y","2011-12-17","201112170NSH"
"BOS",0,4,1,1,0,6,0,0,0,0,0,0,"A","N","2011-12-17","201112170PHI"
"PHI",0,0,0,0,0,0,0,4,1,1,0,6,"H","N","2011-12-17","201112170PHI"
"NYR",0,1,0,2,0,3,0,1,1,0,0,2,"A","N","2011-12-17","201112170PHX"
"PHX",0,1,1,0,0,2,0,1,0,2,0,3,"H","N","2011-12-17","201112170PHX"
"BUF",0,1,0,2,0,3,0,4,2,2,0,8,"A","N","2011-12-17","201112170PIT"
"PIT",0,4,2,2,0,8,0,1,0,2,0,3,"H","N","2011-12-17","201112170PIT"
"EDM",0,1,1,0,0,2,0,1,1,1,0,3,"A","N","2011-12-17","201112170SJS"
"SJS",0,1,1,1,0,3,0,1,1,0,0,2,"H","N","2011-12-17","201112170SJS"
"TOR",0,1,1,1,0,3,0,1,2,2,0,5,"H","N","2011-12-17","201112170TOR"
"VAN",0,1,2,2,0,5,0,1,1,1,0,3,"A","N","2011-12-17","201112170TOR"
"ANA",0,2,0,1,0,3,0,2,2,1,0,5,"A","N","2011-12-17","201112170WPG"
"WPG",0,2,2,1,0,5,0,2,0,1,0,3,"H","N","2011-12-17","201112170WPG"
"CGY",0,0,0,2,0,2,0,1,2,1,0,4,"A","N","2011-12-18","201112180CHI"
"CHI",0,1,2,1,0,4,0,0,0,2,0,2,"H","N","2011-12-18","201112180CHI"
"CAR",0,1,1,0,0,2,1,1,0,1,0,3,"A","N","2011-12-18","201112180FLA"
"FLA",1,1,0,1,0,3,0,1,1,0,0,2,"H","N","2011-12-18","201112180FLA"
"CBJ",0,1,2,1,0,4,0,2,0,4,0,6,"A","N","2011-12-18","201112180STL"
"STL",0,2,0,4,0,6,0,1,2,1,0,4,"H","N","2011-12-18","201112180STL"
"BOS",0,1,1,1,0,3,0,1,0,1,0,2,"H","N","2011-12-19","201112190BOS"
"MTL",0,1,0,1,0,2,0,1,1,1,0,3,"A","N","2011-12-19","201112190BOS"
"COL",0,0,2,0,1,3,0,1,0,1,0,2,"H","Y","2011-12-19","201112190COL"
"PHI",0,1,0,1,0,2,0,0,2,0,1,3,"A","Y","2011-12-19","201112190COL"
"ANA",0,0,3,0,0,3,0,1,2,2,0,5,"A","N","2011-12-19","201112190DAL"
"DAL",0,1,2,2,0,5,0,0,3,0,0,3,"H","N","2011-12-19","201112190DAL"
"DET",0,1,1,1,0,3,0,0,2,0,0,2,"A","N","2011-12-19","201112190EDM"
"EDM",0,0,2,0,0,2,0,1,1,1,0,3,"H","N","2011-12-19","201112190EDM"
"LAK",0,1,1,0,1,3,0,1,0,1,0,2,"A","Y","2011-12-19","201112190TOR"
"TOR",0,1,0,1,0,2,0,1,1,0,1,3,"H","Y","2011-12-19","201112190TOR"
"MIN",0,0,0,0,0,0,0,1,2,1,0,4,"A","N","2011-12-19","201112190VAN"
"VAN",0,1,2,1,0,4,0,0,0,0,0,0,"H","N","2011-12-19","201112190VAN"
"CGY",0,1,1,0,0,2,0,1,0,0,0,1,"H","N","2011-12-20","201112200CGY"
"MIN",0,1,0,0,0,1,0,1,1,0,0,2,"A","N","2011-12-20","201112200CGY"
"FLA",0,0,1,0,0,1,0,1,1,0,0,2,"H","N","2011-12-20","201112200FLA"
"PHX",0,1,1,0,0,2,0,0,1,0,0,1,"A","N","2011-12-20","201112200FLA"
"NJD",0,1,0,0,0,1,0,0,1,3,0,4,"H","N","2011-12-20","201112200NJD"
"NYR",0,0,1,3,0,4,0,1,0,0,0,1,"A","N","2011-12-20","201112200NJD"
"BUF",0,0,1,0,0,1,0,1,0,3,0,4,"A","N","2011-12-20","201112200OTT"
"OTT",0,1,0,3,0,4,0,0,1,0,0,1,"H","N","2011-12-20","201112200OTT"
"CHI",0,0,0,2,0,2,0,1,2,0,0,3,"A","N","2011-12-20","201112200PIT"
"PIT",0,1,2,0,0,3,0,0,0,2,0,2,"H","N","2011-12-20","201112200PIT"
"NYI",0,1,1,0,1,3,0,1,1,0,0,2,"A","Y","2011-12-20","201112200WPG"
"WPG",0,1,1,0,0,2,0,1,1,0,1,3,"H","Y","2011-12-20","201112200WPG"
"NSH",0,0,0,1,0,1,0,2,0,2,0,4,"A","N","2011-12-20","201112200WSH"
"WSH",0,2,0,2,0,4,0,0,0,1,0,1,"H","N","2011-12-20","201112200WSH"
"CAR",0,1,2,0,0,3,0,1,1,2,0,4,"H","N","2011-12-21","201112210CAR"
"PHX",0,1,1,2,0,4,0,1,2,0,0,3,"A","N","2011-12-21","201112210CAR"
"CHI",0,0,2,3,0,5,0,0,1,0,0,1,"H","N","2011-12-21","201112210CHI"
"MTL",0,0,1,0,0,1,0,0,2,3,0,5,"A","N","2011-12-21","201112210CHI"
"COL",0,2,1,0,0,3,0,0,2,0,0,2,"H","N","2011-12-21","201112210COL"
"STL",0,0,2,0,0,2,0,2,1,0,0,3,"A","N","2011-12-21","201112210COL"
"DAL",0,1,0,0,0,1,0,2,1,1,0,4,"H","N","2011-12-21","201112210DAL"
"PHI",0,2,1,1,0,4,0,1,0,0,0,1,"A","N","2011-12-21","201112210DAL"
"SJS",0,5,0,2,0,7,0,1,0,1,0,2,"H","N","2011-12-21","201112210SJS"
"TBL",0,1,0,1,0,2,0,5,0,2,0,7,"A","N","2011-12-21","201112210SJS"
"DET",0,1,1,0,0,2,0,3,0,1,0,4,"A","N","2011-12-21","201112210VAN"
"VAN",0,3,0,1,0,4,0,1,1,0,0,2,"H","N","2011-12-21","201112210VAN"
"CGY",0,1,2,0,0,3,0,0,0,2,0,2,"H","N","2011-12-22","201112220CGY"
"DET",0,0,0,2,0,2,0,1,2,0,0,3,"A","N","2011-12-22","201112220CGY"
"EDM",0,2,2,0,0,4,0,0,0,1,0,1,"H","N","2011-12-22","201112220EDM"
"MIN",0,0,0,1,0,1,0,2,2,0,0,4,"A","N","2011-12-22","201112220EDM"
"ANA",0,0,1,1,0,2,0,0,1,1,1,3,"A","Y","2011-12-22","201112220LAK"
"LAK",0,0,1,1,1,3,0,0,1,1,0,2,"H","Y","2011-12-22","201112220LAK"
"CBJ",0,4,1,0,0,5,0,1,3,2,0,6,"A","N","2011-12-22","201112220NSH"
"NSH",0,1,3,2,0,6,0,4,1,0,0,5,"H","N","2011-12-22","201112220NSH"
"NYI",0,0,1,1,0,2,0,1,2,1,0,4,"A","N","2011-12-22","201112220NYR"
"NYR",0,1,2,1,0,4,0,0,1,1,0,2,"H","N","2011-12-22","201112220NYR"
"FLA",0,0,1,2,0,3,1,1,0,2,0,4,"A","N","2011-12-22","201112220OTT"
"OTT",1,1,0,2,0,4,0,0,1,2,0,3,"H","N","2011-12-22","201112220OTT"
"BUF",0,0,1,1,0,2,0,0,2,1,0,3,"A","N","2011-12-22","201112220TOR"
"TOR",0,0,2,1,0,3,0,0,1,1,0,2,"H","N","2011-12-22","201112220TOR"
"MTL",0,0,0,0,0,0,0,2,1,1,0,4,"A","N","2011-12-22","201112220WPG"
"WPG",0,2,1,1,0,4,0,0,0,0,0,0,"H","N","2011-12-22","201112220WPG"
"BOS",0,4,2,2,0,8,0,0,0,0,0,0,"H","N","2011-12-23","201112230BOS"
"FLA",0,0,0,0,0,0,0,4,2,2,0,8,"A","N","2011-12-23","201112230BOS"
"CAR",1,1,0,0,0,2,0,1,0,0,0,1,"H","N","2011-12-23","201112230CAR"
"OTT",0,1,0,0,0,1,1,1,0,0,0,2,"A","N","2011-12-23","201112230CAR"
"COL",1,0,1,0,0,2,0,1,0,0,0,1,"H","N","2011-12-23","201112230COL"
"TBL",0,1,0,0,0,1,1,0,1,0,0,2,"A","N","2011-12-23","201112230COL"
"DAL",0,3,1,2,0,6,0,0,2,1,0,3,"H","N","2011-12-23","201112230DAL"
"NSH",0,0,2,1,0,3,0,3,1,2,0,6,"A","N","2011-12-23","201112230DAL"
"NJD",0,0,3,0,1,4,0,0,0,3,0,3,"H","Y","2011-12-23","201112230NJD"
"WSH",0,0,0,3,0,3,0,0,3,0,1,4,"A","Y","2011-12-23","201112230NJD"
"NYI",0,1,1,1,0,3,0,3,1,1,0,5,"H","N","2011-12-23","201112230NYI"
"TOR",0,3,1,1,0,5,0,1,1,1,0,3,"A","N","2011-12-23","201112230NYI"
"NYR",0,0,2,2,0,4,0,0,0,2,0,2,"H","N","2011-12-23","201112230NYR"
"PHI",0,0,0,2,0,2,0,0,2,2,0,4,"A","N","2011-12-23","201112230NYR"
"PHX",0,0,1,1,0,2,0,0,2,1,0,3,"H","N","2011-12-23","201112230PHX"
"STL",0,0,2,1,0,3,0,0,1,1,0,2,"A","N","2011-12-23","201112230PHX"
"LAK",0,0,1,0,0,1,0,0,1,0,1,2,"A","Y","2011-12-23","201112230SJS"
"SJS",0,0,1,0,1,2,0,0,1,0,0,1,"H","Y","2011-12-23","201112230SJS"
"CGY",0,0,0,3,0,3,0,0,0,1,0,1,"A","N","2011-12-23","201112230VAN"
"VAN",0,0,0,1,0,1,0,0,0,3,0,3,"H","N","2011-12-23","201112230VAN"
"PIT",0,1,0,3,0,4,0,0,1,0,0,1,"A","N","2011-12-23","201112230WPG"
"WPG",0,0,1,0,0,1,0,1,0,3,0,4,"H","N","2011-12-23","201112230WPG"
"BUF",0,4,0,0,0,4,0,0,1,1,0,2,"H","N","2011-12-26","201112260BUF"
"WSH",0,0,1,1,0,2,0,4,0,0,0,4,"A","N","2011-12-26","201112260BUF"
"CAR",0,1,2,1,0,4,0,0,0,2,0,2,"H","N","2011-12-26","201112260CAR"
"NJD",0,0,0,2,0,2,0,1,2,1,0,4,"A","N","2011-12-26","201112260CAR"
"CBJ",0,0,0,1,0,1,0,0,3,1,0,4,"A","N","2011-12-26","201112260CHI"
"CHI",0,0,3,1,0,4,0,0,0,1,0,1,"H","N","2011-12-26","201112260CHI"
"LAK",0,2,0,2,0,4,0,1,1,1,0,3,"H","N","2011-12-26","201112260LAK"
"PHX",0,1,1,1,0,3,0,2,0,2,0,4,"A","N","2011-12-26","201112260LAK"
"COL",0,0,2,2,0,4,0,1,1,0,0,2,"A","N","2011-12-26","201112260MIN"
"MIN",0,1,1,0,0,2,0,0,2,2,0,4,"H","N","2011-12-26","201112260MIN"
"DET",0,1,2,1,0,4,0,0,0,1,0,1,"A","N","2011-12-26","201112260NSH"
"NSH",0,0,0,1,0,1,0,1,2,1,0,4,"H","N","2011-12-26","201112260NSH"
"NYI",0,0,0,0,0,0,0,0,1,2,0,3,"A","N","2011-12-26","201112260NYR"
"NYR",0,0,1,2,0,3,0,0,0,0,0,0,"H","N","2011-12-26","201112260NYR"
"ANA",0,1,2,0,0,3,0,1,1,0,0,2,"A","N","2011-12-26","201112260SJS"
"SJS",0,1,1,0,0,2,0,1,2,0,0,3,"H","N","2011-12-26","201112260SJS"
"DAL",0,0,1,2,0,3,0,1,2,2,0,5,"A","N","2011-12-26","201112260STL"
"STL",0,1,2,2,0,5,0,0,1,2,0,3,"H","N","2011-12-26","201112260STL"
"EDM",0,0,2,1,0,3,0,3,1,1,0,5,"A","N","2011-12-26","201112260VAN"
"VAN",0,3,1,1,0,5,0,0,2,1,0,3,"H","N","2011-12-26","201112260VAN"
"CBJ",0,0,1,0,0,1,0,0,0,1,1,2,"H","Y","2011-12-27","201112270CBJ"
"CGY",0,0,0,1,1,2,0,0,1,0,0,1,"A","Y","2011-12-27","201112270CBJ"
"COL",0,0,0,1,0,1,0,1,2,1,0,4,"H","N","2011-12-27","201112270COL"
"WPG",0,1,2,1,0,4,0,0,0,1,0,1,"A","N","2011-12-27","201112270COL"
"DET",0,0,1,2,0,3,0,1,1,0,0,2,"H","N","2011-12-27","201112270DET"
"STL",0,1,1,0,0,2,0,0,1,2,0,3,"A","N","2011-12-27","201112270DET"
"FLA",0,1,3,1,0,5,0,0,2,1,0,3,"H","N","2011-12-27","201112270FLA"
"TOR",0,0,2,1,0,3,0,1,3,1,0,5,"A","N","2011-12-27","201112270FLA"
"MTL",0,3,2,1,0,6,0,1,1,0,0,2,"A","N","2011-12-27","201112270OTT"
"OTT",0,1,1,0,0,2,0,3,2,1,0,6,"H","N","2011-12-27","201112270OTT"
"CAR",0,1,0,1,0,2,0,0,1,3,0,4,"A","N","2011-12-27","201112270PIT"
"PIT",0,0,1,3,0,4,0,1,0,1,0,2,"H","N","2011-12-27","201112270PIT"
"PHI",0,1,0,0,0,1,0,1,3,1,0,5,"A","N","2011-12-27","201112270TBL"
"TBL",0,1,3,1,0,5,0,1,0,0,0,1,"H","N","2011-12-27","201112270TBL"
"CHI",0,0,0,0,0,0,0,0,1,1,0,2,"H","N","2011-12-28","201112280CHI"
"LAK",0,0,1,1,0,2,0,0,0,0,0,0,"A","N","2011-12-28","201112280CHI"
"BUF",0,0,1,0,0,1,0,1,2,0,0,3,"A","N","2011-12-28","201112280NJD"
"NJD",0,1,2,0,0,3,0,0,1,0,0,1,"H","N","2011-12-28","201112280NJD"
"MIN",0,0,0,1,0,1,0,0,0,1,1,2,"A","Y","2011-12-28","201112280NSH"
"NSH",0,0,0,1,1,2,0,0,0,1,0,1,"H","Y","2011-12-28","201112280NSH"
"BOS",1,1,0,0,0,2,0,1,0,0,0,1,"A","N","2011-12-28","201112280PHX"
"PHX",0,1,0,0,0,1,1,1,0,0,0,2,"H","N","2011-12-28","201112280PHX"
"SJS",0,0,2,0,0,2,1,1,1,0,0,3,"H","N","2011-12-28","201112280SJS"
"VAN",1,1,1,0,0,3,0,0,2,0,0,2,"A","N","2011-12-28","201112280SJS"
"NYR",0,1,0,0,0,1,0,1,2,1,0,4,"A","N","2011-12-28","201112280WSH"
"WSH",0,1,2,1,0,4,0,1,0,0,0,1,"H","N","2011-12-28","201112280WSH"
"ANA",0,0,0,2,0,2,0,2,2,1,0,5,"H","N","2011-12-29","201112290ANA"
"VAN",0,2,2,1,0,5,0,0,0,2,0,2,"A","N","2011-12-29","201112290ANA"
"CAR",1,1,0,2,0,4,0,0,1,2,0,3,"H","N","2011-12-29","201112290CAR"
"TOR",0,0,1,2,0,3,1,1,0,2,0,4,"A","N","2011-12-29","201112290CAR"
"COL",0,2,0,1,0,3,0,1,1,0,0,2,"H","N","2011-12-29","201112290COL"
"PHX",0,1,1,0,0,2,0,2,0,1,0,3,"A","N","2011-12-29","201112290COL"
"CBJ",0,1,1,2,0,4,0,1,0,0,0,1,"A","N","2011-12-29","201112290DAL"
"DAL",0,1,0,0,0,1,0,1,1,2,0,4,"H","N","2011-12-29","201112290DAL"
"EDM",0,1,1,1,0,3,0,1,3,0,0,4,"A","N","2011-12-29","201112290MIN"
"MIN",0,1,3,0,0,4,0,1,1,1,0,3,"H","N","2011-12-29","201112290MIN"
"CGY",0,1,0,0,0,1,0,0,1,2,0,3,"A","N","2011-12-29","201112290NYI"
"NYI",0,0,1,2,0,3,0,1,0,0,0,1,"H","N","2011-12-29","201112290NYI"
"PHI",0,1,2,1,0,4,0,1,0,1,0,2,"A","N","2011-12-29","201112290PIT"
"PIT",0,1,0,1,0,2,0,1,2,1,0,4,"H","N","2011-12-29","201112290PIT"
"MTL",0,1,2,0,0,3,0,1,1,2,0,4,"A","N","2011-12-29","201112290TBL"
"TBL",0,1,1,2,0,4,0,1,2,0,0,3,"H","N","2011-12-29","201112290TBL"
"LAK",0,0,0,0,0,0,1,0,0,0,0,1,"A","N","2011-12-29","201112290WPG"
"WPG",1,0,0,0,0,1,0,0,0,0,0,0,"H","N","2011-12-29","201112290WPG"
"CHI",0,1,1,1,0,3,0,1,1,0,0,2,"H","N","2011-12-30","201112300CHI"
"DET",0,1,1,0,0,2,0,1,1,1,0,3,"A","N","2011-12-30","201112300CHI"
"FLA",0,0,1,0,0,1,0,3,1,0,0,4,"H","N","2011-12-30","201112300FLA"
"NYR",0,3,1,0,0,4,0,0,1,0,0,1,"A","N","2011-12-30","201112300FLA"
"CGY",0,3,0,0,0,3,1,0,2,1,0,4,"A","N","2011-12-30","201112300OTT"
"OTT",1,0,2,1,0,4,0,3,0,0,0,3,"H","N","2011-12-30","201112300OTT"
"NSH",0,1,0,0,1,2,0,1,0,0,0,1,"A","Y","2011-12-30","201112300STL"
"STL",0,1,0,0,0,1,0,1,0,0,1,2,"H","Y","2011-12-30","201112300STL"
"BUF",0,0,1,0,0,1,0,1,1,1,0,3,"A","N","2011-12-30","201112300WSH"
"WSH",0,1,1,1,0,3,0,0,1,0,0,1,"H","N","2011-12-30","201112300WSH"
"ANA",0,0,1,1,0,2,0,1,2,1,0,4,"H","N","2011-12-31","201112310ANA"
"COL",0,1,2,1,0,4,0,0,1,1,0,2,"A","N","2011-12-31","201112310ANA"
"BUF",0,1,1,0,0,2,0,0,2,0,1,3,"H","Y","2011-12-31","201112310BUF"
"OTT",0,0,2,0,1,3,0,1,1,0,0,2,"A","Y","2011-12-31","201112310BUF"
"CBJ",0,0,2,0,0,2,0,0,0,4,0,4,"H","N","2011-12-31","201112310CBJ"
"WSH",0,0,0,4,0,4,0,0,2,0,0,2,"A","N","2011-12-31","201112310CBJ"
"BOS",0,1,0,1,0,2,0,3,1,0,0,4,"A","N","2011-12-31","201112310DAL"
"DAL",0,3,1,0,0,4,0,1,0,1,0,2,"H","N","2011-12-31","201112310DAL"
"DET",0,0,3,0,0,3,0,0,0,0,0,0,"H","N","2011-12-31","201112310DET"
"STL",0,0,0,0,0,0,0,0,3,0,0,3,"A","N","2011-12-31","201112310DET"
"FLA",0,0,1,2,0,3,0,1,0,1,0,2,"H","N","2011-12-31","201112310FLA"
"MTL",0,1,0,1,0,2,0,0,1,2,0,3,"A","N","2011-12-31","201112310FLA"
"LAK",0,1,2,1,0,4,0,1,0,0,0,1,"H","N","2011-12-31","201112310LAK"
"VAN",0,1,0,0,0,1,0,1,2,1,0,4,"A","N","2011-12-31","201112310LAK"
"MIN",0,0,1,1,0,2,0,0,1,3,0,4,"H","N","2011-12-31","201112310MIN"
"PHX",0,0,1,3,0,4,0,0,1,1,0,2,"A","N","2011-12-31","201112310MIN"
"NJD",0,2,0,1,0,3,0,0,0,1,0,1,"H","N","2011-12-31","201112310NJD"
"PIT",0,0,0,1,0,1,0,2,0,1,0,3,"A","N","2011-12-31","201112310NJD"
"EDM",0,1,0,0,0,1,0,2,2,0,0,4,"A","N","2011-12-31","201112310NYI"
"NYI",0,2,2,0,0,4,0,1,0,0,0,1,"H","N","2011-12-31","201112310NYI"
"CAR",0,1,1,0,0,2,0,1,1,3,0,5,"A","N","2011-12-31","201112310TBL"
"TBL",0,1,1,3,0,5,0,1,1,0,0,2,"H","N","2011-12-31","201112310TBL"
"TOR",0,1,1,0,0,2,0,0,3,0,0,3,"A","N","2011-12-31","201112310WPG"
"WPG",0,0,3,0,0,3,0,1,1,0,0,2,"H","N","2011-12-31","201112310WPG"
"CGY",0,1,0,2,0,3,0,2,2,1,0,5,"A","N","2012-01-01","201201010NSH"
"NSH",0,2,2,1,0,5,0,1,0,2,0,3,"H","N","2012-01-01","201201010NSH"
"CHI",0,1,1,1,0,3,0,0,3,1,0,4,"H","N","2012-01-02","201201020CHI"
"EDM",0,0,3,1,0,4,0,1,1,1,0,3,"A","N","2012-01-02","201201020CHI"
"COL",0,0,0,1,1,2,0,0,1,0,0,1,"A","Y","2012-01-02","201201020LAK"
"LAK",0,0,1,0,0,1,0,0,0,1,1,2,"H","Y","2012-01-02","201201020LAK"
"NJD",0,0,2,0,0,2,1,0,0,2,0,3,"A","N","2012-01-02","201201020OTT"
"OTT",1,0,0,2,0,3,0,0,2,0,0,2,"H","N","2012-01-02","201201020OTT"
"NYR",0,0,1,2,0,3,0,0,2,0,0,2,"A","N","2012-01-02","201201020PHI"
"PHI",0,0,2,0,0,2,0,0,1,2,0,3,"H","N","2012-01-02","201201020PHI"
"SJS",0,0,2,0,1,3,0,1,0,1,0,2,"A","Y","2012-01-02","201201020VAN"
"VAN",0,1,0,1,0,2,0,0,2,0,1,3,"H","Y","2012-01-02","201201020VAN"
"BUF",0,1,1,2,0,4,0,1,1,1,0,3,"H","N","2012-01-03","201201030BUF"
"EDM",0,1,1,1,0,3,0,1,1,2,0,4,"A","N","2012-01-03","201201030BUF"
"CAR",0,1,1,1,0,3,0,1,0,2,1,4,"H","Y","2012-01-03","201201030CAR"
"NYI",0,1,0,2,1,4,0,1,1,1,0,3,"A","Y","2012-01-03","201201030CAR"
"DAL",0,1,2,1,0,4,0,3,2,0,0,5,"H","N","2012-01-03","201201030DAL"
"DET",0,3,2,0,0,5,0,1,2,1,0,4,"A","N","2012-01-03","201201030DAL"
"PHX",0,1,0,0,0,1,0,2,1,1,0,4,"A","N","2012-01-03","201201030STL"
"STL",0,2,1,1,0,4,0,1,0,0,0,1,"H","N","2012-01-03","201201030STL"
"TBL",0,1,2,0,0,3,0,2,3,2,0,7,"A","N","2012-01-03","201201030TOR"
"TOR",0,2,3,2,0,7,0,1,2,0,0,3,"H","N","2012-01-03","201201030TOR"
"CGY",0,0,1,0,0,1,0,1,2,0,0,3,"A","N","2012-01-03","201201030WSH"
"WSH",0,1,2,0,0,3,0,0,1,0,0,1,"H","N","2012-01-03","201201030WSH"
"ANA",0,1,0,0,0,1,0,0,2,1,0,3,"H","N","2012-01-04","201201040ANA"
"SJS",0,0,2,1,0,3,0,1,0,0,0,1,"A","N","2012-01-04","201201040ANA"
"MTL",0,2,1,4,0,7,0,1,1,1,0,3,"H","N","2012-01-04","201201040MTL"
"WPG",0,1,1,1,0,3,0,2,1,4,0,7,"A","N","2012-01-04","201201040MTL"
"BOS",0,2,1,3,0,6,0,1,0,0,0,1,"A","N","2012-01-04","201201040NJD"
"NJD",0,1,0,0,0,1,0,2,1,3,0,6,"H","N","2012-01-04","201201040NJD"
"MIN",0,0,0,0,0,0,0,2,0,1,0,3,"A","N","2012-01-04","201201040VAN"
"VAN",0,2,0,1,0,3,0,0,0,0,0,0,"H","N","2012-01-04","201201040VAN"
"BOS",0,3,4,2,0,9,0,0,0,0,0,0,"H","N","2012-01-05","201201050BOS"
"CGY",0,0,0,0,0,0,0,3,4,2,0,9,"A","N","2012-01-05","201201050BOS"
"LAK",1,0,0,0,0,1,0,0,0,0,0,0,"H","N","2012-01-05","201201050LAK"
"PHX",0,0,0,0,0,0,1,0,0,0,0,1,"A","N","2012-01-05","201201050LAK"
"DAL",0,2,1,1,0,4,0,1,0,0,0,1,"A","N","2012-01-05","201201050NSH"
"NSH",0,1,0,0,0,1,0,2,1,1,0,4,"H","N","2012-01-05","201201050NSH"
"FLA",0,1,0,1,0,2,1,1,0,1,0,3,"A","N","2012-01-05","201201050NYR"
"NYR",1,1,0,1,0,3,0,1,0,1,0,2,"H","N","2012-01-05","201201050NYR"
"OTT",0,1,1,2,0,4,0,0,0,1,0,1,"H","N","2012-01-05","201201050OTT"
"TBL",0,0,0,1,0,1,0,1,1,2,0,4,"A","N","2012-01-05","201201050OTT"
"CHI",0,1,1,2,0,4,0,1,3,1,0,5,"A","N","2012-01-05","201201050PHI"
"PHI",0,1,3,1,0,5,0,1,1,2,0,4,"H","N","2012-01-05","201201050PHI"
"CBJ",0,1,0,0,0,1,0,1,1,0,0,2,"A","N","2012-01-05","201201050SJS"
"SJS",0,1,1,0,0,2,0,1,0,0,0,1,"H","N","2012-01-05","201201050SJS"
"EDM",0,0,3,0,0,3,0,1,0,3,0,4,"A","N","2012-01-05","201201050STL"
"STL",0,1,0,3,0,4,0,0,3,0,0,3,"H","N","2012-01-05","201201050STL"
"TOR",0,1,1,2,0,4,0,0,0,0,0,0,"H","N","2012-01-05","201201050TOR"
"WPG",0,0,0,0,0,0,0,1,1,2,0,4,"A","N","2012-01-05","201201050TOR"
"ANA",0,0,1,3,0,4,0,0,1,1,0,2,"H","N","2012-01-06","201201060ANA"
"NYI",0,0,1,1,0,2,0,0,1,3,0,4,"A","N","2012-01-06","201201060ANA"
"BUF",0,0,1,1,0,2,0,0,1,3,0,4,"A","N","2012-01-06","201201060CAR"
"CAR",0,0,1,3,0,4,0,0,1,1,0,2,"H","N","2012-01-06","201201060CAR"
"CHI",0,0,0,0,0,0,0,1,2,1,0,4,"H","N","2012-01-06","201201060CHI"
"COL",0,1,2,1,0,4,0,0,0,0,0,0,"A","N","2012-01-06","201201060CHI"
"FLA",0,1,1,0,0,2,0,1,1,3,0,5,"A","N","2012-01-06","201201060NJD"
"NJD",0,1,1,3,0,5,0,1,1,0,0,2,"H","N","2012-01-06","201201060NJD"
"NYR",0,1,1,1,0,3,0,1,0,0,0,1,"A","N","2012-01-06","201201060PIT"
"PIT",0,1,0,0,0,1,0,1,1,1,0,3,"H","N","2012-01-06","201201060PIT"
"BOS",0,1,1,1,0,3,0,1,2,1,0,4,"H","N","2012-01-07","201201070BOS"
"VAN",0,1,2,1,0,4,0,1,1,1,0,3,"A","N","2012-01-07","201201070BOS"
"BUF",0,0,1,0,0,1,1,0,1,0,0,2,"H","N","2012-01-07","201201070BUF"
"WPG",1,0,1,0,0,2,0,0,1,0,0,1,"A","N","2012-01-07","201201070BUF"
"CGY",0,0,0,3,0,3,0,0,0,1,0,1,"H","N","2012-01-07","201201070CGY"
"MIN",0,0,0,1,0,1,0,0,0,3,0,3,"A","N","2012-01-07","201201070CGY"
"DAL",0,0,1,3,0,4,0,1,0,0,0,1,"H","N","2012-01-07","201201070DAL"
"EDM",0,1,0,0,0,1,0,0,1,3,0,4,"A","N","2012-01-07","201201070DAL"
"CBJ",0,0,1,0,0,1,0,0,0,0,0,0,"A","N","2012-01-07","201201070LAK"
"LAK",0,0,0,0,0,0,0,0,1,0,0,1,"H","N","2012-01-07","201201070LAK"
"MTL",0,0,2,1,0,3,0,1,0,0,0,1,"H","N","2012-01-07","201201070MTL"
"TBL",0,1,0,0,0,1,0,0,2,1,0,3,"A","N","2012-01-07","201201070MTL"
"CAR",0,0,0,2,0,2,0,2,1,2,0,5,"A","N","2012-01-07","201201070NSH"
"NSH",0,2,1,2,0,5,0,0,0,2,0,2,"H","N","2012-01-07","201201070NSH"
"OTT",0,0,1,1,0,2,1,1,0,1,0,3,"A","N","2012-01-07","201201070PHI"
"PHI",1,1,0,1,0,3,0,0,1,1,0,2,"H","N","2012-01-07","201201070PHI"
"NYI",0,1,0,0,0,1,0,1,3,1,0,5,"A","N","2012-01-07","201201070PHX"
"PHX",0,1,3,1,0,5,0,1,0,0,0,1,"H","N","2012-01-07","201201070PHX"
"NJD",0,0,2,1,0,3,0,1,0,0,0,1,"A","N","2012-01-07","201201070PIT"
"PIT",0,1,0,0,0,1,0,0,2,1,0,3,"H","N","2012-01-07","201201070PIT"
"SJS",0,0,2,3,0,5,0,0,1,1,0,2,"H","N","2012-01-07","201201070SJS"
"WSH",0,0,1,1,0,2,0,0,2,3,0,5,"A","N","2012-01-07","201201070SJS"
"COL",0,0,0,0,0,0,0,2,2,0,0,4,"A","N","2012-01-07","201201070STL"
"STL",0,2,2,0,0,4,0,0,0,0,0,0,"H","N","2012-01-07","201201070STL"
"DET",0,0,2,1,0,3,0,3,0,1,0,4,"A","N","2012-01-07","201201070TOR"
"TOR",0,3,0,1,0,4,0,0,2,1,0,3,"H","N","2012-01-07","201201070TOR"
"ANA",0,4,1,2,0,7,0,1,1,2,0,4,"H","N","2012-01-08","201201080ANA"
"CBJ",0,1,1,2,0,4,0,4,1,2,0,7,"A","N","2012-01-08","201201080ANA"
"CHI",0,2,0,0,0,2,1,1,0,1,0,3,"H","N","2012-01-08","201201080CHI"
"DET",1,1,0,1,0,3,0,2,0,0,0,2,"A","N","2012-01-08","201201080CHI"
"OTT",0,2,0,4,0,6,0,3,1,0,0,4,"H","N","2012-01-08","201201080OTT"
"PHI",0,3,1,0,0,4,0,2,0,4,0,6,"A","N","2012-01-08","201201080OTT"
"FLA",0,0,2,0,0,2,0,1,0,0,0,1,"H","N","2012-01-09","201201090FLA"
"VAN",0,1,0,0,0,1,0,0,2,0,0,2,"A","N","2012-01-09","201201090FLA"
"LAK",0,2,2,1,0,5,0,1,0,1,0,2,"H","N","2012-01-09","201201090LAK"
"WSH",0,1,0,1,0,2,0,2,2,1,0,5,"A","N","2012-01-09","201201090LAK"
"ANA",0,1,1,3,0,5,0,0,0,2,0,2,"H","N","2012-01-10","201201100ANA"
"DAL",0,0,0,2,0,2,0,1,1,3,0,5,"A","N","2012-01-10","201201100ANA"
"BOS",0,1,1,3,0,5,0,1,2,0,0,3,"H","N","2012-01-10","201201100BOS"
"WPG",0,1,2,0,0,3,0,1,1,3,0,5,"A","N","2012-01-10","201201100BOS"
"CAR",0,0,1,0,0,1,0,0,1,1,0,2,"H","N","2012-01-10","201201100CAR"
"PHI",0,0,1,1,0,2,0,0,1,0,0,1,"A","N","2012-01-10","201201100CAR"
"CGY",0,4,1,1,0,6,0,0,2,1,0,3,"H","N","2012-01-10","201201100CGY"
"NJD",0,0,2,1,0,3,0,4,1,1,0,6,"A","N","2012-01-10","201201100CGY"
"CBJ",0,0,1,1,0,2,0,0,2,3,0,5,"A","N","2012-01-10","201201100CHI"
"CHI",0,0,2,3,0,5,0,0,1,1,0,2,"H","N","2012-01-10","201201100CHI"
"COL",0,0,1,0,0,1,0,3,0,1,0,4,"H","N","2012-01-10","201201100COL"
"NSH",0,3,0,1,0,4,0,0,1,0,0,1,"A","N","2012-01-10","201201100COL"
"MIN",0,1,1,2,1,5,0,1,0,3,0,4,"H","Y","2012-01-10","201201100MIN"
"SJS",0,1,0,3,0,4,0,1,1,2,1,5,"A","Y","2012-01-10","201201100MIN"
"MTL",0,0,0,0,0,0,0,0,2,1,0,3,"H","N","2012-01-10","201201100MTL"
"STL",0,0,2,1,0,3,0,0,0,0,0,0,"A","N","2012-01-10","201201100MTL"
"DET",0,0,0,1,0,1,0,1,3,1,0,5,"A","N","2012-01-10","201201100NYI"
"NYI",0,1,3,1,0,5,0,0,0,1,0,1,"H","N","2012-01-10","201201100NYI"
"NYR",0,0,0,1,1,2,0,0,0,1,0,1,"H","Y","2012-01-10","201201100NYR"
"PHX",0,0,0,1,0,1,0,0,0,1,1,2,"A","Y","2012-01-10","201201100NYR"
"OTT",0,2,2,1,0,5,0,0,1,0,0,1,"A","N","2012-01-10","201201100PIT"
"PIT",0,0,1,0,0,1,0,2,2,1,0,5,"H","N","2012-01-10","201201100PIT"
"TBL",0,0,2,2,0,4,0,2,2,0,1,5,"H","Y","2012-01-10","201201100TBL"
"VAN",0,2,2,0,1,5,0,0,2,2,0,4,"A","Y","2012-01-10","201201100TBL"
"BUF",0,0,0,0,0,0,0,2,0,0,0,2,"A","N","2012-01-10","201201100TOR"
"TOR",0,2,0,0,0,2,0,0,0,0,0,0,"H","N","2012-01-10","201201100TOR"
"EDM",0,0,0,1,0,1,1,0,1,0,0,2,"H","N","2012-01-11","201201110EDM"
"NJD",1,0,1,0,0,2,0,0,0,1,0,1,"A","N","2012-01-11","201201110EDM"
"PIT",0,0,0,0,0,0,0,1,0,0,0,1,"A","N","2012-01-11","201201110WSH"
"WSH",0,1,0,0,0,1,0,0,0,0,0,0,"H","N","2012-01-11","201201110WSH"
"BOS",0,1,0,1,0,2,0,0,0,1,0,1,"H","N","2012-01-12","201201120BOS"
"MTL",0,0,0,1,0,1,0,1,0,1,0,2,"A","N","2012-01-12","201201120BOS"
"ANA",0,0,0,0,0,0,1,0,0,0,0,1,"A","N","2012-01-12","201201120CGY"
"CGY",1,0,0,0,0,1,0,0,0,0,0,0,"H","N","2012-01-12","201201120CGY"
"CHI",0,1,3,1,0,5,0,1,0,1,0,2,"H","N","2012-01-12","201201120CHI"
"MIN",0,1,0,1,0,2,0,1,3,1,0,5,"A","N","2012-01-12","201201120CHI"
"DET",0,1,0,1,1,3,0,1,0,1,0,2,"H","Y","2012-01-12","201201120DET"
"PHX",0,1,0,1,0,2,0,1,0,1,1,3,"A","Y","2012-01-12","201201120DET"
"DAL",0,2,1,1,1,5,0,0,2,2,0,4,"A","Y","2012-01-12","201201120LAK"
"LAK",0,0,2,2,0,4,0,2,1,1,1,5,"H","Y","2012-01-12","201201120LAK"
"COL",0,2,0,0,0,2,1,0,1,1,0,3,"A","N","2012-01-12","201201120NSH"
"NSH",1,0,1,1,0,3,0,2,0,0,0,2,"H","N","2012-01-12","201201120NSH"
"NYI",0,0,0,2,0,2,0,1,1,1,0,3,"H","N","2012-01-12","201201120NYI"
"PHI",0,1,1,1,0,3,0,0,0,2,0,2,"A","N","2012-01-12","201201120NYI"
"NYR",0,0,0,0,0,0,0,0,1,2,0,3,"H","N","2012-01-12","201201120NYR"
"OTT",0,0,1,2,0,3,0,0,0,0,0,0,"A","N","2012-01-12","201201120NYR"
"STL",0,1,1,0,0,2,1,1,1,0,0,3,"H","N","2012-01-12","201201120STL"
"VAN",1,1,1,0,0,3,0,1,1,0,0,2,"A","N","2012-01-12","201201120STL"
"CAR",0,4,0,1,0,5,0,1,1,0,0,2,"A","N","2012-01-12","201201120TBL"
"TBL",0,1,1,0,0,2,0,4,0,1,0,5,"H","N","2012-01-12","201201120TBL"
"SJS",0,0,1,1,0,2,0,0,0,0,0,0,"A","N","2012-01-12","201201120WPG"
"WPG",0,0,0,0,0,0,0,0,1,1,0,2,"H","N","2012-01-12","201201120WPG"
"BUF",0,2,1,0,0,3,0,2,0,0,0,2,"H","N","2012-01-13","201201130BUF"
"TOR",0,2,0,0,0,2,0,2,1,0,0,3,"A","N","2012-01-13","201201130BUF"
"CBJ",0,2,2,0,0,4,0,1,1,1,0,3,"H","N","2012-01-13","201201130CBJ"
"PHX",0,1,1,1,0,3,0,2,2,0,0,4,"A","N","2012-01-13","201201130CBJ"
"ANA",0,1,3,1,0,5,0,0,0,0,0,0,"A","N","2012-01-13","201201130EDM"
"EDM",0,0,0,0,0,0,0,1,3,1,0,5,"H","N","2012-01-13","201201130EDM"
"FLA",0,0,0,1,0,1,0,0,2,2,0,4,"H","N","2012-01-13","201201130FLA"
"PIT",0,0,2,2,0,4,0,0,0,1,0,1,"A","N","2012-01-13","201201130FLA"
"TBL",0,0,1,2,0,3,0,2,1,1,0,4,"A","N","2012-01-13","201201130WSH"
"WSH",0,2,1,1,0,4,0,0,1,2,0,3,"H","N","2012-01-13","201201130WSH"
"BOS",0,0,1,1,0,2,0,0,1,3,0,4,"A","N","2012-01-14","201201140CAR"
"CAR",0,0,1,3,0,4,0,0,1,1,0,2,"H","N","2012-01-14","201201140CAR"
"CBJ",0,0,0,1,0,1,0,0,1,1,0,2,"H","N","2012-01-14","201201140CBJ"
"SJS",0,0,1,1,0,2,0,0,0,1,0,1,"A","N","2012-01-14","201201140CBJ"
"CGY",0,0,1,0,0,1,0,0,3,1,0,4,"H","N","2012-01-14","201201140CGY"
"LAK",0,0,3,1,0,4,0,0,1,0,0,1,"A","N","2012-01-14","201201140CGY"
"COL",0,1,0,1,0,2,0,0,0,1,0,1,"A","N","2012-01-14","201201140DAL"
"DAL",0,0,0,1,0,1,0,1,0,1,0,2,"H","N","2012-01-14","201201140DAL"
"CHI",0,0,1,1,0,2,1,2,0,0,0,3,"A","N","2012-01-14","201201140DET"
"DET",1,2,0,0,0,3,0,0,1,1,0,2,"H","N","2012-01-14","201201140DET"
"MTL",0,0,0,2,0,2,0,0,0,2,1,3,"H","Y","2012-01-14","201201140MTL"
"OTT",0,0,0,2,1,3,0,0,0,2,0,2,"A","Y","2012-01-14","201201140MTL"
"NSH",0,1,1,2,0,4,0,0,1,1,0,2,"H","N","2012-01-14","201201140NSH"
"PHI",0,0,1,1,0,2,0,1,1,2,0,4,"A","N","2012-01-14","201201140NSH"
"BUF",0,0,2,0,0,2,0,1,1,2,0,4,"A","N","2012-01-14","201201140NYI"
"NYI",0,1,1,2,0,4,0,0,2,0,0,2,"H","N","2012-01-14","201201140NYI"
"MIN",0,1,1,0,0,2,0,0,2,0,1,3,"A","Y","2012-01-14","201201140STL"
"STL",0,0,2,0,1,3,0,1,1,0,0,2,"H","Y","2012-01-14","201201140STL"
"NYR",0,0,2,1,0,3,0,0,0,0,0,0,"A","N","2012-01-14","201201140TOR"
"TOR",0,0,0,0,0,0,0,0,2,1,0,3,"H","N","2012-01-14","201201140TOR"
"NJD",0,0,0,2,0,2,0,1,0,0,0,1,"A","N","2012-01-14","201201140WPG"
"WPG",0,1,0,0,0,1,0,0,0,2,0,2,"H","N","2012-01-14","201201140WPG"
"CHI",0,2,1,1,0,4,0,0,2,1,0,3,"H","N","2012-01-15","201201150CHI"
"SJS",0,0,2,1,0,3,0,2,1,1,0,4,"A","N","2012-01-15","201201150CHI"
"EDM",1,1,0,0,0,2,0,0,0,1,0,1,"H","N","2012-01-15","201201150EDM"
"LAK",0,0,0,1,0,1,1,1,0,0,0,2,"A","N","2012-01-15","201201150EDM"
"MTL",0,1,3,0,0,4,0,1,0,0,0,1,"H","N","2012-01-15","201201150MTL"
"NYR",0,1,0,0,0,1,0,1,3,0,0,4,"A","N","2012-01-15","201201150MTL"
"PIT",0,2,0,4,0,6,0,0,0,3,0,3,"A","N","2012-01-15","201201150TBL"
"TBL",0,0,0,3,0,3,0,2,0,4,0,6,"H","N","2012-01-15","201201150TBL"
"ANA",0,1,2,1,0,4,0,1,0,1,0,2,"A","N","2012-01-15","201201150VAN"
"VAN",0,1,0,1,0,2,0,1,2,1,0,4,"H","N","2012-01-15","201201150VAN"
"CAR",0,0,1,0,0,1,0,0,1,1,0,2,"A","N","2012-01-15","201201150WSH"
"WSH",0,0,1,1,0,2,0,0,1,0,0,1,"H","N","2012-01-15","201201150WSH"
"BUF",0,0,0,0,0,0,0,3,2,0,0,5,"A","N","2012-01-16","201201160DET"
"DET",0,3,2,0,0,5,0,0,0,0,0,0,"H","N","2012-01-16","201201160DET"
"BOS",0,1,1,0,1,3,0,0,2,0,0,2,"A","Y","2012-01-16","201201160FLA"
"FLA",0,0,2,0,0,2,0,1,1,0,1,3,"H","Y","2012-01-16","201201160FLA"
"NSH",0,3,0,0,0,3,0,0,0,1,0,1,"A","N","2012-01-16","201201160NYI"
"NYI",0,0,0,1,0,1,0,3,0,0,0,3,"H","N","2012-01-16","201201160NYI"
"OTT",0,0,0,0,0,0,0,1,1,0,0,2,"H","N","2012-01-16","201201160OTT"
"WPG",0,1,1,0,0,2,0,0,0,0,0,0,"A","N","2012-01-16","201201160OTT"
"COL",0,1,0,0,0,1,0,2,2,2,0,6,"A","N","2012-01-16","201201160PHX"
"PHX",0,2,2,2,0,6,0,1,0,0,0,1,"H","N","2012-01-16","201201160PHX"
"DAL",0,0,0,0,0,0,0,0,0,1,0,1,"A","N","2012-01-16","201201160STL"
"STL",0,0,0,1,0,1,0,0,0,0,0,0,"H","N","2012-01-16","201201160STL"
"CBJ",0,0,2,2,0,4,0,2,0,0,0,2,"H","N","2012-01-17","201201170CBJ"
"EDM",0,2,0,0,0,2,0,0,2,2,0,4,"A","N","2012-01-17","201201170CBJ"
"DAL",0,2,0,0,0,2,0,1,1,0,1,3,"H","Y","2012-01-17","201201170DAL"
"DET",0,1,1,0,1,3,0,2,0,0,0,2,"A","Y","2012-01-17","201201170DAL"
"NJD",0,1,3,1,0,5,0,0,0,1,0,1,"H","N","2012-01-17","201201170NJD"
"WPG",0,0,0,1,0,1,0,1,3,1,0,5,"A","N","2012-01-17","201201170NJD"
"NSH",0,0,0,0,0,0,0,1,1,1,0,3,"A","N","2012-01-17","201201170NYR"
"NYR",0,1,1,1,0,3,0,0,0,0,0,0,"H","N","2012-01-17","201201170NYR"
"MIN",0,0,1,0,0,1,0,1,3,1,0,5,"A","N","2012-01-17","201201170PHI"
"PHI",0,1,3,1,0,5,0,0,1,0,0,1,"H","N","2012-01-17","201201170PHI"
"CAR",0,1,0,0,0,1,0,1,0,0,1,2,"A","Y","2012-01-17","201201170PIT"
"PIT",0,1,0,0,1,2,0,1,0,0,0,1,"H","Y","2012-01-17","201201170PIT"
"CGY",0,0,1,0,0,1,0,0,0,1,1,2,"A","Y","2012-01-17","201201170SJS"
"SJS",0,0,0,1,1,2,0,0,1,0,0,1,"H","Y","2012-01-17","201201170SJS"
"BOS",0,0,2,1,0,3,0,1,1,3,0,5,"A","N","2012-01-17","201201170TBL"
"TBL",0,1,1,3,0,5,0,0,2,1,0,3,"H","N","2012-01-17","201201170TBL"
"OTT",0,1,1,1,0,3,0,2,0,0,0,2,"A","N","2012-01-17","201201170TOR"
"TOR",0,2,0,0,0,2,0,1,1,1,0,3,"H","N","2012-01-17","201201170TOR"
"LAK",0,1,1,0,1,3,0,0,1,1,0,2,"A","Y","2012-01-17","201201170VAN"
"VAN",0,0,1,1,0,2,0,1,1,0,1,3,"H","Y","2012-01-17","201201170VAN"
"NYI",0,1,1,1,0,3,0,0,0,0,0,0,"A","N","2012-01-17","201201170WSH"
"WSH",0,0,0,0,0,0,0,1,1,1,0,3,"H","N","2012-01-17","201201170WSH"
"ANA",0,2,2,2,0,6,0,1,1,0,0,2,"H","N","2012-01-18","201201180ANA"
"PHX",0,1,1,0,0,2,0,2,2,2,0,6,"A","N","2012-01-18","201201180ANA"
"BUF",0,1,1,0,0,2,0,2,2,2,0,6,"A","N","2012-01-18","201201180CHI"
"CHI",0,2,2,2,0,6,0,1,1,0,0,2,"H","N","2012-01-18","201201180CHI"
"COL",1,0,1,2,0,4,0,1,1,1,0,3,"H","N","2012-01-18","201201180COL"
"FLA",0,1,1,1,0,3,1,0,1,2,0,4,"A","N","2012-01-18","201201180COL"
"MTL",0,0,0,0,0,0,0,2,1,0,0,3,"H","N","2012-01-18","201201180MTL"
"WSH",0,2,1,0,0,3,0,0,0,0,0,0,"A","N","2012-01-18","201201180MTL"
"CBJ",0,0,0,0,0,0,0,0,2,1,0,3,"H","N","2012-01-19","201201190CBJ"
"NSH",0,0,2,1,0,3,0,0,0,0,0,0,"A","N","2012-01-19","201201190CBJ"
"CGY",0,0,1,0,1,2,0,1,0,0,0,1,"A","Y","2012-01-19","201201190LAK"
"LAK",0,1,0,0,0,1,0,0,1,0,1,2,"H","Y","2012-01-19","201201190LAK"
"BOS",0,0,0,4,0,4,0,1,0,0,0,1,"A","N","2012-01-19","201201190NJD"
"NJD",0,1,0,0,0,1,0,0,0,4,0,4,"H","N","2012-01-19","201201190NJD"
"NYR",0,0,1,0,0,1,0,1,0,3,0,4,"H","N","2012-01-19","201201190NYR"
"PIT",0,1,0,3,0,4,0,0,1,0,0,1,"A","N","2012-01-19","201201190NYR"
"NYI",0,0,2,2,0,4,0,0,0,1,0,1,"A","N","2012-01-19","201201190PHI"
"PHI",0,0,0,1,0,1,0,0,2,2,0,4,"H","N","2012-01-19","201201190PHI"
"DET",0,0,2,0,1,3,0,1,1,0,0,2,"A","Y","2012-01-19","201201190PHX"
"PHX",0,1,1,0,0,2,0,0,2,0,1,3,"H","Y","2012-01-19","201201190PHX"
"OTT",0,1,2,1,0,4,0,1,0,0,0,1,"A","N","2012-01-19","201201190SJS"
"SJS",0,1,0,0,0,1,0,1,2,1,0,4,"H","N","2012-01-19","201201190SJS"
"EDM",0,0,0,0,0,0,0,0,0,1,0,1,"A","N","2012-01-19","201201190STL"
"STL",0,0,0,1,0,1,0,0,0,0,0,0,"H","N","2012-01-19","201201190STL"
"MIN",0,0,0,1,0,1,0,2,1,1,0,4,"A","N","2012-01-19","201201190TOR"
"TOR",0,2,1,1,0,4,0,0,0,1,0,1,"H","N","2012-01-19","201201190TOR"
"BUF",0,0,1,0,0,1,0,1,1,2,0,4,"A","N","2012-01-19","201201190WPG"
"WPG",0,1,1,2,0,4,0,0,1,0,0,1,"H","N","2012-01-19","201201190WPG"
"CAR",0,1,1,1,0,3,0,0,0,0,0,0,"H","N","2012-01-20","201201200CAR"
"WSH",0,0,0,0,0,0,0,1,1,1,0,3,"A","N","2012-01-20","201201200CAR"
"CHI",0,2,1,0,0,3,0,0,0,1,0,1,"H","N","2012-01-20","201201200CHI"
"FLA",0,0,0,1,0,1,0,2,1,0,0,3,"A","N","2012-01-20","201201200CHI"
"DAL",0,0,0,1,0,1,0,1,0,1,0,2,"H","N","2012-01-20","201201200DAL"
"TBL",0,1,0,1,0,2,0,0,0,1,0,1,"A","N","2012-01-20","201201200DAL"
"MTL",0,2,2,0,0,4,0,1,1,2,1,5,"A","Y","2012-01-20","201201200PIT"
"PIT",0,1,1,2,1,5,0,2,2,0,0,4,"H","Y","2012-01-20","201201200PIT"
"ANA",0,0,2,0,0,2,0,0,0,1,0,1,"H","N","2012-01-21","201201210ANA"
"OTT",0,0,0,1,0,1,0,0,2,0,0,2,"A","N","2012-01-21","201201210ANA"
"BOS",0,0,2,0,0,2,1,0,2,0,0,3,"H","N","2012-01-21","201201210BOS"
"NYR",1,0,2,0,0,3,0,0,2,0,0,2,"A","N","2012-01-21","201201210BOS"
"CBJ",0,1,1,0,0,2,0,1,1,0,1,3,"A","Y","2012-01-21","201201210DET"
"DET",0,1,1,0,1,3,0,1,1,0,0,2,"H","Y","2012-01-21","201201210DET"
"CGY",0,3,1,2,0,6,0,0,0,2,0,2,"A","N","2012-01-21","201201210EDM"
"EDM",0,0,0,2,0,2,0,3,1,2,0,6,"H","N","2012-01-21","201201210EDM"
"COL",0,0,2,1,0,3,0,0,1,0,0,1,"A","N","2012-01-21","201201210LAK"
"LAK",0,0,1,0,0,1,0,0,2,1,0,3,"H","N","2012-01-21","201201210LAK"
"DAL",0,1,1,0,0,2,0,0,4,1,0,5,"A","N","2012-01-21","201201210MIN"
"MIN",0,0,4,1,0,5,0,1,1,0,0,2,"H","N","2012-01-21","201201210MIN"
"NJD",0,0,1,0,0,1,0,0,2,2,0,4,"H","N","2012-01-21","201201210NJD"
"PHI",0,0,2,2,0,4,0,0,1,0,0,1,"A","N","2012-01-21","201201210NJD"
"CHI",0,1,0,1,0,2,0,1,3,1,0,5,"A","N","2012-01-21","201201210NSH"
"NSH",0,1,3,1,0,5,0,1,0,1,0,2,"H","N","2012-01-21","201201210NSH"
"CAR",0,1,0,0,0,1,1,0,1,0,0,2,"A","N","2012-01-21","201201210NYI"
"NYI",1,0,1,0,0,2,0,1,0,0,0,1,"H","N","2012-01-21","201201210NYI"
"PHX",0,0,1,2,0,3,0,2,2,0,0,4,"H","N","2012-01-21","201201210PHX"
"TBL",0,2,2,0,0,4,0,0,1,2,0,3,"A","N","2012-01-21","201201210PHX"
"BUF",0,1,0,1,0,2,0,0,2,2,0,4,"A","N","2012-01-21","201201210STL"
"STL",0,0,2,2,0,4,0,1,0,1,0,2,"H","N","2012-01-21","201201210STL"
"MTL",0,1,0,2,0,3,0,1,0,0,0,1,"A","N","2012-01-21","201201210TOR"
"TOR",0,1,0,0,0,1,0,1,0,2,0,3,"H","N","2012-01-21","201201210TOR"
"SJS",0,1,1,1,0,3,0,1,1,2,0,4,"A","N","2012-01-21","201201210VAN"
"VAN",0,1,1,2,0,4,0,1,1,1,0,3,"H","N","2012-01-21","201201210VAN"
"FLA",0,2,0,1,1,4,0,0,1,2,0,3,"A","Y","2012-01-21","201201210WPG"
"WPG",0,0,1,2,0,3,0,2,0,1,1,4,"H","Y","2012-01-21","201201210WPG"
"ANA",0,1,0,2,0,3,0,0,0,2,0,2,"H","N","2012-01-22","201201220ANA"
"COL",0,0,0,2,0,2,0,1,0,2,0,3,"A","N","2012-01-22","201201220ANA"
"BOS",0,3,0,2,1,6,0,1,3,1,0,5,"A","Y","2012-01-22","201201220PHI"
"PHI",0,1,3,1,0,5,0,3,0,2,1,6,"H","Y","2012-01-22","201201220PHI"
"PIT",1,2,0,1,0,4,0,0,2,1,0,3,"H","N","2012-01-22","201201220PIT"
"WSH",0,0,2,1,0,3,1,2,0,1,0,4,"A","N","2012-01-22","201201220PIT"
"CAR",0,2,0,0,0,2,0,0,1,0,0,1,"H","N","2012-01-23","201201230CAR"
"WPG",0,0,1,0,0,1,0,2,0,0,0,2,"A","N","2012-01-23","201201230CAR"
"DET",0,0,2,1,0,3,0,1,0,0,0,1,"H","N","2012-01-23","201201230DET"
"STL",0,1,0,0,0,1,0,0,2,1,0,3,"A","N","2012-01-23","201201230DET"
"EDM",0,0,1,0,1,2,0,0,0,1,0,1,"H","Y","2012-01-23","201201230EDM"
"SJS",0,0,0,1,0,1,0,0,1,0,1,2,"A","Y","2012-01-23","201201230EDM"
"LAK",0,1,3,0,0,4,0,0,0,1,0,1,"H","N","2012-01-23","201201230LAK"
"OTT",0,0,0,1,0,1,0,1,3,0,0,4,"A","N","2012-01-23","201201230LAK"
"CBJ",0,0,1,0,0,1,0,1,1,2,0,4,"A","N","2012-01-23","201201230NSH"
"NSH",0,1,1,2,0,4,0,0,1,0,0,1,"H","N","2012-01-23","201201230NSH"
"NYI",0,0,0,0,0,0,0,1,0,2,0,3,"A","N","2012-01-23","201201230TOR"
"TOR",0,1,0,2,0,3,0,0,0,0,0,0,"H","N","2012-01-23","201201230TOR"
"CGY",0,0,0,0,0,0,0,0,0,1,0,1,"H","N","2012-01-24","201201240CGY"
"SJS",0,0,0,1,0,1,0,0,0,0,0,0,"A","N","2012-01-24","201201240CGY"
"CHI",0,0,0,1,0,1,0,2,0,1,0,3,"H","N","2012-01-24","201201240CHI"
"NSH",0,2,0,1,0,3,0,0,0,1,0,1,"A","N","2012-01-24","201201240CHI"
"COL",0,1,1,0,0,2,0,2,0,1,0,3,"H","N","2012-01-24","201201240COL"
"MIN",0,2,0,1,0,3,0,1,1,0,0,2,"A","N","2012-01-24","201201240COL"
"ANA",0,0,0,0,0,0,0,1,0,0,0,1,"A","N","2012-01-24","201201240DAL"
"DAL",0,1,0,0,0,1,0,0,0,0,0,0,"H","N","2012-01-24","201201240DAL"
"FLA",0,1,1,0,0,2,0,2,0,0,1,3,"H","Y","2012-01-24","201201240FLA"
"PHI",0,2,0,0,1,3,0,1,1,0,0,2,"A","Y","2012-01-24","201201240FLA"
"BUF",0,1,0,0,1,2,0,0,1,0,0,1,"A","Y","2012-01-24","201201240NJD"
"NJD",0,0,1,0,0,1,0,1,0,0,1,2,"H","Y","2012-01-24","201201240NJD"
"NYI",0,1,1,1,0,3,1,0,1,2,0,4,"H","N","2012-01-24","201201240NYI"
"TOR",1,0,1,2,0,4,0,1,1,1,0,3,"A","N","2012-01-24","201201240NYI"
"NYR",0,1,1,1,0,3,0,0,0,0,0,0,"H","N","2012-01-24","201201240NYR"
"WPG",0,0,0,0,0,0,0,1,1,1,0,3,"A","N","2012-01-24","201201240NYR"
"OTT",0,0,1,1,0,2,0,1,1,1,0,3,"A","N","2012-01-24","201201240PHX"
"PHX",0,1,1,1,0,3,0,0,1,1,0,2,"H","N","2012-01-24","201201240PHX"
"PIT",0,0,2,0,1,3,0,0,1,1,0,2,"A","Y","2012-01-24","201201240STL"
"STL",0,0,1,1,0,2,0,0,2,0,1,3,"H","Y","2012-01-24","201201240STL"
"CBJ",0,1,0,1,0,2,0,1,2,1,0,4,"A","N","2012-01-24","201201240TBL"
"TBL",0,1,2,1,0,4,0,1,0,1,0,2,"H","N","2012-01-24","201201240TBL"
"EDM",0,0,1,1,0,2,0,1,0,1,1,3,"A","Y","2012-01-24","201201240VAN"
"VAN",0,1,0,1,1,3,0,0,1,1,0,2,"H","Y","2012-01-24","201201240VAN"
"BOS",0,1,2,0,0,3,0,0,3,2,0,5,"A","N","2012-01-24","201201240WSH"
"WSH",0,0,3,2,0,5,0,1,2,0,0,3,"H","N","2012-01-24","201201240WSH"
"DET",0,0,0,2,0,2,0,4,2,1,0,7,"A","N","2012-01-25","201201250MTL"
"MTL",0,4,2,1,0,7,0,0,0,2,0,2,"H","N","2012-01-25","201201250MTL"
"BOS",0,1,1,2,0,4,0,1,2,0,0,3,"H","N","2012-01-31","201201310BOS"
"OTT",0,1,2,0,0,3,0,1,1,2,0,4,"A","N","2012-01-31","201201310BOS"
"CAR",0,0,0,2,0,2,0,1,1,3,0,5,"H","N","2012-01-31","201201310CAR"
"NYI",0,1,1,3,0,5,0,0,0,2,0,2,"A","N","2012-01-31","201201310CAR"
"CGY",0,0,1,0,0,1,0,1,0,2,0,3,"H","N","2012-01-31","201201310CGY"
"DET",0,1,0,2,0,3,0,0,1,0,0,1,"A","N","2012-01-31","201201310CGY"
"COL",0,0,1,1,0,2,0,2,0,1,0,3,"A","N","2012-01-31","201201310EDM"
"EDM",0,2,0,1,0,3,0,0,1,1,0,2,"H","N","2012-01-31","201201310EDM"
"MIN",0,2,1,1,0,4,0,0,1,4,0,5,"H","N","2012-01-31","201201310MIN"
"NSH",0,0,1,4,0,5,0,2,1,1,0,4,"A","N","2012-01-31","201201310MIN"
"BUF",0,0,1,2,0,3,0,1,0,0,0,1,"A","N","2012-01-31","201201310MTL"
"MTL",0,1,0,0,0,1,0,0,1,2,0,3,"H","N","2012-01-31","201201310MTL"
"NJD",0,0,1,2,1,4,0,1,0,2,0,3,"H","Y","2012-01-31","201201310NJD"
"NYR",0,1,0,2,0,3,0,0,1,2,1,4,"A","Y","2012-01-31","201201310NJD"
"PHI",0,1,0,0,0,1,0,0,1,0,1,2,"H","Y","2012-01-31","201201310PHI"
"WPG",0,0,1,0,1,2,0,1,0,0,0,1,"A","Y","2012-01-31","201201310PHI"
"ANA",0,0,3,1,0,4,0,1,0,0,0,1,"A","N","2012-01-31","201201310PHX"
"PHX",0,1,0,0,0,1,0,0,3,1,0,4,"H","N","2012-01-31","201201310PHX"
"PIT",0,0,1,3,1,5,0,0,2,2,0,4,"H","Y","2012-01-31","201201310PIT"
"TOR",0,0,2,2,0,4,0,0,1,3,1,5,"A","Y","2012-01-31","201201310PIT"
"CBJ",0,0,0,0,0,0,0,2,2,2,0,6,"A","N","2012-01-31","201201310SJS"
"SJS",0,2,2,2,0,6,0,0,0,0,0,0,"H","N","2012-01-31","201201310SJS"
"TBL",1,1,2,0,0,4,0,1,1,1,0,3,"H","N","2012-01-31","201201310TBL"
"WSH",0,1,1,1,0,3,1,1,2,0,0,4,"A","N","2012-01-31","201201310TBL"
"CHI",0,1,0,1,0,2,1,1,0,1,0,3,"A","N","2012-01-31","201201310VAN"
"VAN",1,1,0,1,0,3,0,1,0,1,0,2,"H","N","2012-01-31","201201310VAN"
"ANA",0,1,1,0,0,2,0,3,1,2,0,6,"H","N","2012-02-01","201202010ANA"
"DAL",0,3,1,2,0,6,0,1,1,0,0,2,"A","N","2012-02-01","201202010ANA"
"BUF",0,0,0,0,0,0,0,0,0,0,1,1,"H","Y","2012-02-01","201202010BUF"
"NYR",0,0,0,0,1,1,0,0,0,0,0,0,"A","Y","2012-02-01","201202010BUF"
"FLA",0,0,1,3,0,4,0,0,1,1,0,2,"H","N","2012-02-01","201202010FLA"
"WSH",0,0,1,1,0,2,0,0,1,3,0,4,"A","N","2012-02-01","201202010FLA"
"CBJ",0,0,1,1,0,2,0,1,1,1,0,3,"A","N","2012-02-01","201202010LAK"
"LAK",0,1,1,1,0,3,0,0,1,1,0,2,"H","N","2012-02-01","201202010LAK"
"PIT",0,0,0,0,0,0,0,0,0,1,0,1,"A","N","2012-02-01","201202010TOR"
"TOR",0,0,0,1,0,1,0,0,0,0,0,0,"H","N","2012-02-01","201202010TOR"
"BOS",0,0,0,0,0,0,0,1,1,1,0,3,"H","N","2012-02-02","201202020BOS"
"CAR",0,1,1,1,0,3,0,0,0,0,0,0,"A","N","2012-02-02","201202020BOS"
"COL",0,0,0,0,0,0,0,1,0,0,0,1,"H","N","2012-02-02","201202020COL"
"MIN",0,1,0,0,0,1,0,0,0,0,0,0,"A","N","2012-02-02","201202020COL"
"CHI",0,1,2,1,0,4,0,0,3,5,0,8,"A","N","2012-02-02","201202020EDM"
"EDM",0,0,3,5,0,8,0,1,2,1,0,4,"H","N","2012-02-02","201202020EDM"
"MTL",0,2,1,0,0,3,0,1,1,3,0,5,"A","N","2012-02-02","201202020NJD"
"NJD",0,1,1,3,0,5,0,2,1,0,0,3,"H","N","2012-02-02","201202020NJD"
"NSH",0,0,0,1,0,1,0,1,1,2,0,4,"A","N","2012-02-02","201202020PHI"
"PHI",0,1,1,2,0,4,0,0,0,1,0,1,"H","N","2012-02-02","201202020PHI"
"DAL",0,0,1,1,0,2,0,2,2,1,0,5,"A","N","2012-02-02","201202020SJS"
"SJS",0,2,2,1,0,5,0,0,1,1,0,2,"H","N","2012-02-02","201202020SJS"
"TBL",0,0,0,1,0,1,1,0,1,0,0,2,"H","N","2012-02-02","201202020TBL"
"WPG",1,0,1,0,0,2,0,0,0,1,0,1,"A","N","2012-02-02","201202020TBL"
"DET",0,1,1,1,1,4,0,1,0,2,0,3,"A","Y","2012-02-02","201202020VAN"
"VAN",0,1,0,2,0,3,0,1,1,1,1,4,"H","Y","2012-02-02","201202020VAN"
"ANA",0,1,1,0,0,2,1,0,1,1,0,3,"H","N","2012-02-03","201202030ANA"
"CBJ",1,0,1,1,0,3,0,1,1,0,0,2,"A","N","2012-02-03","201202030ANA"
"CGY",0,1,1,1,0,3,0,1,0,0,0,1,"H","N","2012-02-03","201202030CGY"
"CHI",0,1,0,0,0,1,0,1,1,1,0,3,"A","N","2012-02-03","201202030CGY"
"FLA",0,1,1,0,0,2,0,0,1,0,0,1,"H","N","2012-02-03","201202030FLA"
"WPG",0,0,1,0,0,1,0,1,1,0,0,2,"A","N","2012-02-03","201202030FLA"
"NYI",1,0,0,1,0,2,0,0,1,0,0,1,"A","N","2012-02-03","201202030OTT"
"OTT",0,0,1,0,0,1,1,0,0,1,0,2,"H","N","2012-02-03","201202030OTT"
"LAK",0,0,0,0,0,0,0,0,1,0,0,1,"A","N","2012-02-03","201202030STL"
"STL",0,0,1,0,0,1,0,0,0,0,0,0,"H","N","2012-02-03","201202030STL"
"BOS",0,0,0,1,0,1,0,1,0,1,0,2,"H","N","2012-02-04","201202040BOS"
"PIT",0,1,0,1,0,2,0,0,0,1,0,1,"A","N","2012-02-04","201202040BOS"
"CAR",0,0,1,1,0,2,0,1,0,0,0,1,"H","N","2012-02-04","201202040CAR"
"LAK",0,1,0,0,0,1,0,0,1,1,0,2,"A","N","2012-02-04","201202040CAR"
"COL",0,1,1,0,0,2,0,1,0,1,1,3,"H","Y","2012-02-04","201202040COL"
"VAN",0,1,0,1,1,3,0,1,1,0,0,2,"A","Y","2012-02-04","201202040COL"
"DAL",0,0,1,0,1,2,0,0,0,1,0,1,"H","Y","2012-02-04","201202040DAL"
"MIN",0,0,0,1,0,1,0,0,1,0,1,2,"A","Y","2012-02-04","201202040DAL"
"DET",0,1,0,3,0,4,0,3,0,1,1,5,"A","Y","2012-02-04","201202040EDM"
"EDM",0,3,0,1,1,5,0,1,0,3,0,4,"H","Y","2012-02-04","201202040EDM"
"MTL",0,0,0,0,0,0,0,1,0,2,0,3,"H","N","2012-02-04","201202040MTL"
"WSH",0,1,0,2,0,3,0,0,0,0,0,0,"A","N","2012-02-04","201202040MTL"
"NSH",0,2,0,1,0,3,0,0,0,1,0,1,"H","N","2012-02-04","201202040NSH"
"STL",0,0,0,1,0,1,0,2,0,1,0,3,"A","N","2012-02-04","201202040NSH"
"BUF",0,1,1,1,1,4,0,3,0,0,0,3,"A","Y","2012-02-04","201202040NYI"
"NYI",0,3,0,0,0,3,0,1,1,1,1,4,"H","Y","2012-02-04","201202040NYI"
"OTT",0,0,0,0,0,0,0,2,1,2,0,5,"H","N","2012-02-04","201202040OTT"
"TOR",0,2,1,2,0,5,0,0,0,0,0,0,"A","N","2012-02-04","201202040OTT"
"NJD",0,3,3,0,0,6,0,0,0,4,0,4,"A","N","2012-02-04","201202040PHI"
"PHI",0,0,0,4,0,4,0,3,3,0,0,6,"H","N","2012-02-04","201202040PHI"
"PHX",0,0,3,2,0,5,0,0,2,1,0,3,"H","N","2012-02-04","201202040PHX"
"SJS",0,0,2,1,0,3,0,0,3,2,0,5,"A","N","2012-02-04","201202040PHX"
"FLA",0,1,2,0,0,3,0,1,4,1,0,6,"A","N","2012-02-04","201202040TBL"
"TBL",0,1,4,1,0,6,0,1,2,0,0,3,"H","N","2012-02-04","201202040TBL"
"MTL",0,1,2,0,0,3,0,0,0,0,0,0,"H","N","2012-02-05","201202050MTL"
"WPG",0,0,0,0,0,0,0,1,2,0,0,3,"A","N","2012-02-05","201202050MTL"
"NJD",0,2,2,1,0,5,0,0,1,1,0,2,"H","N","2012-02-05","201202050NJD"
"PIT",0,0,1,1,0,2,0,2,2,1,0,5,"A","N","2012-02-05","201202050NJD"
"NYR",0,1,1,3,0,5,0,0,1,1,0,2,"H","N","2012-02-05","201202050NYR"
"PHI",0,0,1,1,0,2,0,1,1,3,0,5,"A","N","2012-02-05","201202050NYR"
"BOS",0,2,0,2,0,4,0,0,0,1,0,1,"A","N","2012-02-05","201202050WSH"
"WSH",0,0,0,1,0,1,0,2,0,2,0,4,"H","N","2012-02-05","201202050WSH"
"ANA",0,2,0,0,1,3,0,0,1,1,0,2,"H","Y","2012-02-06","201202060ANA"
"CGY",0,0,1,1,0,2,0,2,0,0,1,3,"A","Y","2012-02-06","201202060ANA"
"DET",0,0,1,0,0,1,0,1,1,1,0,3,"A","N","2012-02-06","201202060PHX"
"PHX",0,1,1,1,0,3,0,0,1,0,0,1,"H","N","2012-02-06","201202060PHX"
"EDM",0,2,1,0,0,3,0,2,3,1,0,6,"A","N","2012-02-06","201202060TOR"
"TOR",0,2,3,1,0,6,0,2,1,0,0,3,"H","N","2012-02-06","201202060TOR"
"CBJ",0,1,1,1,0,3,0,1,0,0,0,1,"H","N","2012-02-07","201202070CBJ"
"MIN",0,1,0,0,0,1,0,1,1,1,0,3,"A","N","2012-02-07","201202070CBJ"
"CHI",0,0,2,0,0,2,0,0,2,3,0,5,"A","N","2012-02-07","201202070COL"
"COL",0,0,2,3,0,5,0,0,2,0,0,2,"H","N","2012-02-07","201202070COL"
"DAL",0,0,1,0,0,1,0,1,1,2,0,4,"H","N","2012-02-07","201202070DAL"
"PHX",0,1,1,2,0,4,0,0,1,0,0,1,"A","N","2012-02-07","201202070DAL"
"MTL",0,0,1,1,1,3,0,0,0,2,0,2,"H","Y","2012-02-07","201202070MTL"
"PIT",0,0,0,2,0,2,0,0,1,1,1,3,"A","Y","2012-02-07","201202070MTL"
"NSH",0,1,2,0,0,3,0,3,0,0,1,4,"H","Y","2012-02-07","201202070NSH"
"VAN",0,3,0,0,1,4,0,1,2,0,0,3,"A","Y","2012-02-07","201202070NSH"
"NJD",0,1,0,0,0,1,0,0,0,0,0,0,"A","N","2012-02-07","201202070NYR"
"NYR",0,0,0,0,0,0,0,1,0,0,0,1,"H","N","2012-02-07","201202070NYR"
"OTT",0,0,1,0,0,1,0,2,1,0,0,3,"H","N","2012-02-07","201202070OTT"
"STL",0,2,1,0,0,3,0,0,1,0,0,1,"A","N","2012-02-07","201202070OTT"
"NYI",0,0,0,0,1,1,0,0,0,0,0,0,"A","Y","2012-02-07","201202070PHI"
"PHI",0,0,0,0,0,0,0,0,0,0,1,1,"H","Y","2012-02-07","201202070PHI"
"LAK",0,1,2,0,0,3,0,0,1,0,0,1,"A","N","2012-02-07","201202070TBL"
"TBL",0,0,1,0,0,1,0,1,2,0,0,3,"H","N","2012-02-07","201202070TBL"
"TOR",0,1,0,0,0,1,0,1,1,0,0,2,"A","N","2012-02-07","201202070WPG"
"WPG",0,1,1,0,0,2,0,1,0,0,0,1,"H","N","2012-02-07","201202070WPG"
"FLA",0,0,0,0,0,0,0,2,2,0,0,4,"A","N","2012-02-07","201202070WSH"
"WSH",0,2,2,0,0,4,0,0,0,0,0,0,"H","N","2012-02-07","201202070WSH"
"ANA",1,0,1,1,0,3,0,1,0,1,0,2,"H","N","2012-02-08","201202080ANA"
"CAR",0,1,0,1,0,2,1,0,1,1,0,3,"A","N","2012-02-08","201202080ANA"
"BOS",0,0,0,0,0,0,0,2,2,2,0,6,"A","N","2012-02-08","201202080BUF"
"BUF",0,2,2,2,0,6,0,0,0,0,0,0,"H","N","2012-02-08","201202080BUF"
"DET",0,1,1,2,0,4,0,0,1,1,0,2,"H","N","2012-02-08","201202080DET"
"EDM",0,0,1,1,0,2,0,1,1,2,0,4,"A","N","2012-02-08","201202080DET"
"CGY",0,1,2,1,0,4,0,0,2,1,0,3,"A","N","2012-02-08","201202080SJS"
"SJS",0,0,2,1,0,3,0,1,2,1,0,4,"H","N","2012-02-08","201202080SJS"
"CBJ",0,0,2,0,0,2,0,2,1,1,0,4,"H","N","2012-02-09","201202090CBJ"
"DAL",0,2,1,1,0,4,0,0,2,0,0,2,"A","N","2012-02-09","201202090CBJ"
"FLA",0,0,2,1,0,3,0,0,0,1,0,1,"H","N","2012-02-09","201202090FLA"
"LAK",0,0,0,1,0,1,0,0,2,1,0,3,"A","N","2012-02-09","201202090FLA"
"MIN",0,1,0,1,0,2,0,2,1,2,0,5,"H","N","2012-02-09","201202090MIN"
"VAN",0,2,1,2,0,5,0,1,0,1,0,2,"A","N","2012-02-09","201202090MIN"
"NJD",0,1,2,0,0,3,0,1,1,1,1,4,"H","Y","2012-02-09","201202090NJD"
"STL",0,1,1,1,1,4,0,1,2,0,0,3,"A","Y","2012-02-09","201202090NJD"
"MTL",0,1,1,2,0,4,0,0,0,2,0,2,"A","N","2012-02-09","201202090NYI"
"NYI",0,0,0,2,0,2,0,1,1,2,0,4,"H","N","2012-02-09","201202090NYI"
"NYR",1,0,2,1,0,4,0,1,2,0,0,3,"H","N","2012-02-09","201202090NYR"
"TBL",0,1,2,0,0,3,1,0,2,1,0,4,"A","N","2012-02-09","201202090NYR"
"NSH",0,1,1,1,0,3,0,1,2,1,0,4,"A","N","2012-02-09","201202090OTT"
"OTT",0,1,2,1,0,4,0,1,1,1,0,3,"H","N","2012-02-09","201202090OTT"
"PHI",0,1,3,0,0,4,0,0,3,0,0,3,"H","N","2012-02-09","201202090PHI"
"TOR",0,0,3,0,0,3,0,1,3,0,0,4,"A","N","2012-02-09","201202090PHI"
"CGY",0,0,0,1,0,1,1,1,0,0,0,2,"A","N","2012-02-09","201202090PHX"
"PHX",1,1,0,0,0,2,0,0,0,1,0,1,"H","N","2012-02-09","201202090PHX"
"WPG",0,0,0,2,1,3,0,0,0,2,0,2,"A","Y","2012-02-09","201202090WSH"
"WSH",0,0,0,2,0,2,0,0,0,2,1,3,"H","Y","2012-02-09","201202090WSH"
"BUF",0,0,0,2,1,3,0,1,0,1,0,2,"H","Y","2012-02-10","201202100BUF"
"DAL",0,1,0,1,0,2,0,0,0,2,1,3,"A","Y","2012-02-10","201202100BUF"
"CAR",0,2,1,0,0,3,1,1,2,0,0,4,"A","N","2012-02-10","201202100COL"
"COL",1,1,2,0,0,4,0,2,1,0,0,3,"H","N","2012-02-10","201202100COL"
"ANA",0,1,0,0,0,1,0,1,0,0,1,2,"A","Y","2012-02-10","201202100DET"
"DET",0,1,0,0,1,2,0,1,0,0,0,1,"H","Y","2012-02-10","201202100DET"
"CHI",0,0,2,1,0,3,0,2,1,2,0,5,"A","N","2012-02-10","201202100SJS"
"SJS",0,2,1,2,0,5,0,0,2,1,0,3,"H","N","2012-02-10","201202100SJS"
"BOS",0,1,0,2,1,4,0,0,1,2,0,3,"H","Y","2012-02-11","201202110BOS"
"NSH",0,0,1,2,0,3,0,1,0,2,1,4,"A","Y","2012-02-11","201202110BOS"
"BUF",0,0,0,1,0,1,0,0,2,0,0,2,"H","N","2012-02-11","201202110BUF"
"TBL",0,0,2,0,0,2,0,0,0,1,0,1,"A","N","2012-02-11","201202110BUF"
"CGY",0,1,1,0,1,3,0,0,1,1,0,2,"H","Y","2012-02-11","201202110CGY"
"VAN",0,0,1,1,0,2,0,1,1,0,1,3,"A","Y","2012-02-11","201202110CGY"
"CBJ",0,1,1,1,0,3,0,1,0,0,0,1,"A","N","2012-02-11","201202110MIN"
"MIN",0,1,0,0,0,1,0,1,1,1,0,3,"H","N","2012-02-11","201202110MIN"
"FLA",0,1,1,1,0,3,0,1,0,0,0,1,"A","N","2012-02-11","201202110NJD"
"NJD",0,1,0,0,0,1,0,1,1,1,0,3,"H","N","2012-02-11","201202110NJD"
"LAK",0,0,1,0,0,1,1,1,0,0,0,2,"A","N","2012-02-11","201202110NYI"
"NYI",1,1,0,0,0,2,0,0,1,0,0,1,"H","N","2012-02-11","201202110NYI"
"EDM",1,0,2,1,0,4,0,1,1,1,0,3,"A","N","2012-02-11","201202110OTT"
"OTT",0,1,1,1,0,3,1,0,2,1,0,4,"H","N","2012-02-11","201202110OTT"
"NYR",0,2,1,2,0,5,0,1,1,0,0,2,"A","N","2012-02-11","201202110PHI"
"PHI",0,1,1,0,0,2,0,2,1,2,0,5,"H","N","2012-02-11","201202110PHI"
"CHI",0,0,0,0,0,0,0,2,1,0,0,3,"A","N","2012-02-11","201202110PHX"
"PHX",0,2,1,0,0,3,0,0,0,0,0,0,"H","N","2012-02-11","201202110PHX"
"PIT",0,2,3,3,0,8,0,2,1,2,0,5,"H","N","2012-02-11","201202110PIT"
"WPG",0,2,1,2,0,5,0,2,3,3,0,8,"A","N","2012-02-11","201202110PIT"
"COL",0,2,0,0,0,2,1,2,0,0,0,3,"A","N","2012-02-11","201202110STL"
"STL",1,2,0,0,0,3,0,2,0,0,0,2,"H","N","2012-02-11","201202110STL"
"MTL",0,0,4,1,0,5,0,0,0,0,0,0,"A","N","2012-02-11","201202110TOR"
"TOR",0,0,0,0,0,0,0,0,4,1,0,5,"H","N","2012-02-11","201202110TOR"
"ANA",0,2,3,0,0,5,0,1,1,1,0,3,"A","N","2012-02-12","201202120CBJ"
"CBJ",0,1,1,1,0,3,0,2,3,0,0,5,"H","N","2012-02-12","201202120CBJ"
"DAL",0,0,1,1,0,2,0,1,1,2,0,4,"H","N","2012-02-12","201202120DAL"
"LAK",0,1,1,2,0,4,0,0,1,1,0,2,"A","N","2012-02-12","201202120DAL"
"DET",0,1,2,1,0,4,0,1,2,0,0,3,"H","N","2012-02-12","201202120DET"
"PHI",0,1,2,0,0,3,0,1,2,1,0,4,"A","N","2012-02-12","201202120DET"
"FLA",0,1,3,0,0,4,0,1,0,0,0,1,"A","N","2012-02-12","201202120NYI"
"NYI",0,1,0,0,0,1,0,1,3,0,0,4,"H","N","2012-02-12","201202120NYI"
"NYR",0,1,1,1,0,3,0,0,1,1,0,2,"H","N","2012-02-12","201202120NYR"
"WSH",0,0,1,1,0,2,0,1,1,1,0,3,"A","N","2012-02-12","201202120NYR"
"PIT",0,1,3,0,0,4,0,2,0,0,0,2,"H","N","2012-02-12","201202120PIT"
"TBL",0,2,0,0,0,2,0,1,3,0,0,4,"A","N","2012-02-12","201202120PIT"
"SJS",0,0,0,0,0,0,0,1,1,1,0,3,"A","N","2012-02-12","201202120STL"
"STL",0,1,1,1,0,3,0,0,0,0,0,0,"H","N","2012-02-12","201202120STL"
"CAR",0,1,1,3,0,5,0,0,3,0,0,3,"A","N","2012-02-13","201202130MTL"
"MTL",0,0,3,0,0,3,0,1,1,3,0,5,"H","N","2012-02-13","201202130MTL"
"PHX",0,0,0,1,0,1,0,0,1,0,1,2,"A","Y","2012-02-13","201202130VAN"
"VAN",0,0,1,0,1,2,0,0,0,1,0,1,"H","Y","2012-02-13","201202130VAN"
"SJS",0,1,2,2,0,5,0,0,1,2,0,3,"A","N","2012-02-13","201202130WSH"
"WSH",0,0,1,2,0,3,0,1,2,2,0,5,"H","N","2012-02-13","201202130WSH"
"BOS",0,0,0,0,0,0,0,2,0,1,0,3,"H","N","2012-02-14","201202140BOS"
"NYR",0,2,0,1,0,3,0,0,0,0,0,0,"A","N","2012-02-14","201202140BOS"
"BUF",0,0,1,0,0,1,0,1,0,3,0,4,"H","N","2012-02-14","201202140BUF"
"NJD",0,1,0,3,0,4,0,0,1,0,0,1,"A","N","2012-02-14","201202140BUF"
"CBJ",0,1,0,1,0,2,0,1,0,0,0,1,"H","N","2012-02-14","201202140CBJ"
"STL",0,1,0,0,0,1,0,1,0,1,0,2,"A","N","2012-02-14","201202140CBJ"
"CGY",0,2,1,2,0,5,0,1,0,0,0,1,"H","N","2012-02-14","201202140CGY"
"TOR",0,1,0,0,0,1,0,2,1,2,0,5,"A","N","2012-02-14","201202140CGY"
"DAL",0,0,0,1,0,1,0,2,0,1,0,3,"A","N","2012-02-14","201202140DET"
"DET",0,2,0,1,0,3,0,0,0,1,0,1,"H","N","2012-02-14","201202140DET"
"ANA",0,0,0,2,0,2,0,1,0,0,0,1,"A","N","2012-02-14","201202140MIN"
"MIN",0,1,0,0,0,1,0,0,0,2,0,2,"H","N","2012-02-14","201202140MIN"
"CHI",0,1,0,1,0,2,0,1,1,1,0,3,"A","N","2012-02-14","201202140NSH"
"NSH",0,1,1,1,0,3,0,1,0,1,0,2,"H","N","2012-02-14","201202140NSH"
"OTT",0,1,1,2,0,4,0,0,0,0,0,0,"A","N","2012-02-14","201202140TBL"
"TBL",0,0,0,0,0,0,0,1,1,2,0,4,"H","N","2012-02-14","201202140TBL"
"NYI",0,0,1,2,0,3,0,1,0,0,0,1,"A","N","2012-02-14","201202140WPG"
"WPG",0,1,0,0,0,1,0,0,1,2,0,3,"H","N","2012-02-14","201202140WPG"
"EDM",0,1,1,1,0,3,1,2,0,1,0,4,"H","N","2012-02-15","201202150EDM"
"TOR",1,2,0,1,0,4,0,1,1,1,0,3,"A","N","2012-02-15","201202150EDM"
"FLA",0,1,0,1,0,2,0,1,3,2,0,6,"H","N","2012-02-15","201202150FLA"
"OTT",0,1,3,2,0,6,0,1,0,1,0,2,"A","N","2012-02-15","201202150FLA"
"BOS",0,1,2,0,1,4,0,0,1,2,0,3,"A","Y","2012-02-15","201202150MTL"
"MTL",0,0,1,2,0,3,0,1,2,0,1,4,"H","Y","2012-02-15","201202150MTL"
"ANA",0,0,1,1,0,2,0,1,0,0,0,1,"A","N","2012-02-15","201202150PIT"
"PIT",0,1,0,0,0,1,0,0,1,1,0,2,"H","N","2012-02-15","201202150PIT"
"COL",0,0,1,0,0,1,0,1,0,2,0,3,"A","N","2012-02-15","201202150VAN"
"VAN",0,1,0,2,0,3,0,0,1,0,0,1,"H","N","2012-02-15","201202150VAN"
"CGY",0,1,0,1,0,2,1,1,1,0,0,3,"A","N","2012-02-16","201202160DAL"
"DAL",1,1,1,0,0,3,0,1,0,1,0,2,"H","N","2012-02-16","201202160DAL"
"LAK",0,0,0,0,0,0,0,0,1,0,0,1,"H","N","2012-02-16","201202160LAK"
"PHX",0,0,1,0,0,1,0,0,0,0,0,0,"A","N","2012-02-16","201202160LAK"
"MIN",0,1,1,1,0,3,0,1,1,1,1,4,"H","Y","2012-02-16","201202160MIN"
"WPG",0,1,1,1,1,4,0,1,1,1,0,3,"A","Y","2012-02-16","201202160MIN"
"CHI",0,4,0,0,0,4,0,0,1,1,0,2,"A","N","2012-02-16","201202160NYR"
"NYR",0,0,1,1,0,2,0,4,0,0,0,4,"H","N","2012-02-16","201202160NYR"
"BUF",0,2,0,0,0,2,0,0,4,3,0,7,"A","N","2012-02-16","201202160PHI"
"PHI",0,0,4,3,0,7,0,2,0,0,0,2,"H","N","2012-02-16","201202160PHI"
"NYI",0,1,0,0,0,1,0,2,3,0,0,5,"A","N","2012-02-16","201202160STL"
"STL",0,2,3,0,0,5,0,1,0,0,0,1,"H","N","2012-02-16","201202160STL"
"SJS",0,1,3,1,0,5,1,2,1,2,0,6,"A","N","2012-02-16","201202160TBL"
"TBL",1,2,1,2,0,6,0,1,3,1,0,5,"H","N","2012-02-16","201202160TBL"
"BUF",0,2,0,1,0,3,0,2,1,0,1,4,"H","Y","2012-02-17","201202170BUF"
"MTL",0,2,1,0,1,4,0,2,0,1,0,3,"A","Y","2012-02-17","201202170BUF"
"CAR",0,2,0,1,0,3,0,0,0,2,0,2,"H","N","2012-02-17","201202170CAR"
"SJS",0,0,0,2,0,2,0,2,0,1,0,3,"A","N","2012-02-17","201202170CAR"
"DET",0,1,0,1,0,2,0,0,1,0,0,1,"H","N","2012-02-17","201202170DET"
"NSH",0,0,1,0,0,1,0,1,0,1,0,2,"A","N","2012-02-17","201202170DET"
"COL",0,1,2,0,0,3,0,0,1,0,0,1,"A","N","2012-02-17","201202170EDM"
"EDM",0,0,1,0,0,1,0,1,2,0,0,3,"H","N","2012-02-17","201202170EDM"
"FLA",0,1,0,0,0,1,0,0,0,2,0,2,"H","N","2012-02-17","201202170FLA"
"WSH",0,0,0,2,0,2,0,1,0,0,0,1,"A","N","2012-02-17","201202170FLA"
"ANA",0,0,1,1,0,2,0,0,2,0,1,3,"A","Y","2012-02-17","201202170NJD"
"NJD",0,0,2,0,1,3,0,0,1,1,0,2,"H","Y","2012-02-17","201202170NJD"
"BOS",0,0,1,1,0,2,0,0,2,2,0,4,"A","N","2012-02-17","201202170WPG"
"WPG",0,0,2,2,0,4,0,0,1,1,0,2,"H","N","2012-02-17","201202170WPG"
"CBJ",0,1,0,0,0,1,0,2,2,2,0,6,"H","N","2012-02-18","201202180CBJ"
"CHI",0,2,2,2,0,6,0,1,0,0,0,1,"A","N","2012-02-18","201202180CBJ"
"CGY",0,0,0,1,0,1,0,0,0,0,0,0,"A","N","2012-02-18","201202180LAK"
"LAK",0,0,0,0,0,0,0,0,0,1,0,1,"H","N","2012-02-18","201202180LAK"
"CAR",0,1,2,0,0,3,0,1,2,1,0,4,"A","N","2012-02-18","201202180NYI"
"NYI",0,1,2,1,0,4,0,1,2,0,0,3,"H","N","2012-02-18","201202180NYI"
"PHI",0,2,1,1,0,4,0,1,2,3,0,6,"H","N","2012-02-18","201202180PHI"
"PIT",0,1,2,3,0,6,0,2,1,1,0,4,"A","N","2012-02-18","201202180PHI"
"DAL",0,0,1,0,0,1,1,1,0,0,0,2,"A","N","2012-02-18","201202180PHX"
"PHX",1,1,0,0,0,2,0,0,1,0,0,1,"H","N","2012-02-18","201202180PHX"
"MIN",0,0,0,0,0,0,0,1,2,1,0,4,"A","N","2012-02-18","201202180STL"
"STL",0,1,2,1,0,4,0,0,0,0,0,0,"H","N","2012-02-18","201202180STL"
"TBL",0,1,1,0,0,2,0,0,1,0,0,1,"H","N","2012-02-18","201202180TBL"
"WSH",0,0,1,0,0,1,0,1,1,0,0,2,"A","N","2012-02-18","201202180TBL"
"TOR",0,0,1,1,0,2,0,2,3,1,0,6,"A","N","2012-02-18","201202180VAN"
"VAN",0,2,3,1,0,6,0,0,1,1,0,2,"H","N","2012-02-18","201202180VAN"
"BUF",0,2,1,3,0,6,0,0,1,1,0,2,"H","N","2012-02-19","201202190BUF"
"PIT",0,0,1,1,0,2,0,2,1,3,0,6,"A","N","2012-02-19","201202190BUF"
"CHI",0,0,0,3,0,3,0,1,0,0,0,1,"H","N","2012-02-19","201202190CHI"
"STL",0,1,0,0,0,1,0,0,0,3,0,3,"A","N","2012-02-19","201202190CHI"
"DAL",0,1,0,1,0,2,0,2,1,0,0,3,"H","N","2012-02-19","201202190DAL"
"NSH",0,2,1,0,0,3,0,1,0,1,0,2,"A","N","2012-02-19","201202190DAL"
"DET",0,1,1,1,0,3,0,0,1,1,0,2,"H","N","2012-02-19","201202190DET"
"SJS",0,0,1,1,0,2,0,1,1,1,0,3,"A","N","2012-02-19","201202190DET"
"EDM",0,0,2,0,0,2,0,2,2,1,0,5,"H","N","2012-02-19","201202190EDM"
"VAN",0,2,2,1,0,5,0,0,2,0,0,2,"A","N","2012-02-19","201202190EDM"
"ANA",0,1,0,1,0,2,0,0,0,0,0,0,"A","N","2012-02-19","201202190FLA"
"FLA",0,0,0,0,0,0,0,1,0,1,0,2,"H","N","2012-02-19","201202190FLA"
"BOS",0,0,0,0,0,0,0,0,2,0,0,2,"A","N","2012-02-19","201202190MIN"
"MIN",0,0,2,0,0,2,0,0,0,0,0,0,"H","N","2012-02-19","201202190MIN"
"MTL",0,0,0,1,0,1,0,1,1,1,0,3,"H","N","2012-02-19","201202190MTL"
"NJD",0,1,1,1,0,3,0,0,0,1,0,1,"A","N","2012-02-19","201202190MTL"
"CBJ",0,0,1,1,0,2,1,1,1,0,0,3,"A","N","2012-02-19","201202190NYR"
"NYR",1,1,1,0,0,3,0,0,1,1,0,2,"H","N","2012-02-19","201202190NYR"
"COL",0,0,1,0,0,1,0,0,3,2,0,5,"A","N","2012-02-19","201202190WPG"
"WPG",0,0,3,2,0,5,0,0,1,0,0,1,"H","N","2012-02-19","201202190WPG"
"CAR",0,3,1,1,0,5,0,0,0,0,0,0,"H","N","2012-02-20","201202200CAR"
"WSH",0,0,0,0,0,0,0,3,1,1,0,5,"A","N","2012-02-20","201202200CAR"
"NYI",0,0,0,0,0,0,0,3,1,2,0,6,"H","N","2012-02-20","201202200NYI"
"OTT",0,3,1,2,0,6,0,0,0,0,0,0,"A","N","2012-02-20","201202200NYI"
"BUF",0,1,1,0,0,2,0,0,0,1,0,1,"H","N","2012-02-21","201202210BUF"
"NYI",0,0,0,1,0,1,0,1,1,0,0,2,"A","N","2012-02-21","201202210BUF"
"CBJ",0,4,1,1,0,6,0,0,2,1,0,3,"H","N","2012-02-21","201202210CBJ"
"SJS",0,0,2,1,0,3,0,4,1,1,0,6,"A","N","2012-02-21","201202210CBJ"
"CGY",0,1,0,0,0,1,0,1,4,1,0,6,"H","N","2012-02-21","201202210CGY"
"EDM",0,1,4,1,0,6,0,1,0,0,0,1,"A","N","2012-02-21","201202210CGY"
"CHI",0,0,1,1,0,2,0,1,0,0,0,1,"H","N","2012-02-21","201202210CHI"
"DET",0,1,0,0,0,1,0,0,1,1,0,2,"A","N","2012-02-21","201202210CHI"
"DAL",0,1,0,2,0,3,0,0,0,0,0,0,"A","N","2012-02-21","201202210MTL"
"MTL",0,0,0,0,0,0,0,1,0,2,0,3,"H","N","2012-02-21","201202210MTL"
"NSH",0,0,2,1,0,3,0,0,1,0,0,1,"H","N","2012-02-21","201202210NSH"
"VAN",0,0,1,0,0,1,0,0,2,1,0,3,"A","N","2012-02-21","201202210NSH"
"LAK",0,3,1,0,0,4,0,0,3,1,1,5,"A","Y","2012-02-21","201202210PHX"
"PHX",0,0,3,1,1,5,0,3,1,0,0,4,"H","Y","2012-02-21","201202210PHX"
"NYR",0,0,0,0,0,0,0,0,2,0,0,2,"A","N","2012-02-21","201202210PIT"
"PIT",0,0,2,0,0,2,0,0,0,0,0,0,"H","N","2012-02-21","201202210PIT"
"ANA",0,0,2,0,0,2,0,2,1,0,0,3,"A","N","2012-02-21","201202210TBL"
"TBL",0,2,1,0,0,3,0,0,2,0,0,2,"H","N","2012-02-21","201202210TBL"
"NJD",1,2,1,0,0,4,0,1,1,1,0,3,"A","N","2012-02-21","201202210TOR"
"TOR",0,1,1,1,0,3,1,2,1,0,0,4,"H","N","2012-02-21","201202210TOR"
"PHI",1,1,2,1,0,5,0,1,2,1,0,4,"A","N","2012-02-21","201202210WPG"
"WPG",0,1,2,1,0,4,1,1,2,1,0,5,"H","N","2012-02-21","201202210WPG"
"COL",0,3,1,0,0,4,0,0,0,1,0,1,"H","N","2012-02-22","201202220COL"
"LAK",0,0,0,1,0,1,0,3,1,0,0,4,"A","N","2012-02-22","201202220COL"
"OTT",0,2,2,1,0,5,0,0,0,2,0,2,"H","N","2012-02-22","201202220OTT"
"WSH",0,0,0,2,0,2,0,2,2,1,0,5,"A","N","2012-02-22","201202220OTT"
"BOS",0,3,0,1,0,4,0,2,0,0,0,2,"A","N","2012-02-22","201202220STL"
"STL",0,2,0,0,0,2,0,3,0,1,0,4,"H","N","2012-02-22","201202220STL"
"ANA",0,1,0,1,1,3,0,1,1,0,0,2,"A","Y","2012-02-23","201202230CAR"
"CAR",0,1,1,0,0,2,0,1,0,1,1,3,"H","Y","2012-02-23","201202230CAR"
"CGY",0,2,0,1,0,3,0,0,2,1,1,4,"H","Y","2012-02-23","201202230CGY"
"PHX",0,0,2,1,1,4,0,2,0,1,0,3,"A","Y","2012-02-23","201202230CGY"
"CHI",0,0,1,0,0,1,0,0,0,3,0,3,"H","N","2012-02-23","201202230CHI"
"DAL",0,0,0,3,0,3,0,0,1,0,0,1,"A","N","2012-02-23","201202230CHI"
"DET",0,1,0,2,0,3,0,0,1,2,1,4,"H","Y","2012-02-23","201202230DET"
"VAN",0,0,1,2,1,4,0,1,0,2,0,3,"A","Y","2012-02-23","201202230DET"
"EDM",0,0,2,0,0,2,0,0,0,0,0,0,"H","N","2012-02-23","201202230EDM"
"PHI",0,0,0,0,0,0,0,0,2,0,0,2,"A","N","2012-02-23","201202230EDM"
"FLA",0,0,1,1,0,2,0,0,1,1,1,3,"H","Y","2012-02-23","201202230FLA"
"MIN",0,0,1,1,1,3,0,0,1,1,0,2,"A","Y","2012-02-23","201202230FLA"
"NSH",0,0,2,0,0,2,0,1,1,0,1,3,"H","Y","2012-02-23","201202230NSH"
"STL",0,1,1,0,1,3,0,0,2,0,0,2,"A","Y","2012-02-23","201202230NSH"
"SJS",0,0,2,0,0,2,0,0,0,1,0,1,"A","N","2012-02-23","201202230TOR"
"TOR",0,0,0,1,0,1,0,0,2,0,0,2,"H","N","2012-02-23","201202230TOR"
"TBL",0,0,0,3,0,3,0,2,2,0,0,4,"A","N","2012-02-23","201202230WPG"
"WPG",0,2,2,0,0,4,0,0,0,3,0,3,"H","N","2012-02-23","201202230WPG"
"BOS",0,0,0,1,0,1,0,0,1,0,1,2,"A","Y","2012-02-24","201202240BUF"
"BUF",0,0,1,0,1,2,0,0,0,1,0,1,"H","Y","2012-02-24","201202240BUF"
"CBJ",0,0,0,0,0,0,0,1,1,3,0,5,"H","N","2012-02-24","201202240CBJ"
"COL",0,1,1,3,0,5,0,0,0,0,0,0,"A","N","2012-02-24","201202240CBJ"
"DAL",0,2,1,1,0,4,0,0,0,1,0,1,"H","N","2012-02-24","201202240DAL"
"MIN",0,0,0,1,0,1,0,2,1,1,0,4,"A","N","2012-02-24","201202240DAL"
"NJD",0,0,1,0,0,1,0,1,1,0,0,2,"H","N","2012-02-24","201202240NJD"
"VAN",0,1,1,0,0,2,0,0,1,0,0,1,"A","N","2012-02-24","201202240NJD"
"NYI",0,2,1,0,1,4,0,1,2,0,0,3,"H","Y","2012-02-24","201202240NYI"
"NYR",0,1,2,0,0,3,0,2,1,0,1,4,"A","Y","2012-02-24","201202240NYI"
"MTL",0,0,0,1,0,1,0,1,2,1,0,4,"A","N","2012-02-24","201202240WSH"
"WSH",0,1,2,1,0,4,0,0,0,1,0,1,"H","N","2012-02-24","201202240WSH"
"CAR",0,1,1,0,0,2,0,0,0,2,1,3,"H","Y","2012-02-25","201202250CAR"
"FLA",0,0,0,2,1,3,0,1,1,0,0,2,"A","Y","2012-02-25","201202250CAR"
"CGY",0,2,1,1,0,4,0,0,2,2,1,5,"H","Y","2012-02-25","201202250CGY"
"PHI",0,0,2,2,1,5,0,2,1,1,0,4,"A","Y","2012-02-25","201202250CGY"
"COL",0,2,1,1,0,4,0,0,0,3,0,3,"A","N","2012-02-25","201202250DET"
"DET",0,0,0,3,0,3,0,2,1,1,0,4,"H","N","2012-02-25","201202250DET"
"EDM",0,0,0,1,0,1,0,2,0,1,0,3,"H","N","2012-02-25","201202250EDM"
"PHX",0,2,0,1,0,3,0,0,0,1,0,1,"A","N","2012-02-25","201202250EDM"
"CHI",0,0,0,0,0,0,0,2,2,0,0,4,"A","N","2012-02-25","201202250LAK"
"LAK",0,2,2,0,0,4,0,0,0,0,0,0,"H","N","2012-02-25","201202250LAK"
"NSH",0,3,1,2,0,6,0,1,1,0,0,2,"H","N","2012-02-25","201202250NSH"
"SJS",0,1,1,0,0,2,0,3,1,2,0,6,"A","N","2012-02-25","201202250NSH"
"BUF",0,1,0,1,0,2,1,0,1,1,0,3,"A","N","2012-02-25","201202250NYR"
"NYR",1,0,1,1,0,3,0,1,0,1,0,2,"H","N","2012-02-25","201202250NYR"
"BOS",0,2,1,2,0,5,0,1,0,2,0,3,"A","N","2012-02-25","201202250OTT"
"OTT",0,1,0,2,0,3,0,2,1,2,0,5,"H","N","2012-02-25","201202250OTT"
"PIT",0,3,2,3,0,8,0,0,1,0,0,1,"H","N","2012-02-25","201202250PIT"
"TBL",0,0,1,0,0,1,0,3,2,3,0,8,"A","N","2012-02-25","201202250PIT"
"TOR",0,0,0,2,0,2,0,2,2,0,0,4,"H","N","2012-02-25","201202250TOR"
"WSH",0,2,2,0,0,4,0,0,0,2,0,2,"A","N","2012-02-25","201202250TOR"
"STL",0,2,0,0,1,3,0,0,2,0,0,2,"A","Y","2012-02-25","201202250WPG"
"WPG",0,0,2,0,0,2,0,2,0,0,1,3,"H","Y","2012-02-25","201202250WPG"
"ANA",0,1,1,1,0,3,0,1,0,0,0,1,"H","N","2012-02-26","201202260ANA"
"CHI",0,1,0,0,0,1,0,1,1,1,0,3,"A","N","2012-02-26","201202260ANA"
"DAL",1,0,1,1,0,3,0,0,2,0,0,2,"H","N","2012-02-26","201202260DAL"
"VAN",0,0,2,0,0,2,1,0,1,1,0,3,"A","N","2012-02-26","201202260DAL"
"FLA",0,1,2,1,0,4,0,2,0,0,0,2,"H","N","2012-02-26","201202260FLA"
"MTL",0,2,0,0,0,2,0,1,2,1,0,4,"A","N","2012-02-26","201202260FLA"
"MIN",0,1,1,2,0,4,0,2,0,1,0,3,"H","N","2012-02-26","201202260MIN"
"SJS",0,2,0,1,0,3,0,1,1,2,0,4,"A","N","2012-02-26","201202260MIN"
"NJD",0,1,0,2,0,3,0,0,2,2,0,4,"H","N","2012-02-26","201202260NJD"
"TBL",0,0,2,2,0,4,0,1,0,2,0,3,"A","N","2012-02-26","201202260NJD"
"NYI",0,1,0,1,0,2,0,0,2,3,0,5,"A","N","2012-02-26","201202260OTT"
"OTT",0,0,2,3,0,5,0,1,0,1,0,2,"H","N","2012-02-26","201202260OTT"
"CBJ",0,0,1,1,0,2,0,0,1,3,0,4,"A","N","2012-02-26","201202260PIT"
"PIT",0,0,1,3,0,4,0,0,1,1,0,2,"H","N","2012-02-26","201202260PIT"
"CGY",0,1,0,0,0,1,0,2,1,0,0,3,"H","N","2012-02-27","201202270CGY"
"STL",0,2,1,0,0,3,0,1,0,0,0,1,"A","N","2012-02-27","201202270CGY"
"ANA",0,0,1,0,0,1,0,1,0,3,0,4,"A","N","2012-02-27","201202270COL"
"COL",0,1,0,3,0,4,0,0,1,0,0,1,"H","N","2012-02-27","201202270COL"
"LAK",0,0,0,1,0,1,0,1,1,0,0,2,"A","N","2012-02-27","201202270NSH"
"NSH",0,1,1,0,0,2,0,0,0,1,0,1,"H","N","2012-02-27","201202270NSH"
"NJD",0,0,0,0,0,0,0,1,0,1,0,2,"A","N","2012-02-27","201202270NYR"
"NYR",0,1,0,1,0,2,0,0,0,0,0,0,"H","N","2012-02-27","201202270NYR"
"EDM",0,0,1,4,0,5,0,0,2,1,0,3,"A","N","2012-02-27","201202270WPG"
"WPG",0,0,2,1,0,3,0,0,1,4,0,5,"H","N","2012-02-27","201202270WPG"
"BOS",0,0,0,0,0,0,0,1,0,0,0,1,"H","N","2012-02-28","201202280BOS"
"OTT",0,1,0,0,0,1,0,0,0,0,0,0,"A","N","2012-02-28","201202280BOS"
"CAR",0,0,3,1,0,4,0,1,1,1,0,3,"H","N","2012-02-28","201202280CAR"
"NSH",0,1,1,1,0,3,0,0,3,1,0,4,"A","N","2012-02-28","201202280CAR"
"CBJ",0,1,0,1,0,2,0,1,0,4,0,5,"H","N","2012-02-28","201202280CBJ"
"DET",0,1,0,4,0,5,0,1,0,1,0,2,"A","N","2012-02-28","201202280CBJ"
"LAK",0,3,1,0,0,4,0,0,0,0,0,0,"A","N","2012-02-28","201202280MIN"
"MIN",0,0,0,0,0,0,0,3,1,0,0,4,"H","N","2012-02-28","201202280MIN"
"PHX",0,0,0,1,1,2,0,1,0,0,0,1,"H","Y","2012-02-28","201202280PHX"
"VAN",0,1,0,0,0,1,0,0,0,1,1,2,"A","Y","2012-02-28","201202280PHX"
"PHI",0,0,0,0,0,0,0,1,0,0,0,1,"A","N","2012-02-28","201202280SJS"
"SJS",0,1,0,0,0,1,0,0,0,0,0,0,"H","N","2012-02-28","201202280SJS"
"MTL",0,1,0,0,0,1,0,1,1,0,0,2,"A","N","2012-02-28","201202280TBL"
"TBL",0,1,1,0,0,2,0,1,0,0,0,1,"H","N","2012-02-28","201202280TBL"
"FLA",0,2,1,2,0,5,0,0,1,2,0,3,"A","N","2012-02-28","201202280TOR"
"TOR",0,0,1,2,0,3,0,2,1,2,0,5,"H","N","2012-02-28","201202280TOR"
"NYI",0,1,0,1,0,2,1,0,0,2,0,3,"A","N","2012-02-28","201202280WSH"
"WSH",1,0,0,2,0,3,0,1,0,1,0,2,"H","N","2012-02-28","201202280WSH"
"ANA",0,0,0,0,0,0,0,1,1,0,0,2,"H","N","2012-02-29","201202290ANA"
"BUF",0,1,1,0,0,2,0,0,0,0,0,0,"A","N","2012-02-29","201202290ANA"
"CHI",0,2,2,1,0,5,0,3,0,1,0,4,"H","N","2012-02-29","201202290CHI"
"TOR",0,3,0,1,0,4,0,2,2,1,0,5,"A","N","2012-02-29","201202290CHI"
"DAL",0,1,1,1,0,3,0,1,0,2,1,4,"H","Y","2012-02-29","201202290DAL"
"PIT",0,1,0,2,1,4,0,1,1,1,0,3,"A","Y","2012-02-29","201202290DAL"
"EDM",0,0,2,0,0,2,0,1,2,2,0,5,"H","N","2012-02-29","201202290EDM"
"STL",0,1,2,2,0,5,0,0,2,0,0,2,"A","N","2012-02-29","201202290EDM"
"BOS",1,2,0,1,0,4,0,0,3,0,0,3,"H","N","2012-03-01","201203010BOS"
"NJD",0,0,3,0,0,3,1,2,0,1,0,4,"A","N","2012-03-01","201203010BOS"
"CAR",0,0,1,1,0,2,0,0,2,1,0,3,"H","N","2012-03-01","201203010CAR"
"NYR",0,0,2,1,0,3,0,0,1,1,0,2,"A","N","2012-03-01","201203010CAR"
"CBJ",0,1,1,0,0,2,0,0,0,0,0,0,"A","N","2012-03-01","201203010COL"
"COL",0,0,0,0,0,0,0,1,1,0,0,2,"H","N","2012-03-01","201203010COL"
"MIN",0,1,0,3,0,4,0,2,1,1,1,5,"A","Y","2012-03-01","201203010MTL"
"MTL",0,2,1,1,1,5,0,1,0,3,0,4,"H","Y","2012-03-01","201203010MTL"
"NYI",0,1,1,1,0,3,0,2,2,2,0,6,"A","N","2012-03-01","201203010PHI"
"PHI",0,2,2,2,0,6,0,1,1,1,0,3,"H","N","2012-03-01","201203010PHI"
"CGY",0,3,0,1,0,4,0,0,2,0,0,2,"A","N","2012-03-01","201203010PHX"
"PHX",0,0,2,0,0,2,0,3,0,1,0,4,"H","N","2012-03-01","201203010PHX"
"BUF",0,1,0,0,0,1,0,0,0,0,0,0,"A","N","2012-03-01","201203010SJS"
"SJS",0,0,0,0,0,0,0,1,0,0,0,1,"H","N","2012-03-01","201203010SJS"
"STL",0,0,0,0,0,0,0,0,0,2,0,2,"A","N","2012-03-01","201203010VAN"
"VAN",0,0,0,2,0,2,0,0,0,0,0,0,"H","N","2012-03-01","201203010VAN"
"FLA",0,0,0,0,0,0,0,2,0,5,0,7,"A","N","2012-03-01","201203010WPG"
"WPG",0,2,0,5,0,7,0,0,0,0,0,0,"H","N","2012-03-01","201203010WPG"
"ANA",0,1,1,1,0,3,0,1,0,1,0,2,"H","N","2012-03-02","201203020ANA"
"CGY",0,1,0,1,0,2,0,1,1,1,0,3,"A","N","2012-03-02","201203020ANA"
"DET",0,2,3,1,0,6,0,0,0,0,0,0,"H","N","2012-03-02","201203020DET"
"MIN",0,0,0,0,0,0,0,2,3,1,0,6,"A","N","2012-03-02","201203020DET"
"DAL",0,0,2,1,0,3,0,0,0,1,0,1,"A","N","2012-03-02","201203020EDM"
"EDM",0,0,0,1,0,1,0,0,2,1,0,3,"H","N","2012-03-02","201203020EDM"
"CHI",0,0,2,0,0,2,0,1,0,0,0,1,"A","N","2012-03-02","201203020OTT"
"OTT",0,1,0,0,0,1,0,0,2,0,0,2,"H","N","2012-03-02","201203020OTT"
"NYR",0,1,1,1,0,3,1,0,1,2,0,4,"A","N","2012-03-02","201203020TBL"
"TBL",1,0,1,2,0,4,0,1,1,1,0,3,"H","N","2012-03-02","201203020TBL"
"NJD",0,3,2,0,0,5,0,0,0,0,0,0,"A","N","2012-03-02","201203020WSH"
"WSH",0,0,0,0,0,0,0,3,2,0,0,5,"H","N","2012-03-02","201203020WSH"
"BOS",0,1,0,1,0,2,0,1,1,1,0,3,"H","N","2012-03-03","201203030BOS"
"NYI",0,1,1,1,0,3,0,1,0,1,0,2,"A","N","2012-03-03","201203030BOS"
"CAR",0,0,3,0,0,3,1,1,1,1,0,4,"H","N","2012-03-03","201203030CAR"
"TBL",1,1,1,1,0,4,0,0,3,0,0,3,"A","N","2012-03-03","201203030CAR"
"COL",0,0,0,1,0,1,0,2,2,1,0,5,"H","N","2012-03-03","201203030COL"
"PIT",0,2,2,1,0,5,0,0,0,1,0,1,"A","N","2012-03-03","201203030COL"
"FLA",0,0,1,0,0,1,0,1,1,1,0,3,"H","N","2012-03-03","201203030FLA"
"NSH",0,1,1,1,0,3,0,0,1,0,0,1,"A","N","2012-03-03","201203030FLA"
"ANA",0,1,1,0,0,2,0,1,2,1,0,4,"A","N","2012-03-03","201203030LAK"
"LAK",0,1,2,1,0,4,0,1,1,0,0,2,"H","N","2012-03-03","201203030LAK"
"MTL",0,1,0,0,0,1,0,0,1,2,0,3,"H","N","2012-03-03","201203030MTL"
"TOR",0,0,1,2,0,3,0,1,0,0,0,1,"A","N","2012-03-03","201203030MTL"
"CBJ",0,1,1,3,0,5,0,0,2,0,0,2,"A","N","2012-03-03","201203030PHX"
"PHX",0,0,2,0,0,2,0,1,1,3,0,5,"H","N","2012-03-03","201203030PHX"
"SJS",0,1,0,0,0,1,0,2,1,0,0,3,"H","N","2012-03-03","201203030SJS"
"STL",0,2,1,0,0,3,0,1,0,0,0,1,"A","N","2012-03-03","201203030SJS"
"BUF",0,3,0,2,0,5,0,0,1,2,0,3,"A","N","2012-03-03","201203030VAN"
"VAN",0,0,1,2,0,3,0,3,0,2,0,5,"H","N","2012-03-03","201203030VAN"
"CGY",0,0,1,1,0,2,0,0,2,0,1,3,"H","Y","2012-03-04","201203040CGY"
"DAL",0,0,2,0,1,3,0,0,1,1,0,2,"A","Y","2012-03-04","201203040CGY"
"CHI",0,1,1,0,0,2,0,1,0,0,0,1,"A","N","2012-03-04","201203040DET"
"DET",0,1,0,0,0,1,0,1,1,0,0,2,"H","N","2012-03-04","201203040DET"
"FLA",0,0,3,1,0,4,0,2,0,0,0,2,"H","N","2012-03-04","201203040FLA"
"OTT",0,2,0,0,0,2,0,0,3,1,0,4,"A","N","2012-03-04","201203040FLA"
"COL",0,2,0,0,0,2,0,0,0,0,0,0,"A","N","2012-03-04","201203040MIN"
"MIN",0,0,0,0,0,0,0,2,0,0,0,2,"H","N","2012-03-04","201203040MIN"
"NJD",0,0,0,0,0,0,0,0,1,0,0,1,"A","N","2012-03-04","201203040NYI"
"NYI",0,0,1,0,0,1,0,0,0,0,0,0,"H","N","2012-03-04","201203040NYI"
"BOS",0,1,1,1,0,3,0,2,0,2,0,4,"A","N","2012-03-04","201203040NYR"
"NYR",0,2,0,2,0,4,0,1,1,1,0,3,"H","N","2012-03-04","201203040NYR"
"PHI",0,0,1,0,0,1,0,0,0,0,0,0,"A","N","2012-03-04","201203040WSH"
"WSH",0,0,0,0,0,0,0,0,1,0,0,1,"H","N","2012-03-04","201203040WSH"
"ANA",0,1,0,3,0,4,0,0,1,1,0,2,"H","N","2012-03-05","201203050ANA"
"EDM",0,0,1,1,0,2,0,1,0,3,0,4,"A","N","2012-03-05","201203050ANA"
"PHX",0,0,0,1,0,1,0,2,0,0,0,2,"A","N","2012-03-05","201203050PIT"
"PIT",0,2,0,0,0,2,0,0,0,1,0,1,"H","N","2012-03-05","201203050PIT"
"BUF",0,0,1,0,0,1,0,1,0,2,0,3,"A","N","2012-03-05","201203050WPG"
"WPG",0,1,0,2,0,3,0,0,1,0,0,1,"H","N","2012-03-05","201203050WPG"
"CBJ",0,2,1,0,0,3,0,1,1,0,0,2,"H","N","2012-03-06","201203060CBJ"
"PHX",0,1,1,0,0,2,0,2,1,0,0,3,"A","N","2012-03-06","201203060CBJ"
"CGY",0,2,2,1,0,5,0,1,1,2,0,4,"H","N","2012-03-06","201203060CGY"
"MTL",0,1,1,2,0,4,0,2,2,1,0,5,"A","N","2012-03-06","201203060CGY"
"COL",0,1,4,2,0,7,0,0,0,1,0,1,"H","N","2012-03-06","201203060COL"
"MIN",0,0,0,1,0,1,0,1,4,2,0,7,"A","N","2012-03-06","201203060COL"
"NJD",0,1,0,3,0,4,0,0,1,0,0,1,"H","N","2012-03-06","201203060NJD"
"NYR",0,0,1,0,0,1,0,1,0,3,0,4,"A","N","2012-03-06","201203060NJD"
"LAK",0,2,1,2,0,5,0,1,2,1,0,4,"A","N","2012-03-06","201203060NSH"
"NSH",0,1,2,1,0,4,0,2,1,2,0,5,"H","N","2012-03-06","201203060NSH"
"DET",0,1,0,1,0,2,0,2,1,0,0,3,"A","N","2012-03-06","201203060PHI"
"PHI",0,2,1,0,0,3,0,1,0,1,0,2,"H","N","2012-03-06","201203060PHI"
"EDM",0,1,1,0,1,3,0,1,1,0,0,2,"A","Y","2012-03-06","201203060SJS"
"SJS",0,1,1,0,0,2,0,1,1,0,1,3,"H","Y","2012-03-06","201203060SJS"
"CHI",0,0,0,1,0,1,0,2,1,2,0,5,"A","N","2012-03-06","201203060STL"
"STL",0,2,1,2,0,5,0,0,0,1,0,1,"H","N","2012-03-06","201203060STL"
"OTT",0,3,1,3,0,7,0,0,2,1,0,3,"A","N","2012-03-06","201203060TBL"
"TBL",0,0,2,1,0,3,0,3,1,3,0,7,"H","N","2012-03-06","201203060TBL"
"BOS",0,1,4,0,0,5,0,1,2,1,0,4,"A","N","2012-03-06","201203060TOR"
"TOR",0,1,2,1,0,4,0,1,4,0,0,5,"H","N","2012-03-06","201203060TOR"
"DAL",0,0,2,3,0,5,0,0,1,1,0,2,"A","N","2012-03-06","201203060VAN"
"VAN",0,0,1,1,0,2,0,0,2,3,0,5,"H","N","2012-03-06","201203060VAN"
"CAR",1,0,2,1,0,4,0,1,1,1,0,3,"A","N","2012-03-06","201203060WSH"
"WSH",0,1,1,1,0,3,1,0,2,1,0,4,"H","N","2012-03-06","201203060WSH"
"BUF",1,0,2,0,0,3,0,1,1,0,0,2,"H","N","2012-03-07","201203070BUF"
"CAR",0,1,1,0,0,2,1,0,2,0,0,3,"A","N","2012-03-07","201203070BUF"
"PIT",0,0,1,2,0,3,0,0,2,0,0,2,"H","N","2012-03-07","201203070PIT"
"TOR",0,0,2,0,0,2,0,0,1,2,0,3,"A","N","2012-03-07","201203070PIT"
"BOS",0,0,1,2,0,3,0,1,0,0,0,1,"H","N","2012-03-08","201203080BOS"
"BUF",0,1,0,0,0,1,0,0,1,2,0,3,"A","N","2012-03-08","201203080BOS"
"CBJ",0,2,1,0,0,3,0,1,0,0,0,1,"H","N","2012-03-08","201203080CBJ"
"LAK",0,1,0,0,0,1,0,2,1,0,0,3,"A","N","2012-03-08","201203080CBJ"
"DAL",0,0,1,2,1,4,0,0,1,2,0,3,"H","Y","2012-03-08","201203080DAL"
"SJS",0,0,1,2,0,3,0,0,1,2,1,4,"A","Y","2012-03-08","201203080DAL"
"EDM",0,1,1,1,0,3,0,1,1,3,0,5,"H","N","2012-03-08","201203080EDM"
"MTL",0,1,1,3,0,5,0,1,1,1,0,3,"A","N","2012-03-08","201203080EDM"
"NJD",0,1,1,3,0,5,0,0,1,0,0,1,"H","N","2012-03-08","201203080NJD"
"NYI",0,0,1,0,0,1,0,1,1,3,0,5,"A","N","2012-03-08","201203080NJD"
"COL",0,1,0,1,0,2,0,2,1,1,0,4,"A","N","2012-03-08","201203080NSH"
"NSH",0,2,1,1,0,4,0,1,0,1,0,2,"H","N","2012-03-08","201203080NSH"
"NYR",0,1,0,0,0,1,0,2,0,2,0,4,"A","N","2012-03-08","201203080OTT"
"OTT",0,2,0,2,0,4,0,1,0,0,0,1,"H","N","2012-03-08","201203080OTT"
"FLA",0,0,0,0,0,0,0,1,2,2,0,5,"A","N","2012-03-08","201203080PHI"
"PHI",0,1,2,2,0,5,0,0,0,0,0,0,"H","N","2012-03-08","201203080PHI"
"MIN",0,2,0,0,1,3,0,0,0,2,0,2,"A","Y","2012-03-08","201203080PHX"
"PHX",0,0,0,2,0,2,0,2,0,0,1,3,"H","Y","2012-03-08","201203080PHX"
"ANA",0,0,1,0,0,1,0,0,1,2,0,3,"A","N","2012-03-08","201203080STL"
"STL",0,0,1,2,0,3,0,0,1,0,0,1,"H","N","2012-03-08","201203080STL"
"VAN",0,0,1,2,0,3,0,0,1,1,0,2,"H","N","2012-03-08","201203080VAN"
"WPG",0,0,1,1,0,2,0,0,1,2,0,3,"A","N","2012-03-08","201203080VAN"
"TBL",0,0,2,0,0,2,1,1,0,1,0,3,"A","N","2012-03-08","201203080WSH"
"WSH",1,1,0,1,0,3,0,0,2,0,0,2,"H","N","2012-03-08","201203080WSH"
"CGY",0,3,1,1,0,5,0,2,0,1,0,3,"H","N","2012-03-09","201203090CGY"
"WPG",0,2,0,1,0,3,0,3,1,1,0,5,"A","N","2012-03-09","201203090CGY"
"CHI",0,0,1,3,0,4,0,1,0,2,0,3,"H","N","2012-03-09","201203090CHI"
"NYR",0,1,0,2,0,3,0,0,1,3,0,4,"A","N","2012-03-09","201203090CHI"
"DET",0,1,1,2,0,4,0,2,0,1,0,3,"H","N","2012-03-09","201203090DET"
"LAK",0,2,0,1,0,3,0,1,1,2,0,4,"A","N","2012-03-09","201203090DET"
"FLA",0,0,1,0,0,1,0,0,0,1,1,2,"A","Y","2012-03-09","201203090PIT"
"PIT",0,0,0,1,1,2,0,0,1,0,0,1,"H","Y","2012-03-09","201203090PIT"
"BOS",0,1,1,1,0,3,0,2,2,0,0,4,"H","N","2012-03-10","201203100BOS"
"WSH",0,2,2,0,0,4,0,1,1,1,0,3,"A","N","2012-03-10","201203100BOS"
"COL",0,0,2,0,1,3,0,1,0,1,0,2,"H","Y","2012-03-10","201203100COL"
"EDM",0,1,0,1,0,2,0,0,2,0,1,3,"A","Y","2012-03-10","201203100COL"
"ANA",0,0,0,0,0,0,0,0,1,1,0,2,"A","N","2012-03-10","201203100DAL"
"DAL",0,0,1,1,0,2,0,0,0,0,0,0,"H","N","2012-03-10","201203100DAL"
"DET",0,1,0,1,0,2,0,2,0,1,0,3,"A","N","2012-03-10","201203100NSH"
"NSH",0,2,0,1,0,3,0,1,0,1,0,2,"H","N","2012-03-10","201203100NSH"
"NJD",0,0,0,2,0,2,0,0,0,1,0,1,"A","N","2012-03-10","201203100NYI"
"NYI",0,0,0,1,0,1,0,0,0,2,0,2,"H","N","2012-03-10","201203100NYI"
"BUF",0,0,2,1,1,4,0,1,1,1,0,3,"A","Y","2012-03-10","201203100OTT"
"OTT",0,1,1,1,0,3,0,0,2,1,1,4,"H","Y","2012-03-10","201203100OTT"
"PHX",0,0,2,1,0,3,0,0,0,0,0,0,"H","N","2012-03-10","201203100PHX"
"SJS",0,0,0,0,0,0,0,0,2,1,0,3,"A","N","2012-03-10","201203100PHX"
"CBJ",0,0,1,0,0,1,0,1,2,1,0,4,"A","N","2012-03-10","201203100STL"
"STL",0,1,2,1,0,4,0,0,1,0,0,1,"H","N","2012-03-10","201203100STL"
"CAR",0,2,0,2,0,4,0,2,0,0,0,2,"A","N","2012-03-10","201203100TBL"
"TBL",0,2,0,0,0,2,0,2,0,2,0,4,"H","N","2012-03-10","201203100TBL"
"PHI",0,0,0,0,1,1,0,0,0,0,0,0,"A","Y","2012-03-10","201203100TOR"
"TOR",0,0,0,0,0,0,0,0,0,0,1,1,"H","Y","2012-03-10","201203100TOR"
"MTL",0,0,1,3,0,4,0,0,1,0,0,1,"A","N","2012-03-10","201203100VAN"
"VAN",0,0,1,0,0,1,0,0,1,3,0,4,"H","N","2012-03-10","201203100VAN"
"CBJ",0,0,1,0,0,1,0,0,1,1,0,2,"H","N","2012-03-11","201203110CBJ"
"STL",0,0,1,1,0,2,0,0,1,0,0,1,"A","N","2012-03-11","201203110CBJ"
"CHI",0,0,1,1,0,2,0,1,1,0,1,3,"H","Y","2012-03-11","201203110CHI"
"LAK",0,1,1,0,1,3,0,0,1,1,0,2,"A","Y","2012-03-11","201203110CHI"
"CAR",0,0,0,0,0,0,0,0,1,1,0,2,"A","N","2012-03-11","201203110FLA"
"FLA",0,0,1,1,0,2,0,0,0,0,0,0,"H","N","2012-03-11","201203110FLA"
"CGY",0,1,0,3,0,4,0,0,0,3,0,3,"A","N","2012-03-11","201203110MIN"
"MIN",0,0,0,3,0,3,0,1,0,3,0,4,"H","N","2012-03-11","201203110MIN"
"NJD",0,1,0,3,0,4,0,0,0,1,0,1,"H","N","2012-03-11","201203110NJD"
"PHI",0,0,0,1,0,1,0,1,0,3,0,4,"A","N","2012-03-11","201203110NJD"
"NYI",0,1,2,0,0,3,1,1,1,1,0,4,"A","N","2012-03-11","201203110NYR"
"NYR",1,1,1,1,0,4,0,1,2,0,0,3,"H","N","2012-03-11","201203110NYR"
"BOS",0,0,2,0,0,2,0,3,1,1,0,5,"A","N","2012-03-11","201203110PIT"
"PIT",0,3,1,1,0,5,0,0,2,0,0,2,"H","N","2012-03-11","201203110PIT"
"TOR",0,0,0,0,0,0,0,1,0,1,0,2,"A","N","2012-03-11","201203110WSH"
"WSH",0,1,0,1,0,2,0,0,0,0,0,0,"H","N","2012-03-11","201203110WSH"
"BUF",1,0,1,1,0,3,0,1,0,1,0,2,"H","N","2012-03-12","201203120BUF"
"MTL",0,1,0,1,0,2,1,0,1,1,0,3,"A","N","2012-03-12","201203120BUF"
"ANA",0,0,1,1,0,2,1,1,0,1,0,3,"A","N","2012-03-12","201203120COL"
"COL",1,1,0,1,0,3,0,0,1,1,0,2,"H","N","2012-03-12","201203120COL"
"EDM",0,1,1,0,0,2,0,1,1,1,0,3,"H","N","2012-03-12","201203120EDM"
"SJS",0,1,1,1,0,3,0,1,1,0,0,2,"A","N","2012-03-12","201203120EDM"
"NSH",0,1,2,1,1,5,0,0,2,2,0,4,"A","Y","2012-03-12","201203120PHX"
"PHX",0,0,2,2,0,4,0,1,2,1,1,5,"H","Y","2012-03-12","201203120PHX"
"CGY",1,0,2,0,0,3,0,1,0,1,0,2,"H","N","2012-03-13","201203130CGY"
"SJS",0,1,0,1,0,2,1,0,2,0,0,3,"A","N","2012-03-13","201203130CGY"
"CHI",0,1,1,1,1,4,0,3,0,0,0,3,"H","Y","2012-03-13","201203130CHI"
"STL",0,3,0,0,0,3,0,1,1,1,1,4,"A","Y","2012-03-13","201203130CHI"
"FLA",0,1,1,3,0,5,0,0,1,1,0,2,"H","N","2012-03-13","201203130FLA"
"TOR",0,0,1,1,0,2,0,1,1,3,0,5,"A","N","2012-03-13","201203130FLA"
"DET",0,0,1,1,0,2,0,2,1,2,0,5,"A","N","2012-03-13","201203130LAK"
"LAK",0,2,1,2,0,5,0,0,1,1,0,2,"H","N","2012-03-13","201203130LAK"
"DAL",0,0,0,1,0,1,0,0,0,0,0,0,"A","N","2012-03-13","201203130MIN"
"MIN",0,0,0,0,0,0,0,0,0,1,0,1,"H","N","2012-03-13","201203130MIN"
"NYI",0,2,2,0,0,4,0,0,2,2,1,5,"H","Y","2012-03-13","201203130NYI"
"WSH",0,0,2,2,1,5,0,2,2,0,0,4,"A","Y","2012-03-13","201203130NYI"
"CAR",0,0,2,0,0,2,0,1,2,1,0,4,"A","N","2012-03-13","201203130NYR"
"NYR",0,1,2,1,0,4,0,0,2,0,0,2,"H","N","2012-03-13","201203130NYR"
"NJD",0,0,0,0,0,0,0,0,1,2,0,3,"A","N","2012-03-13","201203130PHI"
"PHI",0,0,1,2,0,3,0,0,0,0,0,0,"H","N","2012-03-13","201203130PHI"
"BOS",0,0,0,1,0,1,0,4,1,1,0,6,"A","N","2012-03-13","201203130TBL"
"TBL",0,4,1,1,0,6,0,0,0,1,0,1,"H","N","2012-03-13","201203130TBL"
"ANA",0,0,3,1,0,4,0,0,0,0,0,0,"H","N","2012-03-14","201203140ANA"
"DET",0,0,0,0,0,0,0,0,3,1,0,4,"A","N","2012-03-14","201203140ANA"
"BUF",0,2,1,1,0,4,0,2,1,1,1,5,"H","Y","2012-03-14","201203140BUF"
"COL",0,2,1,1,1,5,0,2,1,1,0,4,"A","Y","2012-03-14","201203140BUF"
"CBJ",0,0,0,0,0,0,0,0,2,1,0,3,"A","N","2012-03-14","201203140EDM"
"EDM",0,0,2,1,0,3,0,0,0,0,0,0,"H","N","2012-03-14","201203140EDM"
"MTL",0,1,0,1,1,3,0,1,0,1,0,2,"H","Y","2012-03-14","201203140MTL"
"OTT",0,1,0,1,0,2,0,1,0,1,1,3,"A","Y","2012-03-14","201203140MTL"
"PHX",0,2,2,1,0,5,0,2,1,1,0,4,"A","N","2012-03-14","201203140VAN"
"VAN",0,2,1,1,0,4,0,2,2,1,0,5,"H","N","2012-03-14","201203140VAN"
"DAL",0,0,1,1,0,2,0,1,4,0,0,5,"A","N","2012-03-14","201203140WPG"
"WPG",0,1,4,0,0,5,0,0,1,1,0,2,"H","N","2012-03-14","201203140WPG"
"CAR",0,0,0,2,0,2,0,0,0,0,0,0,"H","N","2012-03-15","201203150CAR"
"STL",0,0,0,0,0,0,0,0,0,2,0,2,"A","N","2012-03-15","201203150CAR"
"CGY",0,1,2,1,0,4,0,0,1,0,0,1,"H","N","2012-03-15","201203150CGY"
"PHX",0,0,1,0,0,1,0,1,2,1,0,4,"A","N","2012-03-15","201203150CGY"
"BOS",0,0,1,1,0,2,0,1,3,2,0,6,"A","N","2012-03-15","201203150FLA"
"FLA",0,1,3,2,0,6,0,0,1,1,0,2,"H","N","2012-03-15","201203150FLA"
"COL",0,0,0,0,0,0,0,0,0,0,1,1,"A","Y","2012-03-15","201203150NJD"
"NJD",0,0,0,0,1,1,0,0,0,0,0,0,"H","Y","2012-03-15","201203150NJD"
"NYI",0,0,0,2,0,2,0,2,1,0,0,3,"H","N","2012-03-15","201203150NYI"
"PHI",0,2,1,0,0,3,0,0,0,2,0,2,"A","N","2012-03-15","201203150NYI"
"NYR",0,1,1,0,0,2,0,1,2,2,0,5,"H","N","2012-03-15","201203150NYR"
"PIT",0,1,2,2,0,5,0,1,1,0,0,2,"A","N","2012-03-15","201203150NYR"
"NSH",0,1,0,0,0,1,0,0,0,1,1,2,"A","Y","2012-03-15","201203150SJS"
"SJS",0,0,0,1,1,2,0,1,0,0,0,1,"H","Y","2012-03-15","201203150SJS"
"TBL",0,0,0,1,0,1,0,1,2,0,0,3,"H","N","2012-03-15","201203150TBL"
"TOR",0,1,2,0,0,3,0,0,0,1,0,1,"A","N","2012-03-15","201203150TBL"
"ANA",0,0,1,1,0,2,0,3,0,1,0,4,"H","N","2012-03-16","201203160ANA"
"LAK",0,3,0,1,0,4,0,0,1,1,0,2,"A","N","2012-03-16","201203160ANA"
"CHI",0,2,0,2,0,4,0,0,0,1,0,1,"A","N","2012-03-16","201203160DAL"
"DAL",0,0,0,1,0,1,0,2,0,2,0,4,"H","N","2012-03-16","201203160DAL"
"CGY",0,0,1,0,0,1,0,2,0,1,0,3,"A","N","2012-03-16","201203160EDM"
"EDM",0,2,0,1,0,3,0,0,1,0,0,1,"H","N","2012-03-16","201203160EDM"
"MTL",0,1,0,0,0,1,1,0,0,1,0,2,"A","N","2012-03-16","201203160OTT"
"OTT",1,0,0,1,0,2,0,1,0,0,0,1,"H","N","2012-03-16","201203160OTT"
"WPG",0,1,1,1,0,3,0,1,0,1,0,2,"H","N","2012-03-16","201203160WPG"
"WSH",0,1,0,1,0,2,0,1,1,1,0,3,"A","N","2012-03-16","201203160WPG"
"BOS",0,2,0,0,1,3,0,0,1,1,0,2,"H","Y","2012-03-17","201203170BOS"
"PHI",0,0,1,1,0,2,0,2,0,0,1,3,"A","Y","2012-03-17","201203170BOS"
"BUF",0,1,1,0,0,2,0,2,0,0,1,3,"A","Y","2012-03-17","201203170FLA"
"FLA",0,2,0,0,1,3,0,1,1,0,0,2,"H","Y","2012-03-17","201203170FLA"
"LAK",0,1,0,3,0,4,0,0,1,1,0,2,"H","N","2012-03-17","201203170LAK"
"NSH",0,0,1,1,0,2,0,1,0,3,0,4,"A","N","2012-03-17","201203170LAK"
"CAR",0,1,1,3,0,5,0,1,2,0,0,3,"A","N","2012-03-17","201203170MIN"
"MIN",0,1,2,0,0,3,0,1,1,3,0,5,"H","N","2012-03-17","201203170MIN"
"MTL",0,1,0,1,0,2,0,0,2,0,1,3,"H","Y","2012-03-17","201203170MTL"
"NYI",0,0,2,0,1,3,0,1,0,1,0,2,"A","Y","2012-03-17","201203170MTL"
"NJD",0,1,0,1,0,2,0,1,3,1,0,5,"H","N","2012-03-17","201203170NJD"
"PIT",0,1,3,1,0,5,0,1,0,1,0,2,"A","N","2012-03-17","201203170NJD"
"COL",0,1,1,1,0,3,0,1,0,0,0,1,"A","N","2012-03-17","201203170NYR"
"NYR",0,1,0,0,0,1,0,1,1,1,0,3,"H","N","2012-03-17","201203170NYR"
"OTT",0,0,0,1,0,1,0,0,1,2,0,3,"H","N","2012-03-17","201203170OTT"
"TOR",0,0,1,2,0,3,0,0,0,1,0,1,"A","N","2012-03-17","201203170OTT"
"DET",0,1,0,1,0,2,1,2,0,0,0,3,"A","N","2012-03-17","201203170SJS"
"SJS",1,2,0,0,0,3,0,1,0,1,0,2,"H","N","2012-03-17","201203170SJS"
"STL",0,2,1,0,0,3,0,0,0,1,0,1,"A","N","2012-03-17","201203170TBL"
"TBL",0,0,0,1,0,1,0,2,1,0,0,3,"H","N","2012-03-17","201203170TBL"
"CBJ",0,1,1,1,0,3,0,2,1,1,0,4,"A","N","2012-03-17","201203170VAN"
"VAN",0,2,1,1,0,4,0,1,1,1,0,3,"H","N","2012-03-17","201203170VAN"
"ANA",0,1,0,0,0,1,0,0,0,3,0,3,"H","N","2012-03-18","201203180ANA"
"NSH",0,0,0,3,0,3,0,1,0,0,0,1,"A","N","2012-03-18","201203180ANA"
"CBJ",0,1,0,0,1,2,0,0,0,1,0,1,"A","Y","2012-03-18","201203180CGY"
"CGY",0,0,0,1,0,1,0,1,0,0,1,2,"H","Y","2012-03-18","201203180CGY"
"CHI",0,2,2,1,0,5,0,0,2,0,0,2,"H","N","2012-03-18","201203180CHI"
"WSH",0,0,2,0,0,2,0,2,2,1,0,5,"A","N","2012-03-18","201203180CHI"
"EDM",0,0,2,0,0,2,0,0,0,2,1,3,"H","Y","2012-03-18","201203180EDM"
"PHX",0,0,0,2,1,3,0,0,2,0,0,2,"A","Y","2012-03-18","201203180EDM"
"PHI",1,0,0,2,0,3,0,1,1,0,0,2,"H","N","2012-03-18","201203180PHI"
"PIT",0,1,1,0,0,2,1,0,0,2,0,3,"A","N","2012-03-18","201203180PHI"
"CAR",0,1,1,2,0,4,0,1,2,0,0,3,"A","N","2012-03-18","201203180WPG"
"WPG",0,1,2,0,0,3,0,1,1,2,0,4,"H","N","2012-03-18","201203180WPG"
"BOS",0,4,3,1,0,8,0,0,0,0,0,0,"H","N","2012-03-19","201203190BOS"
"TOR",0,0,0,0,0,0,0,4,3,1,0,8,"A","N","2012-03-19","201203190BOS"
"DET",0,0,1,2,0,3,0,3,1,1,0,5,"H","N","2012-03-19","201203190DET"
"WSH",0,3,1,1,0,5,0,0,1,2,0,3,"A","N","2012-03-19","201203190DET"
"MIN",0,1,0,1,0,2,0,0,0,0,0,0,"H","N","2012-03-19","201203190MIN"
"VAN",0,0,0,0,0,0,0,1,0,1,0,2,"A","N","2012-03-19","201203190MIN"
"NJD",0,0,2,0,0,2,0,1,2,1,0,4,"A","N","2012-03-19","201203190NYR"
"NYR",0,1,2,1,0,4,0,0,2,0,0,2,"H","N","2012-03-19","201203190NYR"
"ANA",0,2,3,0,0,5,0,2,1,0,0,3,"A","N","2012-03-19","201203190SJS"
"SJS",0,2,1,0,0,3,0,2,3,0,0,5,"H","N","2012-03-19","201203190SJS"
"BUF",0,2,4,1,0,7,0,0,2,1,0,3,"A","N","2012-03-19","201203190TBL"
"TBL",0,0,2,1,0,3,0,2,4,1,0,7,"H","N","2012-03-19","201203190TBL"
"CBJ",0,0,0,1,0,1,0,3,0,2,0,5,"H","N","2012-03-20","201203200CBJ"
"CHI",0,3,0,2,0,5,0,0,0,1,0,1,"A","N","2012-03-20","201203200CBJ"
"CGY",0,1,0,0,0,1,1,1,0,0,0,2,"A","N","2012-03-20","201203200COL"
"COL",1,1,0,0,0,2,0,1,0,0,0,1,"H","N","2012-03-20","201203200COL"
"DAL",0,1,2,0,1,4,0,1,0,2,0,3,"H","Y","2012-03-20","201203200DAL"
"PHX",0,1,0,2,0,3,0,1,2,0,1,4,"A","Y","2012-03-20","201203200DAL"
"LAK",0,1,1,3,0,5,0,1,0,1,0,2,"H","N","2012-03-20","201203200LAK"
"SJS",0,1,0,1,0,2,0,1,1,3,0,5,"A","N","2012-03-20","201203200LAK"
"EDM",0,2,3,1,0,6,0,1,1,1,0,3,"A","N","2012-03-20","201203200NSH"
"NSH",0,1,1,1,0,3,0,2,3,1,0,6,"H","N","2012-03-20","201203200NSH"
"NJD",0,0,1,0,0,1,0,0,0,0,0,0,"A","N","2012-03-20","201203200OTT"
"OTT",0,0,0,0,0,0,0,0,1,0,0,1,"H","N","2012-03-20","201203200OTT"
"FLA",0,1,1,0,0,2,0,0,1,0,0,1,"A","N","2012-03-20","201203200PHI"
"PHI",0,0,1,0,0,1,0,1,1,0,0,2,"H","N","2012-03-20","201203200PHI"
"PIT",0,2,4,2,0,8,0,2,2,0,0,4,"H","N","2012-03-20","201203200PIT"
"WPG",0,2,2,0,0,4,0,2,4,2,0,8,"A","N","2012-03-20","201203200PIT"
"NYI",0,1,1,3,0,5,0,1,1,0,0,2,"A","N","2012-03-20","201203200TOR"
"TOR",0,1,1,0,0,2,0,1,1,3,0,5,"H","N","2012-03-20","201203200TOR"
"ANA",0,1,1,2,0,4,0,2,0,1,0,3,"H","N","2012-03-21","201203210ANA"
"STL",0,2,0,1,0,3,0,1,1,2,0,4,"A","N","2012-03-21","201203210ANA"
"BUF",0,1,1,1,0,3,0,0,0,0,0,0,"H","N","2012-03-21","201203210BUF"
"MTL",0,0,0,0,0,0,0,1,1,1,0,3,"A","N","2012-03-21","201203210BUF"
"CAR",0,1,1,1,0,3,0,0,1,0,0,1,"H","N","2012-03-21","201203210CAR"
"FLA",0,0,1,0,0,1,0,1,1,1,0,3,"A","N","2012-03-21","201203210CAR"
"CHI",1,0,1,0,0,2,0,1,0,0,0,1,"H","N","2012-03-21","201203210CHI"
"VAN",0,1,0,0,0,1,1,0,1,0,0,2,"A","N","2012-03-21","201203210CHI"
"DET",0,1,0,0,0,1,1,1,0,0,0,2,"A","N","2012-03-21","201203210NYR"
"NYR",1,1,0,0,0,2,0,1,0,0,0,1,"H","N","2012-03-21","201203210NYR"
"DAL",0,0,0,1,0,1,0,1,0,1,0,2,"H","N","2012-03-22","201203220DAL"
"VAN",0,1,0,1,0,2,0,0,0,1,0,1,"A","N","2012-03-22","201203220DAL"
"LAK",0,0,0,0,1,1,0,0,0,0,0,0,"H","Y","2012-03-22","201203220LAK"
"STL",0,0,0,0,0,0,0,0,0,0,1,1,"A","Y","2012-03-22","201203220LAK"
"CGY",0,1,1,0,0,2,0,0,1,1,1,3,"A","Y","2012-03-22","201203220MIN"
"MIN",0,0,1,1,1,3,0,1,1,0,0,2,"H","Y","2012-03-22","201203220MIN"
"PHI",0,0,1,0,1,2,0,1,0,0,0,1,"H","Y","2012-03-22","201203220PHI"
"WSH",0,1,0,0,0,1,0,0,1,0,1,2,"A","Y","2012-03-22","201203220PHI"
"COL",0,0,0,2,0,2,0,2,1,0,0,3,"A","N","2012-03-22","201203220PHX"
"PHX",0,2,1,0,0,3,0,0,0,2,0,2,"H","N","2012-03-22","201203220PHX"
"NSH",0,0,1,0,0,1,0,2,2,1,0,5,"A","N","2012-03-22","201203220PIT"
"PIT",0,2,2,1,0,5,0,0,1,0,0,1,"H","N","2012-03-22","201203220PIT"
"BOS",0,0,0,1,0,1,0,1,0,1,0,2,"A","N","2012-03-22","201203220SJS"
"SJS",0,1,0,1,0,2,0,0,0,1,0,1,"H","N","2012-03-22","201203220SJS"
"EDM",0,0,1,1,0,2,0,0,2,0,1,3,"A","Y","2012-03-22","201203220TBL"
"TBL",0,0,2,0,1,3,0,0,1,1,0,2,"H","Y","2012-03-22","201203220TBL"
"CAR",0,0,1,0,0,1,0,1,2,2,0,5,"A","N","2012-03-23","201203230CBJ"
"CBJ",0,1,2,2,0,5,0,0,1,0,0,1,"H","N","2012-03-23","201203230CBJ"
"EDM",0,0,1,0,1,2,0,0,1,0,0,1,"A","Y","2012-03-23","201203230FLA"
"FLA",0,0,1,0,0,1,0,0,1,0,1,2,"H","Y","2012-03-23","201203230FLA"
"MTL",0,4,0,1,0,5,0,1,0,0,0,1,"H","N","2012-03-23","201203230MTL"
"OTT",0,1,0,0,0,1,0,4,0,1,0,5,"A","N","2012-03-23","201203230MTL"
"NJD",0,0,1,2,0,3,0,0,2,1,1,4,"H","Y","2012-03-23","201203230NJD"
"TOR",0,0,2,1,1,4,0,0,1,2,0,3,"A","Y","2012-03-23","201203230NJD"
"BUF",0,0,2,2,0,4,0,0,1,0,0,1,"A","N","2012-03-23","201203230NYR"
"NYR",0,0,1,0,0,1,0,0,2,2,0,4,"H","N","2012-03-23","201203230NYR"
"WPG",1,0,2,1,0,4,0,1,2,0,0,3,"A","N","2012-03-23","201203230WSH"
"WSH",0,1,2,0,0,3,1,0,2,1,0,4,"H","N","2012-03-23","201203230WSH"
"BUF",0,0,1,2,0,3,0,1,0,0,0,1,"H","N","2012-03-24","201203240BUF"
"MIN",0,1,0,0,0,1,0,0,1,2,0,3,"A","N","2012-03-24","201203240BUF"
"COL",0,1,1,0,0,2,1,0,2,0,0,3,"H","N","2012-03-24","201203240COL"
"VAN",1,0,2,0,0,3,0,1,1,0,0,2,"A","N","2012-03-24","201203240COL"
"CGY",0,1,0,0,0,1,0,2,0,2,0,4,"A","N","2012-03-24","201203240DAL"
"DAL",0,2,0,2,0,4,0,1,0,0,0,1,"H","N","2012-03-24","201203240DAL"
"CAR",0,1,3,0,0,4,0,0,3,2,0,5,"A","N","2012-03-24","201203240DET"
"DET",0,0,3,2,0,5,0,1,3,0,0,4,"H","N","2012-03-24","201203240DET"
"BOS",0,0,1,3,0,4,0,0,1,1,0,2,"A","N","2012-03-24","201203240LAK"
"LAK",0,0,1,1,0,2,0,0,1,3,0,4,"H","N","2012-03-24","201203240LAK"
"NSH",0,0,2,1,0,3,0,0,0,1,0,1,"H","N","2012-03-24","201203240NSH"
"WPG",0,0,0,1,0,1,0,0,2,1,0,3,"A","N","2012-03-24","201203240NSH"
"OTT",0,1,4,3,0,8,0,2,1,1,0,4,"H","N","2012-03-24","201203240OTT"
"PIT",0,2,1,1,0,4,0,1,4,3,0,8,"A","N","2012-03-24","201203240OTT"
"MTL",0,0,1,0,0,1,0,1,2,1,0,4,"A","N","2012-03-24","201203240PHI"
"PHI",0,1,2,1,0,4,0,0,1,0,0,1,"H","N","2012-03-24","201203240PHI"
"PHX",0,2,1,0,0,3,0,2,1,0,1,4,"A","Y","2012-03-24","201203240SJS"
"SJS",0,2,1,0,1,4,0,2,1,0,0,3,"H","Y","2012-03-24","201203240SJS"
"NYI",0,0,2,1,0,3,0,1,1,2,0,4,"A","N","2012-03-24","201203240TBL"
"TBL",0,1,1,2,0,4,0,0,2,1,0,3,"H","N","2012-03-24","201203240TBL"
"NYR",0,1,1,1,1,4,0,1,1,1,0,3,"A","Y","2012-03-24","201203240TOR"
"TOR",0,1,1,1,0,3,0,1,1,1,1,4,"H","Y","2012-03-24","201203240TOR"
"ANA",0,0,1,1,0,2,0,0,2,1,0,3,"H","N","2012-03-25","201203250ANA"
"BOS",0,0,2,1,0,3,0,0,1,1,0,2,"A","N","2012-03-25","201203250ANA"
"CBJ",0,1,1,1,0,3,0,0,5,1,0,6,"H","N","2012-03-25","201203250CBJ"
"EDM",0,0,5,1,0,6,0,1,1,1,0,3,"A","N","2012-03-25","201203250CBJ"
"CHI",0,0,0,1,0,1,0,2,1,3,0,6,"H","N","2012-03-25","201203250CHI"
"NSH",0,2,1,3,0,6,0,0,0,1,0,1,"A","N","2012-03-25","201203250CHI"
"FLA",0,1,0,1,0,2,0,0,1,1,1,3,"H","Y","2012-03-25","201203250FLA"
"NYI",0,0,1,1,1,3,0,1,0,1,0,2,"A","Y","2012-03-25","201203250FLA"
"PHX",0,0,0,0,0,0,0,0,1,3,0,4,"H","N","2012-03-25","201203250PHX"
"STL",0,0,1,3,0,4,0,0,0,0,0,0,"A","N","2012-03-25","201203250PHX"
"NJD",0,1,0,1,0,2,0,2,1,2,0,5,"A","N","2012-03-25","201203250PIT"
"PIT",0,2,1,2,0,5,0,1,0,1,0,2,"H","N","2012-03-25","201203250PIT"
"MIN",0,0,0,0,0,0,0,0,2,1,0,3,"A","N","2012-03-25","201203250WSH"
"WSH",0,0,2,1,0,3,0,0,0,0,0,0,"H","N","2012-03-25","201203250WSH"
"CGY",0,1,4,0,0,5,0,1,2,1,0,4,"H","N","2012-03-26","201203260CGY"
"DAL",0,1,2,1,0,4,0,1,4,0,0,5,"A","N","2012-03-26","201203260CGY"
"CBJ",0,0,0,2,0,2,0,4,2,1,0,7,"A","N","2012-03-26","201203260DET"
"DET",0,4,2,1,0,7,0,0,0,2,0,2,"H","N","2012-03-26","201203260DET"
"PHI",0,0,2,1,0,3,0,2,0,3,0,5,"H","N","2012-03-26","201203260PHI"
"TBL",0,2,0,3,0,5,0,0,2,1,0,3,"A","N","2012-03-26","201203260PHI"
"COL",0,0,1,0,0,1,0,0,3,2,0,5,"A","N","2012-03-26","201203260SJS"
"SJS",0,0,3,2,0,5,0,0,1,0,0,1,"H","N","2012-03-26","201203260SJS"
"LAK",0,0,0,0,0,0,0,1,0,0,0,1,"A","N","2012-03-26","201203260VAN"
"VAN",0,1,0,0,0,1,0,0,0,0,0,0,"H","N","2012-03-26","201203260VAN"
"OTT",0,1,2,3,0,6,0,0,3,1,0,4,"A","N","2012-03-26","201203260WPG"
"WPG",0,0,3,1,0,4,0,1,2,3,0,6,"H","N","2012-03-26","201203260WPG"
"BOS",0,1,1,3,0,5,0,1,0,1,0,2,"H","N","2012-03-27","201203270BOS"
"TBL",0,1,0,1,0,2,0,1,1,3,0,5,"A","N","2012-03-27","201203270BOS"
"MIN",0,0,2,0,0,2,0,1,1,1,0,3,"H","N","2012-03-27","201203270MIN"
"NYR",0,1,1,1,0,3,0,0,2,0,0,2,"A","N","2012-03-27","201203270MIN"
"FLA",0,1,0,1,1,3,0,1,1,0,0,2,"A","Y","2012-03-27","201203270MTL"
"MTL",0,1,1,0,0,2,0,1,0,1,1,3,"H","Y","2012-03-27","201203270MTL"
"CHI",0,0,0,1,0,1,0,1,0,0,1,2,"A","Y","2012-03-27","201203270NJD"
"NJD",0,1,0,0,1,2,0,0,0,1,0,1,"H","Y","2012-03-27","201203270NJD"
"NYI",0,2,3,0,0,5,0,0,2,1,0,3,"A","N","2012-03-27","201203270PIT"
"PIT",0,0,2,1,0,3,0,2,3,0,0,5,"H","N","2012-03-27","201203270PIT"
"NSH",0,0,0,0,0,0,0,0,1,2,0,3,"A","N","2012-03-27","201203270STL"
"STL",0,0,1,2,0,3,0,0,0,0,0,0,"H","N","2012-03-27","201203270STL"
"CAR",0,2,1,0,0,3,0,0,0,0,0,0,"A","N","2012-03-27","201203270TOR"
"TOR",0,0,0,0,0,0,0,2,1,0,0,3,"H","N","2012-03-27","201203270TOR"
"BUF",0,2,2,1,0,5,0,0,1,0,0,1,"A","N","2012-03-27","201203270WSH"
"WSH",0,0,1,0,0,1,0,2,2,1,0,5,"H","N","2012-03-27","201203270WSH"
"ANA",0,0,1,2,0,3,0,0,1,0,0,1,"H","N","2012-03-28","201203280ANA"
"SJS",0,0,1,0,0,1,0,0,1,2,0,3,"A","N","2012-03-28","201203280ANA"
"CBJ",0,2,2,0,0,4,0,1,0,1,0,2,"H","N","2012-03-28","201203280CBJ"
"DET",0,1,0,1,0,2,0,2,2,0,0,4,"A","N","2012-03-28","201203280CBJ"
"CGY",0,0,0,0,0,0,0,1,1,1,0,3,"H","N","2012-03-28","201203280CGY"
"LAK",0,1,1,1,0,3,0,0,0,0,0,0,"A","N","2012-03-28","201203280CGY"
"DAL",0,1,1,1,0,3,0,0,0,1,0,1,"A","N","2012-03-28","201203280EDM"
"EDM",0,0,0,1,0,1,0,1,1,1,0,3,"H","N","2012-03-28","201203280EDM"
"COL",0,0,0,0,0,0,0,1,0,0,0,1,"A","N","2012-03-28","201203280VAN"
"VAN",0,1,0,0,0,1,0,0,0,0,0,0,"H","N","2012-03-28","201203280VAN"
"NYR",0,0,2,2,0,4,0,0,2,0,0,2,"A","N","2012-03-28","201203280WPG"
"WPG",0,0,2,0,0,2,0,0,2,2,0,4,"H","N","2012-03-28","201203280WPG"
"BOS",0,0,0,2,0,2,0,0,0,2,1,3,"H","Y","2012-03-29","201203290BOS"
"WSH",0,0,0,2,1,3,0,0,0,2,0,2,"A","Y","2012-03-29","201203290BOS"
"CHI",0,1,0,2,1,4,0,1,0,2,0,3,"H","Y","2012-03-29","201203290CHI"
"STL",0,1,0,2,0,3,0,1,0,2,1,4,"A","Y","2012-03-29","201203290CHI"
"FLA",0,0,1,1,0,2,1,0,0,2,0,3,"A","N","2012-03-29","201203290MIN"
"MIN",1,0,0,2,0,3,0,0,1,1,0,2,"H","N","2012-03-29","201203290MIN"
"NJD",0,0,4,2,0,6,0,1,2,1,0,4,"H","N","2012-03-29","201203290NJD"
"TBL",0,1,2,1,0,4,0,0,4,2,0,6,"A","N","2012-03-29","201203290NJD"
"NYI",0,1,2,2,0,5,0,0,1,2,0,3,"H","N","2012-03-29","201203290NYI"
"PIT",0,0,1,2,0,3,0,1,2,2,0,5,"A","N","2012-03-29","201203290NYI"
"PHX",0,0,1,1,0,2,0,0,0,0,0,0,"H","N","2012-03-29","201203290PHX"
"SJS",0,0,0,0,0,0,0,0,1,1,0,2,"A","N","2012-03-29","201203290PHX"
"PHI",0,2,2,3,0,7,0,1,0,0,0,1,"A","N","2012-03-29","201203290TOR"
"TOR",0,1,0,0,0,1,0,2,2,3,0,7,"H","N","2012-03-29","201203290TOR"
"BUF",0,2,1,0,0,3,0,2,2,1,0,5,"H","N","2012-03-30","201203300BUF"
"PIT",0,2,2,1,0,5,0,2,1,0,0,3,"A","N","2012-03-30","201203300BUF"
"CAR",0,2,1,0,0,3,1,1,1,1,0,4,"H","N","2012-03-30","201203300CAR"
"WPG",1,1,1,1,0,4,0,2,1,0,0,3,"A","N","2012-03-30","201203300CAR"
"CBJ",0,1,1,2,0,4,0,0,0,1,0,1,"H","N","2012-03-30","201203300CBJ"
"FLA",0,0,0,1,0,1,0,1,1,2,0,4,"A","N","2012-03-30","201203300CBJ"
"CGY",0,0,0,1,0,1,0,2,1,1,0,4,"H","N","2012-03-30","201203300CGY"
"COL",0,2,1,1,0,4,0,0,0,1,0,1,"A","N","2012-03-30","201203300CGY"
"DET",0,0,0,1,0,1,0,0,2,2,0,4,"H","N","2012-03-30","201203300DET"
"NSH",0,0,2,2,0,4,0,0,0,1,0,1,"A","N","2012-03-30","201203300DET"
"EDM",0,1,0,0,0,1,0,2,1,1,0,4,"H","N","2012-03-30","201203300EDM"
"LAK",0,2,1,1,0,4,0,1,0,0,0,1,"A","N","2012-03-30","201203300EDM"
"MTL",0,0,0,1,0,1,0,1,1,2,0,4,"A","N","2012-03-30","201203300NYR"
"NYR",0,1,1,2,0,4,0,0,0,1,0,1,"H","N","2012-03-30","201203300NYR"
"DAL",0,0,1,1,0,2,0,1,2,2,0,5,"A","N","2012-03-30","201203300VAN"
"VAN",0,1,2,2,0,5,0,0,1,1,0,2,"H","N","2012-03-30","201203300VAN"
"CAR",0,0,0,0,0,0,0,1,3,1,0,5,"H","N","2012-03-31","201203310CAR"
"NJD",0,1,3,1,0,5,0,0,0,0,0,0,"A","N","2012-03-31","201203310CAR"
"LAK",0,2,1,0,0,3,0,2,0,1,1,4,"A","Y","2012-03-31","201203310MIN"
"MIN",0,2,0,1,1,4,0,2,1,0,0,3,"H","Y","2012-03-31","201203310MIN"
"CHI",0,1,3,1,0,5,0,0,2,2,0,4,"A","N","2012-03-31","201203310NSH"
"NSH",0,0,2,2,0,4,0,1,3,1,0,5,"H","N","2012-03-31","201203310NSH"
"BOS",0,1,1,4,0,6,0,1,1,1,0,3,"A","N","2012-03-31","201203310NYI"
"NYI",0,1,1,1,0,3,0,1,1,4,0,6,"H","N","2012-03-31","201203310NYI"
"OTT",0,3,0,0,1,4,0,0,3,0,0,3,"A","Y","2012-03-31","201203310PHI"
"PHI",0,0,3,0,0,3,0,3,0,0,1,4,"H","Y","2012-03-31","201203310PHI"
"ANA",0,0,0,0,0,0,0,1,3,0,0,4,"A","N","2012-03-31","201203310PHX"
"PHX",0,1,3,0,0,4,0,0,0,0,0,0,"H","N","2012-03-31","201203310PHX"
"DAL",0,0,0,0,0,0,0,2,1,0,0,3,"A","N","2012-03-31","201203310SJS"
"SJS",0,2,1,0,0,3,0,0,0,0,0,0,"H","N","2012-03-31","201203310SJS"
"CBJ",0,2,1,2,0,5,0,1,1,0,0,2,"A","N","2012-03-31","201203310STL"
"STL",0,1,1,0,0,2,0,2,1,2,0,5,"H","N","2012-03-31","201203310STL"
"TBL",1,1,0,1,0,3,0,0,2,0,0,2,"H","N","2012-03-31","201203310TBL"
"WPG",0,0,2,0,0,2,1,1,0,1,0,3,"A","N","2012-03-31","201203310TBL"
"BUF",0,0,1,2,0,3,0,1,2,1,0,4,"A","N","2012-03-31","201203310TOR"
"TOR",0,1,2,1,0,4,0,0,1,2,0,3,"H","N","2012-03-31","201203310TOR"
"CGY",0,0,1,1,0,2,1,1,0,1,0,3,"A","N","2012-03-31","201203310VAN"
"VAN",1,1,0,1,0,3,0,0,1,1,0,2,"H","N","2012-03-31","201203310VAN"
"MTL",0,1,1,0,0,2,0,2,0,0,1,3,"A","Y","2012-03-31","201203310WSH"
"WSH",0,2,0,0,1,3,0,1,1,0,0,2,"H","Y","2012-03-31","201203310WSH"
"ANA",0,1,0,0,0,1,0,2,0,0,0,2,"H","N","2012-04-01","201204010ANA"
"EDM",0,2,0,0,0,2,0,1,0,0,0,1,"A","N","2012-04-01","201204010ANA"
"CHI",0,1,2,1,0,4,0,2,2,0,1,5,"H","Y","2012-04-01","201204010CHI"
"MIN",0,2,2,0,1,5,0,1,2,1,0,4,"A","Y","2012-04-01","201204010CHI"
"DET",0,0,0,1,1,2,0,1,0,0,0,1,"H","Y","2012-04-01","201204010DET"
"FLA",0,1,0,0,0,1,0,0,0,1,1,2,"A","Y","2012-04-01","201204010DET"
"NYI",0,1,0,0,0,1,0,1,3,1,0,5,"H","N","2012-04-01","201204010NYI"
"OTT",0,1,3,1,0,5,0,1,0,0,0,1,"A","N","2012-04-01","201204010NYI"
"BOS",0,0,2,0,0,2,0,1,0,0,0,1,"A","N","2012-04-01","201204010NYR"
"NYR",0,1,0,0,0,1,0,0,2,0,0,2,"H","N","2012-04-01","201204010NYR"
"PHI",0,1,1,4,0,6,0,2,0,2,0,4,"A","N","2012-04-01","201204010PIT"
"PIT",0,2,0,2,0,4,0,1,1,4,0,6,"H","N","2012-04-01","201204010PIT"
"EDM",0,0,0,0,0,0,0,0,0,2,0,2,"A","N","2012-04-02","201204020LAK"
"LAK",0,0,0,2,0,2,0,0,0,0,0,0,"H","N","2012-04-02","201204020LAK"
"TBL",0,0,2,2,0,4,0,0,1,1,0,2,"H","N","2012-04-02","201204020TBL"
"WSH",0,0,1,1,0,2,0,0,2,2,0,4,"A","N","2012-04-02","201204020TBL"
"BOS",0,1,1,1,0,3,0,2,2,1,0,5,"H","N","2012-04-03","201204030BOS"
"PIT",0,2,2,1,0,5,0,1,1,1,0,3,"A","N","2012-04-03","201204030BOS"
"BUF",1,0,2,3,0,6,0,3,0,2,0,5,"H","N","2012-04-03","201204030BUF"
"TOR",0,3,0,2,0,5,1,0,2,3,0,6,"A","N","2012-04-03","201204030BUF"
"DAL",0,1,1,0,0,2,0,1,2,2,0,5,"H","N","2012-04-03","201204030DAL"
"SJS",0,1,2,2,0,5,0,1,1,0,0,2,"A","N","2012-04-03","201204030DAL"
"FLA",0,2,1,1,0,4,1,0,2,2,0,5,"H","N","2012-04-03","201204030FLA"
"WPG",1,0,2,2,0,5,0,2,1,1,0,4,"A","N","2012-04-03","201204030FLA"
"NJD",0,1,1,1,0,3,0,1,0,0,0,1,"H","N","2012-04-03","201204030NJD"
"NYI",0,1,0,0,0,1,0,1,1,1,0,3,"A","N","2012-04-03","201204030NJD"
"MIN",0,0,1,0,0,1,0,0,1,0,1,2,"A","Y","2012-04-03","201204030NSH"
"NSH",0,0,1,0,1,2,0,0,1,0,0,1,"H","Y","2012-04-03","201204030NSH"
"CAR",0,0,2,0,0,2,0,0,0,1,0,1,"A","N","2012-04-03","201204030OTT"
"OTT",0,0,0,1,0,1,0,0,2,0,0,2,"H","N","2012-04-03","201204030OTT"
"NYR",0,4,1,0,0,5,0,0,2,1,0,3,"A","N","2012-04-03","201204030PHI"
"PHI",0,0,2,1,0,3,0,4,1,0,0,5,"H","N","2012-04-03","201204030PHI"
"CBJ",0,0,0,0,0,0,0,0,2,0,0,2,"A","N","2012-04-03","201204030PHX"
"PHX",0,0,2,0,0,2,0,0,0,0,0,0,"H","N","2012-04-03","201204030PHX"
"ANA",0,2,2,0,0,4,0,2,2,0,1,5,"A","Y","2012-04-03","201204030VAN"
"VAN",0,2,2,0,1,5,0,2,2,0,0,4,"H","Y","2012-04-03","201204030VAN"
"MTL",0,1,2,2,0,5,0,1,0,1,0,2,"H","N","2012-04-04","201204040MTL"
"TBL",0,1,0,1,0,2,0,1,2,2,0,5,"A","N","2012-04-04","201204040MTL"
"DET",0,0,0,2,1,3,0,0,0,2,0,2,"A","Y","2012-04-04","201204040STL"
"STL",0,0,0,2,0,2,0,0,0,2,1,3,"H","Y","2012-04-04","201204040STL"
"CAR",0,0,1,0,1,2,0,0,1,0,0,1,"H","Y","2012-04-05","201204050CAR"
"MTL",0,0,1,0,0,1,0,0,1,0,1,2,"A","Y","2012-04-05","201204050CAR"
"CGY",0,0,0,3,0,3,0,1,0,1,0,2,"H","N","2012-04-05","201204050CGY"
"VAN",0,1,0,1,0,2,0,0,0,3,0,3,"A","N","2012-04-05","201204050CGY"
"CBJ",0,2,2,1,0,5,0,1,1,0,0,2,"A","N","2012-04-05","201204050COL"
"COL",0,1,1,0,0,2,0,2,2,1,0,5,"H","N","2012-04-05","201204050COL"
"DET",0,0,1,0,0,1,0,1,0,1,0,2,"H","N","2012-04-05","201204050DET"
"NJD",0,1,0,1,0,2,0,0,1,0,0,1,"A","N","2012-04-05","201204050DET"
"ANA",1,0,2,0,0,3,0,0,1,1,0,2,"A","N","2012-04-05","201204050EDM"
"EDM",0,0,1,1,0,2,1,0,2,0,0,3,"H","N","2012-04-05","201204050EDM"
"LAK",0,1,2,2,0,5,0,1,1,3,1,6,"H","Y","2012-04-05","201204050LAK"
"SJS",0,1,1,3,1,6,0,1,2,2,0,5,"A","Y","2012-04-05","201204050LAK"
"CHI",0,1,0,0,0,1,0,0,0,1,1,2,"A","Y","2012-04-05","201204050MIN"
"MIN",0,0,0,1,1,2,0,1,0,0,0,1,"H","Y","2012-04-05","201204050MIN"
"DAL",0,0,0,0,0,0,0,0,0,2,0,2,"A","N","2012-04-05","201204050NSH"
"NSH",0,0,0,2,0,2,0,0,0,0,0,0,"H","N","2012-04-05","201204050NSH"
"NYI",0,2,1,2,0,5,0,2,0,2,0,4,"H","N","2012-04-05","201204050NYI"
"WPG",0,2,0,2,0,4,0,2,1,2,0,5,"A","N","2012-04-05","201204050NYI"
"BOS",0,1,1,1,0,3,0,0,1,0,0,1,"A","N","2012-04-05","201204050OTT"
"OTT",0,0,1,0,0,1,0,1,1,1,0,3,"H","N","2012-04-05","201204050OTT"
"BUF",0,0,1,0,0,1,0,0,0,2,0,2,"A","N","2012-04-05","201204050PHI"
"PHI",0,0,0,2,0,2,0,0,1,0,0,1,"H","N","2012-04-05","201204050PHI"
"NYR",0,1,0,1,0,2,0,2,1,2,0,5,"A","N","2012-04-05","201204050PIT"
"PIT",0,2,1,2,0,5,0,1,0,1,0,2,"H","N","2012-04-05","201204050PIT"
"TBL",0,1,0,1,0,2,1,1,0,1,0,3,"A","N","2012-04-05","201204050TOR"
"TOR",1,1,0,1,0,3,0,1,0,1,0,2,"H","N","2012-04-05","201204050TOR"
"FLA",0,0,1,1,0,2,0,1,2,1,0,4,"A","N","2012-04-05","201204050WSH"
"WSH",0,1,2,1,0,4,0,0,1,1,0,2,"H","N","2012-04-05","201204050WSH"
"PHX",0,1,2,1,0,4,0,1,0,0,0,1,"A","N","2012-04-06","201204060STL"
"STL",0,1,0,0,0,1,0,1,2,1,0,4,"H","N","2012-04-06","201204060STL"
"BOS",0,0,1,2,1,4,0,0,1,2,0,3,"H","Y","2012-04-07","201204070BOS"
"BUF",0,0,1,2,0,3,0,0,1,2,1,4,"A","Y","2012-04-07","201204070BOS"
"CBJ",0,1,4,2,0,7,0,0,2,1,0,3,"H","N","2012-04-07","201204070CBJ"
"NYI",0,0,2,1,0,3,0,1,4,2,0,7,"A","N","2012-04-07","201204070CBJ"
"ANA",0,0,1,1,0,2,0,1,2,2,0,5,"A","N","2012-04-07","201204070CGY"
"CGY",0,1,2,2,0,5,0,0,1,1,0,2,"H","N","2012-04-07","201204070CGY"
"COL",0,1,0,0,0,1,0,3,1,2,0,6,"H","N","2012-04-07","201204070COL"
"NSH",0,3,1,2,0,6,0,1,0,0,0,1,"A","N","2012-04-07","201204070COL"
"DAL",0,0,0,2,0,2,0,0,1,2,0,3,"H","N","2012-04-07","201204070DAL"
"STL",0,0,1,2,0,3,0,0,0,2,0,2,"A","N","2012-04-07","201204070DAL"
"CHI",0,1,1,0,1,3,0,0,0,2,0,2,"A","Y","2012-04-07","201204070DET"
"DET",0,0,0,2,0,2,0,1,1,0,1,3,"H","Y","2012-04-07","201204070DET"
"CAR",0,0,0,1,0,1,0,2,1,1,0,4,"A","N","2012-04-07","201204070FLA"
"FLA",0,2,1,1,0,4,0,0,0,1,0,1,"H","N","2012-04-07","201204070FLA"
"MIN",0,0,1,0,0,1,0,2,1,1,0,4,"H","N","2012-04-07","201204070MIN"
"PHX",0,2,1,1,0,4,0,0,1,0,0,1,"A","N","2012-04-07","201204070MIN"
"MTL",0,1,1,2,0,4,0,0,0,1,0,1,"H","N","2012-04-07","201204070MTL"
"TOR",0,0,0,1,0,1,0,1,1,2,0,4,"A","N","2012-04-07","201204070MTL"
"NJD",0,1,1,2,0,4,0,1,1,0,0,2,"H","N","2012-04-07","201204070NJD"
"OTT",0,1,1,0,0,2,0,1,1,2,0,4,"A","N","2012-04-07","201204070NJD"
"NYR",0,0,1,0,0,1,0,3,1,0,0,4,"H","N","2012-04-07","201204070NYR"
"WSH",0,3,1,0,0,4,0,0,1,0,0,1,"A","N","2012-04-07","201204070NYR"
"PHI",0,1,1,0,0,2,0,1,3,0,0,4,"A","N","2012-04-07","201204070PIT"
"PIT",0,1,3,0,0,4,0,1,1,0,0,2,"H","N","2012-04-07","201204070PIT"
"LAK",0,1,1,0,0,2,1,0,0,2,0,3,"A","N","2012-04-07","201204070SJS"
"SJS",1,0,0,2,0,3,0,1,1,0,0,2,"H","N","2012-04-07","201204070SJS"
"EDM",0,0,0,0,0,0,0,0,1,2,0,3,"A","N","2012-04-07","201204070VAN"
"VAN",0,0,1,2,0,3,0,0,0,0,0,0,"H","N","2012-04-07","201204070VAN"
"TBL",1,1,1,1,0,4,0,0,1,2,0,3,"A","N","2012-04-07","201204070WPG"
"WPG",0,0,1,2,0,3,1,1,1,1,0,4,"H","N","2012-04-07","201204070WPG"
"DET",0,0,1,1,0,2,0,1,1,1,0,3,"A","N","2012-04-11","201204110NSH"
"NSH",0,1,1,1,0,3,0,0,1,1,0,2,"H","N","2012-04-11","201204110NSH"
"PHI",1,0,1,2,0,4,0,3,0,0,0,3,"A","N","2012-04-11","201204110PIT"
"PIT",0,3,0,0,0,3,1,0,1,2,0,4,"H","N","2012-04-11","201204110PIT"
"LAK",0,1,1,2,0,4,0,1,1,0,0,2,"A","N","2012-04-11","201204110VAN"
"VAN",0,1,1,0,0,2,0,1,1,2,0,4,"H","N","2012-04-11","201204110VAN"
"BOS",1,0,0,0,0,1,0,0,0,0,0,0,"H","N","2012-04-12","201204120BOS"
"WSH",0,0,0,0,0,0,1,0,0,0,0,1,"A","N","2012-04-12","201204120BOS"
"NYR",0,1,2,1,0,4,0,0,0,2,0,2,"H","N","2012-04-12","201204120NYR"
"OTT",0,0,0,2,0,2,0,1,2,1,0,4,"A","N","2012-04-12","201204120NYR"
"CHI",0,1,0,1,0,2,1,0,2,0,0,3,"A","N","2012-04-12","201204120PHX"
"PHX",1,0,2,0,0,3,0,1,0,1,0,2,"H","N","2012-04-12","201204120PHX"
"SJS",1,0,1,1,0,3,0,0,0,2,0,2,"A","N","2012-04-12","201204120STL"
"STL",0,0,0,2,0,2,1,0,1,1,0,3,"H","N","2012-04-12","201204120STL"
"FLA",0,0,2,0,0,2,0,3,0,0,0,3,"H","N","2012-04-13","201204130FLA"
"NJD",0,3,0,0,0,3,0,0,2,0,0,2,"A","N","2012-04-13","201204130FLA"
"DET",0,2,1,0,0,3,0,0,1,1,0,2,"A","N","2012-04-13","201204130NSH"
"NSH",0,0,1,1,0,2,0,2,1,0,0,3,"H","N","2012-04-13","201204130NSH"
"PHI",0,1,3,4,0,8,0,3,1,1,0,5,"A","N","2012-04-13","201204130PIT"
"PIT",0,3,1,1,0,5,0,1,3,4,0,8,"H","N","2012-04-13","201204130PIT"
"LAK",0,1,1,2,0,4,0,0,1,1,0,2,"A","N","2012-04-13","201204130VAN"
"VAN",0,0,1,1,0,2,0,1,1,2,0,4,"H","N","2012-04-13","201204130VAN"
"BOS",0,0,0,1,0,1,1,0,1,0,0,2,"H","N","2012-04-14","201204140BOS"
"WSH",1,0,1,0,0,2,0,0,0,1,0,1,"A","N","2012-04-14","201204140BOS"
"NYR",0,1,0,1,0,2,1,0,1,1,0,3,"H","N","2012-04-14","201204140NYR"
"OTT",1,0,1,1,0,3,0,1,0,1,0,2,"A","N","2012-04-14","201204140NYR"
"CHI",1,1,1,1,0,4,0,2,1,0,0,3,"A","N","2012-04-14","201204140PHX"
"PHX",0,2,1,0,0,3,1,1,1,1,0,4,"H","N","2012-04-14","201204140PHX"
"SJS",0,0,0,0,0,0,0,1,1,1,0,3,"A","N","2012-04-14","201204140STL"
"STL",0,1,1,1,0,3,0,0,0,0,0,0,"H","N","2012-04-14","201204140STL"
"DET",0,0,1,1,0,2,0,1,1,1,0,3,"H","N","2012-04-15","201204150DET"
"NSH",0,1,1,1,0,3,0,0,1,1,0,2,"A","N","2012-04-15","201204150DET"
"FLA",0,1,2,1,0,4,0,0,0,2,0,2,"H","N","2012-04-15","201204150FLA"
"NJD",0,0,0,2,0,2,0,1,2,1,0,4,"A","N","2012-04-15","201204150FLA"
"LAK",0,0,0,1,0,1,0,0,0,0,0,0,"H","N","2012-04-15","201204150LAK"
"VAN",0,0,0,0,0,0,0,0,0,1,0,1,"A","N","2012-04-15","201204150LAK"
"PHI",0,4,2,2,0,8,0,2,2,0,0,4,"H","N","2012-04-15","201204150PHI"
"PIT",0,2,2,0,0,4,0,4,2,2,0,8,"A","N","2012-04-15","201204150PHI"
"NYR",0,0,0,1,0,1,0,0,0,0,0,0,"A","N","2012-04-16","201204160OTT"
"OTT",0,0,0,0,0,0,0,0,0,1,0,1,"H","N","2012-04-16","201204160OTT"
"SJS",0,1,0,2,0,3,0,1,2,1,0,4,"H","N","2012-04-16","201204160SJS"
"STL",0,1,2,1,0,4,0,1,0,2,0,3,"A","N","2012-04-16","201204160SJS"
"BOS",0,0,2,2,0,4,0,1,1,1,0,3,"A","N","2012-04-16","201204160WSH"
"WSH",0,1,1,1,0,3,0,0,2,2,0,4,"H","N","2012-04-16","201204160WSH"
"CHI",0,1,0,1,0,2,1,0,0,2,0,3,"H","N","2012-04-17","201204170CHI"
"PHX",1,0,0,2,0,3,0,1,0,1,0,2,"A","N","2012-04-17","201204170CHI"
"DET",0,0,0,1,0,1,0,0,0,3,0,3,"H","N","2012-04-17","201204170DET"
"NSH",0,0,0,3,0,3,0,0,0,1,0,1,"A","N","2012-04-17","201204170DET"
"FLA",0,2,2,0,0,4,0,3,0,0,0,3,"A","N","2012-04-17","201204170NJD"
"NJD",0,3,0,0,0,3,0,2,2,0,0,4,"H","N","2012-04-17","201204170NJD"
"LAK",0,1,0,0,0,1,0,0,2,1,0,3,"H","N","2012-04-18","201204180LAK"
"VAN",0,0,2,1,0,3,0,1,0,0,0,1,"A","N","2012-04-18","201204180LAK"
"NYR",0,2,0,0,0,2,1,0,2,0,0,3,"A","N","2012-04-18","201204180OTT"
"OTT",1,0,2,0,0,3,0,2,0,0,0,2,"H","N","2012-04-18","201204180OTT"
"PHI",0,3,0,0,0,3,0,4,5,1,0,10,"H","N","2012-04-18","201204180PHI"
"PIT",0,4,5,1,0,10,0,3,0,0,0,3,"A","N","2012-04-18","201204180PHI"
"CHI",0,0,0,2,0,2,1,0,0,2,0,3,"H","N","2012-04-19","201204190CHI"
"PHX",1,0,0,2,0,3,0,0,0,2,0,2,"A","N","2012-04-19","201204190CHI"
"FLA",0,0,0,0,0,0,0,0,1,3,0,4,"A","N","2012-04-19","201204190NJD"
"NJD",0,0,1,3,0,4,0,0,0,0,0,0,"H","N","2012-04-19","201204190NJD"
"SJS",0,0,0,1,0,1,0,1,0,1,0,2,"H","N","2012-04-19","201204190SJS"
"STL",0,1,0,1,0,2,0,0,0,1,0,1,"A","N","2012-04-19","201204190SJS"
"BOS",0,1,0,0,0,1,0,1,1,0,0,2,"A","N","2012-04-19","201204190WSH"
"WSH",0,1,1,0,0,2,0,1,0,0,0,1,"H","N","2012-04-19","201204190WSH"
"DET",0,0,1,0,0,1,0,1,0,1,0,2,"A","N","2012-04-20","201204200NSH"
"NSH",0,1,0,1,0,2,0,0,1,0,0,1,"H","N","2012-04-20","201204200NSH"
"PHI",0,2,0,0,0,2,0,1,2,0,0,3,"A","N","2012-04-20","201204200PIT"
"PIT",0,1,2,0,0,3,0,2,0,0,0,2,"H","N","2012-04-20","201204200PIT"
"BOS",0,0,2,1,0,3,0,0,2,2,0,4,"H","N","2012-04-21","201204210BOS"
"WSH",0,0,2,2,0,4,0,0,2,1,0,3,"A","N","2012-04-21","201204210BOS"
"FLA",0,0,1,2,0,3,0,0,0,0,0,0,"H","N","2012-04-21","201204210FLA"
"NJD",0,0,0,0,0,0,0,0,1,2,0,3,"A","N","2012-04-21","201204210FLA"
"NYR",0,0,0,0,0,0,0,1,0,1,0,2,"H","N","2012-04-21","201204210NYR"
"OTT",0,1,0,1,0,2,0,0,0,0,0,0,"A","N","2012-04-21","201204210NYR"
"CHI",1,0,0,1,0,2,0,0,1,0,0,1,"A","N","2012-04-21","201204210PHX"
"PHX",0,0,1,0,0,1,1,0,0,1,0,2,"H","N","2012-04-21","201204210PHX"
"SJS",0,0,1,0,0,1,0,0,0,3,0,3,"A","N","2012-04-21","201204210STL"
"STL",0,0,0,3,0,3,0,0,1,0,0,1,"H","N","2012-04-21","201204210STL"
"PHI",0,2,2,1,0,5,0,0,1,0,0,1,"H","N","2012-04-22","201204220PHI"
"PIT",0,0,1,0,0,1,0,2,2,1,0,5,"A","N","2012-04-22","201204220PHI"
"LAK",1,0,0,1,0,2,0,1,0,0,0,1,"A","N","2012-04-22","201204220VAN"
"VAN",0,1,0,0,0,1,1,0,0,1,0,2,"H","N","2012-04-22","201204220VAN"
"BOS",1,2,0,1,0,4,0,1,1,1,0,3,"A","N","2012-04-22","201204220WSH"
"WSH",0,1,1,1,0,3,1,2,0,1,0,4,"H","N","2012-04-22","201204220WSH"
"CHI",0,0,0,0,0,0,0,0,1,3,0,4,"H","N","2012-04-23","201204230CHI"
"PHX",0,0,1,3,0,4,0,0,0,0,0,0,"A","N","2012-04-23","201204230CHI"
"NYR",0,0,3,0,0,3,0,1,0,1,0,2,"A","N","2012-04-23","201204230OTT"
"OTT",0,1,0,1,0,2,0,0,3,0,0,3,"H","N","2012-04-23","201204230OTT"
"FLA",0,0,2,0,0,2,1,1,1,0,0,3,"A","N","2012-04-24","201204240NJD"
"NJD",1,1,1,0,0,3,0,0,2,0,0,2,"H","N","2012-04-24","201204240NJD"
"BOS",0,0,1,0,0,1,1,1,0,0,0,2,"H","N","2012-04-25","201204250BOS"
"WSH",1,1,0,0,0,2,0,0,1,0,0,1,"A","N","2012-04-25","201204250BOS"
"FLA",0,0,0,2,0,2,1,1,1,0,0,3,"H","N","2012-04-26","201204260FLA"
"NJD",1,1,1,0,0,3,0,0,0,2,0,2,"A","N","2012-04-26","201204260FLA"
"NYR",0,0,2,0,0,2,0,0,1,0,0,1,"H","N","2012-04-26","201204260NYR"
"OTT",0,0,1,0,0,1,0,0,2,0,0,2,"A","N","2012-04-26","201204260NYR"
"NSH",0,1,1,1,0,3,1,1,2,0,0,4,"A","N","2012-04-27","201204270PHX"
"PHX",1,1,2,0,0,4,0,1,1,1,0,3,"H","N","2012-04-27","201204270PHX"
"NYR",0,0,1,2,0,3,0,0,1,0,0,1,"H","N","2012-04-28","201204280NYR"
"WSH",0,0,1,0,0,1,0,0,1,2,0,3,"A","N","2012-04-28","201204280NYR"
"LAK",0,1,1,1,0,3,0,1,0,0,0,1,"A","N","2012-04-28","201204280STL"
"STL",0,1,0,0,0,1,0,1,1,1,0,3,"H","N","2012-04-28","201204280STL"
"NJD",0,1,1,1,0,3,1,0,2,1,0,4,"A","N","2012-04-29","201204290PHI"
"PHI",1,0,2,1,0,4,0,1,1,1,0,3,"H","N","2012-04-29","201204290PHI"
"NSH",0,1,1,1,0,3,0,1,3,1,0,5,"A","N","2012-04-29","201204290PHX"
"PHX",0,1,3,1,0,5,0,1,1,1,0,3,"H","N","2012-04-29","201204290PHX"
"NYR",0,1,0,1,0,2,0,2,0,1,0,3,"H","N","2012-04-30","201204300NYR"
"WSH",0,2,0,1,0,3,0,1,0,1,0,2,"A","N","2012-04-30","201204300NYR"
"LAK",0,4,1,0,0,5,0,0,1,1,0,2,"A","N","2012-04-30","201204300STL"
"STL",0,0,1,1,0,2,0,4,1,0,0,5,"H","N","2012-04-30","201204300STL"
"NJD",0,0,0,4,0,4,0,1,0,0,0,1,"A","N","2012-05-01","201205010PHI"
"PHI",0,1,0,0,0,1,0,0,0,4,0,4,"H","N","2012-05-01","201205010PHI"
"NSH",0,2,0,0,0,2,0,0,0,0,0,0,"H","N","2012-05-02","201205020NSH"
"PHX",0,0,0,0,0,0,0,2,0,0,0,2,"A","N","2012-05-02","201205020NSH"
"NYR",1,0,1,0,0,2,0,0,1,0,0,1,"A","N","2012-05-02","201205020WSH"
"WSH",0,0,1,0,0,1,1,0,1,0,0,2,"H","N","2012-05-02","201205020WSH"
"LAK",0,1,2,1,0,4,0,0,1,1,0,2,"H","N","2012-05-03","201205030LAK"
"STL",0,0,1,1,0,2,0,1,2,1,0,4,"A","N","2012-05-03","201205030LAK"
"NJD",1,2,0,1,0,4,0,1,1,1,0,3,"H","N","2012-05-03","201205030NJD"
"PHI",0,1,1,1,0,3,1,2,0,1,0,4,"A","N","2012-05-03","201205030NJD"
"NSH",0,0,0,0,0,0,0,1,0,0,0,1,"H","N","2012-05-04","201205040NSH"
"PHX",0,1,0,0,0,1,0,0,0,0,0,0,"A","N","2012-05-04","201205040NSH"
"NYR",0,0,2,0,0,2,0,1,1,1,0,3,"A","N","2012-05-05","201205050WSH"
"WSH",0,1,1,1,0,3,0,0,2,0,0,2,"H","N","2012-05-05","201205050WSH"
"LAK",0,2,0,1,0,3,0,1,0,0,0,1,"H","N","2012-05-06","201205060LAK"
"STL",0,1,0,0,0,1,0,2,0,1,0,3,"A","N","2012-05-06","201205060LAK"
"NJD",0,2,1,1,0,4,0,2,0,0,0,2,"H","N","2012-05-06","201205060NJD"
"PHI",0,2,0,0,0,2,0,2,1,1,0,4,"A","N","2012-05-06","201205060NJD"
"NYR",1,1,0,1,0,3,0,0,1,1,0,2,"H","N","2012-05-07","201205070NYR"
"WSH",0,0,1,1,0,2,1,1,0,1,0,3,"A","N","2012-05-07","201205070NYR"
"NSH",0,0,0,1,0,1,0,0,2,0,0,2,"A","N","2012-05-07","201205070PHX"
"PHX",0,0,2,0,0,2,0,0,0,1,0,1,"H","N","2012-05-07","201205070PHX"
"NJD",0,2,0,1,0,3,0,1,0,0,0,1,"A","N","2012-05-08","201205080PHI"
"PHI",0,1,0,0,0,1,0,2,0,1,0,3,"H","N","2012-05-08","201205080PHI"
"NYR",0,0,0,1,0,1,0,1,1,0,0,2,"A","N","2012-05-09","201205090WSH"
"WSH",0,1,1,0,0,2,0,0,0,1,0,1,"H","N","2012-05-09","201205090WSH"
"NYR",0,1,0,1,0,2,0,0,0,1,0,1,"H","N","2012-05-12","201205120NYR"
"WSH",0,0,0,1,0,1,0,1,0,1,0,2,"A","N","2012-05-12","201205120NYR"
"LAK",0,1,1,2,0,4,0,1,1,0,0,2,"A","N","2012-05-13","201205130PHX"
"PHX",0,1,1,0,0,2,0,1,1,2,0,4,"H","N","2012-05-13","201205130PHX"
"NJD",0,0,0,0,0,0,0,0,0,3,0,3,"A","N","2012-05-14","201205140NYR"
"NYR",0,0,0,3,0,3,0,0,0,0,0,0,"H","N","2012-05-14","201205140NYR"
"LAK",0,1,2,1,0,4,0,0,0,0,0,0,"A","N","2012-05-15","201205150PHX"
"PHX",0,0,0,0,0,0,0,1,2,1,0,4,"H","N","2012-05-15","201205150PHX"
"NJD",0,1,1,1,0,3,0,0,2,0,0,2,"A","N","2012-05-16","201205160NYR"
"NYR",0,0,2,0,0,2,0,1,1,1,0,3,"H","N","2012-05-16","201205160NYR"
"LAK",0,0,1,1,0,2,0,0,1,0,0,1,"H","N","2012-05-17","201205170LAK"
"PHX",0,0,1,0,0,1,0,0,1,1,0,2,"A","N","2012-05-17","201205170LAK"
"NJD",0,0,0,0,0,0,0,0,0,3,0,3,"H","N","2012-05-19","201205190NJD"
"NYR",0,0,0,3,0,3,0,0,0,0,0,0,"A","N","2012-05-19","201205190NJD"
"LAK",0,0,0,0,0,0,0,1,1,0,0,2,"H","N","2012-05-20","201205200LAK"
"PHX",0,1,1,0,0,2,0,0,0,0,0,0,"A","N","2012-05-20","201205200LAK"
"NJD",0,2,0,2,0,4,0,0,0,1,0,1,"H","N","2012-05-21","201205210NJD"
"NYR",0,0,0,1,0,1,0,2,0,2,0,4,"A","N","2012-05-21","201205210NJD"
"LAK",1,1,2,0,0,4,0,1,2,0,0,3,"A","N","2012-05-22","201205220PHX"
"PHX",0,1,2,0,0,3,1,1,2,0,0,4,"H","N","2012-05-22","201205220PHX"
"NJD",0,3,0,2,0,5,0,1,1,1,0,3,"A","N","2012-05-23","201205230NYR"
"NYR",0,1,1,1,0,3,0,3,0,2,0,5,"H","N","2012-05-23","201205230NYR"
"NJD",1,2,0,0,0,3,0,0,2,0,0,2,"H","N","2012-05-25","201205250NJD"
"NYR",0,0,2,0,0,2,1,2,0,0,0,3,"A","N","2012-05-25","201205250NJD"
"LAK",1,1,0,0,0,2,0,0,1,0,0,1,"A","N","2012-05-30","201205300NJD"
"NJD",0,0,1,0,0,1,1,1,0,0,0,2,"H","N","2012-05-30","201205300NJD"
"LAK",1,1,0,0,0,2,0,0,0,1,0,1,"A","N","2012-06-02","201206020NJD"
"NJD",0,0,0,1,0,1,1,1,0,0,0,2,"H","N","2012-06-02","201206020NJD"
"LAK",0,0,2,2,0,4,0,0,0,0,0,0,"H","N","2012-06-04","201206040LAK"
"NJD",0,0,0,0,0,0,0,0,2,2,0,4,"A","N","2012-06-04","201206040LAK"
"LAK",0,0,0,1,0,1,0,0,0,3,0,3,"H","N","2012-06-06","201206060LAK"
"NJD",0,0,0,3,0,3,0,0,0,1,0,1,"A","N","2012-06-06","201206060LAK"
"LAK",0,0,1,0,0,1,0,1,1,0,0,2,"A","N","2012-06-09","201206090NJD"
"NJD",0,1,1,0,0,2,0,0,1,0,0,1,"H","N","2012-06-09","201206090NJD"
"LAK",0,3,1,2,0,6,0,0,1,0,0,1,"H","N","2012-06-11","201206110LAK"
"NJD",0,0,1,0,0,1,0,3,1,2,0,6,"A","N","2012-06-11","201206110LAK"
"BOS",0,1,1,1,0,3,0,0,1,0,0,1,"H","N","2013-01-19","201301190BOS"
"NYR",0,0,1,0,0,1,0,1,1,1,0,3,"A","N","2013-01-19","201301190BOS"
"DAL",0,1,1,2,0,4,0,0,2,1,0,3,"H","N","2013-01-19","201301190DAL"
"PHX",0,0,2,1,0,3,0,1,1,2,0,4,"A","N","2013-01-19","201301190DAL"
"CAR",0,0,1,0,0,1,0,4,1,0,0,5,"A","N","2013-01-19","201301190FLA"
"FLA",0,4,1,0,0,5,0,0,1,0,0,1,"H","N","2013-01-19","201301190FLA"
"CHI",0,3,1,1,0,5,0,0,1,1,0,2,"A","N","2013-01-19","201301190LAK"
"LAK",0,0,1,1,0,2,0,3,1,1,0,5,"H","N","2013-01-19","201301190LAK"
"COL",0,1,0,1,0,2,0,0,3,1,0,4,"A","N","2013-01-19","201301190MIN"
"MIN",0,0,3,1,0,4,0,1,0,1,0,2,"H","N","2013-01-19","201301190MIN"
"MTL",0,0,0,1,0,1,0,1,1,0,0,2,"H","N","2013-01-19","201301190MTL"
"TOR",0,1,1,0,0,2,0,0,0,1,0,1,"A","N","2013-01-19","201301190MTL"
"CBJ",0,1,1,0,1,3,0,2,0,0,0,2,"A","Y","2013-01-19","201301190NSH"
"NSH",0,2,0,0,0,2,0,1,1,0,1,3,"H","Y","2013-01-19","201301190NSH"
"NJD",0,0,1,1,0,2,0,0,0,1,0,1,"A","N","2013-01-19","201301190NYI"
"NYI",0,0,0,1,0,1,0,0,1,1,0,2,"H","N","2013-01-19","201301190NYI"
"PHI",0,0,1,0,0,1,0,2,0,1,0,3,"H","N","2013-01-19","201301190PHI"
"PIT",0,2,0,1,0,3,0,0,1,0,0,1,"A","N","2013-01-19","201301190PHI"
"DET",0,0,0,0,0,0,0,2,2,2,0,6,"A","N","2013-01-19","201301190STL"
"STL",0,2,2,2,0,6,0,0,0,0,0,0,"H","N","2013-01-19","201301190STL"
"TBL",0,2,1,3,0,6,0,1,2,0,0,3,"H","N","2013-01-19","201301190TBL"
"WSH",0,1,2,0,0,3,0,2,1,3,0,6,"A","N","2013-01-19","201301190TBL"
"ANA",0,2,4,1,0,7,0,2,0,1,0,3,"A","N","2013-01-19","201301190VAN"
"VAN",0,2,0,1,0,3,0,2,4,1,0,7,"H","N","2013-01-19","201301190VAN"
"OTT",0,1,1,2,0,4,0,1,0,0,0,1,"A","N","2013-01-19","201301190WPG"
"WPG",0,1,0,0,0,1,0,1,1,2,0,4,"H","N","2013-01-19","201301190WPG"
"BUF",0,1,1,3,0,5,0,0,2,0,0,2,"H","N","2013-01-20","201301200BUF"
"PHI",0,0,2,0,0,2,0,1,1,3,0,5,"A","N","2013-01-20","201301200BUF"
"CGY",0,1,0,0,0,1,0,0,3,1,0,4,"H","N","2013-01-20","201301200CGY"
"SJS",0,0,3,1,0,4,0,1,0,0,0,1,"A","N","2013-01-20","201301200CGY"
"DAL",0,0,0,0,0,0,0,1,0,0,0,1,"A","N","2013-01-20","201301200MIN"
"MIN",0,1,0,0,0,1,0,0,0,0,0,0,"H","N","2013-01-20","201301200MIN"
"NYR",0,1,0,2,0,3,0,3,1,2,0,6,"H","N","2013-01-20","201301200NYR"
"PIT",0,3,1,2,0,6,0,1,0,2,0,3,"A","N","2013-01-20","201301200NYR"
"CHI",0,1,3,2,0,6,0,1,1,2,0,4,"A","N","2013-01-20","201301200PHX"
"PHX",0,1,1,2,0,4,0,1,3,2,0,6,"H","N","2013-01-20","201301200PHX"
"EDM",0,0,1,1,1,3,0,1,1,0,0,2,"A","Y","2013-01-20","201301200VAN"
"VAN",0,1,1,0,0,2,0,0,1,1,1,3,"H","Y","2013-01-20","201301200VAN"
"BOS",0,1,0,0,1,2,0,1,0,0,0,1,"H","Y","2013-01-21","201301210BOS"
"WPG",0,1,0,0,0,1,0,1,0,0,1,2,"A","Y","2013-01-21","201301210BOS"
"CBJ",0,0,1,2,0,3,0,0,2,1,1,4,"H","Y","2013-01-21","201301210CBJ"
"DET",0,0,2,1,1,4,0,0,1,2,0,3,"A","Y","2013-01-21","201301210CBJ"
"ANA",0,3,0,2,0,5,0,2,1,1,0,4,"A","N","2013-01-21","201301210CGY"
"CGY",0,2,1,1,0,4,0,3,0,2,0,5,"H","N","2013-01-21","201301210CGY"
"NSH",0,2,1,0,0,3,0,2,0,1,1,4,"H","Y","2013-01-21","201301210NSH"
"STL",0,2,0,1,1,4,0,2,1,0,0,3,"A","Y","2013-01-21","201301210NSH"
"NYI",0,0,3,1,0,4,0,0,0,3,0,3,"H","N","2013-01-21","201301210NYI"
"TBL",0,0,0,3,0,3,0,0,3,1,0,4,"A","N","2013-01-21","201301210NYI"
"FLA",0,0,0,0,0,0,0,1,1,2,0,4,"A","N","2013-01-21","201301210OTT"
"OTT",0,1,1,2,0,4,0,0,0,0,0,0,"H","N","2013-01-21","201301210OTT"
"BUF",0,1,1,0,0,2,0,0,0,1,0,1,"A","N","2013-01-21","201301210TOR"
"TOR",0,0,0,1,0,1,0,1,1,0,0,2,"H","N","2013-01-21","201301210TOR"
"CAR",0,0,1,0,0,1,0,2,0,2,0,4,"H","N","2013-01-22","201301220CAR"
"TBL",0,2,0,2,0,4,0,0,1,0,0,1,"A","N","2013-01-22","201301220CAR"
"CHI",0,1,1,1,0,3,0,0,0,2,0,2,"H","N","2013-01-22","201301220CHI"
"STL",0,0,0,2,0,2,0,1,1,1,0,3,"A","N","2013-01-22","201301220CHI"
"COL",0,0,0,3,0,3,0,1,0,0,0,1,"H","N","2013-01-22","201301220COL"
"LAK",0,1,0,0,0,1,0,0,0,3,0,3,"A","N","2013-01-22","201301220COL"
"DAL",0,1,0,1,0,2,0,0,0,1,0,1,"A","N","2013-01-22","201301220DET"
"DET",0,0,0,1,0,1,0,1,0,1,0,2,"H","N","2013-01-22","201301220DET"
"EDM",0,1,1,1,0,3,0,6,0,0,0,6,"H","N","2013-01-22","201301220EDM"
"SJS",0,6,0,0,0,6,0,1,1,1,0,3,"A","N","2013-01-22","201301220EDM"
"MIN",0,1,0,0,0,1,0,1,0,2,0,3,"H","N","2013-01-22","201301220MIN"
"NSH",0,1,0,2,0,3,0,1,0,0,0,1,"A","N","2013-01-22","201301220MIN"
"FLA",0,0,1,0,0,1,0,2,2,0,0,4,"A","N","2013-01-22","201301220MTL"
"MTL",0,2,2,0,0,4,0,0,1,0,0,1,"H","N","2013-01-22","201301220MTL"
"NJD",0,2,1,0,0,3,0,0,0,0,0,0,"H","N","2013-01-22","201301220NJD"
"PHI",0,0,0,0,0,0,0,2,1,0,0,3,"A","N","2013-01-22","201301220NJD"
"WPG",0,2,2,0,0,4,0,1,0,1,0,2,"A","N","2013-01-22","201301220WSH"
"WSH",0,1,0,1,0,2,0,2,2,0,0,4,"H","N","2013-01-22","201301220WSH"
"BOS",0,0,2,1,0,3,1,2,1,0,0,4,"A","N","2013-01-23","201301230NYR"
"NYR",1,2,1,0,0,4,0,0,2,1,0,3,"H","N","2013-01-23","201301230NYR"
"CBJ",0,0,1,0,0,1,0,0,2,3,0,5,"A","N","2013-01-23","201301230PHX"
"PHX",0,0,2,3,0,5,0,0,1,0,0,1,"H","N","2013-01-23","201301230PHX"
"PIT",0,1,1,0,0,2,0,0,3,2,0,5,"H","N","2013-01-23","201301230PIT"
"TOR",0,0,3,2,0,5,0,1,1,0,0,2,"A","N","2013-01-23","201301230PIT"
"CGY",0,0,2,0,0,2,0,0,2,0,1,3,"A","Y","2013-01-23","201301230VAN"
"VAN",0,0,2,0,1,3,0,0,2,0,0,2,"H","Y","2013-01-23","201301230VAN"
"BUF",0,0,2,1,0,3,0,0,4,2,0,6,"A","N","2013-01-24","201301240CAR"
"CAR",0,0,4,2,0,6,0,0,2,1,0,3,"H","N","2013-01-24","201301240CAR"
"CBJ",0,0,0,0,0,0,0,2,0,2,0,4,"A","N","2013-01-24","201301240COL"
"COL",0,2,0,2,0,4,0,0,0,0,0,0,"H","N","2013-01-24","201301240COL"
"CHI",1,0,1,1,0,3,0,1,1,0,0,2,"A","N","2013-01-24","201301240DAL"
"DAL",0,1,1,0,0,2,1,0,1,1,0,3,"H","N","2013-01-24","201301240DAL"
"EDM",1,0,0,1,0,2,0,0,1,0,0,1,"H","N","2013-01-24","201301240EDM"
"LAK",0,0,1,0,0,1,1,0,0,1,0,2,"A","N","2013-01-24","201301240EDM"
"FLA",0,1,0,0,0,1,0,1,1,1,0,3,"H","N","2013-01-24","201301240FLA"
"OTT",0,1,1,1,0,3,0,1,0,0,0,1,"A","N","2013-01-24","201301240FLA"
"NYR",0,0,0,1,0,1,0,0,2,0,0,2,"A","N","2013-01-24","201301240PHI"
"PHI",0,0,2,0,0,2,0,0,0,1,0,1,"H","N","2013-01-24","201301240PHI"
"PHX",0,0,1,2,0,3,0,1,0,4,0,5,"A","N","2013-01-24","201301240SJS"
"SJS",0,1,0,4,0,5,0,0,1,2,0,3,"H","N","2013-01-24","201301240SJS"
"NSH",0,0,0,0,0,0,0,1,1,1,0,3,"A","N","2013-01-24","201301240STL"
"STL",0,1,1,1,0,3,0,0,0,0,0,0,"H","N","2013-01-24","201301240STL"
"NYI",0,1,2,4,0,7,0,3,0,1,0,4,"A","N","2013-01-24","201301240TOR"
"TOR",0,3,0,1,0,4,0,1,2,4,0,7,"H","N","2013-01-24","201301240TOR"
"MTL",0,0,4,0,0,4,0,0,0,1,0,1,"A","N","2013-01-24","201301240WSH"
"WSH",0,0,0,1,0,1,0,0,4,0,0,4,"H","N","2013-01-24","201301240WSH"
"ANA",0,0,0,0,0,0,0,2,1,2,0,5,"H","N","2013-01-25","201301250ANA"
"VAN",0,2,1,2,0,5,0,0,0,0,0,0,"A","N","2013-01-25","201301250ANA"
"BOS",0,1,1,2,0,4,0,1,1,0,0,2,"H","N","2013-01-25","201301250BOS"
"NYI",0,1,1,0,0,2,0,1,1,2,0,4,"A","N","2013-01-25","201301250BOS"
"BUF",0,0,0,1,0,1,0,0,0,3,0,3,"H","N","2013-01-25","201301250BUF"
"CAR",0,0,0,3,0,3,0,0,0,1,0,1,"A","N","2013-01-25","201301250BUF"
"DET",0,0,4,1,0,5,0,0,2,1,0,3,"H","N","2013-01-25","201301250DET"
"MIN",0,0,2,1,0,3,0,0,4,1,0,5,"A","N","2013-01-25","201301250DET"
"NJD",1,1,1,0,0,3,0,0,0,2,0,2,"H","N","2013-01-25","201301250NJD"
"WSH",0,0,0,2,0,2,1,1,1,0,0,3,"A","N","2013-01-25","201301250NJD"
"OTT",0,0,4,0,0,4,0,1,2,3,0,6,"A","N","2013-01-25","201301250TBL"
"TBL",0,1,2,3,0,6,0,0,4,0,0,4,"H","N","2013-01-25","201301250TBL"
"PIT",0,2,0,0,0,2,0,0,3,1,0,4,"A","N","2013-01-25","201301250WPG"
"WPG",0,0,3,1,0,4,0,2,0,0,0,2,"H","N","2013-01-25","201301250WPG"
"ANA",0,0,1,1,1,3,0,1,0,1,0,2,"H","Y","2013-01-26","201301260ANA"
"NSH",0,1,0,1,0,2,0,0,1,1,1,3,"A","Y","2013-01-26","201301260ANA"
"CBJ",0,1,0,1,0,2,0,1,1,1,0,3,"H","N","2013-01-26","201301260CBJ"
"CHI",0,1,1,1,0,3,0,1,0,1,0,2,"A","N","2013-01-26","201301260CBJ"
"CGY",0,2,2,0,0,4,0,1,1,1,0,3,"H","N","2013-01-26","201301260CGY"
"EDM",0,1,1,1,0,3,0,2,2,0,0,4,"A","N","2013-01-26","201301260CGY"
"DAL",0,2,0,1,0,3,0,1,3,0,0,4,"H","N","2013-01-26","201301260DAL"
"STL",0,1,3,0,0,4,0,2,0,1,0,3,"A","N","2013-01-26","201301260DAL"
"FLA",0,0,1,0,0,1,0,3,2,2,0,7,"H","N","2013-01-26","201301260FLA"
"PHI",0,3,2,2,0,7,0,0,1,0,0,1,"A","N","2013-01-26","201301260FLA"
"NYR",0,0,1,4,0,5,0,2,0,0,0,2,"H","N","2013-01-26","201301260NYR"
"TOR",0,2,0,0,0,2,0,0,1,4,0,5,"A","N","2013-01-26","201301260NYR"
"LAK",0,0,3,1,0,4,0,0,1,1,0,2,"A","N","2013-01-26","201301260PHX"
"PHX",0,0,1,1,0,2,0,0,3,1,0,4,"H","N","2013-01-26","201301260PHX"
"COL",0,0,0,0,0,0,0,2,2,0,0,4,"A","N","2013-01-26","201301260SJS"
"SJS",0,2,2,0,0,4,0,0,0,0,0,0,"H","N","2013-01-26","201301260SJS"
"CHI",1,1,0,0,0,2,0,0,0,1,0,1,"H","N","2013-01-27","201301270CHI"
"DET",0,0,0,1,0,1,1,1,0,0,0,2,"A","N","2013-01-27","201301270CHI"
"MTL",1,2,0,1,0,4,0,0,1,2,0,3,"H","N","2013-01-27","201301270MTL"
"NJD",0,0,1,2,0,3,1,2,0,1,0,4,"A","N","2013-01-27","201301270MTL"
"OTT",0,0,1,0,0,1,0,1,0,0,1,2,"H","Y","2013-01-27","201301270OTT"
"PIT",0,1,0,0,1,2,0,0,1,0,0,1,"A","Y","2013-01-27","201301270OTT"
"SJS",0,2,1,1,0,4,0,0,1,0,0,1,"H","N","2013-01-27","201301270SJS"
"VAN",0,0,1,0,0,1,0,2,1,1,0,4,"A","N","2013-01-27","201301270SJS"
"MIN",0,0,3,1,0,4,1,1,1,2,0,5,"A","N","2013-01-27","201301270STL"
"STL",1,1,1,2,0,5,0,0,3,1,0,4,"H","N","2013-01-27","201301270STL"
"PHI",0,1,0,0,0,1,0,3,0,2,0,5,"A","N","2013-01-27","201301270TBL"
"TBL",0,3,0,2,0,5,0,1,0,0,0,1,"H","N","2013-01-27","201301270TBL"
"NYI",0,1,0,3,0,4,1,1,1,2,0,5,"A","N","2013-01-27","201301270WPG"
"WPG",1,1,1,2,0,5,0,1,0,3,0,4,"H","N","2013-01-27","201301270WPG"
"BUF",0,1,0,1,0,2,0,1,1,1,0,3,"A","N","2013-01-27","201301270WSH"
"WSH",0,1,1,1,0,3,0,1,0,1,0,2,"H","N","2013-01-27","201301270WSH"
"BOS",0,2,1,2,0,5,0,1,2,0,0,3,"A","N","2013-01-28","201301280CAR"
"CAR",0,1,2,0,0,3,0,2,1,2,0,5,"H","N","2013-01-28","201301280CAR"
"CBJ",0,0,1,1,0,2,0,0,1,0,0,1,"H","N","2013-01-28","201301280CBJ"
"DAL",0,0,1,0,0,1,0,0,1,1,0,2,"A","N","2013-01-28","201301280CBJ"
"COL",0,0,0,1,0,1,0,2,1,1,0,4,"A","N","2013-01-28","201301280EDM"
"EDM",0,2,1,1,0,4,0,0,0,1,0,1,"H","N","2013-01-28","201301280EDM"
"LAK",0,0,1,1,1,3,0,1,1,0,0,2,"H","Y","2013-01-28","201301280LAK"
"VAN",0,1,1,0,0,2,0,0,1,1,1,3,"A","Y","2013-01-28","201301280LAK"
"NSH",0,0,0,0,0,0,0,1,1,2,0,4,"A","N","2013-01-28","201301280PHX"
"PHX",0,1,1,2,0,4,0,0,0,0,0,0,"H","N","2013-01-28","201301280PHX"
"BOS",0,0,0,1,1,2,0,0,1,0,0,1,"H","Y","2013-01-29","201301290BOS"
"NJD",0,0,1,0,0,1,0,0,0,1,1,2,"A","Y","2013-01-29","201301290BOS"
"BUF",0,1,1,1,0,3,1,1,2,0,0,4,"H","N","2013-01-29","201301290BUF"
"TOR",1,1,2,0,0,4,0,1,1,1,0,3,"A","N","2013-01-29","201301290BUF"
"DAL",0,0,1,0,0,1,0,0,2,2,0,4,"A","N","2013-01-29","201301290DET"
"DET",0,0,2,2,0,4,0,0,1,0,0,1,"H","N","2013-01-29","201301290DET"
"CBJ",0,0,1,1,0,2,0,2,0,1,0,3,"A","N","2013-01-29","201301290MIN"
"MIN",0,2,0,1,0,3,0,0,1,1,0,2,"H","N","2013-01-29","201301290MIN"
"MTL",0,2,1,1,0,4,0,1,2,0,0,3,"H","N","2013-01-29","201301290MTL"
"WPG",0,1,2,0,0,3,0,2,1,1,0,4,"A","N","2013-01-29","201301290MTL"
"NYR",0,1,1,0,0,2,0,0,0,1,0,1,"H","N","2013-01-29","201301290NYR"
"PHI",0,0,0,1,0,1,0,1,1,0,0,2,"A","N","2013-01-29","201301290NYR"
"OTT",0,0,1,2,0,3,0,2,0,0,0,2,"H","N","2013-01-29","201301290OTT"
"WSH",0,2,0,0,0,2,0,0,1,2,0,3,"A","N","2013-01-29","201301290OTT"
"NYI",0,1,3,0,0,4,0,0,0,1,0,1,"A","N","2013-01-29","201301290PIT"
"PIT",0,0,0,1,0,1,0,1,3,0,0,4,"H","N","2013-01-29","201301290PIT"
"ANA",0,0,2,0,0,2,0,1,0,1,1,3,"A","Y","2013-01-29","201301290SJS"
"SJS",0,1,0,1,1,3,0,0,2,0,0,2,"H","Y","2013-01-29","201301290SJS"
"FLA",0,1,0,1,0,2,0,2,2,1,0,5,"A","N","2013-01-29","201301290TBL"
"TBL",0,2,2,1,0,5,0,1,0,1,0,2,"H","N","2013-01-29","201301290TBL"
"CHI",0,2,0,0,0,2,0,1,1,0,1,3,"A","Y","2013-01-30","201301300MIN"
"MIN",0,1,1,0,1,3,0,2,0,0,0,2,"H","Y","2013-01-30","201301300MIN"
"MTL",0,1,0,0,0,1,0,1,3,1,0,5,"A","N","2013-01-30","201301300OTT"
"OTT",0,1,3,1,0,5,0,1,0,0,0,1,"H","N","2013-01-30","201301300OTT"
"EDM",1,1,0,0,0,2,0,0,0,1,0,1,"A","N","2013-01-30","201301300PHX"
"PHX",0,0,0,1,0,1,1,1,0,0,0,2,"H","N","2013-01-30","201301300PHX"
"COL",0,0,0,0,0,0,0,1,1,1,0,3,"A","N","2013-01-30","201301300VAN"
"VAN",0,1,1,1,0,3,0,0,0,0,0,0,"H","N","2013-01-30","201301300VAN"
"BOS",0,0,3,1,0,4,0,0,3,4,0,7,"H","N","2013-01-31","201301310BOS"
"BUF",0,0,3,4,0,7,0,0,3,1,0,4,"A","N","2013-01-31","201301310BOS"
"CBJ",0,0,1,0,0,1,0,3,0,1,0,4,"H","N","2013-01-31","201301310CBJ"
"STL",0,3,0,1,0,4,0,0,1,0,0,1,"A","N","2013-01-31","201301310CBJ"
"CGY",0,1,2,0,0,3,0,1,2,3,0,6,"H","N","2013-01-31","201301310CGY"
"COL",0,1,2,3,0,6,0,1,2,0,0,3,"A","N","2013-01-31","201301310CGY"
"FLA",0,0,1,5,0,6,0,0,1,2,0,3,"H","N","2013-01-31","201301310FLA"
"WPG",0,0,1,2,0,3,0,0,1,5,0,6,"A","N","2013-01-31","201301310FLA"
"LAK",0,1,0,0,0,1,0,1,0,0,1,2,"H","Y","2013-01-31","201301310LAK"
"NSH",0,1,0,0,1,2,0,1,0,0,0,1,"A","Y","2013-01-31","201301310LAK"
"NJD",0,0,3,1,0,4,1,1,2,1,0,5,"H","N","2013-01-31","201301310NJD"
"NYI",1,1,2,1,0,5,0,0,3,1,0,4,"A","N","2013-01-31","201301310NJD"
"NYR",0,0,0,0,0,0,0,1,0,2,0,3,"H","N","2013-01-31","201301310NYR"
"PIT",0,1,0,2,0,3,0,0,0,0,0,0,"A","N","2013-01-31","201301310NYR"
"EDM",0,0,1,1,0,2,0,0,2,0,1,3,"A","Y","2013-01-31","201301310SJS"
"SJS",0,0,2,0,1,3,0,0,1,1,0,2,"H","Y","2013-01-31","201301310SJS"
"TOR",0,1,0,2,0,3,0,1,1,0,0,2,"H","N","2013-01-31","201301310TOR"
"WSH",0,1,1,0,0,2,0,1,0,2,0,3,"A","N","2013-01-31","201301310TOR"
"ANA",0,0,1,2,0,3,0,1,0,0,0,1,"H","N","2013-02-01","201302010ANA"
"MIN",0,1,0,0,0,1,0,0,1,2,0,3,"A","N","2013-02-01","201302010ANA"
"CAR",0,1,0,0,0,1,0,0,0,0,0,0,"H","N","2013-02-01","201302010CAR"
"OTT",0,0,0,0,0,0,0,1,0,0,0,1,"A","N","2013-02-01","201302010CAR"
"DAL",0,2,1,0,1,4,0,1,2,0,0,3,"H","Y","2013-02-01","201302010DAL"
"PHX",0,1,2,0,0,3,0,2,1,0,1,4,"A","Y","2013-02-01","201302010DAL"
"DET",0,2,0,3,0,5,0,2,1,0,0,3,"H","N","2013-02-01","201302010DET"
"STL",0,2,1,0,0,3,0,2,0,3,0,5,"A","N","2013-02-01","201302010DET"
"TBL",0,3,3,2,0,8,0,0,0,3,0,3,"H","N","2013-02-01","201302010TBL"
"WPG",0,0,0,3,0,3,0,3,3,2,0,8,"A","N","2013-02-01","201302010TBL"
"CHI",0,0,0,1,0,1,0,1,0,0,1,2,"A","Y","2013-02-01","201302010VAN"
"VAN",0,1,0,0,1,2,0,0,0,1,0,1,"H","Y","2013-02-01","201302010VAN"
"PHI",0,0,1,1,0,2,0,0,1,2,0,3,"A","N","2013-02-01","201302010WSH"
"WSH",0,0,1,2,0,3,0,0,1,1,0,2,"H","N","2013-02-01","201302010WSH"
"ANA",0,3,2,2,0,7,0,2,2,0,0,4,"H","N","2013-02-02","201302020ANA"
"LAK",0,2,2,0,0,4,0,3,2,2,0,7,"A","N","2013-02-02","201302020ANA"
"CBJ",0,1,2,1,0,4,0,1,0,1,0,2,"H","N","2013-02-02","201302020CBJ"
"DET",0,1,0,1,0,2,0,1,2,1,0,4,"A","N","2013-02-02","201302020CBJ"
"CGY",0,0,0,2,0,2,0,0,0,2,1,3,"H","Y","2013-02-02","201302020CGY"
"CHI",0,0,0,2,1,3,0,0,0,2,0,2,"A","Y","2013-02-02","201302020CGY"
"COL",0,0,2,1,0,3,0,1,0,0,0,1,"H","N","2013-02-02","201302020COL"
"EDM",0,1,0,0,0,1,0,0,2,1,0,3,"A","N","2013-02-02","201302020COL"
"BUF",0,0,0,1,0,1,0,1,3,2,0,6,"A","N","2013-02-02","201302020MTL"
"MTL",0,1,3,2,0,6,0,0,0,1,0,1,"H","N","2013-02-02","201302020MTL"
"CAR",0,2,0,1,0,3,0,3,2,0,0,5,"A","N","2013-02-02","201302020PHI"
"PHI",0,3,2,0,0,5,0,2,0,1,0,3,"H","N","2013-02-02","201302020PHI"
"DAL",0,0,0,0,0,0,0,0,1,1,0,2,"A","N","2013-02-02","201302020PHX"
"PHX",0,0,1,1,0,2,0,0,0,0,0,0,"H","N","2013-02-02","201302020PHX"
"NJD",0,0,1,0,0,1,0,0,2,3,0,5,"A","N","2013-02-02","201302020PIT"
"PIT",0,0,2,3,0,5,0,0,1,0,0,1,"H","N","2013-02-02","201302020PIT"
"NSH",0,0,0,1,1,2,0,0,0,1,0,1,"A","Y","2013-02-02","201302020SJS"
"SJS",0,0,0,1,0,1,0,0,0,1,1,2,"H","Y","2013-02-02","201302020SJS"
"NYR",0,0,1,2,0,3,0,0,1,1,0,2,"A","N","2013-02-02","201302020TBL"
"TBL",0,0,1,1,0,2,0,0,1,2,0,3,"H","N","2013-02-02","201302020TBL"
"BOS",0,1,0,0,0,1,0,0,0,0,0,0,"A","N","2013-02-02","201302020TOR"
"TOR",0,0,0,0,0,0,0,1,0,0,0,1,"H","N","2013-02-02","201302020TOR"
"BUF",0,2,1,0,0,3,0,1,2,1,0,4,"H","N","2013-02-03","201302030BUF"
"FLA",0,1,2,1,0,4,0,2,1,0,0,3,"A","N","2013-02-03","201302030BUF"
"MTL",0,2,0,0,0,2,0,1,0,0,0,1,"H","N","2013-02-03","201302030MTL"
"OTT",0,1,0,0,0,1,0,2,0,0,0,2,"A","N","2013-02-03","201302030MTL"
"NJD",0,0,0,3,0,3,0,0,0,0,0,0,"A","N","2013-02-03","201302030NYI"
"NYI",0,0,0,0,0,0,0,0,0,3,0,3,"H","N","2013-02-03","201302030NYI"
"PIT",0,2,3,1,0,6,0,1,1,1,0,3,"A","N","2013-02-03","201302030WSH"
"WSH",0,1,1,1,0,3,0,2,3,1,0,6,"H","N","2013-02-03","201302030WSH"
"ANA",0,0,0,2,0,2,0,1,0,0,0,1,"H","N","2013-02-04","201302040ANA"
"SJS",0,1,0,0,0,1,0,0,0,2,0,2,"A","N","2013-02-04","201302040ANA"
"COL",0,1,1,0,0,2,0,2,1,0,0,3,"H","N","2013-02-04","201302040COL"
"DAL",0,2,1,0,0,3,0,1,1,0,0,2,"A","N","2013-02-04","201302040COL"
"EDM",0,1,1,0,0,2,1,0,1,1,0,3,"H","N","2013-02-04","201302040EDM"
"VAN",1,0,1,1,0,3,0,1,1,0,0,2,"A","N","2013-02-04","201302040EDM"
"MIN",0,0,1,0,0,1,0,1,1,0,0,2,"A","N","2013-02-04","201302040PHX"
"PHX",0,1,1,0,0,2,0,0,1,0,0,1,"H","N","2013-02-04","201302040PHX"
"CAR",0,0,2,2,0,4,0,1,0,0,0,1,"A","N","2013-02-04","201302040TOR"
"TOR",0,1,0,0,0,1,0,0,2,2,0,4,"H","N","2013-02-04","201302040TOR"
"CBJ",0,1,1,0,0,2,0,0,3,1,0,4,"H","N","2013-02-05","201302050CBJ"
"LAK",0,0,3,1,0,4,0,1,1,0,0,2,"A","N","2013-02-05","201302050CBJ"
"CGY",0,2,1,1,0,4,0,0,1,0,0,1,"A","N","2013-02-05","201302050DET"
"DET",0,0,1,0,0,1,0,2,1,1,0,4,"H","N","2013-02-05","201302050DET"
"NJD",0,2,0,1,0,3,0,0,0,1,0,1,"H","N","2013-02-05","201302050NJD"
"NYR",0,0,0,1,0,1,0,2,0,1,0,3,"A","N","2013-02-05","201302050NJD"
"NYI",0,0,0,2,0,2,0,1,1,2,0,4,"H","N","2013-02-05","201302050NYI"
"PIT",0,1,1,2,0,4,0,0,0,2,0,2,"A","N","2013-02-05","201302050NYI"
"BUF",0,1,1,1,0,3,0,3,1,0,0,4,"A","N","2013-02-05","201302050OTT"
"OTT",0,3,1,0,0,4,0,1,1,1,0,3,"H","N","2013-02-05","201302050OTT"
"PHI",0,0,1,1,0,2,0,0,0,1,0,1,"H","N","2013-02-05","201302050PHI"
"TBL",0,0,0,1,0,1,0,0,1,1,0,2,"A","N","2013-02-05","201302050PHI"
"CHI",0,3,1,1,0,5,0,3,0,0,0,3,"A","N","2013-02-05","201302050SJS"
"SJS",0,3,0,0,0,3,0,3,1,1,0,5,"H","N","2013-02-05","201302050SJS"
"NSH",0,3,2,1,0,6,0,0,1,0,0,1,"A","N","2013-02-05","201302050STL"
"STL",0,0,1,0,0,1,0,3,2,1,0,6,"H","N","2013-02-05","201302050STL"
"FLA",0,1,1,0,0,2,1,0,2,0,0,3,"A","N","2013-02-05","201302050WPG"
"WPG",1,0,2,0,0,3,0,1,1,0,0,2,"H","N","2013-02-05","201302050WPG"
"TOR",0,2,1,0,0,3,0,1,0,1,0,2,"A","N","2013-02-05","201302050WSH"
"WSH",0,1,0,1,0,2,0,2,1,0,0,3,"H","N","2013-02-05","201302050WSH"
"ANA",0,2,1,0,0,3,0,0,0,0,0,0,"A","N","2013-02-06","201302060COL"
"COL",0,0,0,0,0,0,0,2,1,0,0,3,"H","N","2013-02-06","201302060COL"
"DAL",1,0,2,0,0,3,0,0,1,1,0,2,"A","N","2013-02-06","201302060EDM"
"EDM",0,0,1,1,0,2,1,0,2,0,0,3,"H","N","2013-02-06","201302060EDM"
"BOS",0,0,0,2,0,2,0,0,1,0,0,1,"A","N","2013-02-06","201302060MTL"
"MTL",0,0,1,0,0,1,0,0,0,2,0,2,"H","N","2013-02-06","201302060MTL"
"BUF",0,1,1,2,1,5,0,1,2,1,0,4,"H","Y","2013-02-07","201302070BUF"
"MTL",0,1,2,1,0,4,0,1,1,2,1,5,"A","Y","2013-02-07","201302070BUF"
"CBJ",0,2,0,1,0,3,1,1,1,1,0,4,"H","N","2013-02-07","201302070CBJ"
"CGY",1,1,1,1,0,4,0,2,0,1,0,3,"A","N","2013-02-07","201302070CBJ"
"MIN",0,0,0,1,0,1,0,2,2,0,0,4,"H","N","2013-02-07","201302070MIN"
"VAN",0,2,2,0,0,4,0,0,0,1,0,1,"A","N","2013-02-07","201302070MIN"
"NJD",0,0,2,2,0,4,0,0,1,1,0,2,"H","N","2013-02-07","201302070NJD"
"TBL",0,0,1,1,0,2,0,0,2,2,0,4,"A","N","2013-02-07","201302070NJD"
"LAK",0,0,0,0,0,0,0,1,2,0,0,3,"A","N","2013-02-07","201302070NSH"
"NSH",0,1,2,0,0,3,0,0,0,0,0,0,"H","N","2013-02-07","201302070NSH"
"NYI",0,0,1,0,0,1,0,2,1,1,0,4,"A","N","2013-02-07","201302070NYR"
"NYR",0,2,1,1,0,4,0,0,1,0,0,1,"H","N","2013-02-07","201302070NYR"
"CAR",1,0,1,1,0,3,0,1,1,0,0,2,"A","N","2013-02-07","201302070OTT"
"OTT",0,1,1,0,0,2,1,0,1,1,0,3,"H","N","2013-02-07","201302070OTT"
"FLA",0,1,0,1,1,3,0,1,1,0,0,2,"A","Y","2013-02-07","201302070PHI"
"PHI",0,1,1,0,0,2,0,1,0,1,1,3,"H","Y","2013-02-07","201302070PHI"
"CHI",0,4,2,0,0,6,0,0,1,1,0,2,"A","N","2013-02-07","201302070PHX"
"PHX",0,0,1,1,0,2,0,4,2,0,0,6,"H","N","2013-02-07","201302070PHX"
"PIT",0,0,5,0,0,5,0,1,0,1,0,2,"H","N","2013-02-07","201302070PIT"
"WSH",0,1,0,1,0,2,0,0,5,0,0,5,"A","N","2013-02-07","201302070PIT"
"DET",0,2,2,1,0,5,0,0,1,0,0,1,"A","N","2013-02-07","201302070STL"
"STL",0,0,1,0,0,1,0,2,2,1,0,5,"H","N","2013-02-07","201302070STL"
"TOR",0,0,1,2,0,3,0,0,1,1,0,2,"A","N","2013-02-07","201302070WPG"
"WPG",0,0,1,1,0,2,0,0,1,2,0,3,"H","N","2013-02-07","201302070WPG"
"ANA",0,0,1,0,0,1,0,2,0,1,0,3,"A","N","2013-02-08","201302080DAL"
"DAL",0,2,0,1,0,3,0,0,1,0,0,1,"H","N","2013-02-08","201302080DAL"
"DET",0,0,1,1,0,2,0,0,1,0,0,1,"H","N","2013-02-09","201302090DET"
"EDM",0,0,1,0,0,1,0,0,1,1,0,2,"A","N","2013-02-09","201302090DET"
"MIN",1,0,1,0,0,2,0,1,0,0,0,1,"H","N","2013-02-09","201302090MIN"
"NSH",0,1,0,0,0,1,1,0,1,0,0,2,"A","N","2013-02-09","201302090MIN"
"MTL",0,0,0,0,0,0,0,2,2,2,0,6,"H","N","2013-02-09","201302090MTL"
"TOR",0,2,2,2,0,6,0,0,0,0,0,0,"A","N","2013-02-09","201302090MTL"
"NJD",0,0,1,2,0,3,0,1,0,0,0,1,"H","N","2013-02-09","201302090NJD"
"PIT",0,1,0,0,0,1,0,0,1,2,0,3,"A","N","2013-02-09","201302090NJD"
"BUF",0,1,1,1,0,3,0,1,1,0,0,2,"A","N","2013-02-09","201302090NYI"
"NYI",0,1,1,0,0,2,0,1,1,1,0,3,"H","N","2013-02-09","201302090NYI"
"OTT",0,0,0,0,0,0,0,0,0,1,0,1,"H","N","2013-02-09","201302090OTT"
"WPG",0,0,0,1,0,1,0,0,0,0,0,0,"A","N","2013-02-09","201302090OTT"
"CAR",0,1,1,1,0,3,1,1,2,0,0,4,"A","N","2013-02-09","201302090PHI"
"PHI",1,1,2,0,0,4,0,1,1,1,0,3,"H","N","2013-02-09","201302090PHI"
"PHX",0,0,0,0,1,1,0,0,0,0,0,0,"A","Y","2013-02-09","201302090SJS"
"SJS",0,0,0,0,0,0,0,0,0,0,1,1,"H","Y","2013-02-09","201302090SJS"
"ANA",0,1,3,1,1,6,0,3,0,2,0,5,"A","Y","2013-02-09","201302090STL"
"STL",0,3,0,2,0,5,0,1,3,1,1,6,"H","Y","2013-02-09","201302090STL"
"CGY",0,1,0,0,0,1,0,0,3,2,0,5,"A","N","2013-02-09","201302090VAN"
"VAN",0,0,3,2,0,5,0,1,0,0,0,1,"H","N","2013-02-09","201302090VAN"
"FLA",0,0,0,0,0,0,0,1,2,2,0,5,"A","N","2013-02-09","201302090WSH"
"WSH",0,1,2,2,0,5,0,0,0,0,0,0,"H","N","2013-02-09","201302090WSH"
"BOS",0,0,1,2,0,3,0,0,1,0,0,1,"A","N","2013-02-10","201302100BUF"
"BUF",0,0,1,0,0,1,0,0,1,2,0,3,"H","N","2013-02-10","201302100BUF"
"CBJ",0,0,0,1,0,1,0,1,0,2,0,3,"H","N","2013-02-10","201302100CBJ"
"EDM",0,1,0,2,0,3,0,0,0,1,0,1,"A","N","2013-02-10","201302100CBJ"
"DET",0,2,0,1,0,3,0,1,0,1,0,2,"H","N","2013-02-10","201302100DET"
"LAK",0,1,0,1,0,2,0,2,0,1,0,3,"A","N","2013-02-10","201302100DET"
"CHI",0,0,2,1,0,3,0,0,0,0,0,0,"A","N","2013-02-10","201302100NSH"
"NSH",0,0,0,0,0,0,0,0,2,1,0,3,"H","N","2013-02-10","201302100NSH"
"NYR",0,2,1,2,0,5,0,0,1,0,0,1,"H","N","2013-02-10","201302100NYR"
"TBL",0,0,1,0,0,1,0,2,1,2,0,5,"A","N","2013-02-10","201302100NYR"
"NJD",0,1,2,0,0,3,0,0,0,1,0,1,"A","N","2013-02-10","201302100PIT"
"PIT",0,0,0,1,0,1,0,1,2,0,0,3,"H","N","2013-02-10","201302100PIT"
"CBJ",0,1,2,3,0,6,0,0,1,1,0,2,"H","N","2013-02-11","201302110CBJ"
"SJS",0,0,1,1,0,2,0,1,2,3,0,6,"A","N","2013-02-11","201302110CBJ"
"CGY",0,0,0,1,0,1,0,0,1,0,1,2,"H","Y","2013-02-11","201302110CGY"
"MIN",0,0,1,0,1,2,0,0,0,1,0,1,"A","Y","2013-02-11","201302110CGY"
"COL",0,0,2,0,0,2,1,1,0,1,0,3,"H","N","2013-02-11","201302110COL"
"PHX",1,1,0,1,0,3,0,0,2,0,0,2,"A","N","2013-02-11","201302110COL"
"CAR",0,1,1,4,0,6,0,1,2,1,0,4,"A","N","2013-02-11","201302110NYI"
"NYI",0,1,2,1,0,4,0,1,1,4,0,6,"H","N","2013-02-11","201302110NYI"
"LAK",0,1,2,1,0,4,0,0,1,0,0,1,"A","N","2013-02-11","201302110STL"
"STL",0,0,1,0,0,1,0,1,2,1,0,4,"H","N","2013-02-11","201302110STL"
"PHI",0,1,0,1,0,2,0,1,3,1,0,5,"A","N","2013-02-11","201302110TOR"
"TOR",0,1,3,1,0,5,0,1,0,1,0,2,"H","N","2013-02-11","201302110TOR"
"BOS",0,0,0,3,0,3,0,1,1,1,1,4,"H","Y","2013-02-12","201302120BOS"
"NYR",0,1,1,1,1,4,0,0,0,3,0,3,"A","Y","2013-02-12","201302120BOS"
"ANA",0,0,1,1,1,3,0,0,2,0,0,2,"A","Y","2013-02-12","201302120CHI"
"CHI",0,0,2,0,0,2,0,0,1,1,1,3,"H","Y","2013-02-12","201302120CHI"
"DAL",0,0,1,3,0,4,0,1,0,0,0,1,"A","N","2013-02-12","201302120EDM"
"EDM",0,1,0,0,0,1,0,0,1,3,0,4,"H","N","2013-02-12","201302120EDM"
"FLA",0,2,2,1,0,5,1,1,2,2,0,6,"H","N","2013-02-12","201302120FLA"
"WSH",1,1,2,2,0,6,0,2,2,1,0,5,"A","N","2013-02-12","201302120FLA"
"CAR",0,0,2,2,0,4,0,1,0,1,0,2,"A","N","2013-02-12","201302120NJD"
"NJD",0,1,0,1,0,2,0,0,2,2,0,4,"H","N","2013-02-12","201302120NJD"
"NSH",1,0,0,0,0,1,0,0,0,0,0,0,"H","N","2013-02-12","201302120NSH"
"SJS",0,0,0,0,0,0,1,0,0,0,0,1,"A","N","2013-02-12","201302120NSH"
"BUF",0,0,0,0,0,0,0,0,2,0,0,2,"A","N","2013-02-12","201302120OTT"
"OTT",0,0,2,0,0,2,0,0,0,0,0,0,"H","N","2013-02-12","201302120OTT"
"MTL",0,1,2,0,1,4,0,0,0,3,0,3,"A","Y","2013-02-12","201302120TBL"
"TBL",0,0,0,3,0,3,0,1,2,0,1,4,"H","Y","2013-02-12","201302120TBL"
"MIN",0,0,1,0,0,1,0,1,1,0,0,2,"A","N","2013-02-12","201302120VAN"
"VAN",0,1,1,0,0,2,0,0,1,0,0,1,"H","N","2013-02-12","201302120VAN"
"PHI",0,2,0,1,0,3,0,1,0,1,0,2,"A","N","2013-02-12","201302120WPG"
"WPG",0,1,0,1,0,2,0,2,0,1,0,3,"H","N","2013-02-12","201302120WPG"
"CGY",0,4,2,1,0,7,0,1,2,1,0,4,"H","N","2013-02-13","201302130CGY"
"DAL",0,1,2,1,0,4,0,4,2,1,0,7,"A","N","2013-02-13","201302130CGY"
"DET",0,2,1,0,0,3,1,1,2,0,0,4,"H","N","2013-02-13","201302130DET"
"STL",1,1,2,0,0,4,0,2,1,0,0,3,"A","N","2013-02-13","201302130DET"
"OTT",0,0,2,0,0,2,0,1,1,2,0,4,"A","N","2013-02-13","201302130PIT"
"PIT",0,1,1,2,0,4,0,0,2,0,0,2,"H","N","2013-02-13","201302130PIT"
"CAR",0,0,3,0,0,3,0,0,1,0,0,1,"H","N","2013-02-14","201302140CAR"
"TOR",0,0,1,0,0,1,0,0,3,0,0,3,"A","N","2013-02-14","201302140CAR"
"FLA",0,0,0,0,0,0,1,0,0,0,0,1,"H","N","2013-02-14","201302140FLA"
"MTL",1,0,0,0,0,1,0,0,0,0,0,0,"A","N","2013-02-14","201302140FLA"
"COL",0,0,2,1,1,4,0,0,1,2,0,3,"A","Y","2013-02-14","201302140MIN"
"MIN",0,0,1,2,0,3,0,0,2,1,1,4,"H","Y","2013-02-14","201302140MIN"
"NSH",0,0,0,3,0,3,0,0,0,0,0,0,"H","N","2013-02-14","201302140NSH"
"PHX",0,0,0,0,0,0,0,0,0,3,0,3,"A","N","2013-02-14","201302140NSH"
"NYI",0,0,3,0,1,4,0,2,1,0,0,3,"A","Y","2013-02-14","201302140NYR"
"NYR",0,2,1,0,0,3,0,0,3,0,1,4,"H","Y","2013-02-14","201302140NYR"
"TBL",0,1,0,2,0,3,0,1,1,2,0,4,"H","N","2013-02-14","201302140TBL"
"WSH",0,1,1,2,0,4,0,1,0,2,0,3,"A","N","2013-02-14","201302140TBL"
"BOS",0,1,1,0,0,2,0,1,0,3,0,4,"A","N","2013-02-15","201302150BUF"
"BUF",0,1,0,3,0,4,0,1,1,0,0,2,"H","N","2013-02-15","201302150BUF"
"CGY",0,0,1,1,0,2,0,4,0,1,0,5,"H","N","2013-02-15","201302150CGY"
"STL",0,4,0,1,0,5,0,0,1,1,0,2,"A","N","2013-02-15","201302150CGY"
"CHI",0,1,2,1,0,4,0,0,1,0,0,1,"H","N","2013-02-15","201302150CHI"
"SJS",0,0,1,0,0,1,0,1,2,1,0,4,"A","N","2013-02-15","201302150CHI"
"ANA",0,0,2,3,0,5,0,0,2,0,0,2,"A","N","2013-02-15","201302150DET"
"DET",0,0,2,0,0,2,0,0,2,3,0,5,"H","N","2013-02-15","201302150DET"
"CBJ",0,0,0,1,0,1,0,0,1,1,0,2,"A","N","2013-02-15","201302150LAK"
"LAK",0,0,1,1,0,2,0,0,0,1,0,1,"H","N","2013-02-15","201302150LAK"
"NJD",0,1,2,2,0,5,0,3,0,0,0,3,"H","N","2013-02-15","201302150NJD"
"PHI",0,3,0,0,0,3,0,1,2,2,0,5,"A","N","2013-02-15","201302150NJD"
"DAL",0,1,1,2,0,4,0,0,3,0,0,3,"A","N","2013-02-15","201302150VAN"
"VAN",0,0,3,0,0,3,0,1,1,2,0,4,"H","N","2013-02-15","201302150VAN"
"PIT",0,1,0,2,0,3,0,0,0,1,0,1,"A","N","2013-02-15","201302150WPG"
"WPG",0,0,0,1,0,1,0,1,0,2,0,3,"H","N","2013-02-15","201302150WPG"
"COL",0,3,1,0,0,4,0,1,2,3,0,6,"A","N","2013-02-16","201302160EDM"
"EDM",0,1,2,3,0,6,0,3,1,0,0,4,"H","N","2013-02-16","201302160EDM"
"FLA",0,1,2,2,0,5,1,2,1,2,0,6,"H","N","2013-02-16","201302160FLA"
"TBL",1,2,1,2,0,6,0,1,2,2,0,5,"A","N","2013-02-16","201302160FLA"
"MTL",0,1,1,2,0,4,0,0,1,0,0,1,"H","N","2013-02-16","201302160MTL"
"PHI",0,0,1,0,0,1,0,1,1,2,0,4,"A","N","2013-02-16","201302160MTL"
"ANA",0,1,1,0,1,3,0,1,1,0,0,2,"A","Y","2013-02-16","201302160NSH"
"NSH",0,1,1,0,0,2,0,1,1,0,1,3,"H","Y","2013-02-16","201302160NSH"
"NJD",0,0,0,1,0,1,0,0,3,2,0,5,"A","N","2013-02-16","201302160NYI"
"NYI",0,0,3,2,0,5,0,0,0,1,0,1,"H","N","2013-02-16","201302160NYI"
"CBJ",0,2,1,0,0,3,0,3,0,2,0,5,"A","N","2013-02-16","201302160PHX"
"PHX",0,3,0,2,0,5,0,2,1,0,0,3,"H","N","2013-02-16","201302160PHX"
"OTT",0,0,0,0,0,0,0,1,0,2,0,3,"A","N","2013-02-16","201302160TOR"
"TOR",0,1,0,2,0,3,0,0,0,0,0,0,"H","N","2013-02-16","201302160TOR"
"BUF",0,1,1,1,0,3,0,2,0,2,0,4,"H","N","2013-02-17","201302170BUF"
"PIT",0,2,0,2,0,4,0,1,1,1,0,3,"A","N","2013-02-17","201302170BUF"
"CHI",0,2,1,0,0,3,0,0,0,2,0,2,"H","N","2013-02-17","201302170CHI"
"LAK",0,0,0,2,0,2,0,2,1,0,0,3,"A","N","2013-02-17","201302170CHI"
"CGY",0,1,0,3,0,4,0,0,3,0,0,3,"A","N","2013-02-17","201302170DAL"
"DAL",0,0,3,0,0,3,0,1,0,3,0,4,"H","N","2013-02-17","201302170DAL"
"DET",0,1,1,0,0,2,0,0,3,0,0,3,"A","N","2013-02-17","201302170MIN"
"MIN",0,0,3,0,0,3,0,1,1,0,0,2,"H","N","2013-02-17","201302170MIN"
"NYR",0,0,1,1,0,2,0,1,0,0,0,1,"H","N","2013-02-17","201302170NYR"
"WSH",0,1,0,0,0,1,0,0,1,1,0,2,"A","N","2013-02-17","201302170NYR"
"STL",0,1,1,1,1,4,0,2,0,1,0,3,"A","Y","2013-02-17","201302170VAN"
"VAN",0,2,0,1,0,3,0,1,1,1,1,4,"H","Y","2013-02-17","201302170VAN"
"BOS",0,0,2,1,0,3,0,0,2,0,0,2,"A","N","2013-02-17","201302170WPG"
"WPG",0,0,2,0,0,2,0,0,2,1,0,3,"H","N","2013-02-17","201302170WPG"
"ANA",0,2,0,1,0,3,0,1,0,1,0,2,"H","N","2013-02-18","201302180ANA"
"CBJ",0,1,0,1,0,2,0,2,0,1,0,3,"A","N","2013-02-18","201302180ANA"
"COL",0,2,4,0,0,6,0,1,3,1,0,5,"H","N","2013-02-18","201302180COL"
"NSH",0,1,3,1,0,5,0,2,4,0,0,6,"A","N","2013-02-18","201302180COL"
"FLA",0,0,0,0,0,0,0,1,2,0,0,3,"H","N","2013-02-18","201302180FLA"
"TOR",0,1,2,0,0,3,0,0,0,0,0,0,"A","N","2013-02-18","201302180FLA"
"CAR",0,0,0,0,0,0,0,0,0,3,0,3,"A","N","2013-02-18","201302180MTL"
"MTL",0,0,0,3,0,3,0,0,0,0,0,0,"H","N","2013-02-18","201302180MTL"
"NJD",0,1,0,0,0,1,0,0,0,1,1,2,"H","Y","2013-02-18","201302180NJD"
"OTT",0,0,0,1,1,2,0,1,0,0,0,1,"A","Y","2013-02-18","201302180NJD"
"NYI",0,0,0,0,0,0,0,1,3,3,0,7,"H","N","2013-02-18","201302180NYI"
"PHI",0,1,3,3,0,7,0,0,0,0,0,0,"A","N","2013-02-18","201302180NYI"
"CGY",0,0,0,0,0,0,0,1,0,3,0,4,"A","N","2013-02-18","201302180PHX"
"PHX",0,1,0,3,0,4,0,0,0,0,0,0,"H","N","2013-02-18","201302180PHX"
"BUF",0,0,1,0,0,1,0,1,1,0,0,2,"H","N","2013-02-19","201302190BUF"
"WPG",0,1,1,0,0,2,0,0,1,0,0,1,"A","N","2013-02-19","201302190BUF"
"CHI",0,0,3,0,1,4,0,1,0,2,0,3,"H","Y","2013-02-19","201302190CHI"
"VAN",0,1,0,2,0,3,0,0,3,0,1,4,"A","Y","2013-02-19","201302190CHI"
"EDM",0,0,1,0,0,1,0,0,1,2,0,3,"H","N","2013-02-19","201302190EDM"
"LAK",0,0,1,2,0,3,0,0,1,0,0,1,"A","N","2013-02-19","201302190EDM"
"DET",0,1,0,2,0,3,1,2,0,1,0,4,"A","N","2013-02-19","201302190NSH"
"NSH",1,2,0,1,0,4,0,1,0,2,0,3,"H","N","2013-02-19","201302190NSH"
"MTL",0,0,1,2,0,3,0,0,1,0,0,1,"A","N","2013-02-19","201302190NYR"
"NYR",0,0,1,0,0,1,0,0,1,2,0,3,"H","N","2013-02-19","201302190NYR"
"NYI",0,0,0,1,0,1,0,0,2,1,0,3,"A","N","2013-02-19","201302190OTT"
"OTT",0,0,2,1,0,3,0,0,0,1,0,1,"H","N","2013-02-19","201302190OTT"
"SJS",0,0,1,1,0,2,0,1,0,0,0,1,"A","N","2013-02-19","201302190STL"
"STL",0,1,0,0,0,1,0,0,1,1,0,2,"H","N","2013-02-19","201302190STL"
"TBL",0,1,1,2,0,4,0,1,0,1,0,2,"H","N","2013-02-19","201302190TBL"
"TOR",0,1,0,1,0,2,0,1,1,2,0,4,"A","N","2013-02-19","201302190TBL"
"CGY",0,1,0,0,0,1,0,2,0,1,0,3,"H","N","2013-02-20","201302200CGY"
"LAK",0,2,0,1,0,3,0,1,0,0,0,1,"A","N","2013-02-20","201302200CGY"
"COL",1,0,0,0,0,1,0,0,0,0,0,0,"H","N","2013-02-20","201302200COL"
"STL",0,0,0,0,0,0,1,0,0,0,0,1,"A","N","2013-02-20","201302200COL"
"PHI",0,2,1,3,0,6,0,2,0,3,0,5,"A","N","2013-02-20","201302200PIT"
"PIT",0,2,0,3,0,5,0,2,1,3,0,6,"H","N","2013-02-20","201302200PIT"
"CAR",0,1,0,2,0,3,0,1,0,3,0,4,"H","N","2013-02-21","201302210CAR"
"WPG",0,1,0,3,0,4,0,1,0,2,0,3,"A","N","2013-02-21","201302210CAR"
"DAL",0,1,1,1,0,3,0,1,1,2,0,4,"H","N","2013-02-21","201302210DAL"
"VAN",0,1,1,2,0,4,0,1,1,1,0,3,"A","N","2013-02-21","201302210DAL"
"CBJ",0,1,0,2,0,3,0,2,0,0,0,2,"A","N","2013-02-21","201302210DET"
"DET",0,2,0,0,0,2,0,1,0,2,0,3,"H","N","2013-02-21","201302210DET"
"EDM",0,0,1,0,0,1,0,0,1,2,0,3,"H","N","2013-02-21","201302210EDM"
"MIN",0,0,1,2,0,3,0,0,1,0,0,1,"A","N","2013-02-21","201302210EDM"
"MTL",0,2,1,0,0,3,1,0,2,1,0,4,"H","N","2013-02-21","201302210MTL"
"NYI",1,0,2,1,0,4,0,2,1,0,0,3,"A","N","2013-02-21","201302210MTL"
"NYR",0,0,0,2,0,2,0,1,0,1,1,3,"A","Y","2013-02-21","201302210OTT"
"OTT",0,1,0,1,1,3,0,0,0,2,0,2,"H","Y","2013-02-21","201302210OTT"
"FLA",0,3,1,1,0,5,0,0,0,2,0,2,"A","N","2013-02-21","201302210PHI"
"PHI",0,0,0,2,0,2,0,3,1,1,0,5,"H","N","2013-02-21","201302210PHI"
"BOS",0,2,1,1,0,4,0,1,1,0,0,2,"A","N","2013-02-21","201302210TBL"
"TBL",0,1,1,0,0,2,0,2,1,1,0,4,"H","N","2013-02-21","201302210TBL"
"BUF",0,1,0,0,0,1,0,0,2,1,0,3,"A","N","2013-02-21","201302210TOR"
"TOR",0,0,2,1,0,3,0,1,0,0,0,1,"H","N","2013-02-21","201302210TOR"
"NJD",0,0,1,2,0,3,0,0,2,0,0,2,"A","N","2013-02-21","201302210WSH"
"WSH",0,0,2,0,0,2,0,0,1,2,0,3,"H","N","2013-02-21","201302210WSH"
"CHI",0,0,1,1,0,2,0,1,0,0,0,1,"H","N","2013-02-22","201302220CHI"
"SJS",0,1,0,0,0,1,0,0,1,1,0,2,"A","N","2013-02-22","201302220CHI"
"NSH",0,0,0,0,0,0,0,0,0,1,0,1,"H","N","2013-02-22","201302220NSH"
"VAN",0,0,0,1,0,1,0,0,0,0,0,0,"A","N","2013-02-22","201302220NSH"
"FLA",0,0,1,0,0,1,0,0,1,2,0,3,"A","N","2013-02-22","201302220PIT"
"PIT",0,0,1,2,0,3,0,0,1,0,0,1,"H","N","2013-02-22","201302220PIT"
"BUF",0,0,0,0,0,0,0,0,2,2,0,4,"H","N","2013-02-23","201302230BUF"
"NYI",0,0,2,2,0,4,0,0,0,0,0,0,"A","N","2013-02-23","201302230BUF"
"CAR",0,0,0,2,0,2,0,1,0,4,0,5,"H","N","2013-02-23","201302230CAR"
"TBL",0,1,0,4,0,5,0,0,0,2,0,2,"A","N","2013-02-23","201302230CAR"
"CGY",0,1,0,2,0,3,0,1,0,0,0,1,"H","N","2013-02-23","201302230CGY"
"MIN",0,1,0,0,0,1,0,1,0,2,0,3,"A","N","2013-02-23","201302230CGY"
"DAL",0,0,1,2,0,3,0,0,0,1,0,1,"H","N","2013-02-23","201302230DAL"
"SJS",0,0,0,1,0,1,0,0,1,2,0,3,"A","N","2013-02-23","201302230DAL"
"DET",0,1,2,1,0,4,0,0,0,0,0,0,"H","N","2013-02-23","201302230DET"
"NSH",0,0,0,0,0,0,0,1,2,1,0,4,"A","N","2013-02-23","201302230DET"
"EDM",0,0,1,1,1,3,0,1,1,0,0,2,"H","Y","2013-02-23","201302230EDM"
"PHX",0,1,1,0,0,2,0,0,1,1,1,3,"A","Y","2013-02-23","201302230EDM"
"COL",0,0,1,0,0,1,0,2,2,0,0,4,"A","N","2013-02-23","201302230LAK"
"LAK",0,2,2,0,0,4,0,0,1,0,0,1,"H","N","2013-02-23","201302230LAK"
"MTL",0,0,3,0,0,3,0,0,0,0,0,0,"H","N","2013-02-23","201302230MTL"
"NYR",0,0,0,0,0,0,0,0,3,0,0,3,"A","N","2013-02-23","201302230MTL"
"OTT",0,1,1,1,0,3,0,1,0,1,0,2,"H","N","2013-02-23","201302230OTT"
"TOR",0,1,0,1,0,2,0,1,1,1,0,3,"A","N","2013-02-23","201302230OTT"
"PHI",0,1,1,3,0,5,0,1,2,0,0,3,"H","N","2013-02-23","201302230PHI"
"WPG",0,1,2,0,0,3,0,1,1,3,0,5,"A","N","2013-02-23","201302230PHI"
"CBJ",0,0,1,0,0,1,0,1,0,1,0,2,"A","N","2013-02-23","201302230STL"
"STL",0,1,0,1,0,2,0,0,1,0,0,1,"H","N","2013-02-23","201302230STL"
"NJD",0,0,1,0,0,1,0,0,1,4,0,5,"A","N","2013-02-23","201302230WSH"
"WSH",0,0,1,4,0,5,0,0,1,0,0,1,"H","N","2013-02-23","201302230WSH"
"ANA",1,0,2,1,0,4,0,2,1,0,0,3,"H","N","2013-02-24","201302240ANA"
"COL",0,2,1,0,0,3,1,0,2,1,0,4,"A","N","2013-02-24","201302240ANA"
"CGY",0,1,2,2,0,5,0,0,2,2,0,4,"H","N","2013-02-24","201302240CGY"
"PHX",0,0,2,2,0,4,0,1,2,2,0,5,"A","N","2013-02-24","201302240CGY"
"CBJ",0,0,0,0,0,0,0,0,1,0,0,1,"A","N","2013-02-24","201302240CHI"
"CHI",0,0,1,0,0,1,0,0,0,0,0,0,"H","N","2013-02-24","201302240CHI"
"DET",0,2,3,3,0,8,0,3,0,0,0,3,"H","N","2013-02-24","201302240DET"
"VAN",0,3,0,0,0,3,0,2,3,3,0,8,"A","N","2013-02-24","201302240DET"
"BOS",0,2,1,1,0,4,0,1,0,0,0,1,"A","N","2013-02-24","201302240FLA"
"FLA",0,1,0,0,0,1,0,2,1,1,0,4,"H","N","2013-02-24","201302240FLA"
"NJD",0,2,0,0,0,2,0,1,2,1,0,4,"H","N","2013-02-24","201302240NJD"
"WPG",0,1,2,1,0,4,0,2,0,0,0,2,"A","N","2013-02-24","201302240NJD"
"CAR",0,0,2,2,0,4,0,2,0,0,0,2,"A","N","2013-02-24","201302240NYI"
"NYI",0,2,0,0,0,2,0,0,2,2,0,4,"H","N","2013-02-24","201302240NYI"
"PIT",0,3,1,1,0,5,0,0,2,1,0,3,"H","N","2013-02-24","201302240PIT"
"TBL",0,0,2,1,0,3,0,3,1,1,0,5,"A","N","2013-02-24","201302240PIT"
"CHI",1,1,0,1,0,3,0,1,1,0,0,2,"H","N","2013-02-25","201302250CHI"
"EDM",0,1,1,0,0,2,1,1,0,1,0,3,"A","N","2013-02-25","201302250CHI"
"ANA",0,0,2,0,0,2,0,0,2,3,0,5,"A","N","2013-02-25","201302250LAK"
"LAK",0,0,2,3,0,5,0,0,2,0,0,2,"H","N","2013-02-25","201302250LAK"
"DAL",0,0,4,0,0,4,1,1,2,1,0,5,"A","N","2013-02-25","201302250NSH"
"NSH",1,1,2,1,0,5,0,0,4,0,0,4,"H","N","2013-02-25","201302250NSH"
"MTL",0,0,1,0,0,1,0,0,1,0,1,2,"A","Y","2013-02-25","201302250OTT"
"OTT",0,0,1,0,1,2,0,0,1,0,0,1,"H","Y","2013-02-25","201302250OTT"
"PHI",0,0,1,1,0,2,0,1,1,2,0,4,"H","N","2013-02-25","201302250PHI"
"TOR",0,1,1,2,0,4,0,0,1,1,0,2,"A","N","2013-02-25","201302250PHI"
"CBJ",0,0,2,2,0,4,1,1,2,1,0,5,"H","N","2013-02-26","201302260CBJ"
"DAL",1,1,2,1,0,5,0,0,2,2,0,4,"A","N","2013-02-26","201302260CBJ"
"FLA",0,1,3,2,0,6,0,0,4,0,0,4,"H","N","2013-02-26","201302260FLA"
"PIT",0,0,4,0,0,4,0,1,3,2,0,6,"A","N","2013-02-26","201302260FLA"
"CGY",0,1,0,0,0,1,1,0,0,1,0,2,"A","N","2013-02-26","201302260MIN"
"MIN",1,0,0,1,0,2,0,1,0,0,0,1,"H","N","2013-02-26","201302260MIN"
"BOS",0,1,2,1,0,4,0,1,0,0,0,1,"A","N","2013-02-26","201302260NYI"
"NYI",0,1,0,0,0,1,0,1,2,1,0,4,"H","N","2013-02-26","201302260NYI"
"NYR",0,0,1,2,0,3,0,0,3,1,0,4,"H","N","2013-02-26","201302260NYR"
"WPG",0,0,3,1,0,4,0,0,1,2,0,3,"A","N","2013-02-26","201302260NYR"
"COL",0,1,0,1,0,2,0,1,1,0,1,3,"A","Y","2013-02-26","201302260SJS"
"SJS",0,1,1,0,1,3,0,1,0,1,0,2,"H","Y","2013-02-26","201302260SJS"
"BUF",0,1,0,1,0,2,0,1,0,0,0,1,"A","N","2013-02-26","201302260TBL"
"TBL",0,1,0,0,0,1,0,1,0,1,0,2,"H","N","2013-02-26","201302260TBL"
"PHX",0,1,1,2,0,4,0,0,1,1,0,2,"A","N","2013-02-26","201302260VAN"
"VAN",0,0,1,1,0,2,0,1,1,2,0,4,"H","N","2013-02-26","201302260VAN"
"CAR",0,0,0,0,0,0,0,1,1,1,0,3,"A","N","2013-02-26","201302260WSH"
"WSH",0,1,1,1,0,3,0,0,0,0,0,0,"H","N","2013-02-26","201302260WSH"
"ANA",0,3,2,0,0,5,0,0,1,0,0,1,"H","N","2013-02-27","201302270ANA"
"NSH",0,0,1,0,0,1,0,3,2,0,0,5,"A","N","2013-02-27","201302270ANA"
"DET",0,1,0,0,0,1,0,0,0,2,0,2,"A","N","2013-02-27","201302270LAK"
"LAK",0,0,0,2,0,2,0,1,0,0,0,1,"H","N","2013-02-27","201302270LAK"
"PHI",0,2,2,0,0,4,0,0,0,1,0,1,"H","N","2013-02-27","201302270PHI"
"WSH",0,0,0,1,0,1,0,2,2,0,0,4,"A","N","2013-02-27","201302270PHI"
"MTL",0,1,1,3,0,5,0,1,1,0,0,2,"A","N","2013-02-27","201302270TOR"
"TOR",0,1,1,0,0,2,0,1,1,3,0,5,"H","N","2013-02-27","201302270TOR"
"BOS",1,0,1,0,0,2,0,0,1,0,0,1,"H","N","2013-02-28","201302280BOS"
"OTT",0,0,1,0,0,1,1,0,1,0,0,2,"A","N","2013-02-28","201302280BOS"
"CAR",0,1,3,0,0,4,0,1,0,0,0,1,"H","N","2013-02-28","201302280CAR"
"PIT",0,1,0,0,0,1,0,1,3,0,0,4,"A","N","2013-02-28","201302280CAR"
"CGY",0,3,1,0,0,4,0,0,2,3,0,5,"A","N","2013-02-28","201302280COL"
"COL",0,0,2,3,0,5,0,3,1,0,0,4,"H","N","2013-02-28","201302280COL"
"DAL",0,0,0,1,0,1,0,2,1,2,0,5,"H","N","2013-02-28","201302280DAL"
"EDM",0,2,1,2,0,5,0,0,0,1,0,1,"A","N","2013-02-28","201302280DAL"
"BUF",0,3,0,0,1,4,0,2,0,1,0,3,"A","Y","2013-02-28","201302280FLA"
"FLA",0,2,0,1,0,3,0,3,0,0,1,4,"H","Y","2013-02-28","201302280FLA"
"NYI",0,1,1,2,0,4,1,1,3,0,0,5,"H","N","2013-02-28","201302280NYI"
"TOR",1,1,3,0,0,5,0,1,1,2,0,4,"A","N","2013-02-28","201302280NYI"
"NYR",0,2,1,1,0,4,0,1,0,0,0,1,"H","N","2013-02-28","201302280NYR"
"TBL",0,1,0,0,0,1,0,2,1,1,0,4,"A","N","2013-02-28","201302280NYR"
"MIN",0,2,2,0,0,4,0,0,1,2,0,3,"A","N","2013-02-28","201302280PHX"
"PHX",0,0,1,2,0,3,0,2,2,0,0,4,"H","N","2013-02-28","201302280PHX"
"DET",0,0,0,1,1,2,0,0,0,1,0,1,"A","Y","2013-02-28","201302280SJS"
"SJS",0,0,0,1,0,1,0,0,0,1,1,2,"H","Y","2013-02-28","201302280SJS"
"CHI",0,1,0,2,0,3,0,0,0,0,0,0,"A","N","2013-02-28","201302280STL"
"STL",0,0,0,0,0,0,0,1,0,2,0,3,"H","N","2013-02-28","201302280STL"
"NJD",0,0,1,0,0,1,0,1,0,2,0,3,"A","N","2013-02-28","201302280WPG"
"WPG",0,1,0,2,0,3,0,0,1,0,0,1,"H","N","2013-02-28","201302280WPG"
"ANA",0,2,1,0,0,3,0,0,0,2,0,2,"H","N","2013-03-01","201303010ANA"
"MIN",0,0,0,2,0,2,0,2,1,0,0,3,"A","N","2013-03-01","201303010ANA"
"CBJ",0,1,1,1,0,3,1,1,2,0,0,4,"A","N","2013-03-01","201303010CHI"
"CHI",1,1,2,0,0,4,0,1,1,1,0,3,"H","N","2013-03-01","201303010CHI"
"EDM",0,2,0,0,0,2,0,0,2,2,0,4,"A","N","2013-03-01","201303010STL"
"STL",0,0,2,2,0,4,0,2,0,0,0,2,"H","N","2013-03-01","201303010STL"
"BOS",0,0,2,1,0,3,0,2,0,0,0,2,"H","N","2013-03-02","201303020BOS"
"TBL",0,2,0,0,0,2,0,0,2,1,0,3,"A","N","2013-03-02","201303020BOS"
"BUF",0,0,1,2,1,4,0,0,1,2,0,3,"H","Y","2013-03-02","201303020BUF"
"NJD",0,0,1,2,0,3,0,0,1,2,1,4,"A","Y","2013-03-02","201303020BUF"
"CAR",0,3,2,1,0,6,0,1,1,0,0,2,"H","N","2013-03-02","201303020CAR"
"FLA",0,1,1,0,0,2,0,3,2,1,0,6,"A","N","2013-03-02","201303020CAR"
"MTL",0,1,3,2,0,6,1,1,3,2,0,7,"H","N","2013-03-02","201303020MTL"
"PIT",1,1,3,2,0,7,0,1,3,2,0,6,"A","N","2013-03-02","201303020MTL"
"OTT",0,0,1,0,0,1,0,0,2,0,0,2,"A","N","2013-03-02","201303020PHI"
"PHI",0,0,2,0,0,2,0,0,1,0,0,1,"H","N","2013-03-02","201303020PHI"
"ANA",0,1,2,1,0,4,0,1,1,2,1,5,"A","Y","2013-03-02","201303020PHX"
"PHX",0,1,1,2,1,5,0,1,2,1,0,4,"H","Y","2013-03-02","201303020PHX"
"NSH",0,0,0,1,0,1,0,1,1,0,0,2,"A","N","2013-03-02","201303020SJS"
"SJS",0,1,1,0,0,2,0,0,0,1,0,1,"H","N","2013-03-02","201303020SJS"
"LAK",0,0,2,0,0,2,0,1,3,1,0,5,"A","N","2013-03-02","201303020VAN"
"VAN",0,1,3,1,0,5,0,0,2,0,0,2,"H","N","2013-03-02","201303020VAN"
"WPG",0,0,0,0,0,0,0,0,1,2,0,3,"H","N","2013-03-02","201303020WPG"
"WSH",0,0,1,2,0,3,0,0,0,0,0,0,"A","N","2013-03-02","201303020WPG"
"BOS",0,1,2,0,0,3,0,2,0,2,0,4,"H","N","2013-03-03","201303030BOS"
"MTL",0,2,0,2,0,4,0,1,2,0,0,3,"A","N","2013-03-03","201303030BOS"
"CBJ",1,0,0,1,0,2,0,0,1,0,0,1,"H","N","2013-03-03","201303030CBJ"
"COL",0,0,1,0,0,1,1,0,0,1,0,2,"A","N","2013-03-03","201303030CBJ"
"CGY",0,1,1,2,0,4,0,1,1,0,0,2,"H","N","2013-03-03","201303030CGY"
"VAN",0,1,1,0,0,2,0,1,1,2,0,4,"A","N","2013-03-03","201303030CGY"
"DAL",0,2,0,2,0,4,0,1,0,0,0,1,"H","N","2013-03-03","201303030DAL"
"STL",0,1,0,0,0,1,0,2,0,2,0,4,"A","N","2013-03-03","201303030DAL"
"CHI",0,0,0,1,1,2,0,0,0,1,0,1,"A","Y","2013-03-03","201303030DET"
"DET",0,0,0,1,0,1,0,0,0,1,1,2,"H","Y","2013-03-03","201303030DET"
"CAR",0,2,1,0,0,3,0,0,1,1,0,2,"A","N","2013-03-03","201303030FLA"
"FLA",0,0,1,1,0,2,0,2,1,0,0,3,"H","N","2013-03-03","201303030FLA"
"EDM",0,1,0,1,0,2,0,1,0,3,0,4,"A","N","2013-03-03","201303030MIN"
"MIN",0,1,0,3,0,4,0,1,0,1,0,2,"H","N","2013-03-03","201303030MIN"
"NYI",0,1,0,1,1,3,0,0,1,1,0,2,"H","Y","2013-03-03","201303030NYI"
"OTT",0,0,1,1,0,2,0,1,0,1,1,3,"A","Y","2013-03-03","201303030NYI"
"BUF",0,0,1,1,0,2,0,0,0,2,1,3,"A","Y","2013-03-03","201303030NYR"
"NYR",0,0,0,2,1,3,0,0,1,1,0,2,"H","Y","2013-03-03","201303030NYR"
"LAK",0,0,1,4,0,5,0,0,0,1,0,1,"H","N","2013-03-04","201303040LAK"
"NSH",0,0,0,1,0,1,0,0,1,4,0,5,"A","N","2013-03-04","201303040LAK"
"ANA",0,1,1,2,0,4,0,0,2,2,1,5,"A","Y","2013-03-04","201303040PHX"
"PHX",0,0,2,2,1,5,0,1,1,2,0,4,"H","Y","2013-03-04","201303040PHX"
"PIT",0,1,0,3,0,4,0,0,2,1,0,3,"H","N","2013-03-04","201303040PIT"
"TBL",0,0,2,1,0,3,0,1,0,3,0,4,"A","N","2013-03-04","201303040PIT"
"NJD",0,0,2,0,0,2,0,1,0,3,0,4,"A","N","2013-03-04","201303040TOR"
"TOR",0,1,0,3,0,4,0,0,2,0,0,2,"H","N","2013-03-04","201303040TOR"
"BUF",0,0,0,3,0,3,0,1,1,2,0,4,"A","N","2013-03-05","201303050CAR"
"CAR",0,1,1,2,0,4,0,0,0,3,0,3,"H","N","2013-03-05","201303050CAR"
"CBJ",0,2,1,0,1,4,0,2,1,0,0,3,"H","Y","2013-03-05","201303050CBJ"
"EDM",0,2,1,0,0,3,0,2,1,0,1,4,"A","Y","2013-03-05","201303050CBJ"
"CHI",0,4,0,1,0,5,0,1,0,2,0,3,"H","N","2013-03-05","201303050CHI"
"MIN",0,1,0,2,0,3,0,4,0,1,0,5,"A","N","2013-03-05","201303050CHI"
"COL",0,0,0,1,0,1,0,0,2,0,0,2,"A","N","2013-03-05","201303050DET"
"DET",0,0,2,0,0,2,0,0,0,1,0,1,"H","N","2013-03-05","201303050DET"
"FLA",0,1,2,1,0,4,0,0,1,0,0,1,"H","N","2013-03-05","201303050FLA"
"WPG",0,0,1,0,0,1,0,1,2,1,0,4,"A","N","2013-03-05","201303050FLA"
"LAK",0,1,1,4,0,6,0,2,2,0,0,4,"H","N","2013-03-05","201303050LAK"
"STL",0,2,2,0,0,4,0,1,1,4,0,6,"A","N","2013-03-05","201303050LAK"
"NJD",0,0,0,2,0,2,0,1,2,2,0,5,"H","N","2013-03-05","201303050NJD"
"TBL",0,1,2,2,0,5,0,0,0,2,0,2,"A","N","2013-03-05","201303050NJD"
"MTL",0,1,1,1,0,3,0,0,3,3,0,6,"A","N","2013-03-05","201303050NYI"
"NYI",0,0,3,3,0,6,0,1,1,1,0,3,"H","N","2013-03-05","201303050NYI"
"NYR",0,2,0,2,0,4,0,2,0,0,0,2,"H","N","2013-03-05","201303050NYR"
"PHI",0,2,0,0,0,2,0,2,0,2,0,4,"A","N","2013-03-05","201303050NYR"
"SJS",0,1,1,0,1,3,0,0,2,0,0,2,"A","Y","2013-03-05","201303050VAN"
"VAN",0,0,2,0,0,2,0,1,1,0,1,3,"H","Y","2013-03-05","201303050VAN"
"BOS",0,3,0,0,0,3,1,0,2,1,0,4,"A","N","2013-03-05","201303050WSH"
"WSH",1,0,2,1,0,4,0,3,0,0,0,3,"H","N","2013-03-05","201303050WSH"
"ANA",0,1,0,1,0,2,0,0,0,0,0,0,"H","N","2013-03-06","201303060ANA"
"PHX",0,0,0,0,0,0,0,1,0,1,0,2,"A","N","2013-03-06","201303060ANA"
"CGY",0,1,0,3,0,4,0,0,1,0,0,1,"H","N","2013-03-06","201303060CGY"
"SJS",0,0,1,0,0,1,0,1,0,3,0,4,"A","N","2013-03-06","201303060CGY"
"CHI",0,1,0,2,0,3,0,1,1,0,0,2,"H","N","2013-03-06","201303060CHI"
"COL",0,1,1,0,0,2,0,1,0,2,0,3,"A","N","2013-03-06","201303060CHI"
"OTT",0,0,1,3,0,4,0,2,1,2,0,5,"A","N","2013-03-06","201303060TOR"
"TOR",0,2,1,2,0,5,0,0,1,3,0,4,"H","N","2013-03-06","201303060TOR"
"BOS",0,1,2,1,0,4,0,0,1,1,0,2,"H","N","2013-03-07","201303070BOS"
"TOR",0,0,1,1,0,2,0,1,2,1,0,4,"A","N","2013-03-07","201303070BOS"
"CAR",0,0,2,0,0,2,0,2,0,2,0,4,"H","N","2013-03-07","201303070CAR"
"MTL",0,2,0,2,0,4,0,0,2,0,0,2,"A","N","2013-03-07","201303070CAR"
"CBJ",1,1,0,0,0,2,0,0,0,1,0,1,"H","N","2013-03-07","201303070CBJ"
"VAN",0,0,0,1,0,1,1,1,0,0,0,2,"A","N","2013-03-07","201303070CBJ"
"DET",0,0,2,1,0,3,0,0,0,0,0,0,"H","N","2013-03-07","201303070DET"
"EDM",0,0,0,0,0,0,0,0,2,1,0,3,"A","N","2013-03-07","201303070DET"
"DAL",0,1,1,3,0,5,0,1,1,0,0,2,"A","N","2013-03-07","201303070LAK"
"LAK",0,1,1,0,0,2,0,1,1,3,0,5,"H","N","2013-03-07","201303070LAK"
"BUF",0,0,1,1,0,2,0,0,0,2,1,3,"A","Y","2013-03-07","201303070NJD"
"NJD",0,0,0,2,1,3,0,0,1,1,0,2,"H","Y","2013-03-07","201303070NJD"
"NYI",0,1,0,0,0,1,1,0,0,1,0,2,"H","N","2013-03-07","201303070NYI"
"NYR",1,0,0,1,0,2,0,1,0,0,0,1,"A","N","2013-03-07","201303070NYI"
"PHI",0,4,0,0,0,4,0,1,3,1,0,5,"H","N","2013-03-07","201303070PHI"
"PIT",0,1,3,1,0,5,0,4,0,0,0,4,"A","N","2013-03-07","201303070PHI"
"PHX",0,1,1,1,0,3,0,1,3,2,0,6,"H","N","2013-03-07","201303070PHX"
"STL",0,1,3,2,0,6,0,1,1,1,0,3,"A","N","2013-03-07","201303070PHX"
"TBL",0,0,0,1,0,1,0,1,0,1,0,2,"H","N","2013-03-07","201303070TBL"
"WPG",0,1,0,1,0,2,0,0,0,1,0,1,"A","N","2013-03-07","201303070TBL"
"FLA",0,0,0,1,0,1,0,4,1,2,0,7,"A","N","2013-03-07","201303070WSH"
"WSH",0,4,1,2,0,7,0,0,0,1,0,1,"H","N","2013-03-07","201303070WSH"
"ANA",0,1,2,1,0,4,0,0,0,0,0,0,"H","N","2013-03-08","201303080ANA"
"CGY",0,0,0,0,0,0,0,1,2,1,0,4,"A","N","2013-03-08","201303080ANA"
"CHI",0,1,0,1,0,2,0,1,4,1,0,6,"A","N","2013-03-08","201303080COL"
"COL",0,1,4,1,0,6,0,1,0,1,0,2,"H","N","2013-03-08","201303080COL"
"FLA",0,1,0,1,0,2,1,2,0,0,0,3,"H","N","2013-03-08","201303080FLA"
"WPG",1,2,0,0,0,3,0,1,0,1,0,2,"A","N","2013-03-08","201303080FLA"
"EDM",0,0,0,0,0,0,0,2,2,2,0,6,"A","N","2013-03-08","201303080NSH"
"NSH",0,2,2,2,0,6,0,0,0,0,0,0,"H","N","2013-03-08","201303080NSH"
"NYR",0,2,0,0,0,2,0,2,0,1,0,3,"H","N","2013-03-08","201303080NYR"
"OTT",0,2,0,1,0,3,0,2,0,0,0,2,"A","N","2013-03-08","201303080NYR"
"BOS",0,3,0,0,0,3,0,0,0,0,0,0,"H","N","2013-03-09","201303090BOS"
"PHI",0,0,0,0,0,0,0,3,0,0,0,3,"A","N","2013-03-09","201303090BOS"
"CAR",0,2,3,1,0,6,0,1,0,2,0,3,"H","N","2013-03-09","201303090CAR"
"NJD",0,1,0,2,0,3,0,2,3,1,0,6,"A","N","2013-03-09","201303090CAR"
"CBJ",0,1,2,0,0,3,0,0,0,0,0,0,"H","N","2013-03-09","201303090CBJ"
"DET",0,0,0,0,0,0,0,1,2,0,0,3,"A","N","2013-03-09","201303090CBJ"
"CGY",0,2,0,0,0,2,0,3,1,2,0,6,"A","N","2013-03-09","201303090LAK"
"LAK",0,3,1,2,0,6,0,2,0,0,0,2,"H","N","2013-03-09","201303090LAK"
"MIN",0,0,1,0,1,2,0,0,0,1,0,1,"A","Y","2013-03-09","201303090NSH"
"NSH",0,0,0,1,0,1,0,0,1,0,1,2,"H","Y","2013-03-09","201303090NSH"
"NYI",0,1,1,3,0,5,0,0,1,1,0,2,"H","N","2013-03-09","201303090NYI"
"WSH",0,0,1,1,0,2,0,1,1,3,0,5,"A","N","2013-03-09","201303090NYI"
"DAL",0,0,1,0,0,1,0,1,1,0,0,2,"A","N","2013-03-09","201303090PHX"
"PHX",0,1,1,0,0,2,0,0,1,0,0,1,"H","N","2013-03-09","201303090PHX"
"SJS",0,1,2,0,0,3,1,1,0,2,0,4,"H","N","2013-03-09","201303090SJS"
"STL",1,1,0,2,0,4,0,1,2,0,0,3,"A","N","2013-03-09","201303090SJS"
"MTL",0,0,1,3,0,4,0,0,3,0,0,3,"A","N","2013-03-09","201303090TBL"
"TBL",0,0,3,0,0,3,0,0,1,3,0,4,"H","N","2013-03-09","201303090TBL"
"PIT",0,3,1,0,1,5,0,1,2,1,0,4,"A","Y","2013-03-09","201303090TOR"
"TOR",0,1,2,1,0,4,0,3,1,0,1,5,"H","Y","2013-03-09","201303090TOR"
"ANA",0,0,1,3,0,4,0,1,0,1,0,2,"H","N","2013-03-10","201303100ANA"
"STL",0,1,0,1,0,2,0,0,1,3,0,4,"A","N","2013-03-10","201303100ANA"
"CHI",0,0,4,1,0,5,0,4,2,0,0,6,"H","N","2013-03-10","201303100CHI"
"EDM",0,4,2,0,0,6,0,0,4,1,0,5,"A","N","2013-03-10","201303100CHI"
"COL",1,1,1,0,0,3,0,0,1,1,0,2,"H","N","2013-03-10","201303100COL"
"SJS",0,0,1,1,0,2,1,1,1,0,0,3,"A","N","2013-03-10","201303100COL"
"CBJ",0,0,2,0,1,3,0,0,1,1,0,2,"A","Y","2013-03-10","201303100DET"
"DET",0,0,1,1,0,2,0,0,2,0,1,3,"H","Y","2013-03-10","201303100DET"
"FLA",0,0,0,2,0,2,0,2,2,1,0,5,"H","N","2013-03-10","201303100FLA"
"MTL",0,2,2,1,0,5,0,0,0,2,0,2,"A","N","2013-03-10","201303100FLA"
"MIN",0,2,1,1,0,4,0,0,1,1,0,2,"H","N","2013-03-10","201303100MIN"
"VAN",0,0,1,1,0,2,0,2,1,1,0,4,"A","N","2013-03-10","201303100MIN"
"NJD",0,2,0,0,1,3,0,1,1,0,0,2,"H","Y","2013-03-10","201303100NJD"
"WPG",0,1,1,0,0,2,0,2,0,0,1,3,"A","Y","2013-03-10","201303100NJD"
"BUF",0,1,0,1,0,2,0,2,1,0,0,3,"A","N","2013-03-10","201303100PHI"
"PHI",0,2,1,0,0,3,0,1,0,1,0,2,"H","N","2013-03-10","201303100PHI"
"NYI",0,0,1,0,0,1,0,3,2,1,0,6,"A","N","2013-03-10","201303100PIT"
"PIT",0,3,2,1,0,6,0,0,1,0,0,1,"H","N","2013-03-10","201303100PIT"
"NYR",0,1,2,1,0,4,0,1,0,0,0,1,"A","N","2013-03-10","201303100WSH"
"WSH",0,1,0,0,0,1,0,1,2,1,0,4,"H","N","2013-03-10","201303100WSH"
"CGY",0,0,0,1,0,1,0,2,0,1,0,3,"A","N","2013-03-11","201303110LAK"
"LAK",0,2,0,1,0,3,0,0,0,1,0,1,"H","N","2013-03-11","201303110LAK"
"BOS",0,1,1,0,1,3,0,2,0,0,0,2,"A","Y","2013-03-11","201303110OTT"
"OTT",0,2,0,0,0,2,0,1,1,0,1,3,"H","Y","2013-03-11","201303110OTT"
"BUF",0,0,2,1,0,3,0,0,1,0,0,1,"H","N","2013-03-12","201303120BUF"
"NYR",0,0,1,0,0,1,0,0,2,1,0,3,"A","N","2013-03-12","201303120BUF"
"CBJ",0,0,1,0,0,1,0,0,1,0,1,2,"H","Y","2013-03-12","201303120CBJ"
"VAN",0,0,1,0,1,2,0,0,1,0,0,1,"A","Y","2013-03-12","201303120CBJ"
"COL",0,0,0,0,0,0,0,2,1,1,0,4,"H","N","2013-03-12","201303120COL"
"EDM",0,2,1,1,0,4,0,0,0,0,0,0,"A","N","2013-03-12","201303120COL"
"DAL",0,0,0,0,0,0,0,1,2,1,0,4,"H","N","2013-03-12","201303120DAL"
"NSH",0,1,2,1,0,4,0,0,0,0,0,0,"A","N","2013-03-12","201303120DAL"
"FLA",0,0,2,0,0,2,0,2,0,1,0,3,"H","N","2013-03-12","201303120FLA"
"TBL",0,2,0,1,0,3,0,0,2,0,0,2,"A","N","2013-03-12","201303120FLA"
"ANA",0,0,0,2,0,2,0,1,0,0,0,1,"A","N","2013-03-12","201303120MIN"
"MIN",0,1,0,0,0,1,0,0,0,2,0,2,"H","N","2013-03-12","201303120MIN"
"LAK",0,0,1,1,0,2,0,2,2,1,0,5,"A","N","2013-03-12","201303120PHX"
"PHX",0,2,2,1,0,5,0,0,1,1,0,2,"H","N","2013-03-12","201303120PHX"
"BOS",0,2,0,0,0,2,0,0,0,3,0,3,"A","N","2013-03-12","201303120PIT"
"PIT",0,0,0,3,0,3,0,2,0,0,0,2,"H","N","2013-03-12","201303120PIT"
"SJS",0,0,1,1,0,2,0,1,2,1,0,4,"A","N","2013-03-12","201303120STL"
"STL",0,1,2,1,0,4,0,0,1,1,0,2,"H","N","2013-03-12","201303120STL"
"TOR",0,0,1,1,0,2,0,1,2,2,0,5,"A","N","2013-03-12","201303120WPG"
"WPG",0,1,2,2,0,5,0,0,1,1,0,2,"H","N","2013-03-12","201303120WPG"
"CAR",0,1,2,1,0,4,0,0,0,0,0,0,"A","N","2013-03-12","201303120WSH"
"WSH",0,0,0,0,0,0,0,1,2,1,0,4,"H","N","2013-03-12","201303120WSH"
"CGY",0,2,0,3,0,5,0,1,1,0,0,2,"H","N","2013-03-13","201303130CGY"
"DET",0,1,1,0,0,2,0,2,0,3,0,5,"A","N","2013-03-13","201303130CGY"
"MTL",0,1,2,0,1,4,0,1,1,1,0,3,"H","Y","2013-03-13","201303130MTL"
"OTT",0,1,1,1,0,3,0,1,2,0,1,4,"A","Y","2013-03-13","201303130MTL"
"NJD",0,3,1,1,0,5,0,1,0,1,0,2,"H","N","2013-03-13","201303130NJD"
"PHI",0,1,0,1,0,2,0,3,1,1,0,5,"A","N","2013-03-13","201303130NJD"
"BOS",0,2,0,2,0,4,0,0,1,0,0,1,"H","N","2013-03-14","201303140BOS"
"FLA",0,0,1,0,0,1,0,2,0,2,0,4,"A","N","2013-03-14","201303140BOS"
"CAR",0,2,0,0,0,2,0,0,1,2,0,3,"H","N","2013-03-14","201303140CAR"
"WSH",0,0,1,2,0,3,0,2,0,0,0,2,"A","N","2013-03-14","201303140CAR"
"CBJ",0,0,1,0,0,1,0,0,1,0,1,2,"H","Y","2013-03-14","201303140CBJ"
"CHI",0,0,1,0,1,2,0,0,1,0,0,1,"A","Y","2013-03-14","201303140CBJ"
"ANA",0,0,1,0,1,2,0,1,0,0,0,1,"A","Y","2013-03-14","201303140DAL"
"DAL",0,1,0,0,0,1,0,0,1,0,1,2,"H","Y","2013-03-14","201303140DAL"
"COL",0,1,1,1,0,3,0,1,3,1,0,5,"A","N","2013-03-14","201303140MIN"
"MIN",0,1,3,1,0,5,0,1,1,1,0,3,"H","N","2013-03-14","201303140MIN"
"LAK",0,0,1,2,0,3,0,1,2,1,0,4,"A","N","2013-03-14","201303140SJS"
"SJS",0,1,2,1,0,4,0,0,1,2,0,3,"H","N","2013-03-14","201303140SJS"
"PHX",0,0,0,0,0,0,0,0,1,2,0,3,"A","N","2013-03-14","201303140STL"
"STL",0,0,1,2,0,3,0,0,0,0,0,0,"H","N","2013-03-14","201303140STL"
"NYI",0,0,1,1,0,2,0,0,0,0,0,0,"A","N","2013-03-14","201303140TBL"
"TBL",0,0,0,0,0,0,0,0,1,1,0,2,"H","N","2013-03-14","201303140TBL"
"PIT",0,0,0,3,0,3,0,0,1,0,0,1,"A","N","2013-03-14","201303140TOR"
"TOR",0,0,1,0,0,1,0,0,0,3,0,3,"H","N","2013-03-14","201303140TOR"
"NSH",0,1,1,2,0,4,0,3,2,2,0,7,"A","N","2013-03-14","201303140VAN"
"VAN",0,3,2,2,0,7,0,1,1,2,0,4,"H","N","2013-03-14","201303140VAN"
"NYR",0,0,1,0,0,1,0,1,1,1,0,3,"A","N","2013-03-14","201303140WPG"
"WPG",0,1,1,1,0,3,0,0,1,0,0,1,"H","N","2013-03-14","201303140WPG"
"CGY",0,2,1,3,0,6,0,0,1,2,0,3,"H","N","2013-03-15","201303150CGY"
"NSH",0,0,1,2,0,3,0,2,1,3,0,6,"A","N","2013-03-15","201303150CGY"
"DET",1,0,0,2,0,3,0,1,1,0,0,2,"A","N","2013-03-15","201303150EDM"
"EDM",0,1,1,0,0,2,1,0,0,2,0,3,"H","N","2013-03-15","201303150EDM"
"NJD",0,0,1,0,0,1,0,1,0,0,1,2,"A","Y","2013-03-15","201303150PHI"
"PHI",0,1,0,0,1,2,0,0,1,0,0,1,"H","Y","2013-03-15","201303150PHI"
"BOS",0,2,1,1,0,4,0,0,1,0,0,1,"H","N","2013-03-16","201303160BOS"
"WSH",0,0,1,0,0,1,0,2,1,1,0,4,"A","N","2013-03-16","201303160BOS"
"BUF",0,2,0,1,0,3,1,0,3,0,0,4,"H","N","2013-03-16","201303160BUF"
"OTT",1,0,3,0,0,4,0,2,0,1,0,3,"A","N","2013-03-16","201303160BUF"
"CBJ",0,0,0,0,1,1,0,0,0,0,0,0,"H","Y","2013-03-16","201303160CBJ"
"PHX",0,0,0,0,0,0,0,0,0,0,1,1,"A","Y","2013-03-16","201303160CBJ"
"COL",0,1,2,1,0,4,0,4,1,1,0,6,"H","N","2013-03-16","201303160COL"
"MIN",0,4,1,1,0,6,0,1,2,1,0,4,"A","N","2013-03-16","201303160COL"
"CHI",0,3,3,2,0,8,0,0,0,1,0,1,"A","N","2013-03-16","201303160DAL"
"DAL",0,0,0,1,0,1,0,3,3,2,0,8,"H","N","2013-03-16","201303160DAL"
"FLA",0,0,0,3,0,3,0,2,1,1,0,4,"H","N","2013-03-16","201303160FLA"
"NYI",0,2,1,1,0,4,0,0,0,3,0,3,"A","N","2013-03-16","201303160FLA"
"LAK",0,2,3,0,0,5,0,0,1,1,0,2,"H","N","2013-03-16","201303160LAK"
"SJS",0,0,1,1,0,2,0,2,3,0,0,5,"A","N","2013-03-16","201303160LAK"
"MTL",0,1,0,1,0,2,0,0,1,0,0,1,"A","N","2013-03-16","201303160NJD"
"NJD",0,0,1,0,0,1,0,1,0,1,0,2,"H","N","2013-03-16","201303160NJD"
"NYR",0,0,0,0,0,0,0,1,0,2,0,3,"A","N","2013-03-16","201303160PIT"
"PIT",0,1,0,2,0,3,0,0,0,0,0,0,"H","N","2013-03-16","201303160PIT"
"ANA",0,1,0,0,0,1,1,0,1,0,0,2,"A","N","2013-03-16","201303160STL"
"STL",1,0,1,0,0,2,0,1,0,0,0,1,"H","N","2013-03-16","201303160STL"
"CAR",0,0,0,1,0,1,0,1,2,1,0,4,"A","N","2013-03-16","201303160TBL"
"TBL",0,1,2,1,0,4,0,0,0,1,0,1,"H","N","2013-03-16","201303160TBL"
"TOR",0,1,2,1,0,4,0,0,4,0,1,5,"H","Y","2013-03-16","201303160TOR"
"WPG",0,0,4,0,1,5,0,1,2,1,0,4,"A","Y","2013-03-16","201303160TOR"
"DET",0,1,1,3,0,5,0,1,0,1,0,2,"A","N","2013-03-16","201303160VAN"
"VAN",0,1,0,1,0,2,0,1,1,3,0,5,"H","N","2013-03-16","201303160VAN"
"EDM",0,0,1,2,0,3,0,0,1,1,0,2,"H","N","2013-03-17","201303170EDM"
"NSH",0,0,1,1,0,2,0,0,1,2,0,3,"A","N","2013-03-17","201303170EDM"
"OTT",0,2,0,2,0,4,0,0,0,1,0,1,"H","N","2013-03-17","201303170OTT"
"WPG",0,0,0,1,0,1,0,2,0,2,0,4,"A","N","2013-03-17","201303170OTT"
"BOS",0,1,0,0,0,1,0,2,0,0,0,2,"A","N","2013-03-17","201303170PIT"
"PIT",0,2,0,0,0,2,0,1,0,0,0,1,"H","N","2013-03-17","201303170PIT"
"BUF",0,0,2,1,0,3,0,1,3,1,0,5,"A","N","2013-03-17","201303170WSH"
"WSH",0,1,3,1,0,5,0,0,2,1,0,3,"H","N","2013-03-17","201303170WSH"
"ANA",0,1,3,1,0,5,0,1,1,1,0,3,"H","N","2013-03-18","201303180ANA"
"SJS",0,1,1,1,0,3,0,1,3,1,0,5,"A","N","2013-03-18","201303180ANA"
"CHI",0,2,2,1,0,5,0,1,1,0,0,2,"A","N","2013-03-18","201303180COL"
"COL",0,1,1,0,0,2,0,2,2,1,0,5,"H","N","2013-03-18","201303180COL"
"CGY",0,0,2,1,0,3,0,3,0,1,0,4,"A","N","2013-03-18","201303180DAL"
"DAL",0,3,0,1,0,4,0,0,2,1,0,3,"H","N","2013-03-18","201303180DAL"
"LAK",0,1,1,2,0,4,0,0,0,0,0,0,"H","N","2013-03-18","201303180LAK"
"PHX",0,0,0,0,0,0,0,1,1,2,0,4,"A","N","2013-03-18","201303180LAK"
"CAR",0,1,0,0,0,1,0,0,1,0,1,2,"A","Y","2013-03-18","201303180NYR"
"NYR",0,0,1,0,1,2,0,1,0,0,0,1,"H","Y","2013-03-18","201303180NYR"
"PHI",0,1,1,0,0,2,0,2,0,2,0,4,"A","N","2013-03-18","201303180TBL"
"TBL",0,2,0,2,0,4,0,1,1,0,0,2,"H","N","2013-03-18","201303180TBL"
"MIN",0,0,1,2,0,3,0,0,1,0,0,1,"A","N","2013-03-18","201303180VAN"
"VAN",0,0,1,0,0,1,0,0,1,2,0,3,"H","N","2013-03-18","201303180VAN"
"CAR",0,0,0,1,0,1,0,0,0,4,0,4,"H","N","2013-03-19","201303190CAR"
"FLA",0,0,0,4,0,4,0,0,0,1,0,1,"A","N","2013-03-19","201303190CAR"
"CBJ",0,0,2,2,0,4,0,0,1,2,0,3,"H","N","2013-03-19","201303190CBJ"
"NSH",0,0,1,2,0,3,0,0,2,2,0,4,"A","N","2013-03-19","201303190CBJ"
"LAK",0,1,1,1,0,3,0,0,0,2,0,2,"H","N","2013-03-19","201303190LAK"
"PHX",0,0,0,2,0,2,0,1,1,1,0,3,"A","N","2013-03-19","201303190LAK"
"BUF",1,2,0,0,0,3,0,0,0,2,0,2,"A","N","2013-03-19","201303190MTL"
"MTL",0,0,0,2,0,2,1,2,0,0,0,3,"H","N","2013-03-19","201303190MTL"
"NJD",0,2,0,0,0,2,0,2,1,0,0,3,"H","N","2013-03-19","201303190NJD"
"NYR",0,2,1,0,0,3,0,2,0,0,0,2,"A","N","2013-03-19","201303190NJD"
"NYI",0,1,2,0,0,3,0,1,0,4,0,5,"H","N","2013-03-19","201303190NYI"
"OTT",0,1,0,4,0,5,0,1,2,0,0,3,"A","N","2013-03-19","201303190NYI"
"PIT",0,0,1,1,0,2,0,0,1,0,0,1,"H","N","2013-03-19","201303190PIT"
"WSH",0,0,1,0,0,1,0,0,1,1,0,2,"A","N","2013-03-19","201303190PIT"
"STL",0,0,0,2,0,2,0,0,3,0,0,3,"A","N","2013-03-19","201303190VAN"
"VAN",0,0,3,0,0,3,0,0,0,2,0,2,"H","N","2013-03-19","201303190VAN"
"BOS",0,0,1,0,0,1,0,0,0,3,0,3,"A","N","2013-03-19","201303190WPG"
"WPG",0,0,0,3,0,3,0,0,1,0,0,1,"H","N","2013-03-19","201303190WPG"
"ANA",0,1,0,3,0,4,0,1,1,0,0,2,"H","N","2013-03-20","201303200ANA"
"CHI",0,1,1,0,0,2,0,1,0,3,0,4,"A","N","2013-03-20","201303200ANA"
"COL",0,0,2,2,0,4,0,2,1,0,0,3,"H","N","2013-03-20","201303200COL"
"DAL",0,2,1,0,0,3,0,0,2,2,0,4,"A","N","2013-03-20","201303200COL"
"DET",0,0,1,1,0,2,0,1,3,0,0,4,"H","N","2013-03-20","201303200DET"
"MIN",0,1,3,0,0,4,0,0,1,1,0,2,"A","N","2013-03-20","201303200DET"
"EDM",0,1,1,1,0,3,0,1,0,2,1,4,"H","Y","2013-03-20","201303200EDM"
"SJS",0,1,0,2,1,4,0,1,1,1,0,3,"A","Y","2013-03-20","201303200EDM"
"TBL",0,0,0,2,0,2,0,1,3,0,0,4,"A","N","2013-03-20","201303200TOR"
"TOR",0,1,3,0,0,4,0,0,0,2,0,2,"H","N","2013-03-20","201303200TOR"
"BUF",0,1,2,1,1,5,0,2,1,1,0,4,"H","Y","2013-03-21","201303210BUF"
"TOR",0,2,1,1,0,4,0,1,2,1,1,5,"A","Y","2013-03-21","201303210BUF"
"CAR",0,0,0,1,0,1,0,1,2,1,0,4,"H","N","2013-03-21","201303210CAR"
"NJD",0,1,2,1,0,4,0,0,0,1,0,1,"A","N","2013-03-21","201303210CAR"
"DAL",0,0,0,2,0,2,0,0,0,0,0,0,"A","N","2013-03-21","201303210LAK"
"LAK",0,0,0,0,0,0,0,0,0,2,0,2,"H","N","2013-03-21","201303210LAK"
"CGY",0,2,0,1,0,3,0,2,2,1,0,5,"A","N","2013-03-21","201303210NSH"
"NSH",0,2,2,1,0,5,0,2,0,1,0,3,"H","N","2013-03-21","201303210NSH"
"MTL",0,1,1,3,0,5,0,1,1,0,0,2,"A","N","2013-03-21","201303210NYI"
"NYI",0,1,1,0,0,2,0,1,1,3,0,5,"H","N","2013-03-21","201303210NYI"
"FLA",0,1,1,1,0,3,0,0,0,1,0,1,"A","N","2013-03-21","201303210NYR"
"NYR",0,0,0,1,0,1,0,1,1,1,0,3,"H","N","2013-03-21","201303210NYR"
"BOS",0,0,1,1,0,2,0,0,1,0,0,1,"A","N","2013-03-21","201303210OTT"
"OTT",0,0,1,0,0,1,0,0,1,1,0,2,"H","N","2013-03-21","201303210OTT"
"PHX",0,0,0,1,0,1,0,1,0,1,0,2,"H","N","2013-03-21","201303210PHX"
"VAN",0,1,0,1,0,2,0,0,0,1,0,1,"A","N","2013-03-21","201303210PHX"
"WPG",0,0,0,0,0,0,0,2,0,2,0,4,"H","N","2013-03-21","201303210WPG"
"WSH",0,2,0,2,0,4,0,0,0,0,0,0,"A","N","2013-03-21","201303210WPG"
"ANA",0,1,0,0,0,1,0,2,2,1,0,5,"H","N","2013-03-22","201303220ANA"
"DET",0,2,2,1,0,5,0,1,0,0,0,1,"A","N","2013-03-22","201303220ANA"
"CBJ",0,1,3,1,0,5,0,0,1,0,0,1,"H","N","2013-03-22","201303220CBJ"
"CGY",0,0,1,0,0,1,0,1,3,1,0,5,"A","N","2013-03-22","201303220CBJ"
"NYI",0,1,1,0,0,2,0,0,2,2,0,4,"H","N","2013-03-22","201303220NYI"
"PIT",0,0,2,2,0,4,0,1,1,0,0,2,"A","N","2013-03-22","201303220NYI"
"WPG",0,0,0,1,0,1,0,2,2,2,0,6,"H","N","2013-03-22","201303220WPG"
"WSH",0,2,2,2,0,6,0,0,0,1,0,1,"A","N","2013-03-22","201303220WPG"
"COL",0,0,1,1,0,2,0,2,2,1,0,5,"A","N","2013-03-23","201303230DAL"
"DAL",0,2,2,1,0,5,0,0,1,1,0,2,"H","N","2013-03-23","201303230DAL"
"EDM",0,0,0,0,0,0,0,1,0,2,0,3,"H","N","2013-03-23","201303230EDM"
"STL",0,1,0,2,0,3,0,0,0,0,0,0,"A","N","2013-03-23","201303230EDM"
"LAK",0,0,0,0,0,0,0,1,0,0,0,1,"H","N","2013-03-23","201303230LAK"
"VAN",0,1,0,0,0,1,0,0,0,0,0,0,"A","N","2013-03-23","201303230LAK"
"MIN",0,0,1,1,0,2,0,0,0,0,0,0,"H","N","2013-03-23","201303230MIN"
"SJS",0,0,0,0,0,0,0,0,1,1,0,2,"A","N","2013-03-23","201303230MIN"
"BUF",0,0,2,0,0,2,0,0,0,1,0,1,"A","N","2013-03-23","201303230MTL"
"MTL",0,0,0,1,0,1,0,0,2,0,0,2,"H","N","2013-03-23","201303230MTL"
"FLA",0,0,1,0,0,1,0,0,2,0,0,2,"A","N","2013-03-23","201303230NJD"
"NJD",0,0,2,0,0,2,0,0,1,0,0,1,"H","N","2013-03-23","201303230NJD"
"CBJ",0,1,1,0,0,2,0,4,0,1,0,5,"A","N","2013-03-23","201303230NSH"
"NSH",0,4,0,1,0,5,0,1,1,0,0,2,"H","N","2013-03-23","201303230NSH"
"OTT",0,4,0,1,0,5,0,0,0,3,0,3,"H","N","2013-03-23","201303230OTT"
"TBL",0,0,0,3,0,3,0,4,0,1,0,5,"A","N","2013-03-23","201303230OTT"
"BOS",0,0,0,2,0,2,0,1,1,1,0,3,"A","N","2013-03-23","201303230TOR"
"TOR",0,1,1,1,0,3,0,0,0,2,0,2,"H","N","2013-03-23","201303230TOR"
"ANA",0,0,1,0,0,1,0,2,0,0,0,2,"H","N","2013-03-24","201303240ANA"
"DET",0,2,0,0,0,2,0,0,1,0,0,1,"A","N","2013-03-24","201303240ANA"
"CGY",0,1,1,1,0,3,0,0,1,1,0,2,"H","N","2013-03-24","201303240CGY"
"STL",0,0,1,1,0,2,0,1,1,1,0,3,"A","N","2013-03-24","201303240CGY"
"COL",0,1,0,1,0,2,0,1,2,0,0,3,"H","N","2013-03-24","201303240COL"
"VAN",0,1,2,0,0,3,0,1,0,1,0,2,"A","N","2013-03-24","201303240COL"
"FLA",0,0,0,0,0,0,0,1,0,2,0,3,"A","N","2013-03-24","201303240NYI"
"NYI",0,1,0,2,0,3,0,0,0,0,0,0,"H","N","2013-03-24","201303240NYI"
"NYR",0,2,0,0,0,2,0,2,0,0,1,3,"H","Y","2013-03-24","201303240NYR"
"WSH",0,2,0,0,1,3,0,2,0,0,0,2,"A","Y","2013-03-24","201303240NYR"
"PHI",0,0,1,0,0,1,1,0,0,1,0,2,"A","N","2013-03-24","201303240PIT"
"PIT",1,0,0,1,0,2,0,0,1,0,0,1,"H","N","2013-03-24","201303240PIT"
"TBL",0,0,1,1,0,2,0,1,2,0,0,3,"A","N","2013-03-24","201303240WPG"
"WPG",0,1,2,0,0,3,0,0,1,1,0,2,"H","N","2013-03-24","201303240WPG"
"ANA",0,0,1,2,0,3,0,2,1,2,0,5,"H","N","2013-03-25","201303250ANA"
"SJS",0,2,1,2,0,5,0,0,1,2,0,3,"A","N","2013-03-25","201303250ANA"
"BOS",0,0,1,1,1,3,0,0,2,0,0,2,"H","Y","2013-03-25","201303250BOS"
"TOR",0,0,2,0,0,2,0,0,1,1,1,3,"A","Y","2013-03-25","201303250BOS"
"CHI",0,1,2,1,0,4,0,0,3,2,0,5,"H","N","2013-03-25","201303250CHI"
"LAK",0,0,3,2,0,5,0,1,2,1,0,4,"A","N","2013-03-25","201303250CHI"
"DAL",0,2,1,1,0,4,0,1,3,3,0,7,"H","N","2013-03-25","201303250DAL"
"MIN",0,1,3,3,0,7,0,2,1,1,0,4,"A","N","2013-03-25","201303250DAL"
"EDM",0,1,0,1,0,2,0,1,2,0,0,3,"A","N","2013-03-25","201303250NSH"
"NSH",0,1,2,0,0,3,0,1,0,1,0,2,"H","N","2013-03-25","201303250NSH"
"NJD",0,0,1,1,0,2,0,1,1,0,1,3,"A","Y","2013-03-25","201303250OTT"
"OTT",0,1,1,0,1,3,0,0,1,1,0,2,"H","Y","2013-03-25","201303250OTT"
"DET",0,1,1,1,0,3,0,2,0,0,0,2,"A","N","2013-03-25","201303250PHX"
"PHX",0,2,0,0,0,2,0,1,1,1,0,3,"H","N","2013-03-25","201303250PHX"
"CAR",0,1,0,0,0,1,0,1,2,1,0,4,"H","N","2013-03-26","201303260CAR"
"WPG",0,1,2,1,0,4,0,1,0,0,0,1,"A","N","2013-03-26","201303260CAR"
"CGY",0,0,0,0,0,0,0,1,1,0,0,2,"A","N","2013-03-26","201303260CHI"
"CHI",0,1,1,0,0,2,0,0,0,0,0,0,"H","N","2013-03-26","201303260CHI"
"NYR",0,1,2,2,0,5,0,0,1,1,0,2,"A","N","2013-03-26","201303260PHI"
"PHI",0,0,1,1,0,2,0,1,2,2,0,5,"H","N","2013-03-26","201303260PHI"
"MTL",0,0,0,0,0,0,0,0,1,0,0,1,"A","N","2013-03-26","201303260PIT"
"PIT",0,0,1,0,0,1,0,0,0,0,0,0,"H","N","2013-03-26","201303260PIT"
"EDM",0,1,2,0,0,3,0,0,0,0,0,0,"A","N","2013-03-26","201303260STL"
"STL",0,0,0,0,0,0,0,1,2,0,0,3,"H","N","2013-03-26","201303260STL"
"BUF",0,0,0,1,0,1,0,1,1,0,0,2,"A","N","2013-03-26","201303260TBL"
"TBL",0,1,1,0,0,2,0,0,0,1,0,1,"H","N","2013-03-26","201303260TBL"
"FLA",0,1,0,1,0,2,0,0,1,2,0,3,"A","N","2013-03-26","201303260TOR"
"TOR",0,0,1,2,0,3,0,1,0,1,0,2,"H","N","2013-03-26","201303260TOR"
"CBJ",0,0,0,0,0,0,0,0,0,0,1,1,"A","Y","2013-03-26","201303260VAN"
"VAN",0,0,0,0,1,1,0,0,0,0,0,0,"H","Y","2013-03-26","201303260VAN"
"NYI",0,2,0,1,0,3,0,0,2,0,0,2,"A","N","2013-03-26","201303260WSH"
"WSH",0,0,2,0,0,2,0,2,0,1,0,3,"H","N","2013-03-26","201303260WSH"
"BOS",0,0,4,1,0,5,0,1,1,3,1,6,"H","Y","2013-03-27","201303270BOS"
"MTL",0,1,1,3,1,6,0,0,4,1,0,5,"A","Y","2013-03-27","201303270BOS"
"CGY",0,2,2,0,0,4,0,0,2,1,0,3,"H","N","2013-03-27","201303270CGY"
"COL",0,0,2,1,0,3,0,2,2,0,0,4,"A","N","2013-03-27","201303270CGY"
"MIN",1,1,1,1,0,4,0,0,2,1,0,3,"H","N","2013-03-27","201303270MIN"
"PHX",0,0,2,1,0,3,1,1,1,1,0,4,"A","N","2013-03-27","201303270MIN"
"ANA",0,0,0,0,0,0,0,3,0,1,0,4,"A","N","2013-03-27","201303270SJS"
"SJS",0,3,0,1,0,4,0,0,0,0,0,0,"H","N","2013-03-27","201303270SJS"
"CBJ",0,2,1,1,0,4,0,1,2,3,0,6,"A","N","2013-03-28","201303280EDM"
"EDM",0,1,2,3,0,6,0,2,1,1,0,4,"H","N","2013-03-28","201303280EDM"
"BUF",0,0,3,1,0,4,0,1,1,2,1,5,"A","Y","2013-03-28","201303280FLA"
"FLA",0,1,1,2,1,5,0,0,3,1,0,4,"H","Y","2013-03-28","201303280FLA"
"NSH",0,3,0,1,0,4,0,6,1,0,0,7,"H","N","2013-03-28","201303280NSH"
"PHX",0,6,1,0,0,7,0,3,0,1,0,4,"A","N","2013-03-28","201303280NSH"
"NYR",0,0,0,0,0,0,0,0,1,2,0,3,"A","N","2013-03-28","201303280OTT"
"OTT",0,0,1,2,0,3,0,0,0,0,0,0,"H","N","2013-03-28","201303280OTT"
"NYI",0,0,1,2,1,4,0,2,0,1,0,3,"A","Y","2013-03-28","201303280PHI"
"PHI",0,2,0,1,0,3,0,0,1,2,1,4,"H","Y","2013-03-28","201303280PHI"
"PIT",0,2,2,0,0,4,0,0,0,0,0,0,"H","N","2013-03-28","201303280PIT"
"WPG",0,0,0,0,0,0,0,2,2,0,0,4,"A","N","2013-03-28","201303280PIT"
"DET",0,0,0,0,0,0,0,1,0,1,0,2,"A","N","2013-03-28","201303280SJS"
"SJS",0,1,0,1,0,2,0,0,0,0,0,0,"H","N","2013-03-28","201303280SJS"
"LAK",0,0,2,2,0,4,0,0,1,1,0,2,"A","N","2013-03-28","201303280STL"
"STL",0,0,1,1,0,2,0,0,2,2,0,4,"H","N","2013-03-28","201303280STL"
"CAR",0,0,2,1,0,3,0,1,1,4,0,6,"A","N","2013-03-28","201303280TOR"
"TOR",0,1,1,4,0,6,0,0,2,1,0,3,"H","N","2013-03-28","201303280TOR"
"COL",0,0,0,1,0,1,0,1,0,3,0,4,"A","N","2013-03-28","201303280VAN"
"VAN",0,1,0,3,0,4,0,0,0,1,0,1,"H","N","2013-03-28","201303280VAN"
"CBJ",0,1,4,1,0,6,0,0,3,1,0,4,"A","N","2013-03-29","201303290CGY"
"CGY",0,0,3,1,0,4,0,1,4,1,0,6,"H","N","2013-03-29","201303290CGY"
"ANA",0,0,1,1,0,2,0,0,0,1,0,1,"A","N","2013-03-29","201303290CHI"
"CHI",0,0,0,1,0,1,0,0,1,1,0,2,"H","N","2013-03-29","201303290CHI"
"DAL",0,2,0,3,0,5,0,1,1,1,0,3,"H","N","2013-03-29","201303290DAL"
"MIN",0,1,1,1,0,3,0,2,0,3,0,5,"A","N","2013-03-29","201303290DAL"
"NJD",0,0,3,1,0,4,0,0,2,2,1,5,"A","Y","2013-03-29","201303290TBL"
"TBL",0,0,2,2,1,5,0,0,3,1,0,4,"H","Y","2013-03-29","201303290TBL"
"BUF",0,1,2,0,0,3,0,0,1,2,1,4,"H","Y","2013-03-30","201303300BUF"
"WSH",0,0,1,2,1,4,0,1,2,0,0,3,"A","Y","2013-03-30","201303300BUF"
"COL",1,0,0,0,0,1,0,0,0,0,0,0,"H","N","2013-03-30","201303300COL"
"NSH",0,0,0,0,0,0,1,0,0,0,0,1,"A","N","2013-03-30","201303300COL"
"EDM",0,4,0,0,0,4,0,0,0,0,0,0,"H","N","2013-03-30","201303300EDM"
"VAN",0,0,0,0,0,0,0,4,0,0,0,4,"A","N","2013-03-30","201303300EDM"
"FLA",1,1,0,1,0,3,0,1,0,1,0,2,"H","N","2013-03-30","201303300FLA"
"NJD",0,1,0,1,0,2,1,1,0,1,0,3,"A","N","2013-03-30","201303300FLA"
"LAK",0,1,2,0,0,3,0,1,1,1,1,4,"A","Y","2013-03-30","201303300MIN"
"MIN",0,1,1,1,1,4,0,1,2,0,0,3,"H","Y","2013-03-30","201303300MIN"
"MTL",0,2,1,0,0,3,0,0,0,0,0,0,"H","N","2013-03-30","201303300MTL"
"NYR",0,0,0,0,0,0,0,2,1,0,0,3,"A","N","2013-03-30","201303300MTL"
"OTT",0,0,0,0,0,0,0,1,1,2,0,4,"H","N","2013-03-30","201303300OTT"
"TOR",0,1,1,2,0,4,0,0,0,0,0,0,"A","N","2013-03-30","201303300OTT"
"BOS",0,0,0,1,0,1,0,1,1,1,0,3,"A","N","2013-03-30","201303300PHI"
"PHI",0,1,1,1,0,3,0,0,0,1,0,1,"H","N","2013-03-30","201303300PHI"
"NYI",0,0,0,0,0,0,0,0,0,2,0,2,"A","N","2013-03-30","201303300PIT"
"PIT",0,0,0,2,0,2,0,0,0,0,0,0,"H","N","2013-03-30","201303300PIT"
"PHX",0,1,0,1,0,2,0,0,1,1,1,3,"A","Y","2013-03-30","201303300SJS"
"SJS",0,0,1,1,1,3,0,1,0,1,0,2,"H","Y","2013-03-30","201303300SJS"
"CAR",0,2,0,1,0,3,0,0,1,0,0,1,"A","N","2013-03-30","201303300WPG"
"WPG",0,0,1,0,0,1,0,2,0,1,0,3,"H","N","2013-03-30","201303300WPG"
"BOS",0,0,0,2,0,2,0,0,0,0,0,0,"A","N","2013-03-31","201303310BUF"
"BUF",0,0,0,0,0,0,0,0,0,2,0,2,"H","N","2013-03-31","201303310BUF"
"ANA",0,0,0,1,0,1,1,0,1,0,0,2,"A","N","2013-03-31","201303310CBJ"
"CBJ",1,0,1,0,0,2,0,0,0,1,0,1,"H","N","2013-03-31","201303310CBJ"
"DAL",0,0,1,1,0,2,0,1,0,2,0,3,"H","N","2013-03-31","201303310DAL"
"LAK",0,1,0,2,0,3,0,0,1,1,0,2,"A","N","2013-03-31","201303310DAL"
"CHI",0,3,2,2,0,7,0,0,0,1,0,1,"A","N","2013-03-31","201303310DET"
"DET",0,0,0,1,0,1,0,3,2,2,0,7,"H","N","2013-03-31","201303310DET"
"PHI",1,2,0,2,0,5,0,1,1,2,0,4,"H","N","2013-03-31","201303310PHI"
"WSH",0,1,1,2,0,4,1,2,0,2,0,5,"A","N","2013-03-31","201303310PHI"
"CHI",0,1,1,0,1,3,0,0,0,2,0,2,"H","Y","2013-04-01","201304010CHI"
"NSH",0,0,0,2,0,2,0,1,1,0,1,3,"A","Y","2013-04-01","201304010CHI"
"ANA",0,0,3,1,0,4,0,0,0,0,0,0,"A","N","2013-04-01","201304010DAL"
"DAL",0,0,0,0,0,0,0,0,3,1,0,4,"H","N","2013-04-01","201304010DAL"
"COL",0,0,0,2,0,2,0,1,2,0,0,3,"A","N","2013-04-01","201304010DET"
"DET",0,1,2,0,0,3,0,0,0,2,0,2,"H","N","2013-04-01","201304010DET"
"CGY",0,0,0,1,0,1,0,3,0,1,0,4,"A","N","2013-04-01","201304010EDM"
"EDM",0,3,0,1,0,4,0,0,0,1,0,1,"H","N","2013-04-01","201304010EDM"
"MIN",0,0,1,0,0,1,0,1,2,1,0,4,"H","N","2013-04-01","201304010MIN"
"STL",0,1,2,1,0,4,0,0,1,0,0,1,"A","N","2013-04-01","201304010MIN"
"CAR",0,1,0,0,0,1,0,1,1,2,0,4,"A","N","2013-04-01","201304010MTL"
"MTL",0,1,1,2,0,4,0,1,0,0,0,1,"H","N","2013-04-01","201304010MTL"
"NJD",0,0,1,0,0,1,0,2,0,1,0,3,"H","N","2013-04-01","201304010NJD"
"NYI",0,2,0,1,0,3,0,0,1,0,0,1,"A","N","2013-04-01","201304010NJD"
"NYR",0,1,1,2,0,4,0,2,0,0,0,2,"H","N","2013-04-01","201304010NYR"
"WPG",0,2,0,0,0,2,0,1,1,2,0,4,"A","N","2013-04-01","201304010NYR"
"SJS",0,0,3,0,0,3,0,0,1,1,0,2,"H","N","2013-04-01","201304010SJS"
"VAN",0,0,1,1,0,2,0,0,3,0,0,3,"A","N","2013-04-01","201304010SJS"
"BOS",0,2,0,1,0,3,0,1,0,1,0,2,"H","N","2013-04-02","201304020BOS"
"OTT",0,1,0,1,0,2,0,2,0,1,0,3,"A","N","2013-04-02","201304020BOS"
"CAR",0,2,1,0,0,3,0,1,4,0,0,5,"H","N","2013-04-02","201304020CAR"
"WSH",0,1,4,0,0,5,0,2,1,0,0,3,"A","N","2013-04-02","201304020CAR"
"COL",0,0,0,1,0,1,0,0,0,3,0,3,"A","N","2013-04-02","201304020NSH"
"NSH",0,0,0,3,0,3,0,0,0,1,0,1,"H","N","2013-04-02","201304020NSH"
"NYI",0,1,2,2,0,5,0,1,1,0,0,2,"H","N","2013-04-02","201304020NYI"
"WPG",0,1,1,0,0,2,0,1,2,2,0,5,"A","N","2013-04-02","201304020NYI"
"LAK",0,1,0,0,0,1,0,1,1,1,0,3,"A","N","2013-04-02","201304020PHX"
"PHX",0,1,1,1,0,3,0,1,0,0,0,1,"H","N","2013-04-02","201304020PHX"
"BUF",0,2,2,0,0,4,0,1,0,0,0,1,"A","N","2013-04-02","201304020PIT"
"PIT",0,1,0,0,0,1,0,2,2,0,0,4,"H","N","2013-04-02","201304020PIT"
"FLA",0,1,1,0,1,3,0,0,0,2,0,2,"A","Y","2013-04-02","201304020TBL"
"TBL",0,0,0,2,0,2,0,1,1,0,1,3,"H","Y","2013-04-02","201304020TBL"
"ANA",0,1,2,2,0,5,0,0,0,2,0,2,"H","N","2013-04-03","201304030ANA"
"DAL",0,0,0,2,0,2,0,1,2,2,0,5,"A","N","2013-04-03","201304030ANA"
"CGY",0,2,0,0,0,2,0,2,3,3,0,8,"H","N","2013-04-03","201304030CGY"
"EDM",0,2,3,3,0,8,0,2,0,0,0,2,"A","N","2013-04-03","201304030CGY"
"NYR",0,3,2,1,0,6,0,0,1,0,0,1,"H","N","2013-04-03","201304030NYR"
"PIT",0,0,1,0,0,1,0,3,2,1,0,6,"A","N","2013-04-03","201304030NYR"
"MTL",0,1,2,0,0,3,0,0,2,3,0,5,"A","N","2013-04-03","201304030PHI"
"PHI",0,0,2,3,0,5,0,1,2,0,0,3,"H","N","2013-04-03","201304030PHI"
"MIN",0,0,2,0,0,2,0,2,1,1,0,4,"A","N","2013-04-03","201304030SJS"
"SJS",0,2,1,1,0,4,0,0,2,0,0,2,"H","N","2013-04-03","201304030SJS"
"BOS",0,0,1,0,0,1,0,0,0,0,0,0,"H","N","2013-04-04","201304040BOS"
"NJD",0,0,0,0,0,0,0,0,1,0,0,1,"A","N","2013-04-04","201304040BOS"
"CAR",0,0,0,0,0,0,0,0,3,2,0,5,"H","N","2013-04-04","201304040CAR"
"TBL",0,0,3,2,0,5,0,0,0,0,0,0,"A","N","2013-04-04","201304040CAR"
"CHI",0,0,2,1,0,3,0,1,0,2,1,4,"H","Y","2013-04-04","201304040CHI"
"STL",0,1,0,2,1,4,0,0,2,1,0,3,"A","Y","2013-04-04","201304040CHI"
"LAK",0,2,1,0,0,3,0,0,0,0,0,0,"H","N","2013-04-04","201304040LAK"
"MIN",0,0,0,0,0,0,0,2,1,0,0,3,"A","N","2013-04-04","201304040LAK"
"MTL",0,1,2,1,0,4,0,1,0,0,0,1,"H","N","2013-04-04","201304040MTL"
"WPG",0,1,0,0,0,1,0,1,2,1,0,4,"A","N","2013-04-04","201304040MTL"
"CBJ",0,0,1,2,0,3,0,0,1,0,0,1,"A","N","2013-04-04","201304040NSH"
"NSH",0,0,1,0,0,1,0,0,1,2,0,3,"H","N","2013-04-04","201304040NSH"
"DET",0,1,0,1,0,2,0,0,3,1,0,4,"A","N","2013-04-04","201304040PHX"
"PHX",0,0,3,1,0,4,0,1,0,1,0,2,"H","N","2013-04-04","201304040PHX"
"PHI",0,2,2,1,0,5,0,2,0,1,0,3,"A","N","2013-04-04","201304040TOR"
"TOR",0,2,0,1,0,3,0,2,2,1,0,5,"H","N","2013-04-04","201304040TOR"
"EDM",0,0,0,0,0,0,0,1,1,2,0,4,"A","N","2013-04-04","201304040VAN"
"VAN",0,1,1,2,0,4,0,0,0,0,0,0,"H","N","2013-04-04","201304040VAN"
"NYI",0,0,0,1,0,1,0,1,0,0,1,2,"A","Y","2013-04-04","201304040WSH"
"WSH",0,1,0,0,1,2,0,0,0,1,0,1,"H","Y","2013-04-04","201304040WSH"
"ANA",0,1,0,0,0,1,0,3,0,0,0,3,"H","N","2013-04-05","201304050ANA"
"DAL",0,3,0,0,0,3,0,1,0,0,0,1,"A","N","2013-04-05","201304050ANA"
"BUF",0,1,0,3,0,4,0,1,0,1,0,2,"H","N","2013-04-05","201304050BUF"
"OTT",0,1,0,1,0,2,0,1,0,3,0,4,"A","N","2013-04-05","201304050BUF"
"COL",0,1,0,1,0,2,1,2,0,0,0,3,"H","N","2013-04-05","201304050COL"
"DET",1,2,0,0,0,3,0,1,0,1,0,2,"A","N","2013-04-05","201304050COL"
"NYR",0,0,0,1,0,1,0,0,0,1,1,2,"A","Y","2013-04-05","201304050PIT"
"PIT",0,0,0,1,1,2,0,0,0,1,0,1,"H","Y","2013-04-05","201304050PIT"
"CGY",0,1,0,0,0,1,0,0,0,2,0,2,"A","N","2013-04-05","201304050SJS"
"SJS",0,0,0,2,0,2,0,1,0,0,0,1,"H","N","2013-04-05","201304050SJS"
"CBJ",0,0,1,0,0,1,0,0,2,1,0,3,"A","N","2013-04-05","201304050STL"
"STL",0,0,2,1,0,3,0,0,1,0,0,1,"H","N","2013-04-05","201304050STL"
"CAR",0,0,0,1,0,1,0,0,3,1,0,4,"H","N","2013-04-06","201304060CAR"
"NYR",0,0,3,1,0,4,0,0,0,1,0,1,"A","N","2013-04-06","201304060CAR"
"FLA",0,0,0,3,0,3,0,1,3,0,0,4,"H","N","2013-04-06","201304060FLA"
"WSH",0,1,3,0,0,4,0,0,0,3,0,3,"A","N","2013-04-06","201304060FLA"
"EDM",0,0,1,0,0,1,0,2,1,1,0,4,"A","N","2013-04-06","201304060LAK"
"LAK",0,2,1,1,0,4,0,0,1,0,0,1,"H","N","2013-04-06","201304060LAK"
"BOS",0,0,1,0,0,1,0,1,1,0,0,2,"A","N","2013-04-06","201304060MTL"
"MTL",0,1,1,0,0,2,0,0,1,0,0,1,"H","N","2013-04-06","201304060MTL"
"NJD",0,0,0,1,0,1,0,1,0,1,0,2,"H","N","2013-04-06","201304060NJD"
"TOR",0,1,0,1,0,2,0,0,0,1,0,1,"A","N","2013-04-06","201304060NJD"
"CHI",0,1,0,0,0,1,0,0,0,0,0,0,"A","N","2013-04-06","201304060NSH"
"NSH",0,0,0,0,0,0,0,1,0,0,0,1,"H","N","2013-04-06","201304060NSH"
"NYI",0,1,1,2,0,4,0,0,1,1,0,2,"H","N","2013-04-06","201304060NYI"
"TBL",0,0,1,1,0,2,0,1,1,2,0,4,"A","N","2013-04-06","201304060NYI"
"COL",0,0,0,0,0,0,0,1,3,0,0,4,"A","N","2013-04-06","201304060PHX"
"PHX",0,1,3,0,0,4,0,0,0,0,0,0,"H","N","2013-04-06","201304060PHX"
"CGY",0,1,0,1,0,2,0,2,2,1,0,5,"A","N","2013-04-06","201304060VAN"
"VAN",0,2,2,1,0,5,0,1,0,1,0,2,"H","N","2013-04-06","201304060VAN"
"PHI",0,1,0,0,0,1,0,0,4,0,0,4,"A","N","2013-04-06","201304060WPG"
"WPG",0,0,4,0,0,4,0,1,0,0,0,1,"H","N","2013-04-06","201304060WPG"
"ANA",0,1,1,1,1,4,0,0,2,1,0,3,"H","Y","2013-04-07","201304070ANA"
"LAK",0,0,2,1,0,3,0,1,1,1,1,4,"A","Y","2013-04-07","201304070ANA"
"BUF",0,1,1,0,1,3,0,1,0,1,0,2,"H","Y","2013-04-07","201304070BUF"
"NJD",0,1,0,1,0,2,0,1,1,0,1,3,"A","Y","2013-04-07","201304070BUF"
"CBJ",0,0,0,0,0,0,0,0,2,1,0,3,"H","N","2013-04-07","201304070CBJ"
"MIN",0,0,2,1,0,3,0,0,0,0,0,0,"A","N","2013-04-07","201304070CBJ"
"CHI",0,1,1,3,0,5,0,1,1,1,0,3,"H","N","2013-04-07","201304070CHI"
"NSH",0,1,1,1,0,3,0,1,1,3,0,5,"A","N","2013-04-07","201304070CHI"
"DET",0,0,0,0,0,0,0,0,1,0,0,1,"H","N","2013-04-07","201304070DET"
"STL",0,0,1,0,0,1,0,0,0,0,0,0,"A","N","2013-04-07","201304070DET"
"FLA",0,0,1,1,0,2,0,1,0,0,0,1,"H","N","2013-04-07","201304070FLA"
"OTT",0,1,0,0,0,1,0,0,1,1,0,2,"A","N","2013-04-07","201304070FLA"
"DAL",0,0,2,2,1,5,0,1,3,0,0,4,"A","Y","2013-04-07","201304070SJS"
"SJS",0,1,3,0,0,4,0,0,2,2,1,5,"H","Y","2013-04-07","201304070SJS"
"TBL",0,1,1,0,0,2,0,0,3,1,0,4,"A","N","2013-04-07","201304070WSH"
"WSH",0,0,3,1,0,4,0,1,1,0,0,2,"H","N","2013-04-07","201304070WSH"
"ANA",0,1,0,1,0,2,0,0,0,1,0,1,"H","N","2013-04-08","201304080ANA"
"EDM",0,0,0,1,0,1,0,1,0,1,0,2,"A","N","2013-04-08","201304080ANA"
"BOS",0,3,2,1,0,6,0,0,0,2,0,2,"H","N","2013-04-08","201304080BOS"
"CAR",0,0,0,2,0,2,0,3,2,1,0,6,"A","N","2013-04-08","201304080BOS"
"CGY",0,0,2,1,0,3,0,0,1,0,0,1,"A","N","2013-04-08","201304080COL"
"COL",0,0,1,0,0,1,0,0,2,1,0,3,"H","N","2013-04-08","201304080COL"
"NYR",0,0,1,2,0,3,0,1,2,1,0,4,"A","N","2013-04-08","201304080TOR"
"TOR",0,1,2,1,0,4,0,0,1,2,0,3,"H","N","2013-04-08","201304080TOR"
"PHX",0,0,0,0,0,0,0,1,0,1,0,2,"A","N","2013-04-08","201304080VAN"
"VAN",0,1,0,1,0,2,0,0,0,0,0,0,"H","N","2013-04-08","201304080VAN"
"CAR",0,2,0,1,0,3,0,2,0,3,0,5,"H","N","2013-04-09","201304090CAR"
"PIT",0,2,0,3,0,5,0,2,0,1,0,3,"A","N","2013-04-09","201304090CAR"
"CBJ",0,1,2,1,0,4,0,0,0,0,0,0,"H","N","2013-04-09","201304090CBJ"
"SJS",0,0,0,0,0,0,0,1,2,1,0,4,"A","N","2013-04-09","201304090CBJ"
"DAL",0,1,0,4,0,5,0,1,0,0,0,1,"H","N","2013-04-09","201304090DAL"
"LAK",0,1,0,0,0,1,0,1,0,4,0,5,"A","N","2013-04-09","201304090DAL"
"CHI",0,0,1,0,0,1,0,0,0,0,0,0,"A","N","2013-04-09","201304090MIN"
"MIN",0,0,0,0,0,0,0,0,1,0,0,1,"H","N","2013-04-09","201304090MIN"
"MTL",0,1,0,1,0,2,0,0,2,1,0,3,"H","N","2013-04-09","201304090MTL"
"WSH",0,0,2,1,0,3,0,1,0,1,0,2,"A","N","2013-04-09","201304090MTL"
"NSH",0,0,0,0,0,0,0,0,1,0,0,1,"H","N","2013-04-09","201304090NSH"
"STL",0,0,1,0,0,1,0,0,0,0,0,0,"A","N","2013-04-09","201304090NSH"
"NYI",0,1,1,2,0,4,0,1,0,0,0,1,"H","N","2013-04-09","201304090NYI"
"PHI",0,1,0,0,0,1,0,1,1,2,0,4,"A","N","2013-04-09","201304090NYI"
"OTT",0,1,0,1,0,2,0,0,2,1,0,3,"A","N","2013-04-09","201304090TBL"
"TBL",0,0,2,1,0,3,0,1,0,1,0,2,"H","N","2013-04-09","201304090TBL"
"BUF",0,0,0,1,0,1,0,0,3,1,0,4,"A","N","2013-04-09","201304090WPG"
"WPG",0,0,3,1,0,4,0,0,0,1,0,1,"H","N","2013-04-09","201304090WPG"
"ANA",0,0,1,0,0,1,0,1,3,0,0,4,"H","N","2013-04-10","201304100ANA"
"COL",0,1,3,0,0,4,0,0,1,0,0,1,"A","N","2013-04-10","201304100ANA"
"CGY",0,1,0,0,0,1,0,1,0,3,0,4,"H","N","2013-04-10","201304100CGY"
"VAN",0,1,0,3,0,4,0,1,0,0,0,1,"A","N","2013-04-10","201304100CGY"
"EDM",0,0,0,1,0,1,0,0,2,1,0,3,"H","N","2013-04-10","201304100EDM"
"PHX",0,0,2,1,0,3,0,0,0,1,0,1,"A","N","2013-04-10","201304100EDM"
"BOS",0,3,1,1,0,5,0,0,2,2,0,4,"A","N","2013-04-10","201304100NJD"
"NJD",0,0,2,2,0,4,0,3,1,1,0,5,"H","N","2013-04-10","201304100NJD"
"NYR",0,0,2,0,1,3,0,0,1,1,0,2,"H","Y","2013-04-10","201304100NYR"
"TOR",0,0,1,1,0,2,0,0,2,0,1,3,"A","Y","2013-04-10","201304100NYR"
"BOS",0,0,1,0,0,1,0,1,1,0,0,2,"H","N","2013-04-11","201304110BOS"
"NYI",0,1,1,0,0,2,0,0,1,0,0,1,"A","N","2013-04-11","201304110BOS"
"BUF",0,0,0,1,0,1,0,2,2,1,0,5,"H","N","2013-04-11","201304110BUF"
"MTL",0,2,2,1,0,5,0,0,0,1,0,1,"A","N","2013-04-11","201304110BUF"
"DET",0,0,1,1,0,2,0,1,0,1,1,3,"H","Y","2013-04-11","201304110DET"
"SJS",0,1,0,1,1,3,0,0,1,1,0,2,"A","Y","2013-04-11","201304110DET"
"COL",0,0,1,1,0,2,0,2,0,0,1,3,"A","Y","2013-04-11","201304110LAK"
"LAK",0,2,0,0,1,3,0,0,1,1,0,2,"H","Y","2013-04-11","201304110LAK"
"MIN",0,0,0,0,0,0,0,1,0,1,0,2,"H","N","2013-04-11","201304110MIN"
"STL",0,1,0,1,0,2,0,0,0,0,0,0,"A","N","2013-04-11","201304110MIN"
"OTT",0,1,0,2,0,3,0,1,0,0,0,1,"A","N","2013-04-11","201304110PHI"
"PHI",0,1,0,0,0,1,0,1,0,2,0,3,"H","N","2013-04-11","201304110PHI"
"PIT",0,2,1,3,0,6,0,1,1,1,0,3,"A","N","2013-04-11","201304110TBL"
"TBL",0,1,1,1,0,3,0,2,1,3,0,6,"H","N","2013-04-11","201304110TBL"
"FLA",0,2,0,0,0,2,0,3,3,1,0,7,"A","N","2013-04-11","201304110WPG"
"WPG",0,3,3,1,0,7,0,2,0,0,0,2,"H","N","2013-04-11","201304110WPG"
"CAR",0,1,0,0,0,1,0,0,2,1,0,3,"A","N","2013-04-11","201304110WSH"
"WSH",0,0,2,1,0,3,0,1,0,0,0,1,"H","N","2013-04-11","201304110WSH"
"CBJ",0,1,2,1,0,4,0,1,0,0,0,1,"H","N","2013-04-12","201304120CBJ"
"STL",0,1,0,0,0,1,0,1,2,1,0,4,"A","N","2013-04-12","201304120CBJ"
"CGY",1,1,1,0,0,3,0,1,0,1,0,2,"H","N","2013-04-12","201304120CGY"
"PHX",0,1,0,1,0,2,1,1,1,0,0,3,"A","N","2013-04-12","201304120CGY"
"CHI",0,0,1,1,1,3,0,0,2,0,0,2,"H","Y","2013-04-12","201304120CHI"
"DET",0,0,2,0,0,2,0,0,1,1,1,3,"A","Y","2013-04-12","201304120CHI"
"NJD",0,0,0,0,0,0,0,0,2,0,0,2,"H","N","2013-04-12","201304120NJD"
"OTT",0,0,2,0,0,2,0,0,0,0,0,0,"A","N","2013-04-12","201304120NJD"
"DAL",0,2,2,1,0,5,0,1,0,1,0,2,"A","N","2013-04-12","201304120NSH"
"NSH",0,1,0,1,0,2,0,2,2,1,0,5,"H","N","2013-04-12","201304120NSH"
"BUF",0,0,0,1,0,1,0,0,0,0,0,0,"H","N","2013-04-13","201304130BUF"
"PHI",0,0,0,0,0,0,0,0,0,1,0,1,"A","N","2013-04-13","201304130BUF"
"BOS",0,1,1,0,0,2,0,1,1,2,0,4,"A","N","2013-04-13","201304130CAR"
"CAR",0,1,1,2,0,4,0,1,1,0,0,2,"H","N","2013-04-13","201304130CAR"
"COL",0,1,0,3,0,4,0,0,2,1,0,3,"H","N","2013-04-13","201304130COL"
"VAN",0,0,2,1,0,3,0,1,0,3,0,4,"A","N","2013-04-13","201304130COL"
"DAL",0,2,0,0,0,2,0,0,0,1,0,1,"H","N","2013-04-13","201304130DAL"
"SJS",0,0,0,1,0,1,0,2,0,0,0,2,"A","N","2013-04-13","201304130DAL"
"CGY",0,1,2,1,0,4,0,1,0,0,0,1,"A","N","2013-04-13","201304130EDM"
"EDM",0,1,0,0,0,1,0,1,2,1,0,4,"H","N","2013-04-13","201304130EDM"
"FLA",0,0,1,0,0,1,0,2,0,1,0,3,"H","N","2013-04-13","201304130FLA"
"PIT",0,2,0,1,0,3,0,0,1,0,0,1,"A","N","2013-04-13","201304130FLA"
"ANA",0,0,1,0,0,1,0,1,1,0,0,2,"A","N","2013-04-13","201304130LAK"
"LAK",0,1,1,0,0,2,0,0,1,0,0,1,"H","N","2013-04-13","201304130LAK"
"CBJ",0,0,2,0,1,3,0,1,0,1,0,2,"A","Y","2013-04-13","201304130MIN"
"MIN",0,1,0,1,0,2,0,0,2,0,1,3,"H","Y","2013-04-13","201304130MIN"
"NYI",0,0,0,0,0,0,1,0,0,0,0,1,"H","N","2013-04-13","201304130NYI"
"NYR",1,0,0,0,0,1,0,0,0,0,0,0,"A","N","2013-04-13","201304130NYI"
"MTL",0,1,0,0,0,1,0,4,1,0,0,5,"A","N","2013-04-13","201304130TOR"
"TOR",0,4,1,0,0,5,0,1,0,0,0,1,"H","N","2013-04-13","201304130TOR"
"TBL",0,0,2,3,0,5,1,3,2,0,0,6,"A","N","2013-04-13","201304130WSH"
"WSH",1,3,2,0,0,6,0,0,2,3,0,5,"H","N","2013-04-13","201304130WSH"
"BUF",0,1,2,0,0,3,0,0,1,0,0,1,"H","N","2013-04-14","201304140BUF"
"TBL",0,0,1,0,0,1,0,1,2,0,0,3,"A","N","2013-04-14","201304140BUF"
"DET",0,0,1,2,0,3,0,0,0,0,0,0,"A","N","2013-04-14","201304140NSH"
"NSH",0,0,0,0,0,0,0,0,1,2,0,3,"H","N","2013-04-14","201304140NSH"
"CHI",0,0,1,1,0,2,0,0,0,0,0,0,"A","N","2013-04-14","201304140STL"
"STL",0,0,0,0,0,0,0,0,1,1,0,2,"H","N","2013-04-14","201304140STL"
"CGY",0,0,0,3,0,3,0,1,1,2,0,4,"H","N","2013-04-15","201304150CGY"
"MIN",0,1,1,2,0,4,0,0,0,3,0,3,"A","N","2013-04-15","201304150CGY"
"CHI",0,1,1,3,0,5,0,0,1,1,0,2,"H","N","2013-04-15","201304150CHI"
"DAL",0,0,1,1,0,2,0,1,1,3,0,5,"A","N","2013-04-15","201304150CHI"
"CBJ",1,0,1,2,0,4,0,0,1,2,0,3,"A","N","2013-04-15","201304150COL"
"COL",0,0,1,2,0,3,1,0,1,2,0,4,"H","N","2013-04-15","201304150COL"
"MTL",0,1,2,0,0,3,0,2,4,1,0,7,"H","N","2013-04-15","201304150MTL"
"PHI",0,2,4,1,0,7,0,1,2,0,0,3,"A","N","2013-04-15","201304150MTL"
"NSH",0,0,2,0,0,2,0,2,1,2,0,5,"H","N","2013-04-15","201304150NSH"
"VAN",0,2,1,2,0,5,0,0,2,0,0,2,"A","N","2013-04-15","201304150NSH"
"PHX",0,0,0,0,0,0,0,0,3,1,0,4,"H","N","2013-04-15","201304150PHX"
"SJS",0,0,3,1,0,4,0,0,0,0,0,0,"A","N","2013-04-15","201304150PHX"
"NJD",0,0,0,0,0,0,0,0,0,2,0,2,"A","N","2013-04-15","201304150TOR"
"TOR",0,0,0,2,0,2,0,0,0,0,0,0,"H","N","2013-04-15","201304150TOR"
"EDM",0,1,0,2,0,3,0,1,2,2,0,5,"H","N","2013-04-16","201304160EDM"
"MIN",0,1,2,2,0,5,0,1,0,2,0,3,"A","N","2013-04-16","201304160EDM"
"FLA",0,1,1,0,0,2,0,3,2,0,0,5,"A","N","2013-04-16","201304160NYI"
"NYI",0,3,2,0,0,5,0,1,1,0,0,2,"H","N","2013-04-16","201304160NYI"
"CAR",0,0,1,1,0,2,0,1,2,0,0,3,"A","N","2013-04-16","201304160OTT"
"OTT",0,1,2,0,0,3,0,0,1,1,0,2,"H","N","2013-04-16","201304160OTT"
"NYR",0,0,1,1,0,2,0,2,1,1,0,4,"A","N","2013-04-16","201304160PHI"
"PHI",0,2,1,1,0,4,0,0,1,1,0,2,"H","N","2013-04-16","201304160PHI"
"LAK",0,0,2,0,0,2,0,0,2,0,1,3,"A","Y","2013-04-16","201304160SJS"
"SJS",0,0,2,0,1,3,0,0,2,0,0,2,"H","Y","2013-04-16","201304160SJS"
"STL",0,0,0,1,1,2,0,0,1,0,0,1,"H","Y","2013-04-16","201304160STL"
"VAN",0,0,1,0,0,1,0,0,0,1,1,2,"A","Y","2013-04-16","201304160STL"
"TBL",0,1,0,2,0,3,0,1,2,0,1,4,"A","Y","2013-04-16","201304160WPG"
"WPG",0,1,2,0,1,4,0,1,0,2,0,3,"H","Y","2013-04-16","201304160WPG"
"TOR",0,0,0,1,0,1,0,1,3,1,0,5,"A","N","2013-04-16","201304160WSH"
"WSH",0,1,3,1,0,5,0,0,0,1,0,1,"H","N","2013-04-16","201304160WSH"
"ANA",0,1,0,1,0,2,1,0,1,1,0,3,"H","N","2013-04-17","201304170ANA"
"CBJ",1,0,1,1,0,3,0,1,0,1,0,2,"A","N","2013-04-17","201304170ANA"
"BOS",0,1,1,0,0,2,0,1,0,1,1,3,"H","Y","2013-04-17","201304170BOS"
"BUF",0,1,0,1,1,3,0,1,1,0,0,2,"A","Y","2013-04-17","201304170BOS"
"CGY",0,1,0,2,0,3,0,0,1,1,0,2,"H","N","2013-04-17","201304170CGY"
"DET",0,0,1,1,0,2,0,1,0,2,0,3,"A","N","2013-04-17","201304170CGY"
"MTL",0,0,2,2,0,4,0,3,2,1,0,6,"A","N","2013-04-17","201304170PIT"
"PIT",0,3,2,1,0,6,0,0,2,2,0,4,"H","N","2013-04-17","201304170PIT"
"DAL",0,0,1,4,0,5,0,0,1,0,0,1,"H","N","2013-04-18","201304180DAL"
"VAN",0,0,1,0,0,1,0,0,1,4,0,5,"A","N","2013-04-18","201304180DAL"
"CBJ",0,0,1,0,0,1,0,1,1,0,0,2,"A","N","2013-04-18","201304180LAK"
"LAK",0,1,1,0,0,2,0,0,1,0,0,1,"H","N","2013-04-18","201304180LAK"
"MTL",0,0,2,1,0,3,0,0,1,1,0,2,"H","N","2013-04-18","201304180MTL"
"TBL",0,0,1,1,0,2,0,0,2,1,0,3,"A","N","2013-04-18","201304180MTL"
"FLA",0,1,0,0,0,1,0,2,1,3,0,6,"A","N","2013-04-18","201304180NYR"
"NYR",0,2,1,3,0,6,0,1,0,0,0,1,"H","N","2013-04-18","201304180NYR"
"OTT",0,0,2,1,0,3,0,0,1,0,0,1,"H","N","2013-04-18","201304180OTT"
"WSH",0,0,1,0,0,1,0,0,2,1,0,3,"A","N","2013-04-18","201304180OTT"
"NJD",0,0,1,2,0,3,0,0,0,0,0,0,"A","N","2013-04-18","201304180PHI"
"PHI",0,0,0,0,0,0,0,0,1,2,0,3,"H","N","2013-04-18","201304180PHI"
"MIN",0,0,1,0,0,1,0,1,2,3,0,6,"A","N","2013-04-18","201304180SJS"
"SJS",0,1,2,3,0,6,0,0,1,0,0,1,"H","N","2013-04-18","201304180SJS"
"PHX",0,0,0,1,0,1,0,1,0,0,1,2,"A","Y","2013-04-18","201304180STL"
"STL",0,1,0,0,1,2,0,0,0,1,0,1,"H","Y","2013-04-18","201304180STL"
"NYI",0,3,1,1,0,5,0,2,0,1,0,3,"A","N","2013-04-18","201304180TOR"
"TOR",0,2,0,1,0,3,0,3,1,1,0,5,"H","N","2013-04-18","201304180TOR"
"CAR",0,0,1,2,0,3,1,1,1,1,0,4,"A","N","2013-04-18","201304180WPG"
"WPG",1,1,1,1,0,4,0,0,1,2,0,3,"H","N","2013-04-18","201304180WPG"
"BUF",0,0,3,1,0,4,0,3,4,1,0,8,"H","N","2013-04-19","201304190BUF"
"NYR",0,3,4,1,0,8,0,0,3,1,0,4,"A","N","2013-04-19","201304190BUF"
"ANA",0,0,0,1,0,1,0,0,1,2,0,3,"A","N","2013-04-19","201304190CGY"
"CGY",0,0,1,2,0,3,0,0,0,1,0,1,"H","N","2013-04-19","201304190CGY"
"CHI",1,2,1,1,0,5,0,2,1,1,0,4,"H","N","2013-04-19","201304190CHI"
"NSH",0,2,1,1,0,4,1,2,1,1,0,5,"A","N","2013-04-19","201304190CHI"
"COL",0,1,0,0,0,1,0,2,2,0,0,4,"H","N","2013-04-19","201304190COL"
"EDM",0,2,2,0,0,4,0,1,0,0,0,1,"A","N","2013-04-19","201304190COL"
"DAL",0,0,0,1,0,1,0,1,1,0,0,2,"A","N","2013-04-19","201304190STL"
"STL",0,1,1,0,0,2,0,0,0,1,0,1,"H","N","2013-04-19","201304190STL"
"BOS",0,1,0,1,0,2,0,0,1,2,0,3,"H","N","2013-04-20","201304200BOS"
"PIT",0,0,1,2,0,3,0,1,0,1,0,2,"A","N","2013-04-20","201304200BOS"
"CAR",0,1,1,1,0,3,0,1,2,2,0,5,"H","N","2013-04-20","201304200CAR"
"PHI",0,1,2,2,0,5,0,1,1,1,0,3,"A","N","2013-04-20","201304200CAR"
"CHI",0,1,1,0,0,2,0,2,0,0,1,3,"H","Y","2013-04-20","201304200CHI"
"PHX",0,2,0,0,1,3,0,1,1,0,0,2,"A","Y","2013-04-20","201304200CHI"
"MTL",0,0,0,1,0,1,0,2,2,1,0,5,"H","N","2013-04-20","201304200MTL"
"WSH",0,2,2,1,0,5,0,0,0,1,0,1,"A","N","2013-04-20","201304200MTL"
"FLA",0,2,0,0,0,2,0,1,4,1,0,6,"A","N","2013-04-20","201304200NJD"
"NJD",0,1,4,1,0,6,0,2,0,0,0,2,"H","N","2013-04-20","201304200NJD"
"OTT",0,0,1,0,0,1,0,0,2,2,0,4,"H","N","2013-04-20","201304200OTT"
"TOR",0,0,2,2,0,4,0,0,1,0,0,1,"A","N","2013-04-20","201304200OTT"
"DET",0,1,0,0,0,1,0,1,0,0,1,2,"A","Y","2013-04-20","201304200VAN"
"VAN",0,1,0,0,1,2,0,1,0,0,0,1,"H","Y","2013-04-20","201304200VAN"
"NYI",0,2,1,1,1,5,0,1,2,1,0,4,"A","Y","2013-04-20","201304200WPG"
"WPG",0,1,2,1,0,4,0,2,1,1,1,5,"H","Y","2013-04-20","201304200WPG"
"BOS",0,1,1,1,0,3,0,0,0,0,0,0,"H","N","2013-04-21","201304210BOS"
"FLA",0,0,0,0,0,0,0,1,1,1,0,3,"A","N","2013-04-21","201304210BOS"
"COL",0,2,2,1,0,5,0,1,1,1,0,3,"H","N","2013-04-21","201304210COL"
"STL",0,1,1,1,0,3,0,2,2,1,0,5,"A","N","2013-04-21","201304210COL"
"ANA",0,1,1,1,0,3,0,1,0,0,0,1,"A","N","2013-04-21","201304210EDM"
"EDM",0,1,0,0,0,1,0,1,1,1,0,3,"H","N","2013-04-21","201304210EDM"
"DAL",0,0,2,1,0,3,1,1,1,1,0,4,"A","N","2013-04-21","201304210LAK"
"LAK",1,1,1,1,0,4,0,0,2,1,0,3,"H","N","2013-04-21","201304210LAK"
"CGY",0,1,1,2,0,4,0,1,0,0,0,1,"A","N","2013-04-21","201304210MIN"
"MIN",0,1,0,0,0,1,0,1,1,2,0,4,"H","N","2013-04-21","201304210MIN"
"NJD",0,0,0,1,0,1,0,2,1,1,0,4,"A","N","2013-04-21","201304210NYR"
"NYR",0,2,1,1,0,4,0,0,0,1,0,1,"H","N","2013-04-21","201304210NYR"
"CBJ",0,1,2,1,0,4,0,0,1,2,0,3,"A","N","2013-04-21","201304210SJS"
"SJS",0,0,1,2,0,3,0,1,2,1,0,4,"H","N","2013-04-21","201304210SJS"
"CAR",0,3,0,0,0,3,0,0,1,1,0,2,"A","N","2013-04-21","201304210TBL"
"TBL",0,0,1,1,0,2,0,3,0,0,0,3,"H","N","2013-04-21","201304210TBL"
"BUF",0,0,1,0,0,1,0,0,1,1,0,2,"H","N","2013-04-22","201304220BUF"
"WPG",0,0,1,1,0,2,0,0,1,0,0,1,"A","N","2013-04-22","201304220BUF"
"DET",0,2,1,1,0,4,0,0,0,0,0,0,"H","N","2013-04-22","201304220DET"
"PHX",0,0,0,0,0,0,0,2,1,1,0,4,"A","N","2013-04-22","201304220DET"
"ANA",0,2,0,1,0,3,0,0,0,0,0,0,"A","N","2013-04-22","201304220EDM"
"EDM",0,0,0,0,0,0,0,2,0,1,0,3,"H","N","2013-04-22","201304220EDM"
"OTT",0,0,0,1,0,1,0,2,0,1,0,3,"H","N","2013-04-22","201304220OTT"
"PIT",0,2,0,1,0,3,0,0,0,1,0,1,"A","N","2013-04-22","201304220OTT"
"CHI",0,0,0,1,0,1,0,1,2,0,0,3,"A","N","2013-04-22","201304220VAN"
"VAN",0,1,2,0,0,3,0,0,0,1,0,1,"H","N","2013-04-22","201304220VAN"
"CAR",0,2,1,0,1,4,0,1,1,1,0,3,"H","Y","2013-04-23","201304230CAR"
"NYI",0,1,1,1,0,3,0,2,1,0,1,4,"A","Y","2013-04-23","201304230CAR"
"FLA",0,0,1,2,0,3,0,0,0,2,0,2,"H","N","2013-04-23","201304230FLA"
"NYR",0,0,0,2,0,2,0,0,1,2,0,3,"A","N","2013-04-23","201304230FLA"
"LAK",0,0,1,0,0,1,0,2,0,0,0,2,"A","N","2013-04-23","201304230MIN"
"MIN",0,2,0,0,0,2,0,0,1,0,0,1,"H","N","2013-04-23","201304230MIN"
"MTL",0,0,2,0,0,2,0,2,1,0,0,3,"A","N","2013-04-23","201304230NJD"
"NJD",0,2,1,0,0,3,0,0,2,0,0,2,"H","N","2013-04-23","201304230NJD"
"CGY",0,1,1,1,0,3,0,1,1,2,0,4,"A","N","2013-04-23","201304230NSH"
"NSH",0,1,1,2,0,4,0,1,1,1,0,3,"H","N","2013-04-23","201304230NSH"
"BOS",0,1,0,1,0,2,0,1,2,2,0,5,"A","N","2013-04-23","201304230PHI"
"PHI",0,1,2,2,0,5,0,1,0,1,0,2,"H","N","2013-04-23","201304230PHI"
"BUF",0,1,0,3,0,4,0,1,0,1,0,2,"A","N","2013-04-23","201304230PIT"
"PIT",0,1,0,1,0,2,0,1,0,3,0,4,"H","N","2013-04-23","201304230PIT"
"DAL",0,1,1,0,0,2,0,1,0,2,0,3,"A","N","2013-04-23","201304230SJS"
"SJS",0,1,0,2,0,3,0,1,1,0,0,2,"H","N","2013-04-23","201304230SJS"
"COL",0,0,1,0,0,1,0,1,2,0,0,3,"A","N","2013-04-23","201304230STL"
"STL",0,1,2,0,0,3,0,0,1,0,0,1,"H","N","2013-04-23","201304230STL"
"WPG",0,0,2,1,0,3,0,2,2,1,0,5,"A","N","2013-04-23","201304230WSH"
"WSH",0,2,2,1,0,5,0,0,2,1,0,3,"H","N","2013-04-23","201304230WSH"
"DET",0,0,1,2,0,3,0,0,1,0,0,1,"H","N","2013-04-24","201304240DET"
"LAK",0,0,1,0,0,1,0,0,1,2,0,3,"A","N","2013-04-24","201304240DET"
"CHI",0,2,0,2,0,4,0,1,0,0,0,1,"A","N","2013-04-24","201304240EDM"
"EDM",0,1,0,0,0,1,0,2,0,2,0,4,"H","N","2013-04-24","201304240EDM"
"PHX",0,2,0,0,0,2,0,0,1,0,0,1,"H","N","2013-04-24","201304240PHX"
"SJS",0,0,1,0,0,1,0,2,0,0,0,2,"A","N","2013-04-24","201304240PHX"
"TBL",0,0,2,3,0,5,0,1,1,0,0,2,"H","N","2013-04-24","201304240TBL"
"TOR",0,1,1,0,0,2,0,0,2,3,0,5,"A","N","2013-04-24","201304240TBL"
"BOS",0,0,2,0,0,2,0,0,0,0,0,0,"H","N","2013-04-25","201304250BOS"
"TBL",0,0,0,0,0,0,0,0,2,0,0,2,"A","N","2013-04-25","201304250BOS"
"CAR",0,0,2,1,0,3,1,2,0,1,0,4,"H","N","2013-04-25","201304250CAR"
"NYR",1,2,0,1,0,4,0,0,2,1,0,3,"A","N","2013-04-25","201304250CAR"
"CBJ",0,1,0,2,0,3,0,0,1,0,0,1,"A","N","2013-04-25","201304250DAL"
"DAL",0,0,1,0,0,1,0,1,0,2,0,3,"H","N","2013-04-25","201304250DAL"
"DET",0,1,3,1,0,5,0,2,0,0,0,2,"H","N","2013-04-25","201304250DET"
"NSH",0,2,0,0,0,2,0,1,3,1,0,5,"A","N","2013-04-25","201304250DET"
"FLA",0,0,0,0,0,0,0,2,2,0,0,4,"H","N","2013-04-25","201304250FLA"
"TOR",0,2,2,0,0,4,0,0,0,0,0,0,"A","N","2013-04-25","201304250FLA"
"NJD",0,0,1,2,0,3,0,1,1,0,0,2,"H","N","2013-04-25","201304250NJD"
"PIT",0,1,1,0,0,2,0,0,1,2,0,3,"A","N","2013-04-25","201304250NJD"
"NYI",0,0,1,0,0,1,0,1,0,1,0,2,"A","N","2013-04-25","201304250PHI"
"PHI",0,1,0,1,0,2,0,0,1,0,0,1,"H","N","2013-04-25","201304250PHI"
"CGY",0,0,1,0,0,1,0,0,3,1,0,4,"A","N","2013-04-25","201304250STL"
"STL",0,0,3,1,0,4,0,0,1,0,0,1,"H","N","2013-04-25","201304250STL"
"ANA",0,0,2,1,0,3,0,0,0,1,0,1,"A","N","2013-04-25","201304250VAN"
"VAN",0,0,0,1,0,1,0,0,2,1,0,3,"H","N","2013-04-25","201304250VAN"
"MTL",0,0,1,3,0,4,0,1,1,0,0,2,"A","N","2013-04-25","201304250WPG"
"WPG",0,1,1,0,0,2,0,0,1,3,0,4,"H","N","2013-04-25","201304250WPG"
"OTT",1,0,1,0,0,2,0,0,0,1,0,1,"A","N","2013-04-25","201304250WSH"
"WSH",0,0,0,1,0,1,1,0,1,0,0,2,"H","N","2013-04-25","201304250WSH"
"BUF",0,0,1,0,1,2,0,0,0,1,0,1,"H","Y","2013-04-26","201304260BUF"
"NYI",0,0,0,1,0,1,0,0,1,0,1,2,"A","Y","2013-04-26","201304260BUF"
"CGY",0,0,1,0,0,1,0,2,0,1,0,3,"A","N","2013-04-26","201304260CHI"
"CHI",0,2,0,1,0,3,0,0,1,0,0,1,"H","N","2013-04-26","201304260CHI"
"EDM",0,3,3,0,0,6,0,0,0,1,0,1,"A","N","2013-04-26","201304260MIN"
"MIN",0,0,0,1,0,1,0,3,3,0,0,6,"H","N","2013-04-26","201304260MIN"
"COL",0,3,1,0,1,5,0,2,1,1,0,4,"A","Y","2013-04-26","201304260PHX"
"PHX",0,2,1,1,0,4,0,3,1,0,1,5,"H","Y","2013-04-26","201304260PHX"
"ANA",0,1,1,1,0,3,0,2,1,2,0,5,"H","N","2013-04-27","201304270ANA"
"PHX",0,2,1,2,0,5,0,1,1,1,0,3,"A","N","2013-04-27","201304270ANA"
"CBJ",0,0,0,3,0,3,0,0,1,0,0,1,"H","N","2013-04-27","201304270CBJ"
"NSH",0,0,1,0,0,1,0,0,0,3,0,3,"A","N","2013-04-27","201304270CBJ"
"COL",0,1,0,0,0,1,0,1,1,1,0,3,"H","N","2013-04-27","201304270COL"
"MIN",0,1,1,1,0,3,0,1,0,0,0,1,"A","N","2013-04-27","201304270COL"
"DAL",0,0,0,0,0,0,0,1,0,2,0,3,"H","N","2013-04-27","201304270DAL"
"DET",0,1,0,2,0,3,0,0,0,0,0,0,"A","N","2013-04-27","201304270DAL"
"EDM",0,0,1,6,0,7,0,1,0,1,0,2,"H","N","2013-04-27","201304270EDM"
"VAN",0,1,0,1,0,2,0,0,1,6,0,7,"A","N","2013-04-27","201304270EDM"
"LAK",0,0,2,1,0,3,0,0,1,1,0,2,"H","N","2013-04-27","201304270LAK"
"SJS",0,0,1,1,0,2,0,0,2,1,0,3,"A","N","2013-04-27","201304270LAK"
"NJD",0,0,0,0,0,0,0,2,1,1,0,4,"A","N","2013-04-27","201304270NYR"
"NYR",0,2,1,1,0,4,0,0,0,0,0,0,"H","N","2013-04-27","201304270NYR"
"OTT",0,0,1,0,0,1,0,1,0,1,0,2,"H","N","2013-04-27","201304270OTT"
"PHI",0,1,0,1,0,2,0,0,1,0,0,1,"A","N","2013-04-27","201304270OTT"
"CAR",0,0,3,0,0,3,0,1,2,5,0,8,"A","N","2013-04-27","201304270PIT"
"PIT",0,1,2,5,0,8,0,0,3,0,0,3,"H","N","2013-04-27","201304270PIT"
"CHI",0,0,0,1,0,1,0,2,1,0,0,3,"A","N","2013-04-27","201304270STL"
"STL",0,2,1,0,0,3,0,0,0,1,0,1,"H","N","2013-04-27","201304270STL"
"FLA",0,1,1,3,0,5,0,2,1,0,0,3,"A","N","2013-04-27","201304270TBL"
"TBL",0,2,1,0,0,3,0,1,1,3,0,5,"H","N","2013-04-27","201304270TBL"
"MTL",0,1,2,1,0,4,0,1,0,0,0,1,"A","N","2013-04-27","201304270TOR"
"TOR",0,1,0,0,0,1,0,1,2,1,0,4,"H","N","2013-04-27","201304270TOR"
"BOS",0,1,1,0,0,2,1,0,0,2,0,3,"A","N","2013-04-27","201304270WSH"
"WSH",1,0,0,2,0,3,0,1,1,0,0,2,"H","N","2013-04-27","201304270WSH"
"BOS",0,0,1,1,0,2,0,1,1,2,0,4,"H","N","2013-04-28","201304280BOS"
"OTT",0,1,1,2,0,4,0,0,1,1,0,2,"A","N","2013-04-28","201304280BOS"
"ANA",0,1,0,2,0,3,0,1,0,0,0,1,"H","N","2013-04-30","201304300ANA"
"DET",0,1,0,0,0,1,0,1,0,2,0,3,"A","N","2013-04-30","201304300ANA"
"CHI",1,0,1,0,0,2,0,1,0,0,0,1,"H","N","2013-04-30","201304300CHI"
"MIN",0,1,0,0,0,1,1,0,1,0,0,2,"A","N","2013-04-30","201304300CHI"
"LAK",0,0,0,1,0,1,1,1,0,0,0,2,"A","N","2013-04-30","201304300STL"
"STL",1,1,0,0,0,2,0,0,0,1,0,1,"H","N","2013-04-30","201304300STL"
"BOS",0,2,2,0,0,4,0,1,0,0,0,1,"H","N","2013-05-01","201305010BOS"
"TOR",0,1,0,0,0,1,0,2,2,0,0,4,"A","N","2013-05-01","201305010BOS"
"NYI",0,0,0,0,0,0,0,2,3,0,0,5,"A","N","2013-05-01","201305010PIT"
"PIT",0,2,3,0,0,5,0,0,0,0,0,0,"H","N","2013-05-01","201305010PIT"
"SJS",0,0,1,2,0,3,0,0,1,0,0,1,"A","N","2013-05-01","201305010VAN"
"VAN",0,0,1,0,0,1,0,0,1,2,0,3,"H","N","2013-05-01","201305010VAN"
"ANA",0,0,1,3,0,4,1,2,1,1,0,5,"H","N","2013-05-02","201305020ANA"
"DET",1,2,1,1,0,5,0,0,1,3,0,4,"A","N","2013-05-02","201305020ANA"
"MTL",0,0,2,0,0,2,0,1,0,3,0,4,"H","N","2013-05-02","201305020MTL"
"OTT",0,1,0,3,0,4,0,0,2,0,0,2,"A","N","2013-05-02","201305020MTL"
"LAK",0,1,0,0,0,1,0,0,0,2,0,2,"A","N","2013-05-02","201305020STL"
"STL",0,0,0,2,0,2,0,1,0,0,0,1,"H","N","2013-05-02","201305020STL"
"NYR",0,1,0,0,0,1,0,0,3,0,0,3,"A","N","2013-05-02","201305020WSH"
"WSH",0,0,3,0,0,3,0,1,0,0,0,1,"H","N","2013-05-02","201305020WSH"
"CHI",0,1,1,3,0,5,0,0,1,1,0,2,"H","N","2013-05-03","201305030CHI"
"MIN",0,0,1,1,0,2,0,1,1,3,0,5,"A","N","2013-05-03","201305030CHI"
"MTL",0,0,3,0,0,3,0,0,1,0,0,1,"H","N","2013-05-03","201305030MTL"
"OTT",0,0,1,0,0,1,0,0,3,0,0,3,"A","N","2013-05-03","201305030MTL"
"NYI",0,1,2,1,0,4,0,3,0,0,0,3,"A","N","2013-05-03","201305030PIT"
"PIT",0,3,0,0,0,3,0,1,2,1,0,4,"H","N","2013-05-03","201305030PIT"
"SJS",1,1,0,1,0,3,0,0,0,2,0,2,"A","N","2013-05-03","201305030VAN"
"VAN",0,0,0,2,0,2,1,1,0,1,0,3,"H","N","2013-05-03","201305030VAN"
"BOS",0,0,1,1,0,2,0,0,2,2,0,4,"H","N","2013-05-04","201305040BOS"
"TOR",0,0,2,2,0,4,0,0,1,1,0,2,"A","N","2013-05-04","201305040BOS"
"ANA",0,0,1,3,0,4,0,0,0,0,0,0,"A","N","2013-05-04","201305040DET"
"DET",0,0,0,0,0,0,0,0,1,3,0,4,"H","N","2013-05-04","201305040DET"
"LAK",0,0,1,0,0,1,0,0,0,0,0,0,"H","N","2013-05-04","201305040LAK"
"STL",0,0,0,0,0,0,0,0,1,0,0,1,"A","N","2013-05-04","201305040LAK"
"NYR",0,0,0,0,0,0,1,0,0,0,0,1,"A","N","2013-05-04","201305040WSH"
"WSH",1,0,0,0,0,1,0,0,0,0,0,0,"H","N","2013-05-04","201305040WSH"
"CHI",0,1,0,1,0,2,1,1,0,1,0,3,"A","N","2013-05-05","201305050MIN"
"MIN",1,1,0,1,0,3,0,1,0,1,0,2,"H","N","2013-05-05","201305050MIN"
"NYI",0,2,0,2,0,4,1,3,1,0,0,5,"H","N","2013-05-05","201305050NYI"
"PIT",1,3,1,0,0,5,0,2,0,2,0,4,"A","N","2013-05-05","201305050NYI"
"MTL",0,1,0,0,0,1,0,1,1,4,0,6,"A","N","2013-05-05","201305050OTT"
"OTT",0,1,1,4,0,6,0,1,0,0,0,1,"H","N","2013-05-05","201305050OTT"
"SJS",0,1,1,3,0,5,0,0,1,1,0,2,"H","N","2013-05-05","201305050SJS"
"VAN",0,0,1,1,0,2,0,1,1,3,0,5,"A","N","2013-05-05","201305050SJS"
"ANA",0,1,0,1,0,2,1,0,0,2,0,3,"A","N","2013-05-06","201305060DET"
"DET",1,0,0,2,0,3,0,1,0,1,0,2,"H","N","2013-05-06","201305060DET"
"LAK",0,2,0,2,0,4,0,2,1,0,0,3,"H","N","2013-05-06","201305060LAK"
"STL",0,2,1,0,0,3,0,2,0,2,0,4,"A","N","2013-05-06","201305060LAK"
"NYR",0,1,1,2,0,4,0,1,1,1,0,3,"H","N","2013-05-06","201305060NYR"
"WSH",0,1,1,1,0,3,0,1,1,2,0,4,"A","N","2013-05-06","201305060NYR"
"BOS",0,1,3,1,0,5,0,0,1,1,0,2,"A","N","2013-05-06","201305060TOR"
"TOR",0,0,1,1,0,2,0,1,3,1,0,5,"H","N","2013-05-06","201305060TOR"
"CHI",0,1,1,1,0,3,0,0,0,0,0,0,"A","N","2013-05-07","201305070MIN"
"MIN",0,0,0,0,0,0,0,1,1,1,0,3,"H","N","2013-05-07","201305070MIN"
"NYI",0,1,2,3,0,6,0,1,2,1,0,4,"H","N","2013-05-07","201305070NYI"
"PIT",0,1,2,1,0,4,0,1,2,3,0,6,"A","N","2013-05-07","201305070NYI"
"MTL",0,0,2,0,0,2,1,0,0,2,0,3,"A","N","2013-05-07","201305070OTT"
"OTT",1,0,0,2,0,3,0,0,2,0,0,2,"H","N","2013-05-07","201305070OTT"
"SJS",1,2,0,1,0,4,0,1,0,2,0,3,"H","N","2013-05-07","201305070SJS"
"VAN",0,1,0,2,0,3,1,2,0,1,0,4,"A","N","2013-05-07","201305070SJS"
"ANA",1,1,1,0,0,3,0,1,1,0,0,2,"H","N","2013-05-08","201305080ANA"
"DET",0,1,1,0,0,2,1,1,1,0,0,3,"A","N","2013-05-08","201305080ANA"
"NYR",0,1,1,2,0,4,0,0,2,1,0,3,"H","N","2013-05-08","201305080NYR"
"WSH",0,0,2,1,0,3,0,1,1,2,0,4,"A","N","2013-05-08","201305080NYR"
"LAK",1,0,1,1,0,3,0,0,1,1,0,2,"A","N","2013-05-08","201305080STL"
"STL",0,0,1,1,0,2,1,0,1,1,0,3,"H","N","2013-05-08","201305080STL"
"BOS",1,0,3,0,0,4,0,2,1,0,0,3,"A","N","2013-05-08","201305080TOR"
"TOR",0,2,1,0,0,3,1,0,3,0,0,4,"H","N","2013-05-08","201305080TOR"
"CHI",0,1,3,1,0,5,0,0,1,0,0,1,"H","N","2013-05-09","201305090CHI"
"MIN",0,0,1,0,0,1,0,1,3,1,0,5,"A","N","2013-05-09","201305090CHI"
"MTL",0,1,0,0,0,1,0,2,1,3,0,6,"H","N","2013-05-09","201305090MTL"
"OTT",0,2,1,3,0,6,0,1,0,0,0,1,"A","N","2013-05-09","201305090MTL"
"NYI",0,0,0,0,0,0,0,0,3,1,0,4,"A","N","2013-05-09","201305090PIT"
"PIT",0,0,3,1,0,4,0,0,0,0,0,0,"H","N","2013-05-09","201305090PIT"
"BOS",0,0,0,1,0,1,0,0,1,1,0,2,"H","N","2013-05-10","201305100BOS"
"TOR",0,0,1,1,0,2,0,0,0,1,0,1,"A","N","2013-05-10","201305100BOS"
"ANA",0,0,1,2,0,3,1,1,0,2,0,4,"A","N","2013-05-10","201305100DET"
"DET",1,1,0,2,0,4,0,0,1,2,0,3,"H","N","2013-05-10","201305100DET"
"LAK",0,1,1,0,0,2,0,0,1,0,0,1,"H","N","2013-05-10","201305100LAK"
"STL",0,0,1,0,0,1,0,1,1,0,0,2,"A","N","2013-05-10","201305100LAK"
"NYR",0,1,0,0,0,1,1,0,1,0,0,2,"A","N","2013-05-10","201305100WSH"
"WSH",1,0,1,0,0,2,0,1,0,0,0,1,"H","N","2013-05-10","201305100WSH"
"NYI",0,2,0,1,0,3,1,1,1,1,0,4,"H","N","2013-05-11","201305110NYI"
"PIT",1,1,1,1,0,4,0,2,0,1,0,3,"A","N","2013-05-11","201305110NYI"
"ANA",0,1,0,1,0,2,0,2,1,0,0,3,"H","N","2013-05-12","201305120ANA"
"DET",0,2,1,0,0,3,0,1,0,1,0,2,"A","N","2013-05-12","201305120ANA"
"NYR",0,0,1,0,0,1,0,0,0,0,0,0,"H","N","2013-05-12","201305120NYR"
"WSH",0,0,0,0,0,0,0,0,1,0,0,1,"A","N","2013-05-12","201305120NYR"
"BOS",0,0,0,1,0,1,0,0,0,2,0,2,"A","N","2013-05-12","201305120TOR"
"TOR",0,0,0,2,0,2,0,0,0,1,0,1,"H","N","2013-05-12","201305120TOR"
"BOS",1,1,0,3,0,5,0,1,1,2,0,4,"H","N","2013-05-13","201305130BOS"
"TOR",0,1,1,2,0,4,1,1,0,3,0,5,"A","N","2013-05-13","201305130BOS"
"NYR",0,1,2,2,0,5,0,0,0,0,0,0,"A","N","2013-05-13","201305130WSH"
"WSH",0,0,0,0,0,0,0,1,2,2,0,5,"H","N","2013-05-13","201305130WSH"
"LAK",0,1,1,0,0,2,0,0,0,0,0,0,"H","N","2013-05-14","201305140LAK"
"SJS",0,0,0,0,0,0,0,1,1,0,0,2,"A","N","2013-05-14","201305140LAK"
"OTT",0,1,0,0,0,1,0,2,1,1,0,4,"A","N","2013-05-14","201305140PIT"
"PIT",0,2,1,1,0,4,0,1,0,0,0,1,"H","N","2013-05-14","201305140PIT"
"CHI",0,1,0,3,0,4,0,1,0,0,0,1,"H","N","2013-05-15","201305150CHI"
"DET",0,1,0,0,0,1,0,1,0,3,0,4,"A","N","2013-05-15","201305150CHI"
"BOS",1,0,1,1,0,3,0,0,1,1,0,2,"H","N","2013-05-16","201305160BOS"
"NYR",0,0,1,1,0,2,1,0,1,1,0,3,"A","N","2013-05-16","201305160BOS"
"LAK",0,1,1,2,0,4,0,0,2,1,0,3,"H","N","2013-05-16","201305160LAK"
"SJS",0,0,2,1,0,3,0,1,1,2,0,4,"A","N","2013-05-16","201305160LAK"
"OTT",0,1,1,1,0,3,0,2,2,0,0,4,"A","N","2013-05-17","201305170PIT"
"PIT",0,2,2,0,0,4,0,1,1,1,0,3,"H","N","2013-05-17","201305170PIT"
"CHI",0,1,0,0,0,1,0,0,2,2,0,4,"H","N","2013-05-18","201305180CHI"
"DET",0,0,2,2,0,4,0,1,0,0,0,1,"A","N","2013-05-18","201305180CHI"
"LAK",0,1,0,0,0,1,1,1,0,0,0,2,"A","N","2013-05-18","201305180SJS"
"SJS",1,1,0,0,0,2,0,1,0,0,0,1,"H","N","2013-05-18","201305180SJS"
"BOS",0,1,2,2,0,5,0,1,1,0,0,2,"H","N","2013-05-19","201305190BOS"
"NYR",0,1,1,0,0,2,0,1,2,2,0,5,"A","N","2013-05-19","201305190BOS"
"OTT",1,0,0,1,0,2,0,0,1,0,0,1,"H","N","2013-05-19","201305190OTT"
"PIT",0,0,1,0,0,1,1,0,0,1,0,2,"A","N","2013-05-19","201305190OTT"
"CHI",0,0,0,1,0,1,0,0,2,1,0,3,"A","N","2013-05-20","201305200DET"
"DET",0,0,2,1,0,3,0,0,0,1,0,1,"H","N","2013-05-20","201305200DET"
"BOS",0,0,0,2,0,2,0,0,1,0,0,1,"A","N","2013-05-21","201305210NYR"
"NYR",0,0,1,0,0,1,0,0,0,2,0,2,"H","N","2013-05-21","201305210NYR"
"LAK",0,0,0,1,0,1,0,1,1,0,0,2,"A","N","2013-05-21","201305210SJS"
"SJS",0,1,1,0,0,2,0,0,0,1,0,1,"H","N","2013-05-21","201305210SJS"
"OTT",0,2,0,1,0,3,0,1,2,4,0,7,"H","N","2013-05-22","201305220OTT"
"PIT",0,1,2,4,0,7,0,2,0,1,0,3,"A","N","2013-05-22","201305220OTT"
"CHI",0,0,0,0,0,0,0,0,1,1,0,2,"A","N","2013-05-23","201305230DET"
"DET",0,0,1,1,0,2,0,0,0,0,0,0,"H","N","2013-05-23","201305230DET"
"LAK",0,0,1,2,0,3,0,0,0,0,0,0,"H","N","2013-05-23","201305230LAK"
"SJS",0,0,0,0,0,0,0,0,1,2,0,3,"A","N","2013-05-23","201305230LAK"
"BOS",0,0,2,1,0,3,1,0,1,2,0,4,"A","N","2013-05-23","201305230NYR"
"NYR",1,0,1,2,0,4,0,0,2,1,0,3,"H","N","2013-05-23","201305230NYR"
"OTT",0,0,1,1,0,2,0,1,3,2,0,6,"A","N","2013-05-24","201305240PIT"
"PIT",0,1,3,2,0,6,0,0,1,1,0,2,"H","N","2013-05-24","201305240PIT"
"BOS",0,0,2,1,0,3,0,1,0,0,0,1,"H","N","2013-05-25","201305250BOS"
"NYR",0,1,0,0,0,1,0,0,2,1,0,3,"A","N","2013-05-25","201305250BOS"
"CHI",0,1,2,1,0,4,0,0,1,0,0,1,"H","N","2013-05-25","201305250CHI"
"DET",0,0,1,0,0,1,0,1,2,1,0,4,"A","N","2013-05-25","201305250CHI"
"LAK",0,0,1,0,0,1,0,1,1,0,0,2,"A","N","2013-05-26","201305260SJS"
"SJS",0,1,1,0,0,2,0,0,1,0,0,1,"H","N","2013-05-26","201305260SJS"
"CHI",0,1,0,3,0,4,0,1,1,1,0,3,"A","N","2013-05-27","201305270DET"
"DET",0,1,1,1,0,3,0,1,0,3,0,4,"H","N","2013-05-27","201305270DET"
"LAK",0,0,2,0,0,2,0,0,0,1,0,1,"H","N","2013-05-28","201305280LAK"
"SJS",0,0,0,1,0,1,0,0,2,0,0,2,"A","N","2013-05-28","201305280LAK"
"CHI",1,0,1,0,0,2,0,0,0,1,0,1,"H","N","2013-05-29","201305290CHI"
"DET",0,0,0,1,0,1,1,0,1,0,0,2,"A","N","2013-05-29","201305290CHI"
"CHI",0,0,2,0,0,2,0,1,0,0,0,1,"H","N","2013-06-01","201306010CHI"
"LAK",0,1,0,0,0,1,0,0,2,0,0,2,"A","N","2013-06-01","201306010CHI"
"BOS",0,1,0,2,0,3,0,0,0,0,0,0,"A","N","2013-06-01","201306010PIT"
"PIT",0,0,0,0,0,0,0,1,0,2,0,3,"H","N","2013-06-01","201306010PIT"
"CHI",0,2,2,0,0,4,0,0,1,1,0,2,"H","N","2013-06-02","201306020CHI"
"LAK",0,0,1,1,0,2,0,2,2,0,0,4,"A","N","2013-06-02","201306020CHI"
"BOS",0,4,0,2,0,6,0,1,0,0,0,1,"A","N","2013-06-03","201306030PIT"
"PIT",0,1,0,0,0,1,0,4,0,2,0,6,"H","N","2013-06-03","201306030PIT"
"CHI",0,0,1,0,0,1,0,1,1,1,0,3,"A","N","2013-06-04","201306040LAK"
"LAK",0,1,1,1,0,3,0,0,1,0,0,1,"H","N","2013-06-04","201306040LAK"
"BOS",1,1,0,0,0,2,0,0,1,0,0,1,"H","N","2013-06-05","201306050BOS"
"PIT",0,0,1,0,0,1,1,1,0,0,0,2,"A","N","2013-06-05","201306050BOS"
"CHI",0,1,1,1,0,3,0,1,1,0,0,2,"A","N","2013-06-06","201306060LAK"
"LAK",0,1,1,0,0,2,0,1,1,1,0,3,"H","N","2013-06-06","201306060LAK"
"BOS",0,0,0,1,0,1,0,0,0,0,0,0,"H","N","2013-06-07","201306070BOS"
"PIT",0,0,0,0,0,0,0,0,0,1,0,1,"A","N","2013-06-07","201306070BOS"
"CHI",1,2,0,1,0,4,0,0,1,2,0,3,"H","N","2013-06-08","201306080CHI"
"LAK",0,0,1,2,0,3,1,2,0,1,0,4,"A","N","2013-06-08","201306080CHI"
"BOS",0,1,1,1,0,3,1,0,1,2,0,4,"A","N","2013-06-12","201306120CHI"
"CHI",1,0,1,2,0,4,0,1,1,1,0,3,"H","N","2013-06-12","201306120CHI"
"BOS",1,0,1,0,0,2,0,1,0,0,0,1,"A","N","2013-06-15","201306150CHI"
"CHI",0,1,0,0,0,1,1,0,1,0,0,2,"H","N","2013-06-15","201306150CHI"
"BOS",0,0,2,0,0,2,0,0,0,0,0,0,"H","N","2013-06-17","201306170BOS"
"CHI",0,0,0,0,0,0,0,0,2,0,0,2,"A","N","2013-06-17","201306170BOS"
"BOS",0,1,2,2,0,5,1,1,3,1,0,6,"H","N","2013-06-19","201306190BOS"
"CHI",1,1,3,1,0,6,0,1,2,2,0,5,"A","N","2013-06-19","201306190BOS"
"BOS",0,0,0,1,0,1,0,1,1,1,0,3,"A","N","2013-06-22","201306220CHI"
"CHI",0,1,1,1,0,3,0,0,0,1,0,1,"H","N","2013-06-22","201306220CHI"
"BOS",0,1,0,1,0,2,0,0,1,2,0,3,"H","N","2013-06-24","201306240BOS"
"CHI",0,0,1,2,0,3,0,1,0,1,0,2,"A","N","2013-06-24","201306240BOS"
"CHI",0,2,1,3,0,6,0,1,1,2,0,4,"H","N","2013-10-01","201310010CHI"
"WSH",0,1,1,2,0,4,0,2,1,3,0,6,"A","N","2013-10-01","201310010CHI"
"EDM",0,2,2,0,0,4,0,2,1,2,0,5,"H","N","2013-10-01","201310010EDM"
"WPG",0,2,1,2,0,5,0,2,2,0,0,4,"A","N","2013-10-01","201310010EDM"
"MTL",0,2,0,1,0,3,0,1,2,1,0,4,"H","N","2013-10-01","201310010MTL"
"TOR",0,1,2,1,0,4,0,2,0,1,0,3,"A","N","2013-10-01","201310010MTL"
"ANA",0,0,0,1,0,1,0,1,3,2,0,6,"A","N","2013-10-02","201310020COL"
"COL",0,1,3,2,0,6,0,0,0,1,0,1,"H","N","2013-10-02","201310020COL"
"BUF",0,0,0,1,0,1,0,2,0,0,0,2,"A","N","2013-10-02","201310020DET"
"DET",0,2,0,0,0,2,0,0,0,1,0,1,"H","N","2013-10-02","201310020DET"
"PHI",0,1,0,0,0,1,0,0,1,2,0,3,"H","N","2013-10-02","201310020PHI"
"TOR",0,0,1,2,0,3,0,1,0,0,0,1,"A","N","2013-10-02","201310020PHI"
"BOS",0,1,1,1,0,3,0,0,1,0,0,1,"H","N","2013-10-03","201310030BOS"
"TBL",0,0,1,0,0,1,0,1,1,1,0,3,"A","N","2013-10-03","201310030BOS"
"DAL",0,0,1,1,0,2,0,1,0,3,0,4,"H","N","2013-10-03","201310030DAL"
"FLA",0,1,0,3,0,4,0,0,1,1,0,2,"A","N","2013-10-03","201310030DAL"
"LAK",0,1,0,1,1,3,0,2,0,0,0,2,"A","Y","2013-10-03","201310030MIN"
"MIN",0,2,0,0,0,2,0,1,0,1,1,3,"H","Y","2013-10-03","201310030MIN"
"NYR",0,0,1,0,0,1,0,1,1,2,0,4,"A","N","2013-10-03","201310030PHX"
"PHX",0,1,1,2,0,4,0,0,1,0,0,1,"H","N","2013-10-03","201310030PHX"
"NJD",0,0,0,0,0,0,0,2,0,1,0,3,"A","N","2013-10-03","201310030PIT"
"PIT",0,2,0,1,0,3,0,0,0,0,0,0,"H","N","2013-10-03","201310030PIT"
"SJS",0,0,2,2,0,4,0,1,0,0,0,1,"H","N","2013-10-03","201310030SJS"
"VAN",0,1,0,0,0,1,0,0,2,2,0,4,"A","N","2013-10-03","201310030SJS"
"NSH",0,1,1,0,0,2,0,3,1,0,0,4,"A","N","2013-10-03","201310030STL"
"STL",0,3,1,0,0,4,0,1,1,0,0,2,"H","N","2013-10-03","201310030STL"
"CGY",0,3,1,0,0,4,0,0,3,1,1,5,"A","Y","2013-10-03","201310030WSH"
"WSH",0,0,3,1,1,5,0,3,1,0,0,4,"H","Y","2013-10-03","201310030WSH"
"BUF",0,0,0,0,0,0,0,0,0,1,0,1,"H","N","2013-10-04","201310040BUF"
"OTT",0,0,0,1,0,1,0,0,0,0,0,0,"A","N","2013-10-04","201310040BUF"
"CAR",0,1,1,0,0,2,1,0,0,2,0,3,"H","N","2013-10-04","201310040CAR"
"DET",1,0,0,2,0,3,0,1,1,0,0,2,"A","N","2013-10-04","201310040CAR"
"CBJ",0,2,0,1,0,3,0,2,0,2,0,4,"H","N","2013-10-04","201310040CBJ"
"CGY",0,2,0,2,0,4,0,2,0,1,0,3,"A","N","2013-10-04","201310040CBJ"
"COL",0,1,1,1,0,3,0,0,1,0,0,1,"H","N","2013-10-04","201310040COL"
"NSH",0,0,1,0,0,1,0,1,1,1,0,3,"A","N","2013-10-04","201310040COL"
"NJD",0,1,1,1,0,3,0,1,1,1,1,4,"H","Y","2013-10-04","201310040NJD"
"NYI",0,1,1,1,1,4,0,1,1,1,0,3,"A","Y","2013-10-04","201310040NJD"
"LAK",0,1,0,2,0,3,0,1,1,3,0,5,"A","N","2013-10-04","201310040WPG"
"WPG",0,1,1,3,0,5,0,1,0,2,0,3,"H","N","2013-10-04","201310040WPG"
"BOS",0,1,2,1,0,4,0,1,0,0,0,1,"H","N","2013-10-05","201310050BOS"
"DET",0,1,0,0,0,1,0,1,2,1,0,4,"A","N","2013-10-05","201310050BOS"
"CHI",0,0,2,0,0,2,0,0,0,2,1,3,"H","Y","2013-10-05","201310050CHI"
"TBL",0,0,0,2,1,3,0,0,2,0,0,2,"A","Y","2013-10-05","201310050CHI"
"DAL",0,1,1,0,0,2,0,1,0,0,0,1,"H","N","2013-10-05","201310050DAL"
"WSH",0,1,0,0,0,1,0,1,1,0,0,2,"A","N","2013-10-05","201310050DAL"
"ANA",1,2,1,0,0,4,0,1,1,1,0,3,"A","N","2013-10-05","201310050MIN"
"MIN",0,1,1,1,0,3,1,2,1,0,0,4,"H","N","2013-10-05","201310050MIN"
"MTL",0,1,0,3,0,4,0,0,0,1,0,1,"H","N","2013-10-05","201310050MTL"
"PHI",0,0,0,1,0,1,0,1,0,3,0,4,"A","N","2013-10-05","201310050MTL"
"CBJ",0,0,0,2,1,3,0,0,2,0,0,2,"A","Y","2013-10-05","201310050NYI"
"NYI",0,0,2,0,0,2,0,0,0,2,1,3,"H","Y","2013-10-05","201310050NYI"
"BUF",0,0,0,1,0,1,0,2,0,2,0,4,"A","N","2013-10-05","201310050PIT"
"PIT",0,2,0,2,0,4,0,0,0,1,0,1,"H","N","2013-10-05","201310050PIT"
"PHX",0,0,1,0,0,1,0,3,0,1,0,4,"A","N","2013-10-05","201310050SJS"
"SJS",0,3,0,1,0,4,0,0,1,0,0,1,"H","N","2013-10-05","201310050SJS"
"FLA",0,0,0,0,0,0,0,1,4,2,0,7,"A","N","2013-10-05","201310050STL"
"STL",0,1,4,2,0,7,0,0,0,0,0,0,"H","N","2013-10-05","201310050STL"
"OTT",0,2,2,0,0,4,0,2,1,1,1,5,"A","Y","2013-10-05","201310050TOR"
"TOR",0,2,1,1,1,5,0,2,2,0,0,4,"H","Y","2013-10-05","201310050TOR"
"EDM",0,1,1,0,0,2,0,3,2,1,0,6,"A","N","2013-10-05","201310050VAN"
"VAN",0,3,2,1,0,6,0,1,1,0,0,2,"H","N","2013-10-05","201310050VAN"
"CAR",0,1,1,0,0,2,0,0,1,0,0,1,"H","N","2013-10-06","201310060CAR"
"PHI",0,0,1,0,0,1,0,1,1,0,0,2,"A","N","2013-10-06","201310060CAR"
"CGY",0,1,1,2,0,4,1,1,0,3,0,5,"H","N","2013-10-06","201310060CGY"
"VAN",1,1,0,3,0,5,0,1,1,2,0,4,"A","N","2013-10-06","201310060CGY"
"ANA",0,1,1,1,0,3,0,2,0,0,0,2,"A","N","2013-10-06","201310060WPG"
"WPG",0,2,0,0,0,2,0,1,1,1,0,3,"H","N","2013-10-06","201310060WPG"
"EDM",0,0,0,4,1,5,0,2,1,1,0,4,"H","Y","2013-10-07","201310070EDM"
"NJD",0,2,1,1,0,4,0,0,0,4,1,5,"A","Y","2013-10-07","201310070EDM"
"LAK",0,0,1,0,0,1,0,1,1,1,0,3,"H","N","2013-10-07","201310070LAK"
"NYR",0,1,1,1,0,3,0,0,1,0,0,1,"A","N","2013-10-07","201310070LAK"
"BUF",0,0,2,0,0,2,1,0,1,1,0,3,"H","N","2013-10-08","201310080BUF"
"TBL",1,0,1,1,0,3,0,0,2,0,0,2,"A","N","2013-10-08","201310080BUF"
"MIN",0,1,1,0,0,2,0,3,0,0,0,3,"A","N","2013-10-08","201310080NSH"
"NSH",0,3,0,0,0,3,0,1,1,0,0,2,"H","N","2013-10-08","201310080NSH"
"NYI",0,2,3,1,0,6,0,0,1,0,0,1,"H","N","2013-10-08","201310080NYI"
"PHX",0,0,1,0,0,1,0,2,3,1,0,6,"A","N","2013-10-08","201310080NYI"
"FLA",0,0,1,0,0,1,0,2,0,0,0,2,"A","N","2013-10-08","201310080PHI"
"PHI",0,2,0,0,0,2,0,0,1,0,0,1,"H","N","2013-10-08","201310080PHI"
"CAR",0,0,1,1,0,2,0,1,1,3,0,5,"A","N","2013-10-08","201310080PIT"
"PIT",0,1,1,3,0,5,0,0,1,1,0,2,"H","N","2013-10-08","201310080PIT"
"NYR",0,1,0,1,0,2,0,2,4,3,0,9,"A","N","2013-10-08","201310080SJS"
"SJS",0,2,4,3,0,9,0,1,0,1,0,2,"H","N","2013-10-08","201310080SJS"
"COL",0,0,1,1,0,2,0,0,1,0,0,1,"A","N","2013-10-08","201310080TOR"
"TOR",0,0,1,0,0,1,0,0,1,1,0,2,"H","N","2013-10-08","201310080TOR"
"NJD",0,1,1,0,0,2,1,0,2,0,0,3,"A","N","2013-10-08","201310080VAN"
"VAN",1,0,2,0,0,3,0,1,1,0,0,2,"H","N","2013-10-08","201310080VAN"
"CGY",0,2,1,0,0,3,0,0,1,1,0,2,"H","N","2013-10-09","201310090CGY"
"MTL",0,0,1,1,0,2,0,2,1,0,0,3,"A","N","2013-10-09","201310090CGY"
"LAK",1,3,0,0,0,4,0,0,1,2,0,3,"H","N","2013-10-09","201310090LAK"
"OTT",0,0,1,2,0,3,1,3,0,0,0,4,"A","N","2013-10-09","201310090LAK"
"CHI",0,1,1,0,0,2,0,1,1,1,0,3,"A","N","2013-10-09","201310090STL"
"STL",0,1,1,1,0,3,0,1,1,0,0,2,"H","N","2013-10-09","201310090STL"
"ANA",0,3,3,0,0,6,0,0,0,0,0,0,"H","N","2013-10-10","201310100ANA"
"NYR",0,0,0,0,0,0,0,3,3,0,0,6,"A","N","2013-10-10","201310100ANA"
"BOS",0,0,0,0,0,0,0,1,0,1,0,2,"H","N","2013-10-10","201310100BOS"
"COL",0,1,0,1,0,2,0,0,0,0,0,0,"A","N","2013-10-10","201310100BOS"
"BUF",0,1,0,0,0,1,0,3,1,0,0,4,"H","N","2013-10-10","201310100BUF"
"CBJ",0,3,1,0,0,4,0,1,0,0,0,1,"A","N","2013-10-10","201310100BUF"
"DET",0,0,2,0,0,2,0,1,1,2,0,4,"H","N","2013-10-10","201310100DET"
"PHX",0,1,1,2,0,4,0,0,2,0,0,2,"A","N","2013-10-10","201310100DET"
"EDM",0,0,1,0,0,1,0,0,2,2,0,4,"H","N","2013-10-10","201310100EDM"
"MTL",0,0,2,2,0,4,0,0,1,0,0,1,"A","N","2013-10-10","201310100EDM"
"MIN",0,1,1,0,0,2,0,1,0,0,0,1,"H","N","2013-10-10","201310100MIN"
"WPG",0,1,0,0,0,1,0,1,1,0,0,2,"A","N","2013-10-10","201310100MIN"
"NSH",0,0,0,0,0,0,0,0,2,2,0,4,"H","N","2013-10-10","201310100NSH"
"TOR",0,0,2,2,0,4,0,0,0,0,0,0,"A","N","2013-10-10","201310100NSH"
"FLA",0,0,1,1,0,2,0,2,2,3,0,7,"A","N","2013-10-10","201310100TBL"
"TBL",0,2,2,3,0,7,0,0,1,1,0,2,"H","N","2013-10-10","201310100TBL"
"SJS",0,2,1,1,0,4,0,0,1,0,0,1,"A","N","2013-10-10","201310100VAN"
"VAN",0,0,1,0,0,1,0,2,1,1,0,4,"H","N","2013-10-10","201310100VAN"
"CAR",0,0,2,1,0,3,0,1,1,0,0,2,"A","N","2013-10-10","201310100WSH"
"WSH",0,1,1,0,0,2,0,0,2,1,0,3,"H","N","2013-10-10","201310100WSH"
"CAR",0,0,0,1,0,1,0,0,0,1,1,2,"H","Y","2013-10-11","201310110CAR"
"LAK",0,0,0,1,1,2,0,0,0,1,0,1,"A","Y","2013-10-11","201310110CAR"
"CGY",0,0,2,1,0,3,0,1,1,0,0,2,"H","N","2013-10-11","201310110CGY"
"NJD",0,1,1,0,0,2,0,0,2,1,0,3,"A","N","2013-10-11","201310110CGY"
"CHI",0,2,1,0,0,3,0,2,0,0,0,2,"H","N","2013-10-11","201310110CHI"
"NYI",0,2,0,0,0,2,0,2,1,0,0,3,"A","N","2013-10-11","201310110CHI"
"FLA",0,2,2,2,0,6,0,2,1,0,0,3,"H","N","2013-10-11","201310110FLA"
"PIT",0,2,1,0,0,3,0,2,2,2,0,6,"A","N","2013-10-11","201310110FLA"
"PHI",0,0,1,0,0,1,0,1,1,0,0,2,"H","N","2013-10-11","201310110PHI"
"PHX",0,1,1,0,0,2,0,0,1,0,0,1,"A","N","2013-10-11","201310110PHI"
"DAL",0,3,1,0,0,4,0,0,0,1,0,1,"A","N","2013-10-11","201310110WPG"
"WPG",0,0,0,1,0,1,0,3,1,0,0,4,"H","N","2013-10-11","201310110WPG"
"BOS",0,0,1,2,0,3,0,1,0,0,0,1,"A","N","2013-10-12","201310120CBJ"
"CBJ",0,1,0,0,0,1,0,0,1,2,0,3,"H","N","2013-10-12","201310120CBJ"
"BUF",0,0,0,1,0,1,0,1,1,0,0,2,"A","N","2013-10-12","201310120CHI"
"CHI",0,1,1,0,0,2,0,0,0,1,0,1,"H","N","2013-10-12","201310120CHI"
"DET",0,1,1,3,0,5,0,0,1,1,0,2,"H","N","2013-10-12","201310120DET"
"PHI",0,0,1,1,0,2,0,1,1,3,0,5,"A","N","2013-10-12","201310120DET"
"DAL",0,0,1,0,0,1,0,2,2,1,0,5,"A","N","2013-10-12","201310120MIN"
"MIN",0,2,2,1,0,5,0,0,1,0,0,1,"H","N","2013-10-12","201310120MIN"
"NSH",0,0,2,1,0,3,0,0,2,0,0,2,"H","N","2013-10-12","201310120NSH"
"NYI",0,0,2,0,0,2,0,0,2,1,0,3,"A","N","2013-10-12","201310120NSH"
"OTT",0,2,0,0,0,2,0,1,1,1,0,3,"A","N","2013-10-12","201310120SJS"
"SJS",0,1,1,1,0,3,0,2,0,0,0,2,"H","N","2013-10-12","201310120SJS"
"NYR",0,1,1,1,0,3,0,1,3,1,0,5,"A","N","2013-10-12","201310120STL"
"STL",0,1,3,1,0,5,0,1,1,1,0,3,"H","N","2013-10-12","201310120STL"
"PIT",0,0,2,3,0,5,0,1,2,1,0,4,"A","N","2013-10-12","201310120TBL"
"TBL",0,1,2,1,0,4,0,0,2,3,0,5,"H","N","2013-10-12","201310120TBL"
"EDM",0,2,1,2,0,5,1,2,1,2,0,6,"A","N","2013-10-12","201310120TOR"
"TOR",1,2,1,2,0,6,0,2,1,2,0,5,"H","N","2013-10-12","201310120TOR"
"MTL",0,1,1,2,0,4,0,0,1,0,0,1,"A","N","2013-10-12","201310120VAN"
"VAN",0,0,1,0,0,1,0,1,1,2,0,4,"H","N","2013-10-12","201310120VAN"
"COL",0,2,1,2,0,5,0,0,0,1,0,1,"A","N","2013-10-12","201310120WSH"
"WSH",0,0,0,1,0,1,0,2,1,2,0,5,"H","N","2013-10-12","201310120WSH"
"ANA",0,2,2,0,0,4,0,1,0,0,0,1,"H","N","2013-10-13","201310130ANA"
"OTT",0,1,0,0,0,1,0,2,2,0,0,4,"A","N","2013-10-13","201310130ANA"
"CAR",0,1,2,0,0,3,0,1,2,2,0,5,"H","N","2013-10-13","201310130CAR"
"PHX",0,1,2,2,0,5,0,1,2,0,0,3,"A","N","2013-10-13","201310130CAR"
"FLA",0,0,0,0,0,0,0,0,2,1,0,3,"H","N","2013-10-13","201310130FLA"
"LAK",0,0,2,1,0,3,0,0,0,0,0,0,"A","N","2013-10-13","201310130FLA"
"NJD",0,0,0,0,0,0,0,0,1,2,0,3,"A","N","2013-10-13","201310130WPG"
"WPG",0,0,1,2,0,3,0,0,0,0,0,0,"H","N","2013-10-13","201310130WPG"
"BOS",0,1,0,1,0,2,0,1,2,0,0,3,"H","N","2013-10-14","201310140BOS"
"DET",0,1,2,0,0,3,0,1,0,1,0,2,"A","N","2013-10-14","201310140BOS"
"BUF",0,0,1,0,0,1,0,1,1,0,0,2,"H","N","2013-10-14","201310140BUF"
"MIN",0,1,1,0,0,2,0,0,1,0,0,1,"A","N","2013-10-14","201310140BUF"
"EDM",0,1,0,1,0,2,0,1,3,0,0,4,"A","N","2013-10-14","201310140WSH"
"WSH",0,1,3,0,0,4,0,1,0,1,0,2,"H","N","2013-10-14","201310140WSH"
"CAR",0,0,0,2,0,2,0,2,0,0,1,3,"H","Y","2013-10-15","201310150CAR"
"CHI",0,2,0,0,1,3,0,0,0,2,0,2,"A","Y","2013-10-15","201310150CAR"
"COL",0,2,1,0,0,3,0,1,1,0,0,2,"H","N","2013-10-15","201310150COL"
"DAL",0,1,1,0,0,2,0,2,1,0,0,3,"A","N","2013-10-15","201310150COL"
"CBJ",0,0,1,0,0,1,0,1,1,0,0,2,"A","N","2013-10-15","201310150DET"
"DET",0,1,1,0,0,2,0,0,1,0,0,1,"H","N","2013-10-15","201310150DET"
"FLA",0,0,2,1,0,3,0,1,1,2,0,4,"A","N","2013-10-15","201310150NSH"
"NSH",0,1,1,2,0,4,0,0,2,1,0,3,"H","N","2013-10-15","201310150NSH"
"BUF",0,0,2,1,1,4,0,1,1,1,0,3,"A","Y","2013-10-15","201310150NYI"
"NYI",0,1,1,1,0,3,0,0,2,1,1,4,"H","Y","2013-10-15","201310150NYI"
"PHI",0,1,1,0,0,2,0,1,0,2,0,3,"H","N","2013-10-15","201310150PHI"
"VAN",0,1,0,2,0,3,0,1,1,0,0,2,"A","N","2013-10-15","201310150PHI"
"OTT",1,0,1,2,0,4,0,0,2,1,0,3,"A","N","2013-10-15","201310150PHX"
"PHX",0,0,2,1,0,3,1,0,1,2,0,4,"H","N","2013-10-15","201310150PHX"
"EDM",0,0,2,0,0,2,0,1,1,1,0,3,"A","N","2013-10-15","201310150PIT"
"PIT",0,1,1,1,0,3,0,0,2,0,0,2,"H","N","2013-10-15","201310150PIT"
"SJS",0,2,2,2,0,6,0,0,0,2,0,2,"A","N","2013-10-15","201310150STL"
"STL",0,0,0,2,0,2,0,2,2,2,0,6,"H","N","2013-10-15","201310150STL"
"LAK",0,0,0,1,0,1,0,2,1,2,0,5,"A","N","2013-10-15","201310150TBL"
"TBL",0,2,1,2,0,5,0,0,0,1,0,1,"H","N","2013-10-15","201310150TBL"
"MIN",0,1,0,0,0,1,0,2,1,1,0,4,"A","N","2013-10-15","201310150TOR"
"TOR",0,2,1,1,0,4,0,1,0,0,0,1,"H","N","2013-10-15","201310150TOR"
"MTL",0,2,0,1,0,3,0,0,0,0,0,0,"A","N","2013-10-15","201310150WPG"
"WPG",0,0,0,0,0,0,0,2,0,1,0,3,"H","N","2013-10-15","201310150WPG"
"ANA",0,2,1,0,0,3,0,1,0,1,0,2,"H","N","2013-10-16","201310160ANA"
"CGY",0,1,0,1,0,2,0,2,1,0,0,3,"A","N","2013-10-16","201310160ANA"
"NYR",0,0,2,0,0,2,0,0,0,0,0,0,"A","N","2013-10-16","201310160WSH"
"WSH",0,0,0,0,0,0,0,0,2,0,0,2,"H","N","2013-10-16","201310160WSH"
"BUF",0,0,0,0,0,0,0,1,1,1,0,3,"H","N","2013-10-17","201310170BUF"
"VAN",0,1,1,1,0,3,0,0,0,0,0,0,"A","N","2013-10-17","201310170BUF"
"CHI",0,1,1,0,0,2,0,1,1,0,1,3,"H","Y","2013-10-17","201310170CHI"
"STL",0,1,1,0,1,3,0,1,1,0,0,2,"A","Y","2013-10-17","201310170CHI"
"COL",0,0,2,0,0,2,0,2,0,2,0,4,"H","N","2013-10-17","201310170COL"
"DET",0,2,0,2,0,4,0,0,2,0,0,2,"A","N","2013-10-17","201310170COL"
"DAL",0,1,2,0,1,4,0,2,1,0,0,3,"H","Y","2013-10-17","201310170DAL"
"SJS",0,2,1,0,0,3,0,1,2,0,1,4,"A","Y","2013-10-17","201310170DAL"
"BOS",0,2,0,1,0,3,0,0,1,1,0,2,"A","N","2013-10-17","201310170FLA"
"FLA",0,0,1,1,0,2,0,2,0,1,0,3,"H","N","2013-10-17","201310170FLA"
"CBJ",0,0,2,1,0,3,0,2,1,2,0,5,"A","N","2013-10-17","201310170MTL"
"MTL",0,2,1,2,0,5,0,0,2,1,0,3,"H","N","2013-10-17","201310170MTL"
"LAK",0,1,0,0,1,2,0,1,0,0,0,1,"A","Y","2013-10-17","201310170NSH"
"NSH",0,1,0,0,0,1,0,1,0,0,1,2,"H","Y","2013-10-17","201310170NSH"
"EDM",0,2,0,0,0,2,0,1,2,0,0,3,"A","N","2013-10-17","201310170NYI"
"NYI",0,1,2,0,0,3,0,2,0,0,0,2,"H","N","2013-10-17","201310170NYI"
"NJD",0,0,0,2,0,2,0,2,1,2,0,5,"A","N","2013-10-17","201310170OTT"
"OTT",0,2,1,2,0,5,0,0,0,2,0,2,"H","N","2013-10-17","201310170OTT"
"PHI",0,0,1,0,0,1,0,0,2,2,0,4,"H","N","2013-10-17","201310170PHI"
"PIT",0,0,2,2,0,4,0,0,1,0,0,1,"A","N","2013-10-17","201310170PHI"
"MIN",0,0,0,1,0,1,0,1,0,2,0,3,"A","N","2013-10-17","201310170TBL"
"TBL",0,1,0,2,0,3,0,0,0,1,0,1,"H","N","2013-10-17","201310170TBL"
"CAR",0,0,0,3,0,3,0,0,2,0,0,2,"A","N","2013-10-17","201310170TOR"
"TOR",0,0,2,0,0,2,0,0,0,3,0,3,"H","N","2013-10-17","201310170TOR"
"ANA",0,1,0,1,1,3,0,0,1,1,0,2,"H","Y","2013-10-18","201310180ANA"
"PHX",0,0,1,1,0,2,0,1,0,1,1,3,"A","Y","2013-10-18","201310180ANA"
"STL",0,2,0,1,0,3,0,1,0,2,1,4,"A","Y","2013-10-18","201310180WPG"
"WPG",0,1,0,2,1,4,0,2,0,1,0,3,"H","Y","2013-10-18","201310180WPG"
"BUF",0,0,1,1,0,2,0,2,2,0,0,4,"H","N","2013-10-19","201310190BUF"
"COL",0,2,2,0,0,4,0,0,1,1,0,2,"A","N","2013-10-19","201310190BUF"
"CHI",0,0,3,0,0,3,0,0,1,0,0,1,"H","N","2013-10-19","201310190CHI"
"TOR",0,0,1,0,0,1,0,0,3,0,0,3,"A","N","2013-10-19","201310190CHI"
"FLA",0,0,0,1,1,2,0,0,1,0,0,1,"H","Y","2013-10-19","201310190FLA"
"MIN",0,0,1,0,0,1,0,0,0,1,1,2,"A","Y","2013-10-19","201310190FLA"
"DAL",0,1,1,0,0,2,0,2,0,3,0,5,"A","N","2013-10-19","201310190LAK"
"LAK",0,2,0,3,0,5,0,1,1,0,0,2,"H","N","2013-10-19","201310190LAK"
"MTL",0,0,1,0,0,1,0,1,0,1,0,2,"H","N","2013-10-19","201310190MTL"
"NSH",0,1,0,1,0,2,0,0,1,0,0,1,"A","N","2013-10-19","201310190MTL"
"NJD",0,2,2,0,0,4,0,0,0,0,0,0,"H","N","2013-10-19","201310190NJD"
"NYR",0,0,0,0,0,0,0,2,2,0,0,4,"A","N","2013-10-19","201310190NJD"
"CAR",0,0,3,1,0,4,0,0,1,2,0,3,"A","N","2013-10-19","201310190NYI"
"NYI",0,0,1,2,0,3,0,0,3,1,0,4,"H","N","2013-10-19","201310190NYI"
"EDM",0,2,0,1,0,3,0,0,0,1,0,1,"A","N","2013-10-19","201310190OTT"
"OTT",0,0,0,1,0,1,0,2,0,1,0,3,"H","N","2013-10-19","201310190OTT"
"DET",0,2,0,0,0,2,0,0,1,4,0,5,"A","N","2013-10-19","201310190PHX"
"PHX",0,0,1,4,0,5,0,2,0,0,0,2,"H","N","2013-10-19","201310190PHX"
"PIT",0,1,1,1,1,4,0,1,1,1,0,3,"H","Y","2013-10-19","201310190PIT"
"VAN",0,1,1,1,0,3,0,1,1,1,1,4,"A","Y","2013-10-19","201310190PIT"
"CGY",0,0,1,2,0,3,0,2,2,2,0,6,"A","N","2013-10-19","201310190SJS"
"SJS",0,2,2,2,0,6,0,0,1,2,0,3,"H","N","2013-10-19","201310190SJS"
"BOS",0,1,3,1,0,5,0,0,0,0,0,0,"A","N","2013-10-19","201310190TBL"
"TBL",0,0,0,0,0,0,0,1,3,1,0,5,"H","N","2013-10-19","201310190TBL"
"CBJ",0,0,0,1,0,1,0,0,2,2,0,4,"A","N","2013-10-19","201310190WSH"
"WSH",0,0,2,2,0,4,0,0,0,1,0,1,"H","N","2013-10-19","201310190WSH"
"ANA",0,1,3,2,0,6,0,3,0,0,0,3,"H","N","2013-10-20","201310200ANA"
"DAL",0,3,0,0,0,3,0,1,3,2,0,6,"A","N","2013-10-20","201310200ANA"
"CBJ",0,1,0,2,0,3,0,0,1,0,0,1,"H","N","2013-10-20","201310200CBJ"
"VAN",0,0,1,0,0,1,0,1,0,2,0,3,"A","N","2013-10-20","201310200CBJ"
"NSH",0,0,3,0,0,3,0,0,0,1,0,1,"A","N","2013-10-20","201310200WPG"
"WPG",0,0,0,1,0,1,0,0,3,0,0,3,"H","N","2013-10-20","201310200WPG"
"DET",0,0,0,0,0,0,0,0,0,0,1,1,"H","Y","2013-10-21","201310210DET"
"SJS",0,0,0,0,1,1,0,0,0,0,0,0,"A","Y","2013-10-21","201310210DET"
"CGY",0,0,2,1,0,3,0,1,1,0,0,2,"A","N","2013-10-21","201310210LAK"
"LAK",0,1,1,0,0,2,0,0,2,1,0,3,"H","N","2013-10-21","201310210LAK"
"COL",0,0,1,0,0,1,0,0,0,0,0,0,"A","N","2013-10-21","201310210PIT"
"PIT",0,0,0,0,0,0,0,0,1,0,0,1,"H","N","2013-10-21","201310210PIT"
"CBJ",0,0,2,2,0,4,0,0,1,0,0,1,"H","N","2013-10-22","201310220CBJ"
"NJD",0,0,1,0,0,1,0,0,2,2,0,4,"A","N","2013-10-22","201310220CBJ"
"CHI",0,0,2,0,1,3,0,0,0,2,0,2,"A","Y","2013-10-22","201310220FLA"
"FLA",0,0,0,2,0,2,0,0,2,0,1,3,"H","Y","2013-10-22","201310220FLA"
"MIN",0,0,1,1,0,2,0,0,0,0,0,0,"H","N","2013-10-22","201310220MIN"
"NSH",0,0,0,0,0,0,0,0,1,1,0,2,"A","N","2013-10-22","201310220MIN"
"EDM",0,0,2,2,0,4,0,2,0,1,0,3,"A","N","2013-10-22","201310220MTL"
"MTL",0,2,0,1,0,3,0,0,2,2,0,4,"H","N","2013-10-22","201310220MTL"
"NYI",0,2,1,1,0,4,1,2,2,0,0,5,"H","N","2013-10-22","201310220NYI"
"VAN",1,2,2,0,0,5,0,2,1,1,0,4,"A","N","2013-10-22","201310220NYI"
"CGY",0,0,1,1,0,2,0,1,1,2,0,4,"A","N","2013-10-22","201310220PHX"
"PHX",0,1,1,2,0,4,0,0,1,1,0,2,"H","N","2013-10-22","201310220PHX"
"ANA",0,1,1,0,0,2,0,0,3,1,0,4,"A","N","2013-10-22","201310220TOR"
"TOR",0,0,3,1,0,4,0,1,1,0,0,2,"H","N","2013-10-22","201310220TOR"
"WPG",0,0,3,1,0,4,0,0,3,1,1,5,"H","Y","2013-10-22","201310220WPG"
"WSH",0,0,3,1,1,5,0,0,3,1,0,4,"A","Y","2013-10-22","201310220WPG"
"BOS",0,1,2,2,0,5,0,0,2,0,0,2,"A","N","2013-10-23","201310230BUF"
"BUF",0,0,2,0,0,2,0,1,2,2,0,5,"H","N","2013-10-23","201310230BUF"
"DET",0,1,0,0,0,1,0,3,1,2,0,6,"H","N","2013-10-23","201310230DET"
"OTT",0,3,1,2,0,6,0,1,0,0,0,1,"A","N","2013-10-23","201310230DET"
"BOS",0,0,1,1,0,2,0,0,0,1,0,1,"H","N","2013-10-24","201310240BOS"
"SJS",0,0,0,1,0,1,0,0,1,1,0,2,"A","N","2013-10-24","201310240BOS"
"CGY",0,0,1,0,0,1,0,1,3,1,0,5,"A","N","2013-10-24","201310240DAL"
"DAL",0,1,3,1,0,5,0,0,1,0,0,1,"H","N","2013-10-24","201310240DAL"
"EDM",0,0,0,1,0,1,0,1,1,2,0,4,"H","N","2013-10-24","201310240EDM"
"WSH",0,1,1,2,0,4,0,0,0,1,0,1,"A","N","2013-10-24","201310240EDM"
"LAK",0,4,0,3,0,7,0,0,2,2,0,4,"H","N","2013-10-24","201310240LAK"
"PHX",0,0,2,2,0,4,0,4,0,3,0,7,"A","N","2013-10-24","201310240LAK"
"CAR",0,0,1,0,0,1,0,2,0,1,0,3,"A","N","2013-10-24","201310240MIN"
"MIN",0,2,0,1,0,3,0,0,1,0,0,1,"H","N","2013-10-24","201310240MIN"
"ANA",0,0,0,1,0,1,0,2,1,1,0,4,"A","N","2013-10-24","201310240MTL"
"MTL",0,2,1,1,0,4,0,0,0,1,0,1,"H","N","2013-10-24","201310240MTL"
"NJD",0,2,0,0,0,2,0,1,1,0,1,3,"H","Y","2013-10-24","201310240NJD"
"VAN",0,1,1,0,1,3,0,2,0,0,0,2,"A","Y","2013-10-24","201310240NJD"
"NSH",1,1,0,1,0,3,0,0,1,1,0,2,"H","N","2013-10-24","201310240NSH"
"WPG",0,0,1,1,0,2,1,1,0,1,0,3,"A","N","2013-10-24","201310240NSH"
"NYR",0,1,0,0,0,1,0,1,0,1,0,2,"A","N","2013-10-24","201310240PHI"
"PHI",0,1,0,1,0,2,0,1,0,0,0,1,"H","N","2013-10-24","201310240PHI"
"CHI",0,0,3,2,0,5,1,1,2,2,0,6,"A","N","2013-10-24","201310240TBL"
"TBL",1,1,2,2,0,6,0,0,3,2,0,5,"H","N","2013-10-24","201310240TBL"
"CBJ",0,1,0,4,0,5,0,0,1,1,0,2,"H","N","2013-10-25","201310250CBJ"
"TOR",0,0,1,1,0,2,0,1,0,4,0,5,"A","N","2013-10-25","201310250CBJ"
"CAR",0,0,1,1,0,2,0,2,1,1,0,4,"A","N","2013-10-25","201310250COL"
"COL",0,2,1,1,0,4,0,0,1,1,0,2,"H","N","2013-10-25","201310250COL"
"BUF",0,0,1,2,0,3,0,1,0,0,0,1,"A","N","2013-10-25","201310250FLA"
"FLA",0,1,0,0,0,1,0,0,1,2,0,3,"H","N","2013-10-25","201310250FLA"
"ANA",0,2,0,0,0,2,0,0,1,0,0,1,"A","N","2013-10-25","201310250OTT"
"OTT",0,0,1,0,0,1,0,2,0,0,0,2,"H","N","2013-10-25","201310250OTT"
"NYI",0,1,0,3,0,4,0,1,1,1,0,3,"A","N","2013-10-25","201310250PIT"
"PIT",0,1,1,1,0,3,0,1,0,3,0,4,"H","N","2013-10-25","201310250PIT"
"STL",0,0,1,1,0,2,1,1,1,0,0,3,"H","N","2013-10-25","201310250STL"
"VAN",1,1,1,0,0,3,0,0,1,1,0,2,"A","N","2013-10-25","201310250STL"
"BOS",0,3,0,0,0,3,0,1,1,2,0,4,"H","N","2013-10-26","201310260BOS"
"NJD",0,1,1,2,0,4,0,3,0,0,0,3,"A","N","2013-10-26","201310260BOS"
"CGY",0,3,0,2,0,5,0,1,1,0,0,2,"H","N","2013-10-26","201310260CGY"
"WSH",0,1,1,0,0,2,0,3,0,2,0,5,"A","N","2013-10-26","201310260CGY"
"CHI",0,0,1,2,0,3,0,1,2,2,0,5,"H","N","2013-10-26","201310260CHI"
"MIN",0,1,2,2,0,5,0,0,1,2,0,3,"A","N","2013-10-26","201310260CHI"
"DAL",0,0,0,1,0,1,0,0,1,0,1,2,"H","Y","2013-10-26","201310260DAL"
"WPG",0,0,1,0,1,2,0,0,0,1,0,1,"A","Y","2013-10-26","201310260DAL"
"DET",0,1,1,0,0,2,1,0,1,1,0,3,"H","N","2013-10-26","201310260DET"
"NYR",1,0,1,1,0,3,0,1,1,0,0,2,"A","N","2013-10-26","201310260DET"
"MTL",0,0,0,0,0,0,0,0,1,1,0,2,"H","N","2013-10-26","201310260MTL"
"SJS",0,0,1,1,0,2,0,0,0,0,0,0,"A","N","2013-10-26","201310260MTL"
"NSH",0,0,0,1,0,1,0,1,2,3,0,6,"H","N","2013-10-26","201310260NSH"
"STL",0,1,2,3,0,6,0,0,0,1,0,1,"A","N","2013-10-26","201310260NSH"
"NYI",0,1,1,0,0,2,0,3,0,2,0,5,"H","N","2013-10-26","201310260NYI"
"PHI",0,3,0,2,0,5,0,1,1,0,0,2,"A","N","2013-10-26","201310260NYI"
"EDM",0,1,2,1,0,4,0,0,3,2,0,5,"A","N","2013-10-26","201310260PHX"
"PHX",0,0,3,2,0,5,0,1,2,1,0,4,"H","N","2013-10-26","201310260PHX"
"BUF",0,0,1,1,0,2,0,1,0,2,0,3,"A","N","2013-10-26","201310260TBL"
"TBL",0,1,0,2,0,3,0,0,1,1,0,2,"H","N","2013-10-26","201310260TBL"
"PIT",0,1,0,0,0,1,0,1,0,3,0,4,"A","N","2013-10-26","201310260TOR"
"TOR",0,1,0,3,0,4,0,1,0,0,0,1,"H","N","2013-10-26","201310260TOR"
"ANA",0,0,2,2,0,4,0,1,1,1,0,3,"A","N","2013-10-27","201310270CBJ"
"CBJ",0,1,1,1,0,3,0,0,2,2,0,4,"H","N","2013-10-27","201310270CBJ"
"COL",0,1,0,2,0,3,0,1,1,0,0,2,"H","N","2013-10-27","201310270COL"
"WPG",0,1,1,0,0,2,0,1,0,2,0,3,"A","N","2013-10-27","201310270COL"
"FLA",0,1,0,2,0,3,0,2,1,0,1,4,"H","Y","2013-10-27","201310270FLA"
"TBL",0,2,1,0,1,4,0,1,0,2,0,3,"A","Y","2013-10-27","201310270FLA"
"EDM",0,0,1,0,0,1,0,0,1,0,1,2,"A","Y","2013-10-27","201310270LAK"
"LAK",0,0,1,0,1,2,0,0,1,0,0,1,"H","Y","2013-10-27","201310270LAK"
"OTT",0,1,1,0,0,2,0,3,0,2,0,5,"H","N","2013-10-27","201310270OTT"
"SJS",0,3,0,2,0,5,0,1,1,0,0,2,"A","N","2013-10-27","201310270OTT"
"BUF",0,1,2,0,0,3,0,3,1,0,0,4,"H","N","2013-10-28","201310280BUF"
"DAL",0,3,1,0,0,4,0,1,2,0,0,3,"A","N","2013-10-28","201310280BUF"
"CAR",0,1,0,0,0,1,0,1,1,1,0,3,"H","N","2013-10-28","201310280CAR"
"PIT",0,1,1,1,0,3,0,1,0,0,0,1,"A","N","2013-10-28","201310280CAR"
"CHI",0,1,2,2,0,5,0,0,1,0,0,1,"A","N","2013-10-28","201310280MIN"
"MIN",0,0,1,0,0,1,0,1,2,2,0,5,"H","N","2013-10-28","201310280MIN"
"MTL",0,0,1,1,0,2,0,0,0,0,0,0,"A","N","2013-10-28","201310280NYR"
"NYR",0,0,0,0,0,0,0,0,1,1,0,2,"H","N","2013-10-28","201310280NYR"
"VAN",0,1,0,2,0,3,0,1,0,1,0,2,"H","N","2013-10-28","201310280VAN"
"WSH",0,1,0,1,0,2,0,1,0,2,0,3,"A","N","2013-10-28","201310280VAN"
"CHI",0,1,2,3,0,6,0,1,3,1,0,5,"H","N","2013-10-29","201310290CHI"
"OTT",0,1,3,1,0,5,0,1,2,3,0,6,"A","N","2013-10-29","201310290CHI"
"EDM",0,0,0,0,0,0,0,1,2,1,0,4,"H","N","2013-10-29","201310290EDM"
"TOR",0,1,2,1,0,4,0,0,0,0,0,0,"A","N","2013-10-29","201310290EDM"
"DAL",0,0,1,0,0,1,0,1,1,0,0,2,"A","N","2013-10-29","201310290MTL"
"MTL",0,1,1,0,0,2,0,0,1,0,0,1,"H","N","2013-10-29","201310290MTL"
"NJD",0,0,2,0,0,2,0,0,1,0,0,1,"H","N","2013-10-29","201310290NJD"
"TBL",0,0,1,0,0,1,0,0,2,0,0,2,"A","N","2013-10-29","201310290NJD"
"NYI",0,0,2,0,0,2,0,1,0,2,0,3,"H","N","2013-10-29","201310290NYI"
"NYR",0,1,0,2,0,3,0,0,2,0,0,2,"A","N","2013-10-29","201310290NYI"
"ANA",0,0,1,2,0,3,0,2,0,0,0,2,"A","N","2013-10-29","201310290PHI"
"PHI",0,2,0,0,0,2,0,0,1,2,0,3,"H","N","2013-10-29","201310290PHI"
"LAK",0,0,0,1,0,1,0,0,2,1,0,3,"A","N","2013-10-29","201310290PHX"
"PHX",0,0,2,1,0,3,0,0,0,1,0,1,"H","N","2013-10-29","201310290PHX"
"STL",0,1,0,2,0,3,0,1,0,1,0,2,"H","N","2013-10-29","201310290STL"
"WPG",0,1,0,1,0,2,0,1,0,2,0,3,"A","N","2013-10-29","201310290STL"
"CGY",0,0,1,1,0,2,0,2,0,2,0,4,"H","N","2013-10-30","201310300CGY"
"TOR",0,2,0,2,0,4,0,0,1,1,0,2,"A","N","2013-10-30","201310300CGY"
"LAK",1,1,1,1,0,4,0,2,1,0,0,3,"H","N","2013-10-30","201310300LAK"
"SJS",0,2,1,0,0,3,1,1,1,1,0,4,"A","N","2013-10-30","201310300LAK"
"BOS",0,0,0,2,0,2,0,0,1,2,0,3,"A","N","2013-10-30","201310300PIT"
"PIT",0,0,1,2,0,3,0,0,0,2,0,2,"H","N","2013-10-30","201310300PIT"
"DET",0,0,2,0,0,2,0,1,0,0,0,1,"A","N","2013-10-30","201310300VAN"
"VAN",0,1,0,0,0,1,0,0,2,0,0,2,"H","N","2013-10-30","201310300VAN"
"ANA",0,1,1,0,0,2,0,0,1,1,1,3,"A","Y","2013-10-31","201310310BOS"
"BOS",0,0,1,1,1,3,0,1,1,0,0,2,"H","Y","2013-10-31","201310310BOS"
"BUF",0,0,0,0,0,0,0,1,1,0,0,2,"A","N","2013-10-31","201310310NYR"
"NYR",0,1,1,0,0,2,0,0,0,0,0,0,"H","N","2013-10-31","201310310NYR"
"NSH",0,3,0,1,0,4,0,0,2,2,1,5,"A","Y","2013-10-31","201310310PHX"
"PHX",0,0,2,2,1,5,0,3,0,1,0,4,"H","Y","2013-10-31","201310310PHX"
"CAR",0,0,0,0,0,0,0,0,1,2,0,3,"H","N","2013-11-01","201311010CAR"
"TBL",0,0,1,2,0,3,0,0,0,0,0,0,"A","N","2013-11-01","201311010CAR"
"CGY",0,0,2,1,0,3,0,2,0,2,0,4,"H","N","2013-11-01","201311010CGY"
"DET",0,2,0,2,0,4,0,0,2,1,0,3,"A","N","2013-11-01","201311010CGY"
"COL",1,1,1,0,0,3,0,0,0,2,0,2,"A","N","2013-11-01","201311010DAL"
"DAL",0,0,0,2,0,2,1,1,1,0,0,3,"H","N","2013-11-01","201311010DAL"
"FLA",0,0,0,0,0,0,0,1,3,0,0,4,"H","N","2013-11-01","201311010FLA"
"STL",0,1,3,0,0,4,0,0,0,0,0,0,"A","N","2013-11-01","201311010FLA"
"MIN",0,1,1,2,0,4,0,1,0,2,0,3,"H","N","2013-11-01","201311010MIN"
"MTL",0,1,0,2,0,3,0,1,1,2,0,4,"A","N","2013-11-01","201311010MIN"
"NYI",0,0,3,1,1,5,0,2,2,0,0,4,"A","Y","2013-11-01","201311010OTT"
"OTT",0,2,2,0,0,4,0,0,3,1,1,5,"H","Y","2013-11-01","201311010OTT"
"PHI",0,0,0,0,0,0,0,1,5,1,0,7,"H","N","2013-11-01","201311010PHI"
"WSH",0,1,5,1,0,7,0,0,0,0,0,0,"A","N","2013-11-01","201311010PHI"
"CBJ",0,0,1,1,0,2,0,1,3,0,0,4,"A","N","2013-11-01","201311010PIT"
"PIT",0,1,3,0,0,4,0,0,1,1,0,2,"H","N","2013-11-01","201311010PIT"
"ANA",0,0,3,3,0,6,0,0,1,2,0,3,"A","N","2013-11-02","201311020BUF"
"BUF",0,0,1,2,0,3,0,0,3,3,0,6,"H","N","2013-11-02","201311020BUF"
"CBJ",0,0,0,0,0,0,0,0,1,2,0,3,"H","N","2013-11-02","201311020CBJ"
"PIT",0,0,1,2,0,3,0,0,0,0,0,0,"A","N","2013-11-02","201311020CBJ"
"COL",0,0,1,3,0,4,0,0,0,1,0,1,"H","N","2013-11-02","201311020COL"
"MTL",0,0,0,1,0,1,0,0,1,3,0,4,"A","N","2013-11-02","201311020COL"
"DET",0,2,1,2,0,5,0,0,0,0,0,0,"A","N","2013-11-02","201311020EDM"
"EDM",0,0,0,0,0,0,0,2,1,2,0,5,"H","N","2013-11-02","201311020EDM"
"LAK",0,1,0,2,0,3,0,2,1,1,0,4,"H","N","2013-11-02","201311020LAK"
"NSH",0,2,1,1,0,4,0,1,0,2,0,3,"A","N","2013-11-02","201311020LAK"
"NJD",0,0,0,0,0,0,0,1,0,0,0,1,"H","N","2013-11-02","201311020NJD"
"PHI",0,1,0,0,0,1,0,0,0,0,0,0,"A","N","2013-11-02","201311020NJD"
"BOS",0,0,1,0,0,1,0,0,3,0,0,3,"A","N","2013-11-02","201311020NYI"
"NYI",0,0,3,0,0,3,0,0,1,0,0,1,"H","N","2013-11-02","201311020NYI"
"CAR",0,0,1,0,0,1,0,1,2,2,0,5,"A","N","2013-11-02","201311020NYR"
"NYR",0,1,2,2,0,5,0,0,1,0,0,1,"H","N","2013-11-02","201311020NYR"
"PHX",0,1,1,0,1,3,0,0,2,0,0,2,"A","Y","2013-11-02","201311020SJS"
"SJS",0,0,2,0,0,2,0,1,1,0,1,3,"H","Y","2013-11-02","201311020SJS"
"STL",0,1,1,0,0,2,0,1,1,2,0,4,"A","N","2013-11-02","201311020TBL"
"TBL",0,1,1,2,0,4,0,1,1,0,0,2,"H","N","2013-11-02","201311020TBL"
"TOR",0,0,0,0,0,0,0,1,2,1,0,4,"A","N","2013-11-02","201311020VAN"
"VAN",0,1,2,1,0,4,0,0,0,0,0,0,"H","N","2013-11-02","201311020VAN"
"CHI",0,1,3,1,0,5,0,1,0,0,0,1,"A","N","2013-11-02","201311020WPG"
"WPG",0,1,0,0,0,1,0,1,3,1,0,5,"H","N","2013-11-02","201311020WPG"
"FLA",0,0,1,1,0,2,0,1,1,0,1,3,"A","Y","2013-11-02","201311020WSH"
"WSH",0,1,1,0,1,3,0,0,1,1,0,2,"H","Y","2013-11-02","201311020WSH"
"CGY",1,0,1,1,0,3,0,0,1,1,0,2,"A","N","2013-11-03","201311030CHI"
"CHI",0,0,1,1,0,2,1,0,1,1,0,3,"H","N","2013-11-03","201311030CHI"
"MIN",0,1,1,2,0,4,0,0,0,0,0,0,"H","N","2013-11-03","201311030MIN"
"NJD",0,0,0,0,0,0,0,1,1,2,0,4,"A","N","2013-11-03","201311030MIN"
"DAL",0,1,1,1,1,4,0,0,2,1,0,3,"A","Y","2013-11-03","201311030OTT"
"OTT",0,0,2,1,0,3,0,1,1,1,1,4,"H","Y","2013-11-03","201311030OTT"
"ANA",0,2,0,0,0,2,0,0,1,0,0,1,"A","N","2013-11-04","201311040NYR"
"NYR",0,0,1,0,0,1,0,2,0,0,0,2,"H","N","2013-11-04","201311040NYR"
"DET",0,0,2,0,0,2,0,1,1,2,0,4,"A","N","2013-11-04","201311040WPG"
"WPG",0,1,1,2,0,4,0,0,2,0,0,2,"H","N","2013-11-04","201311040WPG"
"BOS",0,1,0,1,0,2,0,1,0,1,1,3,"H","Y","2013-11-05","201311050BOS"
"DAL",0,1,0,1,1,3,0,1,0,1,0,2,"A","Y","2013-11-05","201311050BOS"
"CAR",1,0,0,1,0,2,0,0,0,1,0,1,"H","N","2013-11-05","201311050CAR"
"PHI",0,0,0,1,0,1,1,0,0,1,0,2,"A","N","2013-11-05","201311050CAR"
"CBJ",0,0,0,1,0,1,0,2,0,2,0,4,"H","N","2013-11-05","201311050CBJ"
"OTT",0,2,0,2,0,4,0,0,0,1,0,1,"A","N","2013-11-05","201311050CBJ"
"EDM",1,1,2,0,0,4,0,1,0,2,0,3,"A","N","2013-11-05","201311050FLA"
"FLA",0,1,0,2,0,3,1,1,2,0,0,4,"H","N","2013-11-05","201311050FLA"
"CGY",0,1,0,0,0,1,0,1,1,3,0,5,"A","N","2013-11-05","201311050MIN"
"MIN",0,1,1,3,0,5,0,1,0,0,0,1,"H","N","2013-11-05","201311050MIN"
"MTL",0,0,2,0,0,2,0,1,0,1,1,3,"H","Y","2013-11-05","201311050MTL"
"STL",0,1,0,1,1,3,0,0,2,0,0,2,"A","Y","2013-11-05","201311050MTL"
"PHX",0,1,1,0,1,3,0,0,2,0,0,2,"H","Y","2013-11-05","201311050PHX"
"VAN",0,0,2,0,0,2,0,1,1,0,1,3,"A","Y","2013-11-05","201311050PHX"
"BUF",0,0,2,2,1,5,0,1,0,3,0,4,"A","Y","2013-11-05","201311050SJS"
"SJS",0,1,0,3,0,4,0,0,2,2,1,5,"H","Y","2013-11-05","201311050SJS"
"NYI",0,1,1,0,0,2,0,0,5,1,0,6,"A","N","2013-11-05","201311050WSH"
"WSH",0,0,5,1,0,6,0,1,1,0,0,2,"H","N","2013-11-05","201311050WSH"
"ANA",0,1,2,2,0,5,0,1,1,0,0,2,"H","N","2013-11-06","201311060ANA"
"PHX",0,1,1,0,0,2,0,1,2,2,0,5,"A","N","2013-11-06","201311060ANA"
"CHI",0,2,1,1,0,4,0,0,0,1,0,1,"H","N","2013-11-06","201311060CHI"
"WPG",0,0,0,1,0,1,0,2,1,1,0,4,"A","N","2013-11-06","201311060CHI"
"COL",0,1,2,1,0,4,0,2,2,2,0,6,"H","N","2013-11-06","201311060COL"
"NSH",0,2,2,2,0,6,0,1,2,1,0,4,"A","N","2013-11-06","201311060COL"
"NYR",0,2,2,1,0,5,0,0,1,0,0,1,"H","N","2013-11-06","201311060NYR"
"PIT",0,0,1,0,0,1,0,2,2,1,0,5,"A","N","2013-11-06","201311060NYR"
"BOS",0,0,1,3,0,4,0,0,0,1,0,1,"H","N","2013-11-07","201311070BOS"
"FLA",0,0,0,1,0,1,0,0,1,3,0,4,"A","N","2013-11-07","201311070BOS"
"CAR",0,1,0,0,0,1,0,0,0,0,0,0,"H","N","2013-11-07","201311070CAR"
"NYI",0,0,0,0,0,0,0,1,0,0,0,1,"A","N","2013-11-07","201311070CAR"
"CBJ",0,1,1,0,0,2,0,1,2,1,0,4,"H","N","2013-11-07","201311070CBJ"
"NYR",0,1,2,1,0,4,0,1,1,0,0,2,"A","N","2013-11-07","201311070CBJ"
"DAL",1,0,1,2,0,4,0,0,2,1,0,3,"A","N","2013-11-07","201311070DET"
"DET",0,0,2,1,0,3,1,0,1,2,0,4,"H","N","2013-11-07","201311070DET"
"BUF",0,0,0,0,0,0,0,1,1,0,0,2,"A","N","2013-11-07","201311070LAK"
"LAK",0,1,1,0,0,2,0,0,0,0,0,0,"H","N","2013-11-07","201311070LAK"
"MTL",0,1,0,0,0,1,0,1,2,1,0,4,"A","N","2013-11-07","201311070OTT"
"OTT",0,1,2,1,0,4,0,1,0,0,0,1,"H","N","2013-11-07","201311070OTT"
"NJD",0,1,0,2,0,3,0,0,0,0,0,0,"A","N","2013-11-07","201311070PHI"
"PHI",0,0,0,0,0,0,0,1,0,2,0,3,"H","N","2013-11-07","201311070PHI"
"SJS",0,2,0,0,0,2,0,3,1,0,0,4,"H","N","2013-11-07","201311070SJS"
"VAN",0,3,1,0,0,4,0,2,0,0,0,2,"A","N","2013-11-07","201311070SJS"
"CGY",0,0,0,2,0,2,0,2,1,0,0,3,"A","N","2013-11-07","201311070STL"
"STL",0,2,1,0,0,3,0,0,0,2,0,2,"H","N","2013-11-07","201311070STL"
"EDM",0,1,0,1,0,2,0,2,1,1,0,4,"A","N","2013-11-07","201311070TBL"
"TBL",0,2,1,1,0,4,0,1,0,1,0,2,"H","N","2013-11-07","201311070TBL"
"MIN",0,1,1,0,0,2,0,1,0,1,1,3,"A","Y","2013-11-07","201311070WSH"
"WSH",0,1,0,1,1,3,0,1,1,0,0,2,"H","Y","2013-11-07","201311070WSH"
"ANA",0,4,2,0,0,6,0,1,1,0,0,2,"H","N","2013-11-08","201311080ANA"
"BUF",0,1,1,0,0,2,0,4,2,0,0,6,"A","N","2013-11-08","201311080ANA"
"CGY",0,0,2,0,0,2,0,1,2,1,0,4,"A","N","2013-11-08","201311080COL"
"COL",0,1,2,1,0,4,0,0,2,0,0,2,"H","N","2013-11-08","201311080COL"
"NJD",0,0,0,1,0,1,0,0,0,1,1,2,"A","Y","2013-11-08","201311080TOR"
"TOR",0,0,0,1,1,2,0,0,0,1,0,1,"H","Y","2013-11-08","201311080TOR"
"NSH",0,0,0,0,0,0,0,4,0,1,0,5,"A","N","2013-11-08","201311080WPG"
"WPG",0,4,0,1,0,5,0,0,0,0,0,0,"H","N","2013-11-08","201311080WPG"
"BOS",0,1,0,2,0,3,0,0,1,0,0,1,"H","N","2013-11-09","201311090BOS"
"TOR",0,0,1,0,0,1,0,1,0,2,0,3,"A","N","2013-11-09","201311090BOS"
"CAR",0,1,1,0,0,2,0,1,1,0,1,3,"H","Y","2013-11-09","201311090CAR"
"MIN",0,1,1,0,1,3,0,1,1,0,0,2,"A","Y","2013-11-09","201311090CAR"
"CBJ",0,1,1,3,0,5,0,1,1,0,0,2,"H","N","2013-11-09","201311090CBJ"
"NYI",0,1,1,0,0,2,0,1,1,3,0,5,"A","N","2013-11-09","201311090CBJ"
"CHI",0,1,2,2,0,5,0,1,1,0,0,2,"A","N","2013-11-09","201311090DAL"
"DAL",0,1,1,0,0,2,0,1,2,2,0,5,"H","N","2013-11-09","201311090DAL"
"DET",0,1,0,1,0,2,1,1,1,0,0,3,"H","N","2013-11-09","201311090DET"
"TBL",1,1,1,0,0,3,0,1,0,1,0,2,"A","N","2013-11-09","201311090DET"
"LAK",0,2,3,0,0,5,0,0,1,0,0,1,"H","N","2013-11-09","201311090LAK"
"VAN",0,0,1,0,0,1,0,2,3,0,0,5,"A","N","2013-11-09","201311090LAK"
"FLA",0,1,0,1,0,2,0,2,1,0,0,3,"A","N","2013-11-09","201311090OTT"
"OTT",0,2,1,0,0,3,0,1,0,1,0,2,"H","N","2013-11-09","201311090OTT"
"EDM",0,0,1,1,0,2,0,2,0,2,0,4,"A","N","2013-11-09","201311090PHI"
"PHI",0,2,0,2,0,4,0,0,1,1,0,2,"H","N","2013-11-09","201311090PHI"
"PHX",0,1,0,2,1,4,0,0,3,0,0,3,"H","Y","2013-11-09","201311090PHX"
"WSH",0,0,3,0,0,3,0,1,0,2,1,4,"A","Y","2013-11-09","201311090PHX"
"PIT",0,0,1,0,0,1,0,0,1,1,0,2,"A","N","2013-11-09","201311090STL"
"STL",0,0,1,1,0,2,0,0,1,0,0,1,"H","N","2013-11-09","201311090STL"
"ANA",0,0,2,1,0,3,0,0,1,0,0,1,"H","N","2013-11-10","201311100ANA"
"VAN",0,0,1,0,0,1,0,0,2,1,0,3,"A","N","2013-11-10","201311100ANA"
"CHI",0,1,1,3,0,5,0,0,2,2,0,4,"H","N","2013-11-10","201311100CHI"
"EDM",0,0,2,2,0,4,0,1,1,3,0,5,"A","N","2013-11-10","201311100CHI"
"COL",0,1,1,2,0,4,0,0,1,0,0,1,"H","N","2013-11-10","201311100COL"
"WSH",0,0,1,0,0,1,0,1,1,2,0,4,"A","N","2013-11-10","201311100COL"
"MTL",0,0,3,1,0,4,0,0,1,1,0,2,"H","N","2013-11-10","201311100MTL"
"NYI",0,0,1,1,0,2,0,0,3,1,0,4,"A","N","2013-11-10","201311100MTL"
"NJD",0,1,2,2,0,5,0,0,0,0,0,0,"H","N","2013-11-10","201311100NJD"
"NSH",0,0,0,0,0,0,0,1,2,2,0,5,"A","N","2013-11-10","201311100NJD"
"FLA",0,1,1,1,0,3,0,1,1,2,0,4,"A","N","2013-11-10","201311100NYR"
"NYR",0,1,1,2,0,4,0,1,1,1,0,3,"H","N","2013-11-10","201311100NYR"
"SJS",0,2,1,1,0,4,0,0,3,1,1,5,"A","Y","2013-11-10","201311100WPG"
"WPG",0,0,3,1,1,5,0,2,1,1,0,4,"H","Y","2013-11-10","201311100WPG"
"BOS",0,0,2,1,0,3,0,0,0,0,0,0,"H","N","2013-11-11","201311110BOS"
"TBL",0,0,0,0,0,0,0,0,2,1,0,3,"A","N","2013-11-11","201311110BOS"
"BUF",0,0,1,1,1,3,0,1,0,1,0,2,"H","Y","2013-11-12","201311120BUF"
"LAK",0,1,0,1,0,2,0,0,1,1,1,3,"A","Y","2013-11-12","201311120BUF"
"CAR",0,1,1,0,0,2,0,0,1,0,0,1,"H","N","2013-11-12","201311120CAR"
"COL",0,0,1,0,0,1,0,1,1,0,0,2,"A","N","2013-11-12","201311120CAR"
"CGY",0,0,0,2,0,2,1,2,0,0,0,3,"H","N","2013-11-12","201311120CGY"
"SJS",1,2,0,0,0,3,0,0,0,2,0,2,"A","N","2013-11-12","201311120CGY"
"DET",0,1,0,1,0,2,0,1,0,1,1,3,"H","Y","2013-11-12","201311120DET"
"WPG",0,1,0,1,1,3,0,1,0,1,0,2,"A","Y","2013-11-12","201311120DET"
"ANA",0,2,0,0,0,2,0,0,2,1,0,3,"A","N","2013-11-12","201311120FLA"
"FLA",0,0,2,1,0,3,0,2,0,0,0,2,"H","N","2013-11-12","201311120FLA"
"MTL",0,0,0,1,0,1,0,1,0,0,1,2,"H","Y","2013-11-12","201311120MTL"
"TBL",0,1,0,0,1,2,0,0,0,1,0,1,"A","Y","2013-11-12","201311120MTL"
"NSH",0,0,0,1,0,1,0,2,1,0,0,3,"A","N","2013-11-12","201311120NYI"
"NYI",0,2,1,0,0,3,0,0,0,1,0,1,"H","N","2013-11-12","201311120NYI"
"NJD",0,0,2,1,0,3,0,0,1,1,0,2,"A","N","2013-11-12","201311120NYR"
"NYR",0,0,1,1,0,2,0,0,2,1,0,3,"H","N","2013-11-12","201311120NYR"
"OTT",0,0,0,0,0,0,0,1,2,2,0,5,"H","N","2013-11-12","201311120OTT"
"PHI",0,1,2,2,0,5,0,0,0,0,0,0,"A","N","2013-11-12","201311120OTT"
"PHX",1,2,0,0,0,3,0,1,0,1,0,2,"A","N","2013-11-12","201311120STL"
"STL",0,1,0,1,0,2,1,2,0,0,0,3,"H","N","2013-11-12","201311120STL"
"CBJ",0,0,1,2,0,3,1,0,1,2,0,4,"A","N","2013-11-12","201311120WSH"
"WSH",1,0,1,2,0,4,0,0,1,2,0,3,"H","N","2013-11-12","201311120WSH"
"DAL",0,0,1,2,0,3,0,0,0,0,0,0,"A","N","2013-11-13","201311130EDM"
"EDM",0,0,0,0,0,0,0,0,1,2,0,3,"H","N","2013-11-13","201311130EDM"
"MIN",0,0,0,1,1,2,0,0,1,0,0,1,"H","Y","2013-11-13","201311130MIN"
"TOR",0,0,1,0,0,1,0,0,0,1,1,2,"A","Y","2013-11-13","201311130MIN"
"PHI",0,1,1,0,0,2,0,0,1,0,0,1,"A","N","2013-11-13","201311130PIT"
"PIT",0,0,1,0,0,1,0,1,1,0,0,2,"H","N","2013-11-13","201311130PIT"
"BOS",1,1,1,0,0,3,0,1,1,0,0,2,"H","N","2013-11-14","201311140BOS"
"CBJ",0,1,1,0,0,2,1,1,1,0,0,3,"A","N","2013-11-14","201311140BOS"
"CGY",0,0,1,2,0,3,0,1,4,2,0,7,"H","N","2013-11-14","201311140CGY"
"DAL",0,1,4,2,0,7,0,0,1,2,0,3,"A","N","2013-11-14","201311140CGY"
"CHI",0,2,1,1,1,5,0,2,2,0,0,4,"H","Y","2013-11-14","201311140CHI"
"PHX",0,2,2,0,0,4,0,2,1,1,1,5,"A","Y","2013-11-14","201311140CHI"
"LAK",0,0,0,3,0,3,0,0,2,0,0,2,"A","N","2013-11-14","201311140NYI"
"NYI",0,0,2,0,0,2,0,0,0,3,0,3,"H","N","2013-11-14","201311140NYI"
"COL",0,1,0,2,0,3,0,1,4,2,0,7,"A","N","2013-11-14","201311140STL"
"STL",0,1,4,2,0,7,0,1,0,2,0,3,"H","N","2013-11-14","201311140STL"
"ANA",0,0,1,0,0,1,0,2,2,1,0,5,"A","N","2013-11-14","201311140TBL"
"TBL",0,2,2,1,0,5,0,0,1,0,0,1,"H","N","2013-11-14","201311140TBL"
"SJS",1,0,0,1,0,2,0,0,1,0,0,1,"A","N","2013-11-14","201311140VAN"
"VAN",0,0,1,0,0,1,1,0,0,1,0,2,"H","N","2013-11-14","201311140VAN"
"BUF",0,0,2,1,0,3,0,0,1,0,0,1,"H","N","2013-11-15","201311150BUF"
"TOR",0,0,1,0,0,1,0,0,2,1,0,3,"A","N","2013-11-15","201311150BUF"
"ANA",0,0,1,1,0,2,0,0,1,1,1,3,"A","Y","2013-11-15","201311150CAR"
"CAR",0,0,1,1,1,3,0,0,1,1,0,2,"H","Y","2013-11-15","201311150CAR"
"CBJ",0,2,0,0,0,2,0,1,1,0,1,3,"H","Y","2013-11-15","201311150CBJ"
"MTL",0,1,1,0,1,3,0,2,0,0,0,2,"A","Y","2013-11-15","201311150CBJ"
"DET",0,2,1,0,0,3,0,1,0,2,1,4,"H","Y","2013-11-15","201311150DET"
"WSH",0,1,0,2,1,4,0,2,1,0,0,3,"A","Y","2013-11-15","201311150DET"
"EDM",0,0,1,0,0,1,0,2,1,0,0,3,"H","N","2013-11-15","201311150EDM"
"SJS",0,2,1,0,0,3,0,0,1,0,0,1,"A","N","2013-11-15","201311150EDM"
"FLA",0,0,0,2,0,2,0,2,0,1,0,3,"A","N","2013-11-15","201311150MIN"
"MIN",0,2,0,1,0,3,0,0,0,2,0,2,"H","N","2013-11-15","201311150MIN"
"LAK",0,0,0,2,0,2,0,0,0,0,0,0,"A","N","2013-11-15","201311150NJD"
"NJD",0,0,0,0,0,0,0,0,0,2,0,2,"H","N","2013-11-15","201311150NJD"
"BOS",0,2,0,0,0,2,0,1,0,3,0,4,"A","N","2013-11-15","201311150OTT"
"OTT",0,1,0,3,0,4,0,2,0,0,0,2,"H","N","2013-11-15","201311150OTT"
"NSH",0,1,0,0,0,1,0,2,2,0,0,4,"A","N","2013-11-15","201311150PIT"
"PIT",0,2,2,0,0,4,0,1,0,0,0,1,"H","N","2013-11-15","201311150PIT"
"PHI",0,2,0,0,0,2,0,1,0,1,1,3,"A","Y","2013-11-15","201311150WPG"
"WPG",0,1,0,1,1,3,0,2,0,0,0,2,"H","Y","2013-11-15","201311150WPG"
"CGY",0,1,1,0,0,2,0,0,0,4,0,4,"H","N","2013-11-16","201311160CGY"
"EDM",0,0,0,4,0,4,0,1,1,0,0,2,"A","N","2013-11-16","201311160CGY"
"COL",0,0,1,0,0,1,0,1,2,1,0,4,"H","N","2013-11-16","201311160COL"
"FLA",0,1,2,1,0,4,0,0,1,0,0,1,"A","N","2013-11-16","201311160COL"
"MTL",0,0,0,0,0,0,0,0,1,0,0,1,"H","N","2013-11-16","201311160MTL"
"NYR",0,0,1,0,0,1,0,0,0,0,0,0,"A","N","2013-11-16","201311160MTL"
"NJD",0,1,1,2,0,4,0,0,1,0,0,1,"H","N","2013-11-16","201311160NJD"
"PIT",0,0,1,0,0,1,0,1,1,2,0,4,"A","N","2013-11-16","201311160NJD"
"CHI",0,0,1,1,0,2,0,2,2,3,0,7,"A","N","2013-11-16","201311160NSH"
"NSH",0,2,2,3,0,7,0,0,1,1,0,2,"H","N","2013-11-16","201311160NSH"
"DET",0,2,1,1,0,4,0,1,2,1,1,5,"A","Y","2013-11-16","201311160NYI"
"NYI",0,1,2,1,1,5,0,2,1,1,0,4,"H","Y","2013-11-16","201311160NYI"
"PHX",0,2,2,2,0,6,0,0,2,1,0,3,"H","N","2013-11-16","201311160PHX"
"TBL",0,0,2,1,0,3,0,2,2,2,0,6,"A","N","2013-11-16","201311160PHX"
"CAR",0,0,2,0,0,2,0,0,2,2,0,4,"A","N","2013-11-16","201311160STL"
"STL",0,0,2,2,0,4,0,0,2,0,0,2,"H","N","2013-11-16","201311160STL"
"BUF",0,0,0,2,0,2,0,2,1,1,0,4,"A","N","2013-11-16","201311160TOR"
"TOR",0,2,1,1,0,4,0,0,0,2,0,2,"H","N","2013-11-16","201311160TOR"
"CHI",0,1,1,3,0,5,0,0,1,0,0,1,"H","N","2013-11-17","201311170CHI"
"SJS",0,0,1,0,0,1,0,1,1,3,0,5,"A","N","2013-11-17","201311170CHI"
"MIN",0,1,0,1,0,2,0,0,0,1,0,1,"H","N","2013-11-17","201311170MIN"
"WPG",0,0,0,1,0,1,0,1,0,1,0,2,"A","N","2013-11-17","201311170MIN"
"LAK",0,0,1,0,0,1,0,0,0,0,0,0,"A","N","2013-11-17","201311170NYR"
"NYR",0,0,0,0,0,0,0,0,1,0,0,1,"H","N","2013-11-17","201311170NYR"
"CBJ",0,1,2,1,0,4,0,0,0,1,0,1,"A","N","2013-11-17","201311170OTT"
"OTT",0,0,0,1,0,1,0,1,2,1,0,4,"H","N","2013-11-17","201311170OTT"
"DAL",0,1,0,1,0,2,0,0,0,1,0,1,"A","N","2013-11-17","201311170VAN"
"VAN",0,0,0,1,0,1,0,1,0,1,0,2,"H","N","2013-11-17","201311170VAN"
"STL",0,0,1,0,0,1,0,3,1,0,0,4,"A","N","2013-11-17","201311170WSH"
"WSH",0,3,1,0,0,4,0,0,1,0,0,1,"H","N","2013-11-17","201311170WSH"
"BOS",0,2,0,2,0,4,0,1,0,0,0,1,"A","N","2013-11-18","201311180CAR"
"CAR",0,1,0,0,0,1,0,2,0,2,0,4,"H","N","2013-11-18","201311180CAR"
"ANA",0,0,0,1,0,1,0,0,0,3,0,3,"A","N","2013-11-18","201311180PIT"
"PIT",0,0,0,3,0,3,0,0,0,1,0,1,"H","N","2013-11-18","201311180PIT"
"CGY",0,0,2,2,1,5,0,0,1,3,0,4,"A","Y","2013-11-18","201311180WPG"
"WPG",0,0,1,3,0,4,0,0,2,2,1,5,"H","Y","2013-11-18","201311180WPG"
"BUF",0,1,0,0,0,1,0,2,1,1,0,4,"H","N","2013-11-19","201311190BUF"
"STL",0,2,1,1,0,4,0,1,0,0,0,1,"A","N","2013-11-19","201311190BUF"
"CHI",0,0,0,1,0,1,0,3,1,1,0,5,"A","N","2013-11-19","201311190COL"
"COL",0,3,1,1,0,5,0,0,0,1,0,1,"H","N","2013-11-19","201311190COL"
"DET",0,0,0,0,0,0,0,0,1,1,0,2,"H","N","2013-11-19","201311190DET"
"NSH",0,0,1,1,0,2,0,0,0,0,0,0,"A","N","2013-11-19","201311190DET"
"CBJ",0,0,0,0,0,0,0,3,3,1,0,7,"A","N","2013-11-19","201311190EDM"
"EDM",0,3,3,1,0,7,0,0,0,0,0,0,"H","N","2013-11-19","201311190EDM"
"LAK",0,2,3,0,0,5,0,0,1,1,0,2,"H","N","2013-11-19","201311190LAK"
"TBL",0,0,1,1,0,2,0,2,3,0,0,5,"A","N","2013-11-19","201311190LAK"
"MIN",0,0,0,2,0,2,0,0,4,2,0,6,"A","N","2013-11-19","201311190MTL"
"MTL",0,0,4,2,0,6,0,0,0,2,0,2,"H","N","2013-11-19","201311190MTL"
"BOS",0,0,2,0,0,2,0,0,1,0,0,1,"A","N","2013-11-19","201311190NYR"
"NYR",0,0,1,0,0,1,0,0,2,0,0,2,"H","N","2013-11-19","201311190NYR"
"OTT",0,0,1,1,0,2,0,1,1,3,0,5,"A","N","2013-11-19","201311190PHI"
"PHI",0,1,1,3,0,5,0,0,1,1,0,2,"H","N","2013-11-19","201311190PHI"
"NYI",0,0,1,1,0,2,0,1,1,3,0,5,"A","N","2013-11-19","201311190TOR"
"TOR",0,1,1,3,0,5,0,0,1,1,0,2,"H","N","2013-11-19","201311190TOR"
"FLA",0,1,0,1,1,3,0,0,1,1,0,2,"A","Y","2013-11-19","201311190VAN"
"VAN",0,0,1,1,0,2,0,1,0,1,1,3,"H","Y","2013-11-19","201311190VAN"
"ANA",0,1,2,0,0,3,1,2,0,1,0,4,"H","N","2013-11-20","201311200ANA"
"NJD",1,2,0,1,0,4,0,1,2,0,0,3,"A","N","2013-11-20","201311200ANA"
"CBJ",1,1,0,0,0,2,0,0,0,1,0,1,"A","N","2013-11-20","201311200CGY"
"CGY",0,0,0,1,0,1,1,1,0,0,0,2,"H","N","2013-11-20","201311200CGY"
"MIN",0,1,2,1,0,4,0,2,0,1,0,3,"A","N","2013-11-20","201311200OTT"
"OTT",0,2,0,1,0,3,0,1,2,1,0,4,"H","N","2013-11-20","201311200OTT"
"PIT",0,2,1,1,0,4,0,0,0,0,0,0,"A","N","2013-11-20","201311200WSH"
"WSH",0,0,0,0,0,0,0,2,1,1,0,4,"H","N","2013-11-20","201311200WSH"
"BOS",0,1,1,0,0,2,0,1,1,0,1,3,"H","Y","2013-11-21","201311210BOS"
"STL",0,1,1,0,1,3,0,1,1,0,0,2,"A","Y","2013-11-21","201311210BOS"
"DAL",0,0,1,1,0,2,0,1,0,2,0,3,"H","N","2013-11-21","201311210DAL"
"NYR",0,1,0,2,0,3,0,0,1,1,0,2,"A","N","2013-11-21","201311210DAL"
"CAR",0,0,2,1,0,3,0,1,1,2,0,4,"A","N","2013-11-21","201311210DET"
"DET",0,1,1,2,0,4,0,0,2,1,0,3,"H","N","2013-11-21","201311210DET"
"EDM",0,1,2,1,0,4,0,0,1,0,0,1,"H","N","2013-11-21","201311210EDM"
"FLA",0,0,1,0,0,1,0,1,2,1,0,4,"A","N","2013-11-21","201311210EDM"
"LAK",0,0,0,1,0,1,1,0,0,1,0,2,"H","N","2013-11-21","201311210LAK"
"NJD",1,0,0,1,0,2,0,0,0,1,0,1,"A","N","2013-11-21","201311210LAK"
"BUF",0,1,0,0,0,1,0,0,2,2,0,4,"A","N","2013-11-21","201311210PHI"
"PHI",0,0,2,2,0,4,0,1,0,0,0,1,"H","N","2013-11-21","201311210PHI"
"COL",1,0,2,1,0,4,0,0,1,2,0,3,"A","N","2013-11-21","201311210PHX"
"PHX",0,0,1,2,0,3,1,0,2,1,0,4,"H","N","2013-11-21","201311210PHX"
"SJS",0,2,1,2,0,5,0,0,0,1,0,1,"H","N","2013-11-21","201311210SJS"
"TBL",0,0,0,1,0,1,0,2,1,2,0,5,"A","N","2013-11-21","201311210SJS"
"NSH",0,0,3,1,0,4,0,1,0,1,0,2,"A","N","2013-11-21","201311210TOR"
"TOR",0,1,0,1,0,2,0,0,3,1,0,4,"H","N","2013-11-21","201311210TOR"
"CHI",0,1,2,3,0,6,0,0,3,0,0,3,"A","N","2013-11-21","201311210WPG"
"WPG",0,0,3,0,0,3,0,1,2,3,0,6,"H","N","2013-11-21","201311210WPG"
"ANA",1,0,0,0,0,1,0,0,0,0,0,0,"H","N","2013-11-22","201311220ANA"
"TBL",0,0,0,0,0,0,1,0,0,0,0,1,"A","N","2013-11-22","201311220ANA"
"CGY",0,0,2,1,1,4,0,1,0,2,0,3,"H","Y","2013-11-22","201311220CGY"
"FLA",0,1,0,2,0,3,0,0,2,1,1,4,"A","Y","2013-11-22","201311220CGY"
"NYI",0,0,3,0,0,3,0,2,1,1,0,4,"A","N","2013-11-22","201311220PIT"
"PIT",0,2,1,1,0,4,0,0,3,0,0,3,"H","N","2013-11-22","201311220PIT"
"CBJ",0,1,0,1,0,2,0,1,3,2,0,6,"A","N","2013-11-22","201311220VAN"
"VAN",0,1,3,2,0,6,0,1,0,1,0,2,"H","N","2013-11-22","201311220VAN"
"MTL",0,3,0,0,0,3,0,1,0,1,0,2,"A","N","2013-11-22","201311220WSH"
"WSH",0,1,0,1,0,2,0,3,0,0,0,3,"H","N","2013-11-22","201311220WSH"
"BOS",1,1,1,0,0,3,0,1,0,1,0,2,"H","N","2013-11-23","201311230BOS"
"CAR",0,1,0,1,0,2,1,1,1,0,0,3,"A","N","2013-11-23","201311230BOS"
"DET",0,1,0,1,0,2,0,2,0,2,0,4,"H","N","2013-11-23","201311230DET"
"OTT",0,2,0,2,0,4,0,1,0,1,0,2,"A","N","2013-11-23","201311230DET"
"COL",1,0,0,0,0,1,0,0,0,0,0,0,"A","N","2013-11-23","201311230LAK"
"LAK",0,0,0,0,0,0,1,0,0,0,0,1,"H","N","2013-11-23","201311230LAK"
"MTL",0,0,1,2,0,3,0,0,0,2,0,2,"H","N","2013-11-23","201311230MTL"
"PIT",0,0,0,2,0,2,0,0,1,2,0,3,"A","N","2013-11-23","201311230MTL"
"NSH",0,0,0,0,0,0,0,0,1,1,0,2,"H","N","2013-11-23","201311230NSH"
"NYR",0,0,1,1,0,2,0,0,0,0,0,0,"A","N","2013-11-23","201311230NSH"
"NYI",0,0,1,1,0,2,0,0,3,2,0,5,"A","N","2013-11-23","201311230PHI"
"PHI",0,0,3,2,0,5,0,0,1,1,0,2,"H","N","2013-11-23","201311230PHI"
"ANA",0,1,3,0,0,4,0,0,1,1,0,2,"A","N","2013-11-23","201311230PHX"
"PHX",0,0,1,1,0,2,0,1,3,0,0,4,"H","N","2013-11-23","201311230PHX"
"NJD",0,0,0,1,0,1,0,2,0,0,0,2,"A","N","2013-11-23","201311230SJS"
"SJS",0,2,0,0,0,2,0,0,0,1,0,1,"H","N","2013-11-23","201311230SJS"
"DAL",0,1,0,0,0,1,0,2,1,3,0,6,"A","N","2013-11-23","201311230STL"
"STL",0,2,1,3,0,6,0,1,0,0,0,1,"H","N","2013-11-23","201311230STL"
"TOR",0,0,1,0,1,2,0,0,0,1,0,1,"H","Y","2013-11-23","201311230TOR"
"WSH",0,0,0,1,0,1,0,0,1,0,1,2,"A","Y","2013-11-23","201311230TOR"
"CHI",0,0,0,2,0,2,0,1,0,0,0,1,"A","N","2013-11-23","201311230VAN"
"VAN",0,1,0,0,0,1,0,0,0,2,0,2,"H","N","2013-11-23","201311230VAN"
"MIN",0,0,0,2,1,3,0,0,1,1,0,2,"A","Y","2013-11-23","201311230WPG"
"WPG",0,0,1,1,0,2,0,0,0,2,1,3,"H","Y","2013-11-23","201311230WPG"
"BUF",0,1,0,0,0,1,0,0,1,2,0,3,"H","N","2013-11-24","201311240BUF"
"DET",0,0,1,2,0,3,0,1,0,0,0,1,"A","N","2013-11-24","201311240BUF"
"CAR",0,0,3,1,0,4,0,1,0,0,0,1,"H","N","2013-11-24","201311240CAR"
"OTT",0,1,0,0,0,1,0,0,3,1,0,4,"A","N","2013-11-24","201311240CAR"
"BOS",1,2,0,1,0,4,0,0,1,2,0,3,"H","N","2013-11-25","201311250BOS"
"PIT",0,0,1,2,0,3,1,2,0,1,0,4,"A","N","2013-11-25","201311250BOS"
"CHI",0,2,2,1,0,5,0,0,1,0,0,1,"A","N","2013-11-25","201311250EDM"
"EDM",0,0,1,0,0,1,0,2,2,1,0,5,"H","N","2013-11-25","201311250EDM"
"FLA",0,0,2,1,0,3,0,0,0,1,0,1,"H","N","2013-11-25","201311250FLA"
"PHI",0,0,0,1,0,1,0,0,2,1,0,3,"A","N","2013-11-25","201311250FLA"
"NJD",0,0,0,1,0,1,0,1,1,1,0,3,"H","N","2013-11-25","201311250NJD"
"WPG",0,1,1,1,0,3,0,0,0,1,0,1,"A","N","2013-11-25","201311250NJD"
"NSH",0,3,0,1,0,4,0,0,2,0,0,2,"H","N","2013-11-25","201311250NSH"
"PHX",0,0,2,0,0,2,0,3,0,1,0,4,"A","N","2013-11-25","201311250NSH"
"MIN",0,0,0,0,0,0,0,2,0,1,0,3,"A","N","2013-11-25","201311250STL"
"STL",0,2,0,1,0,3,0,0,0,0,0,0,"H","N","2013-11-25","201311250STL"
"NYR",0,0,0,0,0,0,0,2,2,1,0,5,"A","N","2013-11-25","201311250TBL"
"TBL",0,2,2,1,0,5,0,0,0,0,0,0,"H","N","2013-11-25","201311250TBL"
"CBJ",0,2,2,2,0,6,0,0,0,0,0,0,"A","N","2013-11-25","201311250TOR"
"TOR",0,0,0,0,0,0,0,2,2,2,0,6,"H","N","2013-11-25","201311250TOR"
"LAK",1,1,0,1,0,3,0,0,1,1,0,2,"A","N","2013-11-25","201311250VAN"
"VAN",0,0,1,1,0,2,1,1,0,1,0,3,"H","N","2013-11-25","201311250VAN"
"ANA",0,1,1,1,0,3,0,0,1,5,0,6,"A","N","2013-11-26","201311260DAL"
"DAL",0,0,1,5,0,6,0,1,1,1,0,3,"H","N","2013-11-26","201311260DAL"
"BUF",0,0,1,0,0,1,0,1,1,1,0,3,"H","N","2013-11-27","201311270BUF"
"MTL",0,1,1,1,0,3,0,0,1,0,0,1,"A","N","2013-11-27","201311270BUF"
"CBJ",0,0,0,0,0,0,0,1,2,1,0,4,"H","N","2013-11-27","201311270CBJ"
"NSH",0,1,2,1,0,4,0,0,0,0,0,0,"A","N","2013-11-27","201311270CBJ"
"CGY",0,0,1,1,0,2,0,0,0,3,0,3,"H","N","2013-11-27","201311270CGY"
"CHI",0,0,0,3,0,3,0,0,1,1,0,2,"A","N","2013-11-27","201311270CGY"
"COL",0,1,0,0,0,1,0,3,0,1,0,4,"H","N","2013-11-27","201311270COL"
"STL",0,3,0,1,0,4,0,1,0,0,0,1,"A","N","2013-11-27","201311270COL"
"BOS",0,0,0,1,0,1,0,1,3,2,0,6,"A","N","2013-11-27","201311270DET"
"DET",0,1,3,2,0,6,0,0,0,1,0,1,"H","N","2013-11-27","201311270DET"
"FLA",0,0,0,2,0,2,0,1,1,3,0,5,"H","N","2013-11-27","201311270FLA"
"NYR",0,1,1,3,0,5,0,0,0,2,0,2,"A","N","2013-11-27","201311270FLA"
"MIN",0,0,0,1,0,1,0,1,1,1,0,3,"H","N","2013-11-27","201311270MIN"
"PHX",0,1,1,1,0,3,0,0,0,1,0,1,"A","N","2013-11-27","201311270MIN"
"CAR",0,1,3,0,0,4,0,0,1,2,0,3,"A","N","2013-11-27","201311270NJD"
"NJD",0,0,1,2,0,3,0,1,3,0,0,4,"H","N","2013-11-27","201311270NJD"
"NYI",0,0,1,1,0,2,0,0,3,0,0,3,"H","N","2013-11-27","201311270NYI"
"WPG",0,0,3,0,0,3,0,0,1,1,0,2,"A","N","2013-11-27","201311270NYI"
"PIT",0,1,2,2,1,6,0,2,3,0,0,5,"H","Y","2013-11-27","201311270PIT"
"TOR",0,2,3,0,0,5,0,1,2,2,1,6,"A","Y","2013-11-27","201311270PIT"
"LAK",0,1,0,1,0,2,0,0,2,0,1,3,"A","Y","2013-11-27","201311270SJS"
"SJS",0,0,2,0,1,3,0,1,0,1,0,2,"H","Y","2013-11-27","201311270SJS"
"PHI",0,0,0,2,0,2,0,0,2,2,0,4,"A","N","2013-11-27","201311270TBL"
"TBL",0,0,2,2,0,4,0,0,0,2,0,2,"H","N","2013-11-27","201311270TBL"
"OTT",0,1,2,3,0,6,0,3,0,1,0,4,"A","N","2013-11-27","201311270WSH"
"WSH",0,3,0,1,0,4,0,1,2,3,0,6,"H","N","2013-11-27","201311270WSH"
"EDM",0,0,2,1,0,3,0,0,0,0,0,0,"A","N","2013-11-28","201311280NSH"
"NSH",0,0,0,0,0,0,0,0,2,1,0,3,"H","N","2013-11-28","201311280NSH"
"OTT",0,1,1,0,0,2,0,0,4,1,0,5,"H","N","2013-11-28","201311280OTT"
"VAN",0,0,4,1,0,5,0,1,1,0,0,2,"A","N","2013-11-28","201311280OTT"
"ANA",0,2,2,1,0,5,0,0,2,0,0,2,"H","N","2013-11-29","201311290ANA"
"CGY",0,0,2,0,0,2,0,2,2,1,0,5,"A","N","2013-11-29","201311290ANA"
"BOS",0,1,0,2,0,3,0,2,0,0,0,2,"H","N","2013-11-29","201311290BOS"
"NYR",0,2,0,0,0,2,0,1,0,2,0,3,"A","N","2013-11-29","201311290BOS"
"BUF",1,0,2,0,0,3,0,1,1,0,0,2,"H","N","2013-11-29","201311290BUF"
"TOR",0,1,1,0,0,2,1,0,2,0,0,3,"A","N","2013-11-29","201311290BUF"
"CAR",0,0,2,0,0,2,0,1,0,4,0,5,"H","N","2013-11-29","201311290CAR"
"NJD",0,1,0,4,0,5,0,0,2,0,0,2,"A","N","2013-11-29","201311290CAR"
"CBJ",0,1,3,0,0,4,0,0,0,2,0,2,"H","N","2013-11-29","201311290CBJ"
"EDM",0,0,0,2,0,2,0,1,3,0,0,4,"A","N","2013-11-29","201311290CBJ"
"CHI",0,0,0,1,1,2,0,1,0,0,0,1,"A","Y","2013-11-29","201311290DAL"
"DAL",0,1,0,0,0,1,0,0,0,1,1,2,"H","Y","2013-11-29","201311290DAL"
"COL",0,1,1,1,0,3,0,0,1,0,0,1,"A","N","2013-11-29","201311290MIN"
"MIN",0,0,1,0,0,1,0,1,1,1,0,3,"H","N","2013-11-29","201311290MIN"
"DET",0,1,1,3,0,5,0,0,0,0,0,0,"A","N","2013-11-29","201311290NYI"
"NYI",0,0,0,0,0,0,0,1,1,3,0,5,"H","N","2013-11-29","201311290NYI"
"PHI",0,1,1,0,0,2,0,0,0,1,0,1,"H","N","2013-11-29","201311290PHI"
"WPG",0,0,0,1,0,1,0,1,1,0,0,2,"A","N","2013-11-29","201311290PHI"
"SJS",0,4,0,2,0,6,0,0,1,2,0,3,"H","N","2013-11-29","201311290SJS"
"STL",0,0,1,2,0,3,0,4,0,2,0,6,"A","N","2013-11-29","201311290SJS"
"PIT",0,1,0,2,0,3,0,0,0,0,0,0,"A","N","2013-11-29","201311290TBL"
"TBL",0,0,0,0,0,0,0,1,0,2,0,3,"H","N","2013-11-29","201311290TBL"
"MTL",0,1,1,0,0,2,0,0,1,1,1,3,"A","Y","2013-11-29","201311290WSH"
"WSH",0,0,1,1,1,3,0,1,1,0,0,2,"H","Y","2013-11-29","201311290WSH"
"BOS",0,2,0,1,0,3,0,0,0,1,0,1,"H","N","2013-11-30","201311300BOS"
"CBJ",0,0,0,1,0,1,0,2,0,1,0,3,"A","N","2013-11-30","201311300BOS"
"COL",0,1,1,0,1,3,0,0,0,2,0,2,"H","Y","2013-11-30","201311300COL"
"MIN",0,0,0,2,0,2,0,1,1,0,1,3,"A","Y","2013-11-30","201311300COL"
"FLA",0,0,1,0,0,1,0,2,2,1,0,5,"H","N","2013-11-30","201311300FLA"
"PIT",0,2,2,1,0,5,0,0,1,0,0,1,"A","N","2013-11-30","201311300FLA"
"CGY",0,0,1,1,0,2,0,0,0,1,0,1,"A","N","2013-11-30","201311300LAK"
"LAK",0,0,0,1,0,1,0,0,1,1,0,2,"H","N","2013-11-30","201311300LAK"
"MTL",0,2,2,0,0,4,0,0,2,0,0,2,"H","N","2013-11-30","201311300MTL"
"TOR",0,0,2,0,0,2,0,2,2,0,0,4,"A","N","2013-11-30","201311300MTL"
"BUF",0,0,0,0,0,0,1,0,0,0,0,1,"A","N","2013-11-30","201311300NJD"
"NJD",1,0,0,0,0,1,0,0,0,0,0,0,"H","N","2013-11-30","201311300NJD"
"NSH",0,1,0,1,0,2,0,1,0,1,1,3,"H","Y","2013-11-30","201311300NSH"
"PHI",0,1,0,1,1,3,0,1,0,1,0,2,"A","Y","2013-11-30","201311300NSH"
"NYI",0,0,0,2,0,2,1,0,1,1,0,3,"H","N","2013-11-30","201311300NYI"
"WSH",1,0,1,1,0,3,0,0,0,2,0,2,"A","N","2013-11-30","201311300NYI"
"NYR",0,2,2,1,0,5,0,0,1,1,0,2,"H","N","2013-11-30","201311300NYR"
"VAN",0,0,1,1,0,2,0,2,2,1,0,5,"A","N","2013-11-30","201311300NYR"
"CHI",0,3,0,2,0,5,0,0,2,0,0,2,"A","N","2013-11-30","201311300PHX"
"PHX",0,0,2,0,0,2,0,3,0,2,0,5,"H","N","2013-11-30","201311300PHX"
"ANA",0,1,0,2,0,3,0,0,3,0,1,4,"A","Y","2013-11-30","201311300SJS"
"SJS",0,0,3,0,1,4,0,1,0,2,0,3,"H","Y","2013-11-30","201311300SJS"
"CAR",0,0,2,0,0,2,0,2,1,0,0,3,"H","N","2013-12-01","201312010CAR"
"VAN",0,2,1,0,0,3,0,0,2,0,0,2,"A","N","2013-12-01","201312010CAR"
"DAL",0,0,1,1,0,2,0,0,1,1,1,3,"H","Y","2013-12-01","201312010DAL"
"EDM",0,0,1,1,1,3,0,0,1,1,0,2,"A","Y","2013-12-01","201312010DAL"
"DET",0,0,2,2,0,4,0,0,1,1,0,2,"A","N","2013-12-01","201312010OTT"
"OTT",0,0,1,1,0,2,0,0,2,2,0,4,"H","N","2013-12-01","201312010OTT"
"LAK",0,2,1,0,0,3,0,0,0,2,0,2,"H","N","2013-12-02","201312020LAK"
"STL",0,0,0,2,0,2,0,2,1,0,0,3,"A","N","2013-12-02","201312020LAK"
"MIN",0,0,0,2,0,2,0,0,0,0,0,0,"H","N","2013-12-02","201312020MIN"
"PHI",0,0,0,0,0,0,0,0,0,2,0,2,"A","N","2013-12-02","201312020MIN"
"MTL",0,0,2,1,0,3,0,1,0,1,0,2,"H","N","2013-12-02","201312020MTL"
"NJD",0,1,0,1,0,2,0,0,2,1,0,3,"A","N","2013-12-02","201312020MTL"
"NYR",0,1,1,0,0,2,0,0,2,3,0,5,"H","N","2013-12-02","201312020NYR"
"WPG",0,0,2,3,0,5,0,1,1,0,0,2,"A","N","2013-12-02","201312020NYR"
"ANA",0,0,1,1,0,2,0,0,1,1,1,3,"H","Y","2013-12-03","201312030ANA"
"LAK",0,0,1,1,1,3,0,0,1,1,0,2,"A","Y","2013-12-03","201312030ANA"
"CBJ",0,0,1,0,0,1,0,0,0,0,0,0,"H","N","2013-12-03","201312030CBJ"
"TBL",0,0,0,0,0,0,0,0,1,0,0,1,"A","N","2013-12-03","201312030CBJ"
"CHI",0,0,3,0,0,3,0,2,1,1,0,4,"H","N","2013-12-03","201312030CHI"
"DAL",0,2,1,1,0,4,0,0,3,0,0,3,"A","N","2013-12-03","201312030CHI"
"EDM",0,1,1,0,0,2,0,1,2,3,0,6,"H","N","2013-12-03","201312030EDM"
"PHX",0,1,2,3,0,6,0,1,1,0,0,2,"A","N","2013-12-03","201312030EDM"
"FLA",0,2,0,0,0,2,0,2,1,1,0,4,"H","N","2013-12-03","201312030FLA"
"OTT",0,2,1,1,0,4,0,2,0,0,0,2,"A","N","2013-12-03","201312030FLA"
"NSH",0,0,1,0,0,1,0,0,1,2,0,3,"H","N","2013-12-03","201312030NSH"
"VAN",0,0,1,2,0,3,0,0,1,0,0,1,"A","N","2013-12-03","201312030NSH"
"NYI",0,2,0,0,0,2,1,0,1,1,0,3,"H","N","2013-12-03","201312030NYI"
"PIT",1,0,1,1,0,3,0,2,0,0,0,2,"A","N","2013-12-03","201312030NYI"
"SJS",0,2,1,1,0,4,0,0,2,0,0,2,"A","N","2013-12-03","201312030TOR"
"TOR",0,0,2,0,0,2,0,2,1,1,0,4,"H","N","2013-12-03","201312030TOR"
"CAR",0,1,3,0,0,4,0,0,0,1,0,1,"A","N","2013-12-03","201312030WSH"
"WSH",0,0,0,1,0,1,0,1,3,0,0,4,"H","N","2013-12-03","201312030WSH"
"CGY",0,1,2,1,0,4,0,1,0,0,0,1,"H","N","2013-12-04","201312040CGY"
"PHX",0,1,0,0,0,1,0,1,2,1,0,4,"A","N","2013-12-04","201312040CGY"
"DET",0,1,2,0,0,3,0,1,1,4,0,6,"H","N","2013-12-04","201312040DET"
"PHI",0,1,1,4,0,6,0,1,2,0,0,3,"A","N","2013-12-04","201312040DET"
"MTL",0,1,0,2,1,4,0,0,0,3,0,3,"A","Y","2013-12-04","201312040NJD"
"NJD",0,0,0,3,0,3,0,1,0,2,1,4,"H","Y","2013-12-04","201312040NJD"
"BUF",0,0,0,1,0,1,0,1,0,2,0,3,"H","N","2013-12-05","201312050BUF"
"NYR",0,1,0,2,0,3,0,0,0,1,0,1,"A","N","2013-12-05","201312050BUF"
"COL",0,0,2,0,0,2,0,3,1,4,0,8,"A","N","2013-12-05","201312050EDM"
"EDM",0,3,1,4,0,8,0,0,2,0,0,2,"H","N","2013-12-05","201312050EDM"
"FLA",0,1,2,2,0,5,0,1,0,1,0,2,"H","N","2013-12-05","201312050FLA"
"WPG",0,1,0,1,0,2,0,1,2,2,0,5,"A","N","2013-12-05","201312050FLA"
"CHI",0,0,1,2,0,3,0,1,1,2,0,4,"A","N","2013-12-05","201312050MIN"
"MIN",0,1,1,2,0,4,0,0,1,2,0,3,"H","N","2013-12-05","201312050MIN"
"BOS",0,1,0,0,0,1,0,0,2,0,0,2,"A","N","2013-12-05","201312050MTL"
"MTL",0,0,2,0,0,2,0,1,0,0,0,1,"H","N","2013-12-05","201312050MTL"
"CAR",0,1,3,1,0,5,0,0,2,0,0,2,"A","N","2013-12-05","201312050NSH"
"NSH",0,0,2,0,0,2,0,1,3,1,0,5,"H","N","2013-12-05","201312050NSH"
"PIT",0,0,4,1,0,5,0,0,1,0,0,1,"H","N","2013-12-05","201312050PIT"
"SJS",0,0,1,0,0,1,0,0,4,1,0,5,"A","N","2013-12-05","201312050PIT"
"NYI",0,0,1,0,0,1,0,1,3,1,0,5,"A","N","2013-12-05","201312050STL"
"STL",0,1,3,1,0,5,0,0,1,0,0,1,"H","N","2013-12-05","201312050STL"
"OTT",0,0,1,0,0,1,0,1,1,1,0,3,"A","N","2013-12-05","201312050TBL"
"TBL",0,1,1,1,0,3,0,0,1,0,0,1,"H","N","2013-12-05","201312050TBL"
"DAL",0,0,0,2,0,2,1,0,1,1,0,3,"A","N","2013-12-05","201312050TOR"
"TOR",1,0,1,1,0,3,0,0,0,2,0,2,"H","N","2013-12-05","201312050TOR"
"CAR",0,0,1,4,0,5,0,2,0,1,0,3,"H","N","2013-12-06","201312060CAR"
"SJS",0,2,0,1,0,3,0,0,1,4,0,5,"A","N","2013-12-06","201312060CAR"
"CBJ",0,0,2,2,0,4,0,0,0,0,0,0,"H","N","2013-12-06","201312060CBJ"
"MIN",0,0,0,0,0,0,0,0,2,2,0,4,"A","N","2013-12-06","201312060CBJ"
"CGY",0,1,0,1,0,2,0,0,2,1,0,3,"H","N","2013-12-06","201312060CGY"
"COL",0,0,2,1,0,3,0,1,0,1,0,2,"A","N","2013-12-06","201312060CGY"
"ANA",0,1,1,0,1,3,0,1,1,0,0,2,"A","Y","2013-12-06","201312060CHI"
"CHI",0,1,1,0,0,2,0,1,1,0,1,3,"H","Y","2013-12-06","201312060CHI"
"DET",0,0,1,2,0,3,0,1,0,0,0,1,"A","N","2013-12-06","201312060NJD"
"NJD",0,1,0,0,0,1,0,0,1,2,0,3,"H","N","2013-12-06","201312060NJD"
"PHX",0,0,0,2,0,2,1,0,2,0,0,3,"A","N","2013-12-06","201312060VAN"
"VAN",1,0,2,0,0,3,0,0,0,2,0,2,"H","N","2013-12-06","201312060VAN"
"BOS",0,1,0,2,0,3,0,2,0,0,0,2,"H","N","2013-12-07","201312070BOS"
"PIT",0,2,0,0,0,2,0,1,0,2,0,3,"A","N","2013-12-07","201312070BOS"
"DAL",0,0,4,1,0,5,0,1,0,0,0,1,"H","N","2013-12-07","201312070DAL"
"PHI",0,1,0,0,0,1,0,0,4,1,0,5,"A","N","2013-12-07","201312070DAL"
"DET",0,1,0,0,0,1,0,0,1,1,0,2,"H","N","2013-12-07","201312070DET"
"FLA",0,0,1,1,0,2,0,1,0,0,0,1,"A","N","2013-12-07","201312070DET"
"CGY",1,1,0,0,0,2,0,0,0,1,0,1,"A","N","2013-12-07","201312070EDM"
"EDM",0,0,0,1,0,1,1,1,0,0,0,2,"H","N","2013-12-07","201312070EDM"
"LAK",0,0,1,2,0,3,0,0,0,0,0,0,"H","N","2013-12-07","201312070LAK"
"NYI",0,0,0,0,0,0,0,0,1,2,0,3,"A","N","2013-12-07","201312070LAK"
"BUF",0,0,1,1,0,2,0,0,3,0,0,3,"A","N","2013-12-07","201312070MTL"
"MTL",0,0,3,0,0,3,0,0,1,1,0,2,"H","N","2013-12-07","201312070MTL"
"NJD",1,0,1,2,0,4,0,1,1,1,0,3,"A","N","2013-12-07","201312070NYR"
"NYR",0,1,1,1,0,3,1,0,1,2,0,4,"H","N","2013-12-07","201312070NYR"
"OTT",0,1,0,2,0,3,0,1,2,0,1,4,"H","Y","2013-12-07","201312070OTT"
"TOR",0,1,2,0,1,4,0,1,0,2,0,3,"A","Y","2013-12-07","201312070OTT"
"ANA",0,3,1,1,0,5,0,0,0,2,0,2,"A","N","2013-12-07","201312070STL"
"STL",0,0,0,2,0,2,0,3,1,1,0,5,"H","N","2013-12-07","201312070STL"
"TBL",0,0,1,0,0,1,1,1,0,0,0,2,"H","N","2013-12-07","201312070TBL"
"WPG",1,1,0,0,0,2,0,0,1,0,0,1,"A","N","2013-12-07","201312070TBL"
"NSH",0,1,0,1,0,2,0,3,0,2,0,5,"A","N","2013-12-07","201312070WSH"
"WSH",0,3,0,2,0,5,0,1,0,1,0,2,"H","N","2013-12-07","201312070WSH"
"CHI",0,2,2,2,0,6,0,0,2,0,0,2,"H","N","2013-12-08","201312080CHI"
"FLA",0,0,2,0,0,2,0,2,2,2,0,6,"A","N","2013-12-08","201312080CHI"
"MIN",0,0,2,1,0,3,0,0,0,1,0,1,"H","N","2013-12-08","201312080MIN"
"SJS",0,0,0,1,0,1,0,0,2,1,0,3,"A","N","2013-12-08","201312080MIN"
"NYR",0,0,0,1,0,1,0,0,3,1,0,4,"H","N","2013-12-08","201312080NYR"
"WSH",0,0,3,1,0,4,0,0,0,1,0,1,"A","N","2013-12-08","201312080NYR"
"BOS",0,0,3,2,0,5,0,1,0,1,0,2,"A","N","2013-12-08","201312080TOR"
"TOR",0,1,0,1,0,2,0,0,3,2,0,5,"H","N","2013-12-08","201312080TOR"
"COL",0,0,0,1,0,1,0,1,0,2,0,3,"A","N","2013-12-08","201312080VAN"
"VAN",0,1,0,2,0,3,0,0,0,1,0,1,"H","N","2013-12-08","201312080VAN"
"ANA",0,1,3,1,0,5,0,1,1,0,0,2,"H","N","2013-12-09","201312090ANA"
"NYI",0,1,1,0,0,2,0,1,3,1,0,5,"A","N","2013-12-09","201312090ANA"
"OTT",0,1,1,2,1,5,0,1,2,1,0,4,"H","Y","2013-12-09","201312090OTT"
"PHI",0,1,2,1,0,4,0,1,1,2,1,5,"A","Y","2013-12-09","201312090OTT"
"CBJ",0,0,0,1,0,1,0,0,1,1,0,2,"A","N","2013-12-09","201312090PIT"
"PIT",0,0,1,1,0,2,0,0,0,1,0,1,"H","N","2013-12-09","201312090PIT"
"CAR",0,0,0,0,0,0,0,1,0,1,0,2,"A","N","2013-12-09","201312090VAN"
"VAN",0,1,0,1,0,2,0,0,0,0,0,0,"H","N","2013-12-09","201312090VAN"
"BUF",0,0,1,0,1,2,0,1,0,0,0,1,"H","Y","2013-12-10","201312100BUF"
"OTT",0,1,0,0,0,1,0,0,1,0,1,2,"A","Y","2013-12-10","201312100BUF"
"CBJ",0,1,2,2,0,5,0,2,1,1,0,4,"H","N","2013-12-10","201312100CBJ"
"NJD",0,2,1,1,0,4,0,1,2,2,0,5,"A","N","2013-12-10","201312100CBJ"
"BOS",0,0,0,2,0,2,0,0,1,0,0,1,"A","N","2013-12-10","201312100CGY"
"CGY",0,0,1,0,0,1,0,0,0,2,0,2,"H","N","2013-12-10","201312100CGY"
"COL",0,0,1,0,0,1,0,0,3,0,0,3,"H","N","2013-12-10","201312100COL"
"PHX",0,0,3,0,0,3,0,0,1,0,0,1,"A","N","2013-12-10","201312100COL"
"CHI",0,2,4,0,0,6,0,0,1,1,0,2,"A","N","2013-12-10","201312100DAL"
"DAL",0,0,1,1,0,2,0,2,4,0,0,6,"H","N","2013-12-10","201312100DAL"
"CAR",0,1,1,2,0,4,1,3,1,0,0,5,"A","N","2013-12-10","201312100EDM"
"EDM",1,3,1,0,0,5,0,1,1,2,0,4,"H","N","2013-12-10","201312100EDM"
"DET",0,1,1,0,0,2,0,0,0,2,1,3,"A","Y","2013-12-10","201312100FLA"
"FLA",0,0,0,2,1,3,0,1,1,0,0,2,"H","Y","2013-12-10","201312100FLA"
"LAK",0,2,4,0,0,6,0,0,0,0,0,0,"A","N","2013-12-10","201312100MTL"
"MTL",0,0,0,0,0,0,0,2,4,0,0,6,"H","N","2013-12-10","201312100MTL"
"NSH",0,2,0,2,0,4,0,0,1,0,0,1,"A","N","2013-12-10","201312100NYR"
"NYR",0,0,1,0,0,1,0,2,0,2,0,4,"H","N","2013-12-10","201312100NYR"
"NYI",0,0,0,2,1,3,0,0,2,0,0,2,"A","Y","2013-12-10","201312100SJS"
"SJS",0,0,2,0,0,2,0,0,0,2,1,3,"H","Y","2013-12-10","201312100SJS"
"STL",0,0,1,1,0,2,0,0,0,1,0,1,"A","N","2013-12-10","201312100WPG"
"WPG",0,0,0,1,0,1,0,0,1,1,0,2,"H","N","2013-12-10","201312100WPG"
"TBL",0,3,1,1,0,5,0,1,3,1,1,6,"A","Y","2013-12-10","201312100WSH"
"WSH",0,1,3,1,1,6,0,3,1,1,0,5,"H","Y","2013-12-10","201312100WSH"
"ANA",0,0,2,0,0,2,0,0,0,1,0,1,"H","N","2013-12-11","201312110ANA"
"MIN",0,0,0,1,0,1,0,0,2,0,0,2,"A","N","2013-12-11","201312110ANA"
"CHI",0,0,5,2,0,7,0,1,1,0,0,2,"H","N","2013-12-11","201312110CHI"
"PHI",0,1,1,0,0,2,0,0,5,2,0,7,"A","N","2013-12-11","201312110CHI"
"LAK",0,1,0,2,0,3,0,0,1,0,0,1,"A","N","2013-12-11","201312110TOR"
"TOR",0,0,1,0,0,1,0,1,0,2,0,3,"H","N","2013-12-11","201312110TOR"
"CAR",0,0,0,1,0,1,1,0,1,0,0,2,"A","N","2013-12-12","201312120CGY"
"CGY",1,0,1,0,0,2,0,0,0,1,0,1,"H","N","2013-12-12","201312120CGY"
"BOS",0,3,0,1,0,4,0,0,2,0,0,2,"A","N","2013-12-12","201312120EDM"
"EDM",0,0,2,0,0,2,0,3,0,1,0,4,"H","N","2013-12-12","201312120EDM"
"DAL",0,1,0,0,0,1,0,2,1,0,0,3,"A","N","2013-12-12","201312120NSH"
"NSH",0,2,1,0,0,3,0,1,0,0,0,1,"H","N","2013-12-12","201312120NSH"
"CBJ",0,3,0,1,0,4,0,1,0,1,0,2,"A","N","2013-12-12","201312120NYR"
"NYR",0,1,0,1,0,2,0,3,0,1,0,4,"H","N","2013-12-12","201312120NYR"
"BUF",0,1,0,0,0,1,0,1,1,0,0,2,"A","N","2013-12-12","201312120OTT"
"OTT",0,1,1,0,0,2,0,1,0,0,0,1,"H","N","2013-12-12","201312120OTT"
"MTL",0,0,0,1,0,1,0,1,1,0,0,2,"A","N","2013-12-12","201312120PHI"
"PHI",0,1,1,0,0,2,0,0,0,1,0,1,"H","N","2013-12-12","201312120PHI"
"NYI",0,1,2,0,0,3,0,1,4,1,0,6,"A","N","2013-12-12","201312120PHX"
"PHX",0,1,4,1,0,6,0,1,2,0,0,3,"H","N","2013-12-12","201312120PHX"
"MIN",0,0,0,1,0,1,0,2,1,0,0,3,"A","N","2013-12-12","201312120SJS"
"SJS",0,2,1,0,0,3,0,0,0,1,0,1,"H","N","2013-12-12","201312120SJS"
"STL",0,3,1,2,0,6,0,0,1,2,0,3,"H","N","2013-12-12","201312120STL"
"TOR",0,0,1,2,0,3,0,3,1,2,0,6,"A","N","2013-12-12","201312120STL"
"DET",0,1,0,0,0,1,0,0,1,0,1,2,"A","Y","2013-12-12","201312120TBL"
"TBL",0,0,1,0,1,2,0,1,0,0,0,1,"H","Y","2013-12-12","201312120TBL"
"COL",0,1,2,0,1,4,0,2,0,1,0,3,"A","Y","2013-12-12","201312120WPG"
"WPG",0,2,0,1,0,3,0,1,2,0,1,4,"H","Y","2013-12-12","201312120WPG"
"FLA",0,0,2,0,1,3,0,0,2,0,0,2,"H","Y","2013-12-13","201312130FLA"
"WSH",0,0,2,0,0,2,0,0,2,0,1,3,"A","Y","2013-12-13","201312130FLA"
"NJD",0,0,2,0,0,2,0,3,0,0,0,3,"A","N","2013-12-13","201312130PIT"
"PIT",0,3,0,0,0,3,0,0,2,0,0,2,"H","N","2013-12-13","201312130PIT"
"EDM",0,0,0,0,0,0,0,0,1,3,0,4,"A","N","2013-12-13","201312130VAN"
"VAN",0,0,1,3,0,4,0,0,0,0,0,0,"H","N","2013-12-13","201312130VAN"
"BUF",0,0,0,1,0,1,1,0,0,1,0,2,"H","N","2013-12-14","201312140BUF"
"CGY",1,0,0,1,0,2,0,0,0,1,0,1,"A","N","2013-12-14","201312140BUF"
"CBJ",0,3,0,0,0,3,1,1,1,1,0,4,"H","N","2013-12-14","201312140CBJ"
"STL",1,1,1,1,0,4,0,3,0,0,0,3,"A","N","2013-12-14","201312140CBJ"
"COL",0,0,1,0,0,1,0,0,0,1,1,2,"H","Y","2013-12-14","201312140COL"
"MIN",0,0,0,1,1,2,0,0,1,0,0,1,"A","Y","2013-12-14","201312140COL"
"DET",0,1,0,0,0,1,0,2,1,1,0,4,"H","N","2013-12-14","201312140DET"
"PIT",0,2,1,1,0,4,0,1,0,0,0,1,"A","N","2013-12-14","201312140DET"
"NJD",0,0,1,2,0,3,0,0,0,0,0,0,"H","N","2013-12-14","201312140NJD"
"TBL",0,0,0,0,0,0,0,0,1,2,0,3,"A","N","2013-12-14","201312140NJD"
"NSH",0,1,1,1,0,3,0,0,0,2,0,2,"H","N","2013-12-14","201312140NSH"
"SJS",0,0,0,2,0,2,0,1,1,1,0,3,"A","N","2013-12-14","201312140NSH"
"MTL",1,0,0,0,0,1,0,0,0,0,0,0,"A","N","2013-12-14","201312140NYI"
"NYI",0,0,0,0,0,0,1,0,0,0,0,1,"H","N","2013-12-14","201312140NYI"
"LAK",0,3,0,2,0,5,0,0,1,1,0,2,"A","N","2013-12-14","201312140OTT"
"OTT",0,0,1,1,0,2,0,3,0,2,0,5,"H","N","2013-12-14","201312140OTT"
"CAR",0,0,1,2,0,3,0,1,0,0,0,1,"A","N","2013-12-14","201312140PHX"
"PHX",0,1,0,0,0,1,0,0,1,2,0,3,"H","N","2013-12-14","201312140PHX"
"CHI",0,1,1,1,0,3,0,1,4,2,0,7,"A","N","2013-12-14","201312140TOR"
"TOR",0,1,4,2,0,7,0,1,1,1,0,3,"H","N","2013-12-14","201312140TOR"
"BOS",0,0,1,1,0,2,0,1,2,3,0,6,"A","N","2013-12-14","201312140VAN"
"VAN",0,1,2,3,0,6,0,0,1,1,0,2,"H","N","2013-12-14","201312140VAN"
"DAL",0,2,3,1,0,6,0,1,2,1,0,4,"A","N","2013-12-14","201312140WPG"
"WPG",0,1,2,1,0,4,0,2,3,1,0,6,"H","N","2013-12-14","201312140WPG"
"ANA",0,1,1,1,0,3,0,1,0,1,0,2,"H","N","2013-12-15","201312150ANA"
"EDM",0,1,0,1,0,2,0,1,1,1,0,3,"A","N","2013-12-15","201312150ANA"
"CHI",0,3,0,0,0,3,0,0,0,1,0,1,"H","N","2013-12-15","201312150CHI"
"LAK",0,0,0,1,0,1,0,3,0,0,0,3,"A","N","2013-12-15","201312150CHI"
"DET",0,0,0,0,0,0,0,0,0,3,0,3,"H","N","2013-12-15","201312150DET"
"TBL",0,0,0,3,0,3,0,0,0,0,0,0,"A","N","2013-12-15","201312150DET"
"FLA",0,0,2,0,0,2,0,0,0,1,0,1,"A","N","2013-12-15","201312150MTL"
"MTL",0,0,0,1,0,1,0,0,2,0,0,2,"H","N","2013-12-15","201312150MTL"
"CGY",0,2,0,1,0,3,0,1,1,1,1,4,"A","Y","2013-12-15","201312150NYR"
"NYR",0,1,1,1,1,4,0,2,0,1,0,3,"H","Y","2013-12-15","201312150NYR"
"PHI",0,1,1,2,0,4,0,1,0,3,1,5,"A","Y","2013-12-15","201312150WSH"
"WSH",0,1,0,3,1,5,0,1,1,2,0,4,"H","Y","2013-12-15","201312150WSH"
"CBJ",0,0,0,2,0,2,0,0,1,2,0,3,"H","N","2013-12-16","201312160CBJ"
"WPG",0,0,1,2,0,3,0,0,0,2,0,2,"A","N","2013-12-16","201312160CBJ"
"COL",0,1,4,1,0,6,0,1,0,1,0,2,"H","N","2013-12-16","201312160COL"
"DAL",0,1,0,1,0,2,0,1,4,1,0,6,"A","N","2013-12-16","201312160COL"
"OTT",1,1,0,1,0,3,0,0,2,0,0,2,"H","N","2013-12-16","201312160OTT"
"STL",0,0,2,0,0,2,1,1,0,1,0,3,"A","N","2013-12-16","201312160OTT"
"PIT",0,1,0,2,0,3,0,0,1,0,0,1,"H","N","2013-12-16","201312160PIT"
"TOR",0,0,1,0,0,1,0,1,0,2,0,3,"A","N","2013-12-16","201312160PIT"
"BOS",0,0,1,1,0,2,0,0,0,0,0,0,"H","N","2013-12-17","201312170BOS"
"CGY",0,0,0,0,0,0,0,0,1,1,0,2,"A","N","2013-12-17","201312170BOS"
"BUF",0,0,1,3,0,4,0,0,2,0,0,2,"H","N","2013-12-17","201312170BUF"
"WPG",0,0,2,0,0,2,0,0,1,3,0,4,"A","N","2013-12-17","201312170BUF"
"COL",0,1,1,0,0,2,0,1,1,1,0,3,"A","N","2013-12-17","201312170DAL"
"DAL",0,1,1,1,0,3,0,1,1,0,0,2,"H","N","2013-12-17","201312170DAL"
"ANA",0,4,1,0,0,5,0,1,0,1,0,2,"A","N","2013-12-17","201312170DET"
"DET",0,1,0,1,0,2,0,4,1,0,0,5,"H","N","2013-12-17","201312170DET"
"EDM",0,0,0,0,0,0,0,1,0,2,0,3,"A","N","2013-12-17","201312170LAK"
"LAK",0,1,0,2,0,3,0,0,0,0,0,0,"H","N","2013-12-17","201312170LAK"
"MIN",0,1,0,1,1,3,0,1,1,0,0,2,"H","Y","2013-12-17","201312170MIN"
"VAN",0,1,1,0,0,2,0,1,0,1,1,3,"A","Y","2013-12-17","201312170MIN"
"MTL",0,0,0,3,0,3,0,1,0,0,0,1,"H","N","2013-12-17","201312170MTL"
"PHX",0,1,0,0,0,1,0,0,0,3,0,3,"A","N","2013-12-17","201312170MTL"
"CHI",0,2,1,0,0,3,0,1,0,0,0,1,"A","N","2013-12-17","201312170NSH"
"NSH",0,1,0,0,0,1,0,2,1,0,0,3,"H","N","2013-12-17","201312170NSH"
"NYI",0,0,1,1,0,2,0,0,0,2,1,3,"H","Y","2013-12-17","201312170NYI"
"TBL",0,0,0,2,1,3,0,0,1,1,0,2,"A","Y","2013-12-17","201312170NYI"
"PHI",0,0,4,1,0,5,0,0,2,0,0,2,"H","N","2013-12-17","201312170PHI"
"WSH",0,0,2,0,0,2,0,0,4,1,0,5,"A","N","2013-12-17","201312170PHI"
"SJS",0,2,1,1,0,4,0,0,2,0,0,2,"A","N","2013-12-17","201312170STL"
"STL",0,0,2,0,0,2,0,2,1,1,0,4,"H","N","2013-12-17","201312170STL"
"FLA",0,1,2,0,0,3,0,0,0,1,0,1,"A","N","2013-12-17","201312170TOR"
"TOR",0,0,0,1,0,1,0,1,2,0,0,3,"H","N","2013-12-17","201312170TOR"
"NJD",0,2,2,1,0,5,0,0,1,1,0,2,"H","N","2013-12-18","201312180NJD"
"OTT",0,0,1,1,0,2,0,2,2,1,0,5,"A","N","2013-12-18","201312180NJD"
"NYR",0,0,1,2,0,3,0,0,1,2,1,4,"H","Y","2013-12-18","201312180NYR"
"PIT",0,0,1,2,1,4,0,0,1,2,0,3,"A","Y","2013-12-18","201312180NYR"
"BOS",0,0,2,0,0,2,0,1,1,2,0,4,"A","N","2013-12-19","201312190BUF"
"BUF",0,1,1,2,0,4,0,0,2,0,0,2,"H","N","2013-12-19","201312190BUF"
"COL",0,0,3,1,0,4,0,1,1,0,0,2,"H","N","2013-12-19","201312190COL"
"EDM",0,1,1,0,0,2,0,0,3,1,0,4,"A","N","2013-12-19","201312190COL"
"DAL",0,2,1,1,0,4,0,1,0,0,0,1,"H","N","2013-12-19","201312190DAL"
"VAN",0,1,0,0,0,1,0,2,1,1,0,4,"A","N","2013-12-19","201312190DAL"
"CGY",0,1,1,0,0,2,1,1,1,0,0,3,"A","N","2013-12-19","201312190DET"
"DET",1,1,1,0,0,3,0,1,1,0,0,2,"H","N","2013-12-19","201312190DET"
"LAK",0,0,2,2,0,4,0,0,0,1,0,1,"H","N","2013-12-19","201312190LAK"
"SJS",0,0,0,1,0,1,0,0,2,2,0,4,"A","N","2013-12-19","201312190LAK"
"FLA",0,1,1,2,0,4,0,2,0,0,0,2,"A","N","2013-12-19","201312190OTT"
"OTT",0,2,0,0,0,2,0,1,1,2,0,4,"H","N","2013-12-19","201312190OTT"
"CBJ",0,1,2,1,0,4,0,0,0,5,0,5,"A","N","2013-12-19","201312190PHI"
"PHI",0,0,0,5,0,5,0,1,2,1,0,4,"H","N","2013-12-19","201312190PHI"
"MIN",0,0,1,1,0,2,0,1,3,1,0,5,"A","N","2013-12-19","201312190PIT"
"PIT",0,1,3,1,0,5,0,0,1,1,0,2,"H","N","2013-12-19","201312190PIT"
"MTL",0,0,1,0,0,1,0,3,0,2,0,5,"A","N","2013-12-19","201312190STL"
"STL",0,3,0,2,0,5,0,0,1,0,0,1,"H","N","2013-12-19","201312190STL"
"NSH",0,0,2,0,0,2,0,2,2,0,0,4,"A","N","2013-12-19","201312190TBL"
"TBL",0,2,2,0,0,4,0,0,2,0,0,2,"H","N","2013-12-19","201312190TBL"
"PHX",0,0,0,1,0,1,0,1,0,0,1,2,"A","Y","2013-12-19","201312190TOR"
"TOR",0,1,0,0,1,2,0,0,0,1,0,1,"H","Y","2013-12-19","201312190TOR"
"CAR",0,1,1,0,0,2,0,0,3,1,0,4,"H","N","2013-12-20","201312200CAR"
"WSH",0,0,3,1,0,4,0,1,1,0,0,2,"A","N","2013-12-20","201312200CAR"
"CHI",0,1,1,0,0,2,0,0,1,1,1,3,"H","Y","2013-12-20","201312200CHI"
"VAN",0,0,1,1,1,3,0,1,1,0,0,2,"A","Y","2013-12-20","201312200CHI"
"ANA",1,0,1,1,0,3,0,0,1,1,0,2,"A","N","2013-12-20","201312200NJD"
"NJD",0,0,1,1,0,2,1,0,1,1,0,3,"H","N","2013-12-20","201312200NJD"
"NYI",0,2,1,2,0,5,0,1,2,0,0,3,"A","N","2013-12-20","201312200NYR"
"NYR",0,1,2,0,0,3,0,2,1,2,0,5,"H","N","2013-12-20","201312200NYR"
"FLA",0,1,1,0,0,2,0,3,2,0,0,5,"A","N","2013-12-20","201312200WPG"
"WPG",0,3,2,0,0,5,0,1,1,0,0,2,"H","N","2013-12-20","201312200WPG"
"BOS",0,1,1,2,0,4,0,1,0,0,0,1,"H","N","2013-12-21","201312210BOS"
"BUF",0,1,0,0,0,1,0,1,1,2,0,4,"A","N","2013-12-21","201312210BOS"
"CBJ",0,1,1,4,0,6,0,0,2,1,0,3,"H","N","2013-12-21","201312210CBJ"
"PHI",0,0,2,1,0,3,0,1,1,4,0,6,"A","N","2013-12-21","201312210CBJ"
"EDM",0,0,0,0,0,0,0,1,1,4,0,6,"H","N","2013-12-21","201312210EDM"
"STL",0,1,1,4,0,6,0,0,0,0,0,0,"A","N","2013-12-21","201312210EDM"
"COL",0,0,1,1,0,2,0,1,1,0,1,3,"A","Y","2013-12-21","201312210LAK"
"LAK",0,1,1,0,1,3,0,0,1,1,0,2,"H","Y","2013-12-21","201312210LAK"
"MTL",1,3,0,0,0,4,0,0,2,1,0,3,"A","N","2013-12-21","201312210NSH"
"NSH",0,0,2,1,0,3,1,3,0,0,0,4,"H","N","2013-12-21","201312210NSH"
"ANA",0,0,1,4,0,5,0,1,2,0,0,3,"A","N","2013-12-21","201312210NYI"
"NYI",0,1,2,0,0,3,0,0,1,4,0,5,"H","N","2013-12-21","201312210NYI"
"OTT",0,1,2,0,0,3,1,0,2,1,0,4,"H","N","2013-12-21","201312210OTT"
"PHX",1,0,2,1,0,4,0,1,2,0,0,3,"A","N","2013-12-21","201312210OTT"
"CGY",0,0,2,1,0,3,0,2,2,0,0,4,"A","N","2013-12-21","201312210PIT"
"PIT",0,2,2,0,0,4,0,0,2,1,0,3,"H","N","2013-12-21","201312210PIT"
"DAL",0,1,1,0,0,2,0,0,1,1,1,3,"A","Y","2013-12-21","201312210SJS"
"SJS",0,0,1,1,1,3,0,1,1,0,0,2,"H","Y","2013-12-21","201312210SJS"
"CAR",0,1,1,0,0,2,1,1,0,1,0,3,"A","N","2013-12-21","201312210TBL"
"TBL",1,1,0,1,0,3,0,1,1,0,0,2,"H","N","2013-12-21","201312210TBL"
"DET",0,3,0,1,1,5,0,1,2,1,0,4,"A","Y","2013-12-21","201312210TOR"
"TOR",0,1,2,1,0,4,0,3,0,1,1,5,"H","Y","2013-12-21","201312210TOR"
"NJD",1,1,0,3,0,5,0,0,3,1,0,4,"A","N","2013-12-21","201312210WSH"
"WSH",0,0,3,1,0,4,1,1,0,3,0,5,"H","N","2013-12-21","201312210WSH"
"MIN",0,1,0,0,0,1,0,1,2,1,0,4,"A","N","2013-12-22","201312220NYR"
"NYR",0,1,2,1,0,4,0,1,0,0,0,1,"H","N","2013-12-22","201312220NYR"
"VAN",0,1,0,1,0,2,0,0,1,0,0,1,"H","N","2013-12-22","201312220VAN"
"WPG",0,0,1,0,0,1,0,1,0,1,0,2,"A","N","2013-12-22","201312220VAN"
"BUF",1,0,0,1,0,2,0,0,1,0,0,1,"H","N","2013-12-23","201312230BUF"
"PHX",0,0,1,0,0,1,1,0,0,1,0,2,"A","N","2013-12-23","201312230BUF"
"CAR",0,1,1,1,0,3,0,1,1,2,0,4,"H","N","2013-12-23","201312230CAR"
"CBJ",0,1,1,2,0,4,0,1,1,1,0,3,"A","N","2013-12-23","201312230CAR"
"CGY",0,0,1,2,1,4,0,1,2,0,0,3,"H","Y","2013-12-23","201312230CGY"
"STL",0,1,2,0,0,3,0,0,1,2,1,4,"A","Y","2013-12-23","201312230CGY"
"CHI",0,1,2,2,0,5,0,0,1,1,0,2,"H","N","2013-12-23","201312230CHI"
"NJD",0,0,1,1,0,2,0,1,2,2,0,5,"A","N","2013-12-23","201312230CHI"
"DET",0,0,0,0,0,0,0,3,0,0,0,3,"H","N","2013-12-23","201312230DET"
"NYI",0,3,0,0,0,3,0,0,0,0,0,0,"A","N","2013-12-23","201312230DET"
"EDM",0,2,1,3,0,6,0,1,1,0,0,2,"H","N","2013-12-23","201312230EDM"
"WPG",0,1,1,0,0,2,0,2,1,3,0,6,"A","N","2013-12-23","201312230EDM"
"FLA",0,1,0,0,0,1,0,1,3,2,0,6,"H","N","2013-12-23","201312230FLA"
"TBL",0,1,3,2,0,6,0,1,0,0,0,1,"A","N","2013-12-23","201312230FLA"
"DAL",0,2,1,2,0,5,0,2,0,0,0,2,"A","N","2013-12-23","201312230LAK"
"LAK",0,2,0,0,0,2,0,2,1,2,0,5,"H","N","2013-12-23","201312230LAK"
"BOS",0,3,0,3,0,6,0,0,1,1,0,2,"A","N","2013-12-23","201312230NSH"
"NSH",0,0,1,1,0,2,0,3,0,3,0,6,"H","N","2013-12-23","201312230NSH"
"NYR",0,0,0,1,1,2,0,0,0,1,0,1,"H","Y","2013-12-23","201312230NYR"
"TOR",0,0,0,1,0,1,0,0,0,1,1,2,"A","Y","2013-12-23","201312230NYR"
"OTT",0,1,1,3,0,5,0,0,0,0,0,0,"H","N","2013-12-23","201312230OTT"
"PIT",0,0,0,0,0,0,0,1,1,3,0,5,"A","N","2013-12-23","201312230OTT"
"MIN",0,1,0,0,0,1,0,2,1,1,0,4,"A","N","2013-12-23","201312230PHI"
"PHI",0,2,1,1,0,4,0,1,0,0,0,1,"H","N","2013-12-23","201312230PHI"
"COL",0,2,0,2,0,4,0,1,2,1,1,5,"A","Y","2013-12-23","201312230SJS"
"SJS",0,1,2,1,1,5,0,2,0,2,0,4,"H","Y","2013-12-23","201312230SJS"
"ANA",0,1,1,1,0,3,0,2,0,0,0,2,"A","N","2013-12-23","201312230WSH"
"WSH",0,2,0,0,0,2,0,1,1,1,0,3,"H","N","2013-12-23","201312230WSH"
"BOS",0,0,1,4,0,5,0,0,0,0,0,0,"H","N","2013-12-27","201312270BOS"
"OTT",0,0,0,0,0,0,0,0,1,4,0,5,"A","N","2013-12-27","201312270BOS"
"CAR",0,1,1,1,0,3,1,0,1,2,0,4,"H","N","2013-12-27","201312270CAR"
"PIT",1,0,1,2,0,4,0,1,1,1,0,3,"A","N","2013-12-27","201312270CAR"
"CGY",0,0,0,0,0,0,0,1,0,1,0,2,"H","N","2013-12-27","201312270CGY"
"EDM",0,1,0,1,0,2,0,0,0,0,0,0,"A","N","2013-12-27","201312270CGY"
"CHI",0,3,4,0,0,7,0,0,1,1,0,2,"H","N","2013-12-27","201312270CHI"
"COL",0,0,1,1,0,2,0,3,4,0,0,7,"A","N","2013-12-27","201312270CHI"
"DAL",0,1,2,1,0,4,0,0,1,0,0,1,"H","N","2013-12-27","201312270DAL"
"NSH",0,0,1,0,0,1,0,1,2,1,0,4,"A","N","2013-12-27","201312270DAL"
"CBJ",0,1,0,0,1,2,0,0,0,1,0,1,"A","Y","2013-12-27","201312270NJD"
"NJD",0,0,0,1,0,1,0,1,0,0,1,2,"H","Y","2013-12-27","201312270NJD"
"PHX",0,1,1,1,0,3,0,0,2,1,1,4,"H","Y","2013-12-27","201312270PHX"
"SJS",0,0,2,1,1,4,0,1,1,1,0,3,"A","Y","2013-12-27","201312270PHX"
"BUF",0,2,0,1,0,3,0,0,3,0,1,4,"A","Y","2013-12-27","201312270TOR"
"TOR",0,0,3,0,1,4,0,2,0,1,0,3,"H","Y","2013-12-27","201312270TOR"
"MIN",0,3,1,0,0,4,0,4,0,2,0,6,"A","N","2013-12-27","201312270WPG"
"WPG",0,4,0,2,0,6,0,3,1,0,0,4,"H","N","2013-12-27","201312270WPG"
"NYR",0,0,1,1,0,2,0,1,1,1,0,3,"A","N","2013-12-27","201312270WSH"
"WSH",0,1,1,1,0,3,0,0,1,1,0,2,"H","N","2013-12-27","201312270WSH"
"ANA",1,1,0,1,0,3,0,0,0,2,0,2,"H","N","2013-12-28","201312280ANA"
"PHX",0,0,0,2,0,2,1,1,0,1,0,3,"A","N","2013-12-28","201312280ANA"
"EDM",0,2,0,1,0,3,0,0,2,1,1,4,"H","Y","2013-12-28","201312280EDM"
"PHI",0,0,2,1,1,4,0,2,0,1,0,3,"A","Y","2013-12-28","201312280EDM"
"DET",0,2,0,2,0,4,0,0,2,1,0,3,"A","N","2013-12-28","201312280FLA"
"FLA",0,0,2,1,0,3,0,2,0,2,0,4,"H","N","2013-12-28","201312280FLA"
"LAK",0,0,1,1,0,2,0,1,0,2,0,3,"A","N","2013-12-28","201312280NSH"
"NSH",0,1,0,2,0,3,0,0,1,1,0,2,"H","N","2013-12-28","201312280NSH"
"NJD",0,1,0,1,0,2,0,0,0,1,0,1,"A","N","2013-12-28","201312280NYI"
"NYI",0,0,0,1,0,1,0,1,0,1,0,2,"H","N","2013-12-28","201312280NYI"
"BOS",0,1,1,1,0,3,0,2,1,1,0,4,"A","N","2013-12-28","201312280OTT"
"OTT",0,2,1,1,0,4,0,1,1,1,0,3,"H","N","2013-12-28","201312280OTT"
"CHI",0,3,1,1,0,5,0,1,2,2,1,6,"A","Y","2013-12-28","201312280STL"
"STL",0,1,2,2,1,6,0,3,1,1,0,5,"H","Y","2013-12-28","201312280STL"
"MTL",0,0,1,0,1,2,0,0,1,0,0,1,"A","Y","2013-12-28","201312280TBL"
"TBL",0,0,1,0,0,1,0,0,1,0,1,2,"H","Y","2013-12-28","201312280TBL"
"BUF",0,0,1,0,1,2,0,0,0,1,0,1,"H","Y","2013-12-29","201312290BUF"
"WSH",0,0,0,1,0,1,0,0,1,0,1,2,"A","Y","2013-12-29","201312290BUF"
"CBJ",0,1,1,1,0,3,0,1,1,3,0,5,"H","N","2013-12-29","201312290CBJ"
"PIT",0,1,1,3,0,5,0,1,1,1,0,3,"A","N","2013-12-29","201312290CBJ"
"CGY",0,0,0,0,0,0,0,1,0,1,0,2,"H","N","2013-12-29","201312290CGY"
"VAN",0,1,0,1,0,2,0,0,0,0,0,0,"A","N","2013-12-29","201312290CGY"
"COL",0,0,0,1,0,1,1,0,0,1,0,2,"H","N","2013-12-29","201312290COL"
"WPG",1,0,0,1,0,2,0,0,0,1,0,1,"A","N","2013-12-29","201312290COL"
"DAL",0,0,2,0,0,2,1,1,1,0,0,3,"H","N","2013-12-29","201312290DAL"
"STL",1,1,1,0,0,3,0,0,2,0,0,2,"A","N","2013-12-29","201312290DAL"
"FLA",0,1,2,1,0,4,0,0,1,0,0,1,"H","N","2013-12-29","201312290FLA"
"MTL",0,0,1,0,0,1,0,1,2,1,0,4,"A","N","2013-12-29","201312290FLA"
"MIN",0,1,2,1,0,4,0,0,2,3,0,5,"H","N","2013-12-29","201312290MIN"
"NYI",0,0,2,3,0,5,0,1,2,1,0,4,"A","N","2013-12-29","201312290MIN"
"ANA",0,0,0,1,0,1,0,2,1,0,0,3,"A","N","2013-12-29","201312290SJS"
"SJS",0,2,1,0,0,3,0,0,0,1,0,1,"H","N","2013-12-29","201312290SJS"
"NYR",0,2,2,0,0,4,0,2,0,1,0,3,"A","N","2013-12-29","201312290TBL"
"TBL",0,2,0,1,0,3,0,2,2,0,0,4,"H","N","2013-12-29","201312290TBL"
"CAR",0,0,2,0,0,2,0,1,2,2,0,5,"A","N","2013-12-29","201312290TOR"
"TOR",0,1,2,2,0,5,0,0,2,0,0,2,"H","N","2013-12-29","201312290TOR"
"CHI",0,1,0,0,0,1,0,0,0,0,0,0,"H","N","2013-12-30","201312300CHI"
"LAK",0,0,0,0,0,0,0,1,0,0,0,1,"A","N","2013-12-30","201312300CHI"
"DET",0,1,0,3,0,4,0,2,1,3,0,6,"A","N","2013-12-30","201312300NSH"
"NSH",0,2,1,3,0,6,0,1,0,3,0,4,"H","N","2013-12-30","201312300NSH"
"OTT",0,1,1,1,0,3,0,1,0,0,0,1,"H","N","2013-12-30","201312300OTT"
"WSH",0,1,0,0,0,1,0,1,1,1,0,3,"A","N","2013-12-30","201312300OTT"
"PHI",0,1,1,1,1,4,0,0,2,1,0,3,"A","Y","2013-12-30","201312300VAN"
"VAN",0,0,2,1,0,3,0,1,1,1,1,4,"H","Y","2013-12-30","201312300VAN"
"ANA",0,1,3,2,0,6,0,0,2,1,0,3,"H","N","2013-12-31","201312310ANA"
"SJS",0,0,2,1,0,3,0,1,3,2,0,6,"A","N","2013-12-31","201312310ANA"
"BOS",0,1,2,0,0,3,0,0,3,2,0,5,"H","N","2013-12-31","201312310BOS"
"NYI",0,0,3,2,0,5,0,1,2,0,0,3,"A","N","2013-12-31","201312310BOS"
"CAR",1,0,0,4,0,5,0,2,1,1,0,4,"H","N","2013-12-31","201312310CAR"
"MTL",0,2,1,1,0,4,1,0,0,4,0,5,"A","N","2013-12-31","201312310CAR"
"CGY",0,0,1,0,0,1,0,1,1,2,0,4,"H","N","2013-12-31","201312310CGY"
"PHI",0,1,1,2,0,4,0,0,1,0,0,1,"A","N","2013-12-31","201312310CGY"
"CBJ",0,1,1,1,0,3,0,1,2,2,0,5,"A","N","2013-12-31","201312310COL"
"COL",0,1,2,2,0,5,0,1,1,1,0,3,"H","N","2013-12-31","201312310COL"
"DAL",0,1,2,0,0,3,0,1,0,1,0,2,"H","N","2013-12-31","201312310DAL"
"LAK",0,1,0,1,0,2,0,1,2,0,0,3,"A","N","2013-12-31","201312310DAL"
"FLA",0,0,1,0,0,1,0,0,0,1,1,2,"H","Y","2013-12-31","201312310FLA"
"NYR",0,0,0,1,1,2,0,0,1,0,0,1,"A","Y","2013-12-31","201312310FLA"
"MIN",0,0,0,1,0,1,0,0,2,0,0,2,"H","N","2013-12-31","201312310MIN"
"STL",0,0,2,0,0,2,0,0,0,1,0,1,"A","N","2013-12-31","201312310MIN"
"NJD",0,1,1,0,0,2,0,0,1,0,0,1,"H","N","2013-12-31","201312310NJD"
"PIT",0,0,1,0,0,1,0,1,1,0,0,2,"A","N","2013-12-31","201312310NJD"
"EDM",0,1,2,0,0,3,1,1,1,1,0,4,"A","N","2013-12-31","201312310PHX"
"PHX",1,1,1,1,0,4,0,1,2,0,0,3,"H","N","2013-12-31","201312310PHX"
"BUF",0,0,0,0,0,0,0,1,1,1,0,3,"A","N","2013-12-31","201312310WPG"
"WPG",0,1,1,1,0,3,0,0,0,0,0,0,"H","N","2013-12-31","201312310WPG"
"DET",0,0,1,1,0,2,0,0,1,1,1,3,"H","Y","2014-01-01","201401010DET"
"TOR",0,0,1,1,1,3,0,0,1,1,0,2,"A","Y","2014-01-01","201401010DET"
"TBL",0,0,3,1,0,4,0,0,2,0,0,2,"A","N","2014-01-01","201401010VAN"
"VAN",0,0,2,0,0,2,0,0,3,1,0,4,"H","N","2014-01-01","201401010VAN"
"BOS",1,0,0,2,0,3,0,0,1,1,0,2,"H","N","2014-01-02","201401020BOS"
"NSH",0,0,1,1,0,2,1,0,0,2,0,3,"A","N","2014-01-02","201401020BOS"
"COL",0,1,1,0,0,2,0,0,1,0,0,1,"H","N","2014-01-02","201401020COL"
"PHI",0,0,1,0,0,1,0,1,1,0,0,2,"A","N","2014-01-02","201401020COL"
"DAL",0,1,1,2,0,4,0,1,2,3,0,6,"H","N","2014-01-02","201401020DAL"
"MTL",0,1,2,3,0,6,0,1,1,2,0,4,"A","N","2014-01-02","201401020DAL"
"BUF",0,0,0,1,0,1,0,0,3,1,0,4,"A","N","2014-01-02","201401020MIN"
"MIN",0,0,3,1,0,4,0,0,0,1,0,1,"H","N","2014-01-02","201401020MIN"
"CHI",0,0,1,1,0,2,1,1,1,0,0,3,"A","N","2014-01-02","201401020NYI"
"NYI",1,1,1,0,0,3,0,0,1,1,0,2,"H","N","2014-01-02","201401020NYI"
"OTT",0,2,0,2,0,4,0,1,1,1,0,3,"H","N","2014-01-02","201401020OTT"
"WPG",0,1,1,1,0,3,0,2,0,2,0,4,"A","N","2014-01-02","201401020OTT"
"CBJ",0,0,1,1,0,2,0,0,0,0,0,0,"A","N","2014-01-02","201401020PHX"
"PHX",0,0,0,0,0,0,0,0,1,1,0,2,"H","N","2014-01-02","201401020PHX"
"EDM",0,0,1,0,0,1,0,2,2,1,0,5,"A","N","2014-01-02","201401020SJS"
"SJS",0,2,2,1,0,5,0,0,1,0,0,1,"H","N","2014-01-02","201401020SJS"
"LAK",0,0,0,0,0,0,0,1,2,2,0,5,"A","N","2014-01-02","201401020STL"
"STL",0,1,2,2,0,5,0,0,0,0,0,0,"H","N","2014-01-02","201401020STL"
"CAR",1,1,2,0,0,4,0,0,3,0,0,3,"A","N","2014-01-02","201401020WSH"
"WSH",0,0,3,0,0,3,1,1,2,0,0,4,"H","N","2014-01-02","201401020WSH"
"ANA",0,3,1,1,0,5,0,2,0,0,0,2,"H","N","2014-01-03","201401030ANA"
"EDM",0,2,0,0,0,2,0,3,1,1,0,5,"A","N","2014-01-03","201401030ANA"
"CGY",0,0,0,0,0,0,0,0,2,0,0,2,"H","N","2014-01-03","201401030CGY"
"TBL",0,0,2,0,0,2,0,0,0,0,0,0,"A","N","2014-01-03","201401030CGY"
"CHI",0,0,1,4,0,5,0,0,1,2,0,3,"A","N","2014-01-03","201401030NJD"
"NJD",0,0,1,2,0,3,0,0,1,4,0,5,"H","N","2014-01-03","201401030NJD"
"NYR",0,0,0,2,0,2,0,2,2,1,0,5,"A","N","2014-01-03","201401030PIT"
"PIT",0,2,2,1,0,5,0,0,0,2,0,2,"H","N","2014-01-03","201401030PIT"
"BOS",0,1,2,1,0,4,0,1,0,0,0,1,"H","N","2014-01-04","201401040BOS"
"WPG",0,1,0,0,0,1,0,1,2,1,0,4,"A","N","2014-01-04","201401040BOS"
"BUF",0,0,1,1,0,2,0,0,0,1,0,1,"H","N","2014-01-04","201401040BUF"
"NJD",0,0,0,1,0,1,0,0,1,1,0,2,"A","N","2014-01-04","201401040BUF"
"COL",0,1,3,0,0,4,0,0,2,1,0,3,"H","N","2014-01-04","201401040COL"
"SJS",0,0,2,1,0,3,0,1,3,0,0,4,"A","N","2014-01-04","201401040COL"
"DAL",0,1,0,0,0,1,0,3,1,1,0,5,"H","N","2014-01-04","201401040DAL"
"DET",0,3,1,1,0,5,0,1,0,0,0,1,"A","N","2014-01-04","201401040DAL"
"FLA",0,2,1,1,1,5,0,1,1,2,0,4,"H","Y","2014-01-04","201401040FLA"
"NSH",0,1,1,2,0,4,0,2,1,1,1,5,"A","Y","2014-01-04","201401040FLA"
"LAK",0,0,0,3,0,3,0,1,0,0,0,1,"H","N","2014-01-04","201401040LAK"
"VAN",0,1,0,0,0,1,0,0,0,3,0,3,"A","N","2014-01-04","201401040LAK"
"MIN",0,0,4,1,0,5,0,2,1,0,0,3,"H","N","2014-01-04","201401040MIN"
"WSH",0,2,1,0,0,3,0,0,4,1,0,5,"A","N","2014-01-04","201401040MIN"
"MTL",0,1,0,2,0,3,1,3,0,0,0,4,"H","N","2014-01-04","201401040MTL"
"OTT",1,3,0,0,0,4,0,1,0,2,0,3,"A","N","2014-01-04","201401040MTL"
"CAR",0,0,3,0,0,3,0,0,1,1,0,2,"A","N","2014-01-04","201401040NYI"
"NYI",0,0,1,1,0,2,0,0,3,0,0,3,"H","N","2014-01-04","201401040NYI"
"PHI",0,0,2,3,0,5,0,0,3,0,0,3,"A","N","2014-01-04","201401040PHX"
"PHX",0,0,3,0,0,3,0,0,2,3,0,5,"H","N","2014-01-04","201401040PHX"
"CBJ",0,2,0,0,0,2,0,0,3,3,0,6,"A","N","2014-01-04","201401040STL"
"STL",0,0,3,3,0,6,0,2,0,0,0,2,"H","N","2014-01-04","201401040STL"
"NYR",0,2,3,2,0,7,0,0,1,0,0,1,"A","N","2014-01-04","201401040TOR"
"TOR",0,0,1,0,0,1,0,2,3,2,0,7,"H","N","2014-01-04","201401040TOR"
"ANA",1,0,2,1,0,4,0,2,0,1,0,3,"H","N","2014-01-05","201401050ANA"
"VAN",0,2,0,1,0,3,1,0,2,1,0,4,"A","N","2014-01-05","201401050ANA"
"CAR",0,1,0,1,0,2,0,0,0,1,0,1,"H","N","2014-01-05","201401050CAR"
"NSH",0,0,0,1,0,1,0,1,0,1,0,2,"A","N","2014-01-05","201401050CAR"
"CHI",0,0,0,2,0,2,0,1,0,1,1,3,"H","Y","2014-01-05","201401050CHI"
"SJS",0,1,0,1,1,3,0,0,0,2,0,2,"A","Y","2014-01-05","201401050CHI"
"EDM",0,3,0,2,0,5,0,1,2,0,0,3,"H","N","2014-01-05","201401050EDM"
"TBL",0,1,2,0,0,3,0,3,0,2,0,5,"A","N","2014-01-05","201401050EDM"
"PIT",0,0,4,2,0,6,0,2,3,0,0,5,"H","N","2014-01-05","201401050PIT"
"WPG",0,2,3,0,0,5,0,0,4,2,0,6,"A","N","2014-01-05","201401050PIT"
"CGY",0,1,2,1,0,4,0,2,0,1,0,3,"A","N","2014-01-06","201401060COL"
"COL",0,2,0,1,0,3,0,1,2,1,0,4,"H","N","2014-01-06","201401060COL"
"FLA",0,1,0,0,0,1,0,1,1,0,0,2,"A","N","2014-01-06","201401060MTL"
"MTL",0,1,1,0,0,2,0,1,0,0,0,1,"H","N","2014-01-06","201401060MTL"
"DAL",0,2,1,0,0,3,0,0,4,3,0,7,"A","N","2014-01-06","201401060NYI"
"NYI",0,0,4,3,0,7,0,2,1,0,0,3,"H","N","2014-01-06","201401060NYI"
"CBJ",0,1,2,0,1,4,0,1,0,2,0,3,"A","Y","2014-01-06","201401060NYR"
"NYR",0,1,0,2,0,3,0,1,2,0,1,4,"H","Y","2014-01-06","201401060NYR"
"ANA",0,0,3,2,0,5,0,0,1,1,0,2,"H","N","2014-01-07","201401070ANA"
"BOS",0,0,1,1,0,2,0,0,3,2,0,5,"A","N","2014-01-07","201401070ANA"
"EDM",0,0,2,0,0,2,0,1,3,1,0,5,"H","N","2014-01-07","201401070EDM"
"STL",0,1,3,1,0,5,0,0,2,0,0,2,"A","N","2014-01-07","201401070EDM"
"LAK",0,0,0,1,0,1,0,0,0,1,1,2,"H","Y","2014-01-07","201401070LAK"
"MIN",0,0,0,1,1,2,0,0,0,1,0,1,"A","Y","2014-01-07","201401070LAK"
"NJD",0,1,0,1,0,2,1,0,0,2,0,3,"H","N","2014-01-07","201401070NJD"
"PHI",1,0,0,2,0,3,0,1,0,1,0,2,"A","N","2014-01-07","201401070NJD"
"NSH",0,0,3,0,0,3,0,0,1,1,0,2,"H","N","2014-01-07","201401070NSH"
"SJS",0,0,1,1,0,2,0,0,3,0,0,3,"A","N","2014-01-07","201401070NSH"
"CGY",0,0,0,0,0,0,0,0,3,3,0,6,"A","N","2014-01-07","201401070PHX"
"PHX",0,0,3,3,0,6,0,0,0,0,0,0,"H","N","2014-01-07","201401070PHX"
"NYI",0,1,1,3,0,5,0,1,1,1,0,3,"A","N","2014-01-07","201401070TOR"
"TOR",0,1,1,1,0,3,0,1,1,3,0,5,"H","N","2014-01-07","201401070TOR"
"PIT",0,1,1,2,1,5,0,0,1,3,0,4,"A","Y","2014-01-07","201401070VAN"
"VAN",0,0,1,3,0,4,0,1,1,2,1,5,"H","Y","2014-01-07","201401070VAN"
"TBL",0,1,1,2,0,4,0,1,1,0,0,2,"A","N","2014-01-07","201401070WPG"
"WPG",0,1,1,0,0,2,0,1,1,2,0,4,"H","N","2014-01-07","201401070WPG"
"CHI",0,0,2,0,0,2,0,2,0,1,0,3,"H","N","2014-01-08","201401080CHI"
"NYR",0,2,0,1,0,3,0,0,2,0,0,2,"A","N","2014-01-08","201401080CHI"
"COL",1,2,0,1,0,4,0,1,2,0,0,3,"H","N","2014-01-08","201401080COL"
"OTT",0,1,2,0,0,3,1,2,0,1,0,4,"A","N","2014-01-08","201401080COL"
"MTL",0,0,1,0,0,1,0,2,1,0,0,3,"A","N","2014-01-08","201401080PHI"
"PHI",0,2,1,0,0,3,0,0,1,0,0,1,"H","N","2014-01-08","201401080PHI"
"BUF",0,0,1,0,0,1,0,0,0,1,1,2,"H","Y","2014-01-09","201401090BUF"
"FLA",0,0,0,1,1,2,0,0,1,0,0,1,"A","Y","2014-01-09","201401090BUF"
"CAR",0,3,1,2,0,6,0,1,0,0,0,1,"H","N","2014-01-09","201401090CAR"
"TOR",0,1,0,0,0,1,0,3,1,2,0,6,"A","N","2014-01-09","201401090CAR"
"CGY",0,0,0,0,0,0,0,2,1,2,0,5,"H","N","2014-01-09","201401090CGY"
"STL",0,2,1,2,0,5,0,0,0,0,0,0,"A","N","2014-01-09","201401090CGY"
"BOS",0,0,1,1,0,2,0,1,2,1,0,4,"A","N","2014-01-09","201401090LAK"
"LAK",0,1,2,1,0,4,0,0,1,1,0,2,"H","N","2014-01-09","201401090LAK"
"DAL",0,0,0,0,0,0,0,0,1,0,0,1,"A","N","2014-01-09","201401090NJD"
"NJD",0,0,1,0,0,1,0,0,0,0,0,0,"H","N","2014-01-09","201401090NJD"
"ANA",0,0,4,0,0,4,0,2,1,0,0,3,"A","N","2014-01-09","201401090NSH"
"NSH",0,2,1,0,0,3,0,0,4,0,0,4,"H","N","2014-01-09","201401090NSH"
"MIN",0,1,0,3,0,4,0,0,1,0,0,1,"A","N","2014-01-09","201401090PHX"
"PHX",0,0,1,0,0,1,0,1,0,3,0,4,"H","N","2014-01-09","201401090PHX"
"DET",0,1,0,0,0,1,0,1,3,0,0,4,"A","N","2014-01-09","201401090SJS"
"SJS",0,1,3,0,0,4,0,1,0,0,0,1,"H","N","2014-01-09","201401090SJS"
"TBL",0,1,1,1,0,3,0,3,0,1,0,4,"H","N","2014-01-09","201401090TBL"
"WSH",0,3,0,1,0,4,0,1,1,1,0,3,"A","N","2014-01-09","201401090TBL"
"CAR",0,0,0,0,0,0,0,2,0,1,0,3,"A","N","2014-01-10","201401100CBJ"
"CBJ",0,2,0,1,0,3,0,0,0,0,0,0,"H","N","2014-01-10","201401100CBJ"
"COL",0,0,1,0,0,1,1,0,0,1,0,2,"H","N","2014-01-10","201401100COL"
"NYI",1,0,0,1,0,2,0,0,1,0,0,1,"A","N","2014-01-10","201401100COL"
"EDM",1,0,0,3,0,4,0,0,2,1,0,3,"H","N","2014-01-10","201401100EDM"
"PIT",0,0,2,1,0,3,1,0,0,3,0,4,"A","N","2014-01-10","201401100EDM"
"DAL",0,1,1,0,0,2,0,1,1,1,0,3,"A","N","2014-01-10","201401100NYR"
"NYR",0,1,1,1,0,3,0,1,1,0,0,2,"H","N","2014-01-10","201401100NYR"
"STL",0,0,1,0,0,1,0,0,1,1,0,2,"A","N","2014-01-10","201401100VAN"
"VAN",0,0,1,1,0,2,0,0,1,0,0,1,"H","N","2014-01-10","201401100VAN"
"TOR",0,0,1,1,0,2,0,0,1,2,0,3,"A","N","2014-01-10","201401100WSH"
"WSH",0,0,1,2,0,3,0,0,1,1,0,2,"H","N","2014-01-10","201401100WSH"
"CGY",0,0,0,1,0,1,0,1,1,0,0,2,"H","N","2014-01-11","201401110CGY"
"PIT",0,1,1,0,0,2,0,0,0,1,0,1,"A","N","2014-01-11","201401110CGY"
"DET",0,1,0,2,0,3,0,1,0,0,0,1,"A","N","2014-01-11","201401110LAK"
"LAK",0,1,0,0,0,1,0,1,0,2,0,3,"H","N","2014-01-11","201401110LAK"
"COL",0,0,2,2,0,4,0,0,2,0,0,2,"A","N","2014-01-11","201401110MIN"
"MIN",0,0,2,0,0,2,0,0,2,2,0,4,"H","N","2014-01-11","201401110MIN"
"CHI",0,0,0,1,0,1,1,0,1,0,0,2,"A","N","2014-01-11","201401110MTL"
"MTL",1,0,1,0,0,2,0,0,0,1,0,1,"H","N","2014-01-11","201401110MTL"
"FLA",0,0,1,0,0,1,1,1,0,0,0,2,"A","N","2014-01-11","201401110NJD"
"NJD",1,1,0,0,0,2,0,0,1,0,0,1,"H","N","2014-01-11","201401110NJD"
"NSH",0,0,1,0,0,1,0,0,1,0,1,2,"H","Y","2014-01-11","201401110NSH"
"OTT",0,0,1,0,1,2,0,0,1,0,0,1,"A","Y","2014-01-11","201401110NSH"
"PHI",0,0,3,0,0,3,0,1,4,1,0,6,"H","N","2014-01-11","201401110PHI"
"TBL",0,1,4,1,0,6,0,0,3,0,0,3,"A","N","2014-01-11","201401110PHI"
"ANA",0,1,3,1,0,5,0,1,0,2,0,3,"A","N","2014-01-11","201401110PHX"
"PHX",0,1,0,2,0,3,0,1,3,1,0,5,"H","N","2014-01-11","201401110PHX"
"BOS",0,0,0,1,0,1,0,0,0,0,0,0,"A","N","2014-01-11","201401110SJS"
"SJS",0,0,0,0,0,0,0,0,0,1,0,1,"H","N","2014-01-11","201401110SJS"
"CBJ",0,0,4,2,0,6,0,1,1,1,0,3,"A","N","2014-01-11","201401110WPG"
"WPG",0,1,1,1,0,3,0,0,4,2,0,6,"H","N","2014-01-11","201401110WPG"
"ANA",0,0,1,0,0,1,0,0,0,0,0,0,"H","N","2014-01-12","201401120ANA"
"DET",0,0,0,0,0,0,0,0,1,0,0,1,"A","N","2014-01-12","201401120ANA"
"CHI",0,1,3,1,0,5,0,1,1,1,0,3,"H","N","2014-01-12","201401120CHI"
"EDM",0,1,1,1,0,3,0,1,3,1,0,5,"A","N","2014-01-12","201401120CHI"
"DAL",0,2,0,0,0,2,0,0,1,3,0,4,"H","N","2014-01-12","201401120DAL"
"NYI",0,0,1,3,0,4,0,2,0,0,0,2,"A","N","2014-01-12","201401120DAL"
"MIN",0,2,0,2,0,4,0,0,0,0,0,0,"A","N","2014-01-12","201401120NSH"
"NSH",0,0,0,0,0,0,0,2,0,2,0,4,"H","N","2014-01-12","201401120NSH"
"NYR",0,3,1,0,0,4,0,0,0,1,0,1,"H","N","2014-01-12","201401120NYR"
"PHI",0,0,0,1,0,1,0,3,1,0,0,4,"A","N","2014-01-12","201401120NYR"
"NJD",0,0,2,0,0,2,0,1,1,0,1,3,"A","Y","2014-01-12","201401120TOR"
"TOR",0,1,1,0,1,3,0,0,2,0,0,2,"H","Y","2014-01-12","201401120TOR"
"BUF",0,1,0,0,1,2,0,1,0,0,0,1,"A","Y","2014-01-12","201401120WSH"
"WSH",0,1,0,0,0,1,0,1,0,0,1,2,"H","Y","2014-01-12","201401120WSH"
"CAR",0,0,0,0,0,0,0,0,1,1,0,2,"H","N","2014-01-13","201401130CAR"
"CGY",0,0,1,1,0,2,0,0,0,0,0,0,"A","N","2014-01-13","201401130CAR"
"CBJ",0,0,1,2,0,3,0,0,2,0,0,2,"H","N","2014-01-13","201401130CBJ"
"TBL",0,0,2,0,0,2,0,0,1,2,0,3,"A","N","2014-01-13","201401130CBJ"
"LAK",0,0,0,1,0,1,0,0,0,0,0,0,"H","N","2014-01-13","201401130LAK"
"VAN",0,0,0,0,0,0,0,0,0,1,0,1,"A","N","2014-01-13","201401130LAK"
"PHX",0,1,0,0,0,1,0,2,1,2,0,5,"A","N","2014-01-13","201401130WPG"
"WPG",0,2,1,2,0,5,0,1,0,0,0,1,"H","N","2014-01-13","201401130WPG"
"BOS",0,2,0,1,0,3,0,2,1,1,0,4,"H","N","2014-01-14","201401140BOS"
"TOR",0,2,1,1,0,4,0,2,0,1,0,3,"A","N","2014-01-14","201401140BOS"
"BUF",0,1,0,2,0,3,0,0,1,3,0,4,"H","N","2014-01-14","201401140BUF"
"PHI",0,0,1,3,0,4,0,1,0,2,0,3,"A","N","2014-01-14","201401140BUF"
"CHI",0,0,1,1,0,2,1,2,0,0,0,3,"H","N","2014-01-14","201401140CHI"
"COL",1,2,0,0,0,3,0,0,1,1,0,2,"A","N","2014-01-14","201401140CHI"
"DAL",0,3,1,1,0,5,0,1,1,0,0,2,"H","N","2014-01-14","201401140DAL"
"EDM",0,1,1,0,0,2,0,3,1,1,0,5,"A","N","2014-01-14","201401140DAL"
"FLA",0,3,1,0,0,4,0,0,1,1,0,2,"H","N","2014-01-14","201401140FLA"
"NYI",0,0,1,1,0,2,0,3,1,0,0,4,"A","N","2014-01-14","201401140FLA"
"MIN",0,0,0,0,0,0,0,1,0,2,0,3,"H","N","2014-01-14","201401140MIN"
"OTT",0,1,0,2,0,3,0,0,0,0,0,0,"A","N","2014-01-14","201401140MIN"
"MTL",0,1,0,0,0,1,0,1,2,1,0,4,"H","N","2014-01-14","201401140MTL"
"NJD",0,1,2,1,0,4,0,1,0,0,0,1,"A","N","2014-01-14","201401140MTL"
"CGY",0,1,0,1,0,2,0,1,0,3,0,4,"A","N","2014-01-14","201401140NSH"
"NSH",0,1,0,3,0,4,0,1,0,1,0,2,"H","N","2014-01-14","201401140NSH"
"NYR",0,1,0,0,0,1,0,0,2,0,0,2,"H","N","2014-01-14","201401140NYR"
"TBL",0,0,2,0,0,2,0,1,0,0,0,1,"A","N","2014-01-14","201401140NYR"
"PHX",0,0,1,0,0,1,0,1,1,0,0,2,"A","N","2014-01-14","201401140STL"
"STL",0,1,1,0,0,2,0,0,1,0,0,1,"H","N","2014-01-14","201401140STL"
"SJS",0,1,0,0,1,2,0,0,1,0,0,1,"A","Y","2014-01-14","201401140WSH"
"WSH",0,0,1,0,0,1,0,1,0,0,1,2,"H","Y","2014-01-14","201401140WSH"
"ANA",0,2,4,3,0,9,0,0,1,0,0,1,"H","N","2014-01-15","201401150ANA"
"VAN",0,0,1,0,0,1,0,2,4,3,0,9,"A","N","2014-01-15","201401150ANA"
"PIT",0,0,2,2,0,4,0,1,1,1,0,3,"H","N","2014-01-15","201401150PIT"
"WSH",0,1,1,1,0,3,0,0,2,2,0,4,"A","N","2014-01-15","201401150PIT"
"BUF",0,0,2,1,0,3,0,1,2,0,1,4,"A","Y","2014-01-15","201401150TOR"
"TOR",0,1,2,0,1,4,0,0,2,1,0,3,"H","Y","2014-01-15","201401150TOR"
"CGY",0,0,0,2,0,2,0,2,2,1,0,5,"H","N","2014-01-16","201401160CGY"
"WPG",0,2,2,1,0,5,0,0,0,2,0,2,"A","N","2014-01-16","201401160CGY"
"COL",0,1,0,0,1,2,0,0,0,1,0,1,"H","Y","2014-01-16","201401160COL"
"NJD",0,0,0,1,0,1,0,1,0,0,1,2,"A","Y","2014-01-16","201401160COL"
"BOS",0,0,1,3,0,4,0,0,0,2,0,2,"A","N","2014-01-16","201401160DAL"
"DAL",0,0,0,2,0,2,0,0,1,3,0,4,"H","N","2014-01-16","201401160DAL"
"FLA",0,0,0,0,0,0,0,0,1,2,0,3,"H","N","2014-01-16","201401160FLA"
"SJS",0,0,1,2,0,3,0,0,0,0,0,0,"A","N","2014-01-16","201401160FLA"
"EDM",0,0,1,0,0,1,0,1,2,1,0,4,"A","N","2014-01-16","201401160MIN"
"MIN",0,1,2,1,0,4,0,0,1,0,0,1,"H","N","2014-01-16","201401160MIN"
"DET",0,0,0,0,0,0,0,0,0,1,0,1,"A","N","2014-01-16","201401160NYR"
"NYR",0,0,0,1,0,1,0,0,0,0,0,0,"H","N","2014-01-16","201401160NYR"
"MTL",1,3,0,1,0,5,0,2,2,0,0,4,"A","N","2014-01-16","201401160OTT"
"OTT",0,2,2,0,0,4,1,3,0,1,0,5,"H","N","2014-01-16","201401160OTT"
"NSH",0,2,0,1,1,4,0,1,1,1,0,3,"A","Y","2014-01-16","201401160PHI"
"PHI",0,1,1,1,0,3,0,2,0,1,1,4,"H","Y","2014-01-16","201401160PHI"
"PHX",0,1,0,0,0,1,0,0,0,0,0,0,"H","N","2014-01-16","201401160PHX"
"VAN",0,0,0,0,0,0,0,1,0,0,0,1,"A","N","2014-01-16","201401160PHX"
"LAK",0,1,0,3,0,4,0,0,1,0,0,1,"A","N","2014-01-16","201401160STL"
"STL",0,0,1,0,0,1,0,1,0,3,0,4,"H","N","2014-01-16","201401160STL"
"NYI",0,0,1,0,1,2,0,1,0,0,0,1,"A","Y","2014-01-16","201401160TBL"
"TBL",0,1,0,0,0,1,0,0,1,0,1,2,"H","Y","2014-01-16","201401160TBL"
"CBJ",0,2,1,2,0,5,0,0,1,0,0,1,"H","N","2014-01-17","201401170CBJ"
"WSH",0,0,1,0,0,1,0,2,1,2,0,5,"A","N","2014-01-17","201401170CBJ"
"ANA",0,0,0,2,0,2,0,2,0,2,0,4,"A","N","2014-01-17","201401170CHI"
"CHI",0,2,0,2,0,4,0,0,0,2,0,2,"H","N","2014-01-17","201401170CHI"
"BUF",0,2,0,1,0,3,0,2,1,0,1,4,"H","Y","2014-01-18","201401180BUF"
"CBJ",0,2,1,0,1,4,0,2,0,1,0,3,"A","Y","2014-01-18","201401180BUF"
"CAR",0,0,1,2,0,3,0,0,1,1,0,2,"H","N","2014-01-18","201401180CAR"
"FLA",0,0,1,1,0,2,0,0,1,2,0,3,"A","N","2014-01-18","201401180CAR"
"DET",0,0,1,1,1,3,0,0,1,1,0,2,"H","Y","2014-01-18","201401180DET"
"LAK",0,0,1,1,0,2,0,0,1,1,1,3,"A","Y","2014-01-18","201401180DET"
"DAL",0,0,1,1,0,2,1,1,1,0,0,3,"A","N","2014-01-18","201401180MIN"
"MIN",1,1,1,0,0,3,0,0,1,1,0,2,"H","N","2014-01-18","201401180MIN"
"COL",0,3,0,2,0,5,0,0,1,3,0,4,"A","N","2014-01-18","201401180NSH"
"NSH",0,0,1,3,0,4,0,3,0,2,0,5,"H","N","2014-01-18","201401180NSH"
"NYR",0,1,2,1,0,4,0,1,0,0,0,1,"A","N","2014-01-18","201401180OTT"
"OTT",0,1,0,0,0,1,0,1,2,1,0,4,"H","N","2014-01-18","201401180OTT"
"NYI",0,2,2,0,0,4,0,2,1,3,0,6,"A","N","2014-01-18","201401180PHI"
"PHI",0,2,1,3,0,6,0,2,2,0,0,4,"H","N","2014-01-18","201401180PHI"
"NJD",0,1,0,1,0,2,0,2,1,0,0,3,"A","N","2014-01-18","201401180PHX"
"PHX",0,2,1,0,0,3,0,1,0,1,0,2,"H","N","2014-01-18","201401180PHX"
"ANA",0,1,2,0,0,3,0,0,0,2,0,2,"A","N","2014-01-18","201401180STL"
"STL",0,0,0,2,0,2,0,1,2,0,0,3,"H","N","2014-01-18","201401180STL"
"SJS",0,2,3,0,0,5,0,3,1,0,0,4,"A","N","2014-01-18","201401180TBL"
"TBL",0,3,1,0,0,4,0,2,3,0,0,5,"H","N","2014-01-18","201401180TBL"
"MTL",0,1,1,1,0,3,0,1,2,2,0,5,"A","N","2014-01-18","201401180TOR"
"TOR",0,1,2,2,0,5,0,1,1,1,0,3,"H","N","2014-01-18","201401180TOR"
"CGY",0,0,1,1,0,2,0,0,1,1,1,3,"A","Y","2014-01-18","201401180VAN"
"VAN",0,0,1,1,1,3,0,0,1,1,0,2,"H","Y","2014-01-18","201401180VAN"
"EDM",0,0,1,1,0,2,1,0,0,2,0,3,"A","N","2014-01-18","201401180WPG"
"WPG",1,0,0,2,0,3,0,0,1,1,0,2,"H","N","2014-01-18","201401180WPG"
"CAR",0,0,2,1,0,3,0,3,2,0,0,5,"H","N","2014-01-19","201401190CAR"
"TBL",0,3,2,0,0,5,0,0,2,1,0,3,"A","N","2014-01-19","201401190CAR"
"BOS",0,1,1,0,0,2,0,1,1,0,1,3,"A","Y","2014-01-19","201401190CHI"
"CHI",0,1,1,0,1,3,0,1,1,0,0,2,"H","Y","2014-01-19","201401190CHI"
"NYR",0,3,1,0,0,4,0,0,1,0,0,1,"H","N","2014-01-19","201401190NYR"
"WSH",0,0,1,0,0,1,0,3,1,0,0,4,"A","N","2014-01-19","201401190NYR"
"BOS",0,2,0,1,0,3,0,0,1,1,0,2,"H","N","2014-01-20","201401200BOS"
"LAK",0,0,1,1,0,2,0,2,0,1,0,3,"A","N","2014-01-20","201401200BOS"
"DET",0,1,0,0,0,1,0,1,2,1,0,4,"H","N","2014-01-20","201401200DET"
"STL",0,1,2,1,0,4,0,1,0,0,0,1,"A","N","2014-01-20","201401200DET"
"DAL",0,1,0,0,0,1,0,2,1,1,0,4,"A","N","2014-01-20","201401200NSH"
"NSH",0,2,1,1,0,4,0,1,0,0,0,1,"H","N","2014-01-20","201401200NSH"
"NYI",0,0,1,2,1,4,0,0,3,0,0,3,"H","Y","2014-01-20","201401200NYI"
"PHI",0,0,3,0,0,3,0,0,1,2,1,4,"A","Y","2014-01-20","201401200NYI"
"PHX",0,0,0,2,0,2,0,2,1,1,0,4,"H","N","2014-01-20","201401200PHX"
"TOR",0,2,1,1,0,4,0,0,0,2,0,2,"A","N","2014-01-20","201401200PHX"
"FLA",0,1,1,3,0,5,0,0,0,1,0,1,"A","N","2014-01-20","201401200PIT"
"PIT",0,0,0,1,0,1,0,1,1,3,0,5,"H","N","2014-01-20","201401200PIT"
"CGY",0,2,0,0,0,2,0,2,1,0,0,3,"A","N","2014-01-20","201401200SJS"
"SJS",0,2,1,0,0,3,0,2,0,0,0,2,"H","N","2014-01-20","201401200SJS"
"ANA",0,1,0,1,0,2,0,2,1,0,0,3,"H","N","2014-01-21","201401210ANA"
"WPG",0,2,1,0,0,3,0,1,0,1,0,2,"A","N","2014-01-21","201401210ANA"
"BUF",0,2,0,1,0,3,0,3,1,0,0,4,"H","N","2014-01-21","201401210BUF"
"FLA",0,3,1,0,0,4,0,2,0,1,0,3,"A","N","2014-01-21","201401210BUF"
"CBJ",0,2,2,1,0,5,0,1,1,1,0,3,"H","N","2014-01-21","201401210CBJ"
"LAK",0,1,1,1,0,3,0,2,2,1,0,5,"A","N","2014-01-21","201401210CBJ"
"COL",0,0,1,1,0,2,0,2,2,1,0,5,"H","N","2014-01-21","201401210COL"
"TOR",0,2,2,1,0,5,0,0,1,1,0,2,"A","N","2014-01-21","201401210COL"
"DAL",0,2,1,1,0,4,0,0,0,0,0,0,"H","N","2014-01-21","201401210DAL"
"MIN",0,0,0,0,0,0,0,2,1,1,0,4,"A","N","2014-01-21","201401210DAL"
"EDM",0,0,0,1,0,1,0,1,1,0,0,2,"H","N","2014-01-21","201401210EDM"
"VAN",0,1,1,0,0,2,0,0,0,1,0,1,"A","N","2014-01-21","201401210EDM"
"NJD",0,3,2,2,0,7,0,1,0,0,0,1,"H","N","2014-01-21","201401210NJD"
"STL",0,1,0,0,0,1,0,3,2,2,0,7,"A","N","2014-01-21","201401210NJD"
"NYI",0,1,2,2,0,5,0,2,1,0,0,3,"A","N","2014-01-21","201401210NYR"
"NYR",0,2,1,0,0,3,0,1,2,2,0,5,"H","N","2014-01-21","201401210NYR"
"OTT",0,0,1,1,0,2,0,0,0,0,0,0,"A","N","2014-01-21","201401210WSH"
"WSH",0,0,0,0,0,0,0,0,1,1,0,2,"H","N","2014-01-21","201401210WSH"
"CGY",0,1,2,0,0,3,0,0,1,1,0,2,"H","N","2014-01-22","201401220CGY"
"PHX",0,0,1,1,0,2,0,1,2,0,0,3,"A","N","2014-01-22","201401220CGY"
"CHI",0,2,1,1,0,4,0,2,2,0,1,5,"A","Y","2014-01-22","201401220DET"
"DET",0,2,2,0,1,5,0,2,1,1,0,4,"H","Y","2014-01-22","201401220DET"
"CAR",0,1,1,1,0,3,0,0,1,1,0,2,"A","N","2014-01-22","201401220PHI"
"PHI",0,0,1,1,0,2,0,1,1,1,0,3,"H","N","2014-01-22","201401220PHI"
"MTL",0,1,0,0,0,1,0,2,3,0,0,5,"A","N","2014-01-22","201401220PIT"
"PIT",0,2,3,0,0,5,0,1,0,0,0,1,"H","N","2014-01-22","201401220PIT"
"ANA",0,0,2,0,0,2,0,1,0,0,0,1,"H","N","2014-01-23","201401230ANA"
"LAK",0,1,0,0,0,1,0,0,2,0,0,2,"A","N","2014-01-23","201401230ANA"
"BUF",0,1,1,1,0,3,0,1,1,3,0,5,"H","N","2014-01-23","201401230BUF"
"CAR",0,1,1,3,0,5,0,1,1,1,0,3,"A","N","2014-01-23","201401230BUF"
"CBJ",0,1,2,2,0,5,0,0,2,0,0,2,"H","N","2014-01-23","201401230CBJ"
"PHI",0,0,2,0,0,2,0,1,2,2,0,5,"A","N","2014-01-23","201401230CBJ"
"DAL",0,2,4,1,0,7,0,1,0,0,0,1,"H","N","2014-01-23","201401230DAL"
"TOR",0,1,0,0,0,1,0,2,4,1,0,7,"A","N","2014-01-23","201401230DAL"
"CHI",0,0,0,1,0,1,0,2,0,0,0,2,"A","N","2014-01-23","201401230MIN"
"MIN",0,2,0,0,0,2,0,0,0,1,0,1,"H","N","2014-01-23","201401230MIN"
"NYI",0,2,0,2,0,4,0,2,2,2,0,6,"H","N","2014-01-23","201401230NYI"
"PIT",0,2,2,2,0,6,0,2,0,2,0,4,"A","N","2014-01-23","201401230NYI"
"NYR",0,0,1,0,0,1,0,1,0,1,0,2,"H","N","2014-01-23","201401230NYR"
"STL",0,1,0,1,0,2,0,0,1,0,0,1,"A","N","2014-01-23","201401230NYR"
"SJS",0,0,0,1,0,1,0,0,0,0,0,0,"H","N","2014-01-23","201401230SJS"
"WPG",0,0,0,0,0,0,0,0,0,1,0,1,"A","N","2014-01-23","201401230SJS"
"OTT",0,1,1,1,0,3,0,1,1,1,1,4,"A","Y","2014-01-23","201401230TBL"
"TBL",0,1,1,1,1,4,0,1,1,1,0,3,"H","Y","2014-01-23","201401230TBL"
"NSH",0,0,0,2,0,2,0,0,1,0,0,1,"A","N","2014-01-23","201401230VAN"
"VAN",0,0,1,0,0,1,0,0,0,2,0,2,"H","N","2014-01-23","201401230VAN"
"CGY",0,1,0,3,1,5,0,1,2,1,0,4,"H","Y","2014-01-24","201401240CGY"
"NSH",0,1,2,1,0,4,0,1,0,3,1,5,"A","Y","2014-01-24","201401240CGY"
"DET",0,1,2,1,0,4,0,0,1,0,0,1,"H","N","2014-01-24","201401240DET"
"MTL",0,0,1,0,0,1,0,1,2,1,0,4,"A","N","2014-01-24","201401240DET"
"EDM",0,0,1,2,0,3,0,3,1,0,0,4,"H","N","2014-01-24","201401240EDM"
"PHX",0,3,1,0,0,4,0,0,1,2,0,3,"A","N","2014-01-24","201401240EDM"
"COL",0,2,1,0,0,3,0,0,0,2,0,2,"A","N","2014-01-24","201401240FLA"
"FLA",0,0,0,2,0,2,0,2,1,0,0,3,"H","N","2014-01-24","201401240FLA"
"NJD",0,1,1,0,0,2,0,0,0,1,0,1,"H","N","2014-01-24","201401240NJD"
"WSH",0,0,0,1,0,1,0,1,1,0,0,2,"A","N","2014-01-24","201401240NJD"
"CAR",0,1,4,1,0,6,0,0,3,0,0,3,"H","N","2014-01-25","201401250CAR"
"OTT",0,0,3,0,0,3,0,1,4,1,0,6,"A","N","2014-01-25","201401250CAR"
"BUF",0,2,1,2,0,5,0,1,0,1,0,2,"A","N","2014-01-25","201401250CBJ"
"CBJ",0,1,0,1,0,2,0,2,1,2,0,5,"H","N","2014-01-25","201401250CBJ"
"DAL",0,1,2,0,0,3,0,0,0,0,0,0,"H","N","2014-01-25","201401250DAL"
"PIT",0,0,0,0,0,0,0,1,2,0,0,3,"A","N","2014-01-25","201401250DAL"
"ANA",0,2,0,1,0,3,0,0,0,0,0,0,"A","N","2014-01-25","201401250LAK"
"LAK",0,0,0,0,0,0,0,2,0,1,0,3,"H","N","2014-01-25","201401250LAK"
"MTL",0,0,0,0,0,0,0,0,4,1,0,5,"H","N","2014-01-25","201401250MTL"
"WSH",0,0,4,1,0,5,0,0,0,0,0,0,"A","N","2014-01-25","201401250MTL"
"NYI",0,2,1,0,0,3,0,1,1,1,1,4,"H","Y","2014-01-25","201401250NYI"
"STL",0,1,1,1,1,4,0,2,1,0,0,3,"A","Y","2014-01-25","201401250NYI"
"BOS",0,2,2,2,0,6,0,0,0,1,0,1,"A","N","2014-01-25","201401250PHI"
"PHI",0,0,0,1,0,1,0,2,2,2,0,6,"H","N","2014-01-25","201401250PHI"
"MIN",0,1,1,0,0,2,1,0,2,0,0,3,"A","N","2014-01-25","201401250SJS"
"SJS",1,0,2,0,0,3,0,1,1,0,0,2,"H","N","2014-01-25","201401250SJS"
"COL",0,0,2,0,0,2,0,0,3,2,0,5,"A","N","2014-01-25","201401250TBL"
"TBL",0,0,3,2,0,5,0,0,2,0,0,2,"H","N","2014-01-25","201401250TBL"
"TOR",0,0,3,1,0,4,1,2,2,0,0,5,"A","N","2014-01-25","201401250WPG"
"WPG",1,2,2,0,0,5,0,0,3,1,0,4,"H","N","2014-01-25","201401250WPG"
"CHI",0,1,0,0,0,1,0,0,0,3,0,3,"H","N","2014-01-26","201401260CHI"
"WPG",0,0,0,3,0,3,0,1,0,0,0,1,"A","N","2014-01-26","201401260CHI"
"DET",0,0,3,1,0,4,0,1,0,3,1,5,"H","Y","2014-01-26","201401260DET"
"FLA",0,1,0,3,1,5,0,0,3,1,0,4,"A","Y","2014-01-26","201401260DET"
"EDM",0,2,2,1,0,5,0,1,0,0,0,1,"H","N","2014-01-26","201401260EDM"
"NSH",0,1,0,0,0,1,0,2,2,1,0,5,"A","N","2014-01-26","201401260EDM"
"NJD",0,3,0,0,0,3,0,2,4,1,0,7,"H","N","2014-01-26","201401260NJD"
"NYR",0,2,4,1,0,7,0,3,0,0,0,3,"A","N","2014-01-26","201401260NJD"
"PHX",0,1,2,1,0,4,1,2,2,0,0,5,"A","N","2014-01-26","201401260VAN"
"VAN",1,2,2,0,0,5,0,1,2,1,0,4,"H","N","2014-01-26","201401260VAN"
"CAR",0,0,0,3,0,3,0,2,0,0,0,2,"H","N","2014-01-27","201401270CAR"
"CBJ",0,2,0,0,0,2,0,0,0,3,0,3,"A","N","2014-01-27","201401270CAR"
"COL",0,2,1,1,0,4,0,1,2,0,0,3,"A","N","2014-01-27","201401270DAL"
"DAL",0,1,2,0,0,3,0,2,1,1,0,4,"H","N","2014-01-27","201401270DAL"
"BOS",0,1,3,2,0,6,0,1,2,0,0,3,"A","N","2014-01-27","201401270NYI"
"NYI",0,1,2,0,0,3,0,1,3,2,0,6,"H","N","2014-01-27","201401270NYI"
"BUF",0,0,0,0,0,0,0,0,2,1,0,3,"A","N","2014-01-27","201401270PIT"
"PIT",0,0,2,1,0,3,0,0,0,0,0,0,"H","N","2014-01-27","201401270PIT"
"LAK",0,0,1,0,0,1,0,0,0,0,0,0,"A","N","2014-01-27","201401270SJS"
"SJS",0,0,0,0,0,0,0,0,1,0,0,1,"H","N","2014-01-27","201401270SJS"
"EDM",0,2,0,2,0,4,0,1,1,0,0,2,"A","N","2014-01-27","201401270VAN"
"VAN",0,1,1,0,0,2,0,2,0,2,0,4,"H","N","2014-01-27","201401270VAN"
"ANA",0,1,0,1,0,2,0,1,1,2,0,4,"H","N","2014-01-28","201401280ANA"
"MIN",0,1,1,2,0,4,0,1,0,1,0,2,"A","N","2014-01-28","201401280ANA"
"BOS",0,2,2,2,0,6,0,0,1,1,0,2,"H","N","2014-01-28","201401280BOS"
"FLA",0,0,1,1,0,2,0,2,2,2,0,6,"A","N","2014-01-28","201401280BOS"
"BUF",0,1,2,1,0,4,1,2,2,0,0,5,"H","N","2014-01-28","201401280BUF"
"WSH",1,2,2,0,0,5,0,1,2,1,0,4,"A","N","2014-01-28","201401280BUF"
"CBJ",0,0,1,1,0,2,0,1,1,1,0,3,"H","N","2014-01-28","201401280CBJ"
"OTT",0,1,1,1,0,3,0,0,1,1,0,2,"A","N","2014-01-28","201401280CBJ"
"CGY",1,2,2,0,0,5,0,2,2,0,0,4,"H","N","2014-01-28","201401280CGY"
"CHI",0,2,2,0,0,4,1,2,2,0,0,5,"A","N","2014-01-28","201401280CGY"
"CAR",0,0,0,0,0,0,0,2,1,0,0,3,"A","N","2014-01-28","201401280MTL"
"MTL",0,2,1,0,0,3,0,0,0,0,0,0,"H","N","2014-01-28","201401280MTL"
"DET",0,0,0,0,0,0,0,1,2,2,0,5,"A","N","2014-01-28","201401280PHI"
"PHI",0,1,2,2,0,5,0,0,0,0,0,0,"H","N","2014-01-28","201401280PHI"
"LAK",0,0,0,0,0,0,0,1,1,1,0,3,"A","N","2014-01-28","201401280PHX"
"PHX",0,1,1,1,0,3,0,0,0,0,0,0,"H","N","2014-01-28","201401280PHX"
"NJD",0,0,0,0,0,0,0,1,0,2,0,3,"A","N","2014-01-28","201401280STL"
"STL",0,1,0,2,0,3,0,0,0,0,0,0,"H","N","2014-01-28","201401280STL"
"TBL",0,0,2,0,0,2,0,0,2,1,0,3,"A","N","2014-01-28","201401280TOR"
"TOR",0,0,2,1,0,3,0,0,2,0,0,2,"H","N","2014-01-28","201401280TOR"
"NSH",0,1,2,1,0,4,0,1,2,0,0,3,"A","N","2014-01-28","201401280WPG"
"WPG",0,1,2,0,0,3,0,1,2,1,0,4,"H","N","2014-01-28","201401280WPG"
"EDM",0,1,0,2,0,3,0,0,0,0,0,0,"H","N","2014-01-29","201401290EDM"
"SJS",0,0,0,0,0,0,0,1,0,2,0,3,"A","N","2014-01-29","201401290EDM"
"NYI",0,0,1,0,0,1,0,0,1,1,0,2,"H","N","2014-01-29","201401290NYI"
"NYR",0,0,1,1,0,2,0,0,1,0,0,1,"A","N","2014-01-29","201401290NYI"
"CHI",0,0,4,1,0,5,0,1,1,0,0,2,"A","N","2014-01-29","201401290VAN"
"VAN",0,1,1,0,0,2,0,0,4,1,0,5,"H","N","2014-01-29","201401290VAN"
"ANA",0,2,1,2,0,5,0,1,0,2,0,3,"H","N","2014-01-30","201401300ANA"
"PHI",0,1,0,2,0,3,0,2,1,2,0,5,"A","N","2014-01-30","201401300ANA"
"BOS",0,1,0,0,0,1,0,2,2,0,0,4,"H","N","2014-01-30","201401300BOS"
"MTL",0,2,2,0,0,4,0,1,0,0,0,1,"A","N","2014-01-30","201401300BOS"
"CBJ",0,2,2,1,0,5,0,0,1,1,0,2,"H","N","2014-01-30","201401300CBJ"
"WSH",0,0,1,1,0,2,0,2,2,1,0,5,"A","N","2014-01-30","201401300CBJ"
"CGY",0,1,1,2,0,4,0,0,0,1,0,1,"H","N","2014-01-30","201401300CGY"
"SJS",0,0,0,1,0,1,0,1,1,2,0,4,"A","N","2014-01-30","201401300CGY"
"COL",0,1,3,1,0,5,0,1,0,3,0,4,"H","N","2014-01-30","201401300COL"
"MIN",0,1,0,3,0,4,0,1,3,1,0,5,"A","N","2014-01-30","201401300COL"
"DAL",0,0,1,1,0,2,1,1,1,0,0,3,"H","N","2014-01-30","201401300DAL"
"NJD",1,1,1,0,0,3,0,0,1,1,0,2,"A","N","2014-01-30","201401300DAL"
"LAK",0,1,0,0,0,1,0,3,1,0,0,4,"H","N","2014-01-30","201401300LAK"
"PIT",0,3,1,0,0,4,0,1,0,0,0,1,"A","N","2014-01-30","201401300LAK"
"OTT",0,2,2,1,0,5,0,0,1,2,0,3,"H","N","2014-01-30","201401300OTT"
"TBL",0,0,1,2,0,3,0,2,2,1,0,5,"A","N","2014-01-30","201401300OTT"
"BUF",0,1,1,1,0,3,0,2,0,0,0,2,"A","N","2014-01-30","201401300PHX"
"PHX",0,2,0,0,0,2,0,1,1,1,0,3,"H","N","2014-01-30","201401300PHX"
"FLA",0,2,0,1,0,3,0,1,2,3,0,6,"A","N","2014-01-30","201401300TOR"
"TOR",0,1,2,3,0,6,0,2,0,1,0,3,"H","N","2014-01-30","201401300TOR"
"CAR",0,1,1,1,0,3,0,1,0,0,0,1,"H","N","2014-01-31","201401310CAR"
"STL",0,1,0,0,0,1,0,1,1,1,0,3,"A","N","2014-01-31","201401310CAR"
"DET",0,0,2,1,1,4,0,1,0,2,0,3,"H","Y","2014-01-31","201401310DET"
"WSH",0,1,0,2,0,3,0,0,2,1,1,4,"A","Y","2014-01-31","201401310DET"
"NJD",0,0,2,0,0,2,1,1,0,1,0,3,"A","N","2014-01-31","201401310NSH"
"NSH",1,1,0,1,0,3,0,0,2,0,0,2,"H","N","2014-01-31","201401310NSH"
"NYI",0,0,1,0,0,1,0,1,0,3,0,4,"A","N","2014-01-31","201401310NYR"
"NYR",0,1,0,3,0,4,0,0,1,0,0,1,"H","N","2014-01-31","201401310NYR"
"VAN",0,1,1,1,0,3,0,2,1,1,0,4,"A","N","2014-01-31","201401310WPG"
"WPG",0,2,1,1,0,4,0,1,1,1,0,3,"H","N","2014-01-31","201401310WPG"
"ANA",0,0,0,0,0,0,0,0,1,1,0,2,"H","N","2014-02-01","201402010ANA"
"DAL",0,0,1,1,0,2,0,0,0,0,0,0,"A","N","2014-02-01","201402010ANA"
"BOS",0,0,1,3,0,4,0,0,0,0,0,0,"H","N","2014-02-01","201402010BOS"
"EDM",0,0,0,0,0,0,0,0,1,3,0,4,"A","N","2014-02-01","201402010BOS"
"CBJ",0,2,1,1,0,4,0,0,1,0,0,1,"H","N","2014-02-01","201402010CBJ"
"FLA",0,0,1,0,0,1,0,2,1,1,0,4,"A","N","2014-02-01","201402010CBJ"
"CGY",1,1,1,1,0,4,0,0,1,2,0,3,"H","N","2014-02-01","201402010CGY"
"MIN",0,0,1,2,0,3,1,1,1,1,0,4,"A","N","2014-02-01","201402010CGY"
"BUF",0,0,1,0,0,1,0,3,2,2,0,7,"A","N","2014-02-01","201402010COL"
"COL",0,3,2,2,0,7,0,0,1,0,0,1,"H","N","2014-02-01","201402010COL"
"LAK",0,0,0,0,0,0,0,0,1,1,0,2,"H","N","2014-02-01","201402010LAK"
"PHI",0,0,1,1,0,2,0,0,0,0,0,0,"A","N","2014-02-01","201402010LAK"
"MTL",0,0,0,1,0,1,1,0,1,0,0,2,"H","N","2014-02-01","201402010MTL"
"TBL",1,0,1,0,0,2,0,0,0,1,0,1,"A","N","2014-02-01","201402010MTL"
"PHX",0,1,1,1,0,3,0,0,1,0,0,1,"H","N","2014-02-01","201402010PHX"
"PIT",0,0,1,0,0,1,0,1,1,1,0,3,"A","N","2014-02-01","201402010PHX"
"CHI",0,0,0,1,0,1,0,0,0,1,1,2,"A","Y","2014-02-01","201402010SJS"
"SJS",0,0,0,1,1,2,0,0,0,1,0,1,"H","Y","2014-02-01","201402010SJS"
"NSH",0,0,1,2,0,3,0,1,1,1,1,4,"A","Y","2014-02-01","201402010STL"
"STL",0,1,1,1,1,4,0,0,1,2,0,3,"H","Y","2014-02-01","201402010STL"
"OTT",0,1,1,1,0,3,0,0,2,4,0,6,"A","N","2014-02-01","201402010TOR"
"TOR",0,0,2,4,0,6,0,1,1,1,0,3,"H","N","2014-02-01","201402010TOR"
"MTL",0,0,1,0,0,1,0,0,1,1,0,2,"H","N","2014-02-02","201402020MTL"
"WPG",0,0,1,1,0,2,0,0,1,0,0,1,"A","N","2014-02-02","201402020MTL"
"DET",0,1,2,2,0,5,1,3,1,1,0,6,"A","N","2014-02-02","201402020WSH"
"WSH",1,3,1,1,0,6,0,1,2,2,0,5,"H","N","2014-02-02","201402020WSH"
"ANA",0,0,0,2,0,2,0,1,1,2,0,4,"H","N","2014-02-03","201402030ANA"
"CBJ",0,1,1,2,0,4,0,0,0,2,0,2,"A","N","2014-02-03","201402030ANA"
"BUF",0,2,0,0,0,2,0,1,1,1,0,3,"H","N","2014-02-03","201402030BUF"
"EDM",0,1,1,1,0,3,0,2,0,0,0,2,"A","N","2014-02-03","201402030BUF"
"DET",0,0,1,1,0,2,0,0,0,0,0,0,"H","N","2014-02-03","201402030DET"
"VAN",0,0,0,0,0,0,0,0,1,1,0,2,"A","N","2014-02-03","201402030DET"
"CHI",0,2,1,2,0,5,0,1,1,1,0,3,"A","N","2014-02-03","201402030LAK"
"LAK",0,1,1,1,0,3,0,2,1,2,0,5,"H","N","2014-02-03","201402030LAK"
"COL",1,0,0,1,0,2,0,1,0,0,0,1,"A","N","2014-02-03","201402030NJD"
"NJD",0,1,0,0,0,1,1,0,0,1,0,2,"H","N","2014-02-03","201402030NJD"
"OTT",0,1,0,0,0,1,1,1,0,0,0,2,"A","N","2014-02-03","201402030PIT"
"PIT",1,1,0,0,0,2,0,1,0,0,0,1,"H","N","2014-02-03","201402030PIT"
"PHI",0,1,0,4,0,5,0,2,0,0,0,2,"A","N","2014-02-03","201402030SJS"
"SJS",0,2,0,0,0,2,0,1,0,4,0,5,"H","N","2014-02-03","201402030SJS"
"BOS",0,1,2,0,0,3,0,0,1,0,0,1,"H","N","2014-02-04","201402040BOS"
"VAN",0,0,1,0,0,1,0,1,2,0,0,3,"A","N","2014-02-04","201402040BOS"
"CAR",0,0,0,1,0,1,0,0,1,1,0,2,"H","N","2014-02-04","201402040CAR"
"WPG",0,0,1,1,0,2,0,0,0,1,0,1,"A","N","2014-02-04","201402040CAR"
"FLA",0,0,1,3,0,4,0,0,0,1,0,1,"H","N","2014-02-04","201402040FLA"
"TOR",0,0,0,1,0,1,0,0,1,3,0,4,"A","N","2014-02-04","201402040FLA"
"MIN",0,1,0,1,0,2,0,0,0,1,0,1,"H","N","2014-02-04","201402040MIN"
"TBL",0,0,0,1,0,1,0,1,0,1,0,2,"A","N","2014-02-04","201402040MIN"
"CGY",0,0,0,0,0,0,0,0,1,1,0,2,"A","N","2014-02-04","201402040MTL"
"MTL",0,0,1,1,0,2,0,0,0,0,0,0,"H","N","2014-02-04","201402040MTL"
"COL",0,0,1,0,0,1,0,2,1,2,0,5,"A","N","2014-02-04","201402040NYR"
"NYR",0,2,1,2,0,5,0,0,1,0,0,1,"H","N","2014-02-04","201402040NYR"
"DAL",0,0,1,2,0,3,0,0,1,0,0,1,"A","N","2014-02-04","201402040PHX"
"PHX",0,0,1,0,0,1,0,0,1,2,0,3,"H","N","2014-02-04","201402040PHX"
"OTT",0,0,1,3,1,5,0,1,2,1,0,4,"A","Y","2014-02-04","201402040STL"
"STL",0,1,2,1,0,4,0,0,1,3,1,5,"H","Y","2014-02-04","201402040STL"
"NYI",0,0,0,1,0,1,0,0,0,0,0,0,"A","N","2014-02-04","201402040WSH"
"WSH",0,0,0,0,0,0,0,0,0,1,0,1,"H","N","2014-02-04","201402040WSH"
"ANA",0,0,0,0,0,0,0,0,1,1,0,2,"H","N","2014-02-05","201402050ANA"
"CHI",0,0,1,1,0,2,0,0,0,0,0,0,"A","N","2014-02-05","201402050ANA"
"BUF",0,1,0,0,0,1,0,1,2,2,0,5,"H","N","2014-02-05","201402050BUF"
"PIT",0,1,2,2,0,5,0,1,0,0,0,1,"A","N","2014-02-05","201402050BUF"
"DAL",0,0,0,1,0,1,1,0,1,0,0,2,"A","N","2014-02-05","201402050SJS"
"SJS",1,0,1,0,0,2,0,0,0,1,0,1,"H","N","2014-02-05","201402050SJS"
"DET",0,0,2,1,0,3,0,1,0,0,0,1,"A","N","2014-02-06","201402060FLA"
"FLA",0,1,0,0,0,1,0,0,2,1,0,3,"H","N","2014-02-06","201402060FLA"
"CBJ",0,1,0,0,0,1,1,0,0,1,0,2,"A","N","2014-02-06","201402060LAK"
"LAK",1,0,0,1,0,2,0,1,0,0,0,1,"H","N","2014-02-06","201402060LAK"
"MIN",1,2,0,0,0,3,0,1,1,0,0,2,"H","N","2014-02-06","201402060MIN"
"NSH",0,1,1,0,0,2,1,2,0,0,0,3,"A","N","2014-02-06","201402060MIN"
"MTL",0,2,0,3,0,5,0,0,1,1,0,2,"H","N","2014-02-06","201402060MTL"
"VAN",0,0,1,1,0,2,0,2,0,3,0,5,"A","N","2014-02-06","201402060MTL"
"CGY",0,0,2,2,0,4,0,0,1,1,0,2,"A","N","2014-02-06","201402060NYI"
"NYI",0,0,1,1,0,2,0,0,2,2,0,4,"H","N","2014-02-06","201402060NYI"
"EDM",0,1,0,1,0,2,0,0,1,0,0,1,"A","N","2014-02-06","201402060NYR"
"NYR",0,0,1,0,0,1,0,1,0,1,0,2,"H","N","2014-02-06","201402060NYR"
"BUF",0,0,0,2,0,2,0,0,1,2,0,3,"A","N","2014-02-06","201402060OTT"
"OTT",0,0,1,2,0,3,0,0,0,2,0,2,"H","N","2014-02-06","201402060OTT"
"COL",0,0,0,1,0,1,0,0,1,2,0,3,"A","N","2014-02-06","201402060PHI"
"PHI",0,0,1,2,0,3,0,0,0,1,0,1,"H","N","2014-02-06","201402060PHI"
"BOS",0,0,0,2,0,2,1,1,1,0,0,3,"A","N","2014-02-06","201402060STL"
"STL",1,1,1,0,0,3,0,0,0,2,0,2,"H","N","2014-02-06","201402060STL"
"TBL",0,0,0,1,0,1,0,0,1,3,0,4,"H","N","2014-02-06","201402060TBL"
"TOR",0,0,1,3,0,4,0,0,0,1,0,1,"A","N","2014-02-06","201402060TBL"
"WPG",0,1,1,0,0,2,0,1,0,3,0,4,"A","N","2014-02-06","201402060WSH"
"WSH",0,1,0,3,0,4,0,1,1,0,0,2,"H","N","2014-02-06","201402060WSH"
"CAR",0,3,1,1,0,5,0,1,0,0,0,1,"H","N","2014-02-07","201402070CAR"
"FLA",0,1,0,0,0,1,0,3,1,1,0,5,"A","N","2014-02-07","201402070CAR"
"EDM",0,1,0,0,0,1,1,1,0,0,0,2,"A","N","2014-02-07","201402070NJD"
"NJD",1,1,0,0,0,2,0,1,0,0,0,1,"H","N","2014-02-07","201402070NJD"
"CHI",0,0,0,0,0,0,0,1,1,0,0,2,"A","N","2014-02-07","201402070PHX"
"PHX",0,1,1,0,0,2,0,0,0,0,0,0,"H","N","2014-02-07","201402070PHX"
"NYR",0,1,1,1,1,4,0,1,1,1,0,3,"A","Y","2014-02-07","201402070PIT"
"PIT",0,1,1,1,0,3,0,1,1,1,1,4,"H","Y","2014-02-07","201402070PIT"
"CBJ",0,0,1,1,0,2,0,2,0,1,0,3,"A","N","2014-02-07","201402070SJS"
"SJS",0,2,0,1,0,3,0,0,1,1,0,2,"H","N","2014-02-07","201402070SJS"
"BOS",0,2,2,3,0,7,0,0,1,1,0,2,"H","N","2014-02-08","201402080BOS"
"OTT",0,0,1,1,0,2,0,2,2,3,0,7,"A","N","2014-02-08","201402080BOS"
"CAR",0,0,1,0,0,1,0,0,2,2,0,4,"H","N","2014-02-08","201402080CAR"
"MTL",0,0,2,2,0,4,0,0,1,0,0,1,"A","N","2014-02-08","201402080CAR"
"DAL",0,1,1,0,0,2,0,0,0,1,0,1,"H","N","2014-02-08","201402080DAL"
"PHX",0,0,0,1,0,1,0,1,1,0,0,2,"A","N","2014-02-08","201402080DAL"
"ANA",0,1,1,3,0,5,0,1,0,1,0,2,"A","N","2014-02-08","201402080NSH"
"NSH",0,1,0,1,0,2,0,1,1,3,0,5,"H","N","2014-02-08","201402080NSH"
"COL",0,1,2,2,0,5,0,0,0,2,0,2,"A","N","2014-02-08","201402080NYI"
"NYI",0,0,0,2,0,2,0,1,2,2,0,5,"H","N","2014-02-08","201402080NYI"
"CGY",0,0,0,1,0,1,0,0,1,1,0,2,"A","N","2014-02-08","201402080PHI"
"PHI",0,0,1,1,0,2,0,0,0,1,0,1,"H","N","2014-02-08","201402080PHI"
"STL",0,2,0,1,1,4,0,1,1,1,0,3,"H","Y","2014-02-08","201402080STL"
"WPG",0,1,1,1,0,3,0,2,0,1,1,4,"A","Y","2014-02-08","201402080STL"
"DET",0,1,1,0,0,2,0,0,2,2,0,4,"A","N","2014-02-08","201402080TBL"
"TBL",0,0,2,2,0,4,0,1,1,0,0,2,"H","N","2014-02-08","201402080TBL"
"TOR",0,0,0,3,0,3,0,1,0,0,0,1,"H","N","2014-02-08","201402080TOR"
"VAN",0,1,0,0,0,1,0,0,0,3,0,3,"A","N","2014-02-08","201402080TOR"
"NJD",0,0,0,0,0,0,0,0,0,3,0,3,"A","N","2014-02-08","201402080WSH"
"WSH",0,0,0,3,0,3,0,0,0,0,0,0,"H","N","2014-02-08","201402080WSH"
"BUF",0,0,1,2,0,3,0,0,1,1,0,2,"H","N","2014-02-25","201402250BUF"
"CAR",0,0,1,1,0,2,0,0,1,2,0,3,"A","N","2014-02-25","201402250BUF"
"BOS",0,1,2,1,0,4,1,1,2,1,0,5,"A","N","2014-02-26","201402260BUF"
"BUF",1,1,2,1,0,5,0,1,2,1,0,4,"H","N","2014-02-26","201402260BUF"
"COL",0,2,2,0,0,4,0,1,3,2,0,6,"H","N","2014-02-26","201402260COL"
"LAK",0,1,3,2,0,6,0,2,2,0,0,4,"A","N","2014-02-26","201402260COL"
"DET",1,1,0,0,0,2,0,0,0,1,0,1,"A","N","2014-02-26","201402260MTL"
"MTL",0,0,0,1,0,1,1,1,0,0,0,2,"H","N","2014-02-26","201402260MTL"
"STL",0,0,0,0,0,0,0,0,0,1,0,1,"A","N","2014-02-26","201402260VAN"
"VAN",0,0,0,1,0,1,0,0,0,0,0,0,"H","N","2014-02-26","201402260VAN"
"CGY",0,0,0,0,0,0,0,1,0,1,0,2,"H","N","2014-02-27","201402270CGY"
"LAK",0,1,0,1,0,2,0,0,0,0,0,0,"A","N","2014-02-27","201402270CGY"
"CAR",0,0,0,1,0,1,0,2,1,1,0,4,"A","N","2014-02-27","201402270DAL"
"DAL",0,2,1,1,0,4,0,0,0,1,0,1,"H","N","2014-02-27","201402270DAL"
"EDM",0,0,0,0,0,0,0,1,1,1,0,3,"H","N","2014-02-27","201402270EDM"
"MIN",0,1,1,1,0,3,0,0,0,0,0,0,"A","N","2014-02-27","201402270EDM"
"FLA",0,1,1,2,0,4,0,2,2,1,0,5,"H","N","2014-02-27","201402270FLA"
"WSH",0,2,2,1,0,5,0,1,1,2,0,4,"A","N","2014-02-27","201402270FLA"
"CBJ",0,1,1,0,0,2,0,3,1,1,0,5,"A","N","2014-02-27","201402270NJD"
"NJD",0,3,1,1,0,5,0,1,1,0,0,2,"H","N","2014-02-27","201402270NJD"
"NSH",0,0,2,1,0,3,0,2,0,0,0,2,"H","N","2014-02-27","201402270NSH"
"TBL",0,2,0,0,0,2,0,0,2,1,0,3,"A","N","2014-02-27","201402270NSH"
"NYI",1,2,0,2,0,5,0,1,0,3,0,4,"H","N","2014-02-27","201402270NYI"
"TOR",0,1,0,3,0,4,1,2,0,2,0,5,"A","N","2014-02-27","201402270NYI"
"CHI",0,0,0,1,0,1,0,1,0,1,0,2,"A","N","2014-02-27","201402270NYR"
"NYR",0,1,0,1,0,2,0,0,0,1,0,1,"H","N","2014-02-27","201402270NYR"
"DET",0,4,2,0,0,6,0,0,1,0,0,1,"A","N","2014-02-27","201402270OTT"
"OTT",0,0,1,0,0,1,0,4,2,0,0,6,"H","N","2014-02-27","201402270OTT"
"PHI",0,2,0,1,0,3,0,1,5,1,0,7,"H","N","2014-02-27","201402270PHI"
"SJS",0,1,5,1,0,7,0,2,0,1,0,3,"A","N","2014-02-27","201402270PHI"
"MTL",0,1,2,2,1,6,0,2,1,2,0,5,"A","Y","2014-02-27","201402270PIT"
"PIT",0,2,1,2,0,5,0,1,2,2,1,6,"H","Y","2014-02-27","201402270PIT"
"PHX",0,1,0,1,0,2,0,1,1,0,1,3,"A","Y","2014-02-27","201402270WPG"
"WPG",0,1,1,0,1,3,0,1,0,1,0,2,"H","Y","2014-02-27","201402270WPG"
"ANA",0,1,0,0,0,1,0,0,0,0,0,0,"H","N","2014-02-28","201402280ANA"
"STL",0,0,0,0,0,0,0,1,0,0,0,1,"A","N","2014-02-28","201402280ANA"
"BUF",0,1,0,3,0,4,0,0,1,1,0,2,"H","N","2014-02-28","201402280BUF"
"SJS",0,0,1,1,0,2,0,1,0,3,0,4,"A","N","2014-02-28","201402280BUF"
"COL",0,1,0,3,0,4,0,1,0,1,0,2,"H","N","2014-02-28","201402280COL"
"PHX",0,1,0,1,0,2,0,1,0,3,0,4,"A","N","2014-02-28","201402280COL"
"MIN",0,1,0,0,1,2,0,1,0,0,0,1,"A","Y","2014-02-28","201402280VAN"
"VAN",0,1,0,0,0,1,0,1,0,0,1,2,"H","Y","2014-02-28","201402280VAN"
"BOS",0,0,2,0,0,2,0,1,2,1,0,4,"H","N","2014-03-01","201403010BOS"
"WSH",0,1,2,1,0,4,0,0,2,0,0,2,"A","N","2014-03-01","201403010BOS"
"CBJ",0,2,2,2,0,6,0,1,2,0,0,3,"H","N","2014-03-01","201403010CBJ"
"FLA",0,1,2,0,0,3,0,2,2,2,0,6,"A","N","2014-03-01","201403010CBJ"
"CHI",0,1,2,2,0,5,0,0,0,1,0,1,"H","N","2014-03-01","201403010CHI"
"PIT",0,0,0,1,0,1,0,1,2,2,0,5,"A","N","2014-03-01","201403010CHI"
"DAL",0,0,2,0,0,2,0,2,1,1,0,4,"H","N","2014-03-01","201403010DAL"
"TBL",0,2,1,1,0,4,0,0,2,0,0,2,"A","N","2014-03-01","201403010DAL"
"CGY",1,1,0,0,0,2,0,0,0,1,0,1,"A","N","2014-03-01","201403010EDM"
"EDM",0,0,0,1,0,1,1,1,0,0,0,2,"H","N","2014-03-01","201403010EDM"
"CAR",0,1,0,0,0,1,0,1,0,2,0,3,"A","N","2014-03-01","201403010LAK"
"LAK",0,1,0,2,0,3,0,1,0,0,0,1,"H","N","2014-03-01","201403010LAK"
"MTL",1,2,0,1,0,4,0,1,0,2,0,3,"H","N","2014-03-01","201403010MTL"
"TOR",0,1,0,2,0,3,1,2,0,1,0,4,"A","N","2014-03-01","201403010MTL"
"NSH",0,0,0,1,0,1,0,0,2,1,0,3,"H","N","2014-03-01","201403010NSH"
"WPG",0,0,2,1,0,3,0,0,0,1,0,1,"A","N","2014-03-01","201403010NSH"
"NJD",0,1,4,1,0,6,0,0,1,0,0,1,"A","N","2014-03-01","201403010NYI"
"NYI",0,0,1,0,0,1,0,1,4,1,0,6,"H","N","2014-03-01","201403010NYI"
"NYR",0,0,2,0,0,2,0,2,1,1,0,4,"A","N","2014-03-01","201403010PHI"
"PHI",0,2,1,1,0,4,0,0,2,0,0,2,"H","N","2014-03-01","201403010PHI"
"ANA",0,3,2,0,0,5,0,0,1,2,0,3,"H","N","2014-03-02","201403020ANA"
"CAR",0,0,1,2,0,3,0,3,2,0,0,5,"A","N","2014-03-02","201403020ANA"
"COL",0,2,0,4,0,6,0,1,2,0,0,3,"H","N","2014-03-02","201403020COL"
"TBL",0,1,2,0,0,3,0,2,0,4,0,6,"A","N","2014-03-02","201403020COL"
"NJD",0,0,2,0,0,2,0,0,2,2,0,4,"H","N","2014-03-02","201403020NJD"
"SJS",0,0,2,2,0,4,0,0,2,0,0,2,"A","N","2014-03-02","201403020NJD"
"FLA",0,0,1,4,0,5,0,2,1,0,0,3,"A","N","2014-03-02","201403020NYI"
"NYI",0,2,1,0,0,3,0,0,1,4,0,5,"H","N","2014-03-02","201403020NYI"
"BOS",0,1,2,3,0,6,0,1,1,1,0,3,"A","N","2014-03-02","201403020NYR"
"NYR",0,1,1,1,0,3,0,1,2,3,0,6,"H","N","2014-03-02","201403020NYR"
"PHX",0,1,1,0,0,2,0,0,0,4,0,4,"H","N","2014-03-02","201403020PHX"
"STL",0,0,0,4,0,4,0,1,1,0,0,2,"A","N","2014-03-02","201403020PHX"
"OTT",0,2,1,1,0,4,0,2,0,0,0,2,"A","N","2014-03-02","201403020VAN"
"VAN",0,2,0,0,0,2,0,2,1,1,0,4,"H","N","2014-03-02","201403020VAN"
"PHI",1,1,1,2,0,5,0,2,2,0,0,4,"A","N","2014-03-02","201403020WSH"
"WSH",0,2,2,0,0,4,1,1,1,2,0,5,"H","N","2014-03-02","201403020WSH"
"BUF",0,1,0,1,0,2,0,0,2,1,0,3,"A","N","2014-03-03","201403030DAL"
"DAL",0,0,2,1,0,3,0,1,0,1,0,2,"H","N","2014-03-03","201403030DAL"
"LAK",0,1,1,0,0,2,0,1,0,0,0,1,"H","N","2014-03-03","201403030LAK"
"MTL",0,1,0,0,0,1,0,1,1,0,0,2,"A","N","2014-03-03","201403030LAK"
"CGY",0,0,1,1,0,2,0,0,1,2,0,3,"A","N","2014-03-03","201403030MIN"
"MIN",0,0,1,2,0,3,0,0,1,1,0,2,"H","N","2014-03-03","201403030MIN"
"CBJ",0,0,2,0,0,2,0,0,0,1,0,1,"A","N","2014-03-03","201403030TOR"
"TOR",0,0,0,1,0,1,0,0,2,0,0,2,"H","N","2014-03-03","201403030TOR"
"BOS",0,2,1,1,0,4,0,0,0,1,0,1,"H","N","2014-03-04","201403040BOS"
"FLA",0,0,0,1,0,1,0,2,1,1,0,4,"A","N","2014-03-04","201403040BOS"
"CBJ",0,3,0,1,0,4,0,0,0,2,0,2,"H","N","2014-03-04","201403040CBJ"
"DAL",0,0,0,2,0,2,0,3,0,1,0,4,"A","N","2014-03-04","201403040CBJ"
"CHI",0,0,1,1,0,2,0,0,1,3,0,4,"H","N","2014-03-04","201403040CHI"
"COL",0,0,1,3,0,4,0,0,1,1,0,2,"A","N","2014-03-04","201403040CHI"
"EDM",0,1,1,1,0,3,0,1,0,1,0,2,"H","N","2014-03-04","201403040EDM"
"OTT",0,1,0,1,0,2,0,1,1,1,0,3,"A","N","2014-03-04","201403040EDM"
"DET",0,1,1,1,0,3,0,1,0,3,0,4,"A","N","2014-03-04","201403040NJD"
"NJD",0,1,0,3,0,4,0,1,1,1,0,3,"H","N","2014-03-04","201403040NJD"
"NSH",0,0,1,0,0,1,0,0,1,2,0,3,"H","N","2014-03-04","201403040NSH"
"PIT",0,0,1,2,0,3,0,0,1,0,0,1,"A","N","2014-03-04","201403040NSH"
"PHX",0,1,0,0,0,1,0,0,0,0,0,0,"H","N","2014-03-04","201403040PHX"
"VAN",0,0,0,0,0,0,0,1,0,0,0,1,"A","N","2014-03-04","201403040PHX"
"CAR",1,1,1,0,0,3,0,2,0,0,0,2,"A","N","2014-03-04","201403040SJS"
"SJS",0,2,0,0,0,2,1,1,1,0,0,3,"H","N","2014-03-04","201403040SJS"
"STL",0,0,2,2,0,4,0,2,0,0,0,2,"H","N","2014-03-04","201403040STL"
"TBL",0,2,0,0,0,2,0,0,2,2,0,4,"A","N","2014-03-04","201403040STL"
"NYI",1,1,1,0,0,3,0,1,0,1,0,2,"A","N","2014-03-04","201403040WPG"
"WPG",0,1,0,1,0,2,1,1,1,0,0,3,"H","N","2014-03-04","201403040WPG"
"ANA",0,0,3,0,0,3,0,2,1,0,1,4,"H","Y","2014-03-05","201403050ANA"
"MTL",0,2,1,0,1,4,0,0,3,0,0,3,"A","Y","2014-03-05","201403050ANA"
"CGY",0,1,2,1,0,4,0,0,0,1,0,1,"H","N","2014-03-05","201403050CGY"
"OTT",0,0,0,1,0,1,0,1,2,1,0,4,"A","N","2014-03-05","201403050CGY"
"NYR",0,0,0,2,0,2,1,0,1,1,0,3,"H","N","2014-03-05","201403050NYR"
"TOR",1,0,1,1,0,3,0,0,0,2,0,2,"A","N","2014-03-05","201403050NYR"
"PHI",0,2,2,2,0,6,0,0,1,3,0,4,"H","N","2014-03-05","201403050PHI"
"WSH",0,0,1,3,0,4,0,2,2,2,0,6,"A","N","2014-03-05","201403050PHI"
"BOS",0,0,2,1,0,3,0,0,0,0,0,0,"H","N","2014-03-06","201403060BOS"
"WSH",0,0,0,0,0,0,0,0,2,1,0,3,"A","N","2014-03-06","201403060BOS"
"CBJ",0,1,0,0,0,1,0,2,3,1,0,6,"A","N","2014-03-06","201403060CHI"
"CHI",0,2,3,1,0,6,0,1,0,0,0,1,"H","N","2014-03-06","201403060CHI"
"DAL",0,3,2,1,0,6,0,0,1,0,0,1,"H","N","2014-03-06","201403060DAL"
"VAN",0,0,1,0,0,1,0,3,2,1,0,6,"A","N","2014-03-06","201403060DAL"
"COL",1,0,1,1,0,3,0,1,1,0,0,2,"A","N","2014-03-06","201403060DET"
"DET",0,1,1,0,0,2,1,0,1,1,0,3,"H","N","2014-03-06","201403060DET"
"EDM",1,0,0,2,0,3,0,2,0,0,0,2,"H","N","2014-03-06","201403060EDM"
"NYI",0,2,0,0,0,2,1,0,0,2,0,3,"A","N","2014-03-06","201403060EDM"
"NSH",0,1,0,0,0,1,0,1,1,0,0,2,"H","N","2014-03-06","201403060NSH"
"STL",0,1,1,0,0,2,0,1,0,0,0,1,"A","N","2014-03-06","201403060NSH"
"MTL",0,1,1,0,0,2,0,3,0,2,0,5,"A","N","2014-03-06","201403060PHX"
"PHX",0,3,0,2,0,5,0,1,1,0,0,2,"H","N","2014-03-06","201403060PHX"
"PIT",0,2,0,1,0,3,0,0,1,4,0,5,"A","N","2014-03-06","201403060SJS"
"SJS",0,0,1,4,0,5,0,2,0,1,0,3,"H","N","2014-03-06","201403060SJS"
"BUF",0,1,1,1,0,3,0,0,0,1,0,1,"A","N","2014-03-06","201403060TBL"
"TBL",0,0,0,1,0,1,0,1,1,1,0,3,"H","N","2014-03-06","201403060TBL"
"LAK",0,0,2,1,0,3,0,0,1,0,0,1,"A","N","2014-03-06","201403060WPG"
"WPG",0,0,1,0,0,1,0,0,2,1,0,3,"H","N","2014-03-06","201403060WPG"
"ANA",0,1,0,1,0,2,0,1,0,1,1,3,"H","Y","2014-03-07","201403070ANA"
"PIT",0,1,0,1,1,3,0,1,0,1,0,2,"A","Y","2014-03-07","201403070ANA"
"CAR",0,1,0,1,0,2,0,0,0,4,0,4,"H","N","2014-03-07","201403070CAR"
"NYR",0,0,0,4,0,4,0,1,0,1,0,2,"A","N","2014-03-07","201403070CAR"
"CGY",0,1,0,3,0,4,0,1,2,0,0,3,"H","N","2014-03-07","201403070CGY"
"NYI",0,1,2,0,0,3,0,1,0,3,0,4,"A","N","2014-03-07","201403070CGY"
"DET",0,1,4,2,0,7,0,0,3,1,0,4,"H","N","2014-03-07","201403070DET"
"NJD",0,0,3,1,0,4,0,1,4,2,0,7,"A","N","2014-03-07","201403070DET"
"BUF",0,0,0,0,0,0,0,1,0,1,0,2,"A","N","2014-03-07","201403070FLA"
"FLA",0,1,0,1,0,2,0,0,0,0,0,0,"H","N","2014-03-07","201403070FLA"
"COL",0,0,0,1,0,1,0,0,1,1,0,2,"H","N","2014-03-08","201403080COL"
"STL",0,0,1,1,0,2,0,0,0,1,0,1,"A","N","2014-03-08","201403080COL"
"DAL",0,1,1,2,0,4,0,1,1,1,0,3,"H","N","2014-03-08","201403080DAL"
"MIN",0,1,1,1,0,3,0,1,1,2,0,4,"A","N","2014-03-08","201403080DAL"
"CAR",0,0,2,2,0,4,0,1,3,1,0,5,"A","N","2014-03-08","201403080NJD"
"NJD",0,1,3,1,0,5,0,0,2,2,0,4,"H","N","2014-03-08","201403080NJD"
"CBJ",0,0,0,1,0,1,0,0,0,0,0,0,"A","N","2014-03-08","201403080NSH"
"NSH",0,0,0,0,0,0,0,0,0,1,0,1,"H","N","2014-03-08","201403080NSH"
"MTL",0,0,0,0,0,0,0,1,2,1,0,4,"A","N","2014-03-08","201403080SJS"
"SJS",0,1,2,1,0,4,0,0,0,0,0,0,"H","N","2014-03-08","201403080SJS"
"BOS",0,0,2,1,1,4,0,0,3,0,0,3,"A","Y","2014-03-08","201403080TBL"
"TBL",0,0,3,0,0,3,0,0,2,1,1,4,"H","Y","2014-03-08","201403080TBL"
"PHI",0,0,1,2,0,3,1,2,0,1,0,4,"A","N","2014-03-08","201403080TOR"
"TOR",1,2,0,1,0,4,0,0,1,2,0,3,"H","N","2014-03-08","201403080TOR"
"CGY",0,0,1,0,0,1,0,0,1,1,0,2,"A","N","2014-03-08","201403080VAN"
"VAN",0,0,1,1,0,2,0,0,1,0,0,1,"H","N","2014-03-08","201403080VAN"
"OTT",0,2,3,0,0,5,0,1,1,1,0,3,"A","N","2014-03-08","201403080WPG"
"WPG",0,1,1,1,0,3,0,2,3,0,0,5,"H","N","2014-03-08","201403080WPG"
"PHX",0,1,1,0,0,2,0,0,0,3,0,3,"A","N","2014-03-08","201403080WSH"
"WSH",0,0,0,3,0,3,0,1,1,0,0,2,"H","N","2014-03-08","201403080WSH"
"BUF",0,1,0,0,0,1,0,1,0,1,0,2,"H","N","2014-03-09","201403090BUF"
"CHI",0,1,0,1,0,2,0,1,0,0,0,1,"A","N","2014-03-09","201403090BUF"
"EDM",0,1,0,1,0,2,0,1,3,0,0,4,"H","N","2014-03-09","201403090EDM"
"LAK",0,1,3,0,0,4,0,1,0,1,0,2,"A","N","2014-03-09","201403090EDM"
"BOS",0,0,1,4,0,5,0,0,1,1,0,2,"A","N","2014-03-09","201403090FLA"
"FLA",0,0,1,1,0,2,0,0,1,4,0,5,"H","N","2014-03-09","201403090FLA"
"MIN",0,0,2,0,0,2,0,2,0,0,1,3,"H","Y","2014-03-09","201403090MIN"
"STL",0,2,0,0,1,3,0,0,2,0,0,2,"A","Y","2014-03-09","201403090MIN"
"DET",0,0,0,0,0,0,0,1,0,2,0,3,"A","N","2014-03-09","201403090NYR"
"NYR",0,1,0,2,0,3,0,0,0,0,0,0,"H","N","2014-03-09","201403090NYR"
"ANA",0,0,1,0,0,1,0,2,1,0,0,3,"H","N","2014-03-10","201403100ANA"
"TOR",0,2,1,0,0,3,0,0,1,0,0,1,"A","N","2014-03-10","201403100ANA"
"CGY",0,0,0,2,0,2,0,2,0,1,0,3,"H","N","2014-03-10","201403100CGY"
"LAK",0,2,0,1,0,3,0,0,0,2,0,2,"A","N","2014-03-10","201403100CGY"
"COL",1,0,2,0,0,3,0,0,2,0,0,2,"H","N","2014-03-10","201403100COL"
"WPG",0,0,2,0,0,2,1,0,2,0,0,3,"A","N","2014-03-10","201403100COL"
"NSH",1,0,3,0,0,4,0,0,0,3,0,3,"A","N","2014-03-10","201403100OTT"
"OTT",0,0,0,3,0,3,1,0,3,0,0,4,"H","N","2014-03-10","201403100OTT"
"PHX",0,0,1,2,1,4,0,1,1,1,0,3,"A","Y","2014-03-10","201403100TBL"
"TBL",0,1,1,1,0,3,0,0,1,2,1,4,"H","Y","2014-03-10","201403100TBL"
"NYI",0,0,0,7,0,7,0,1,2,1,0,4,"A","N","2014-03-10","201403100VAN"
"VAN",0,1,2,1,0,4,0,0,0,7,0,7,"H","N","2014-03-10","201403100VAN"
"PIT",0,2,1,0,0,3,0,1,1,0,0,2,"A","N","2014-03-10","201403100WSH"
"WSH",0,1,1,0,0,2,0,2,1,0,0,3,"H","N","2014-03-10","201403100WSH"
"BUF",0,1,0,0,0,1,0,1,2,1,0,4,"H","N","2014-03-11","201403110BUF"
"NSH",0,1,2,1,0,4,0,1,0,0,0,1,"A","N","2014-03-11","201403110BUF"
"CAR",0,0,2,1,0,3,0,0,1,0,0,1,"H","N","2014-03-11","201403110CAR"
"NYR",0,0,1,0,0,1,0,0,2,1,0,3,"A","N","2014-03-11","201403110CAR"
"CBJ",0,1,0,3,0,4,0,1,0,0,0,1,"H","N","2014-03-11","201403110CBJ"
"DET",0,1,0,0,0,1,0,1,0,3,0,4,"A","N","2014-03-11","201403110CBJ"
"FLA",0,0,0,1,0,1,0,1,1,1,0,3,"H","N","2014-03-11","201403110FLA"
"PHX",0,1,1,1,0,3,0,0,0,1,0,1,"A","N","2014-03-11","201403110FLA"
"EDM",0,1,0,2,1,4,0,3,0,0,0,3,"A","Y","2014-03-11","201403110MIN"
"MIN",0,3,0,0,0,3,0,1,0,2,1,4,"H","Y","2014-03-11","201403110MIN"
"NJD",0,1,0,1,0,2,0,0,1,0,0,1,"A","N","2014-03-11","201403110PHI"
"PHI",0,0,1,0,0,1,0,1,0,1,0,2,"H","N","2014-03-11","201403110PHI"
"PIT",0,1,0,1,0,2,0,0,0,0,0,0,"H","N","2014-03-11","201403110PIT"
"WSH",0,0,0,0,0,0,0,1,0,1,0,2,"A","N","2014-03-11","201403110PIT"
"SJS",0,2,2,2,0,6,0,1,0,1,0,2,"H","N","2014-03-11","201403110SJS"
"TOR",0,1,0,1,0,2,0,2,2,2,0,6,"A","N","2014-03-11","201403110SJS"
"DAL",1,1,0,1,0,3,0,1,0,1,0,2,"A","N","2014-03-11","201403110STL"
"STL",0,1,0,1,0,2,1,1,0,1,0,3,"H","N","2014-03-11","201403110STL"
"ANA",0,0,1,1,0,2,0,4,2,1,0,7,"A","N","2014-03-12","201403120CGY"
"CGY",0,4,2,1,0,7,0,0,1,1,0,2,"H","N","2014-03-12","201403120CGY"
"CHI",0,0,1,1,0,2,0,1,1,1,0,3,"A","N","2014-03-12","201403120COL"
"COL",0,1,1,1,0,3,0,0,1,1,0,2,"H","N","2014-03-12","201403120COL"
"BOS",0,0,3,1,0,4,0,0,0,1,0,1,"A","N","2014-03-12","201403120MTL"
"MTL",0,0,0,1,0,1,0,0,3,1,0,4,"H","N","2014-03-12","201403120MTL"
"VAN",0,0,1,1,1,3,0,0,1,1,0,2,"A","Y","2014-03-12","201403120WPG"
"WPG",0,0,1,1,0,2,0,0,1,1,1,3,"H","Y","2014-03-12","201403120WPG"
"BOS",0,2,0,0,0,2,0,0,0,1,0,1,"H","N","2014-03-13","201403130BOS"
"PHX",0,0,0,1,0,1,0,2,0,0,0,2,"A","N","2014-03-13","201403130BOS"
"BUF",0,1,0,1,0,2,0,1,0,3,0,4,"A","N","2014-03-13","201403130CAR"
"CAR",0,1,0,3,0,4,0,1,0,1,0,2,"H","N","2014-03-13","201403130CAR"
"CBJ",0,1,1,1,0,3,0,1,0,2,1,4,"H","Y","2014-03-13","201403130CBJ"
"SJS",0,1,0,2,1,4,0,1,1,1,0,3,"A","Y","2014-03-13","201403130CBJ"
"LAK",0,2,0,0,0,2,0,1,1,1,0,3,"H","N","2014-03-13","201403130LAK"
"TOR",0,1,1,1,0,3,0,2,0,0,0,2,"A","N","2014-03-13","201403130LAK"
"MIN",0,1,0,1,0,2,0,0,1,0,0,1,"H","N","2014-03-13","201403130MIN"
"NYR",0,0,1,0,0,1,0,1,0,1,0,2,"A","N","2014-03-13","201403130MIN"
"EDM",0,1,1,0,0,2,0,1,1,4,0,6,"A","N","2014-03-13","201403130STL"
"STL",0,1,1,4,0,6,0,1,1,0,0,2,"H","N","2014-03-13","201403130STL"
"FLA",0,2,0,2,0,4,0,2,2,1,0,5,"A","N","2014-03-13","201403130TBL"
"TBL",0,2,2,1,0,5,0,2,0,2,0,4,"H","N","2014-03-13","201403130TBL"
"CHI",0,1,0,1,0,2,0,2,0,1,0,3,"H","N","2014-03-14","201403140CHI"
"NSH",0,2,0,1,0,3,0,1,0,1,0,2,"A","N","2014-03-14","201403140CHI"
"ANA",0,0,6,0,0,6,0,1,3,0,0,4,"A","N","2014-03-14","201403140COL"
"COL",0,1,3,0,0,4,0,0,6,0,0,6,"H","N","2014-03-14","201403140COL"
"CGY",0,0,1,2,1,4,0,0,3,0,0,3,"A","Y","2014-03-14","201403140DAL"
"DAL",0,0,3,0,0,3,0,0,1,2,1,4,"H","Y","2014-03-14","201403140DAL"
"DET",0,1,0,0,1,2,0,0,0,1,0,1,"H","Y","2014-03-14","201403140DET"
"EDM",0,0,0,1,0,1,0,1,0,0,1,2,"A","Y","2014-03-14","201403140DET"
"FLA",0,1,1,3,0,5,0,1,2,0,0,3,"H","N","2014-03-14","201403140FLA"
"NJD",0,1,2,0,0,3,0,1,1,3,0,5,"A","N","2014-03-14","201403140FLA"
"NYI",0,0,2,1,0,3,0,2,2,0,0,4,"H","N","2014-03-14","201403140NYI"
"SJS",0,2,2,0,0,4,0,0,2,1,0,3,"A","N","2014-03-14","201403140NYI"
"NYR",0,2,1,1,0,4,0,2,0,0,0,2,"A","N","2014-03-14","201403140WPG"
"WPG",0,2,0,0,0,2,0,2,1,1,0,4,"H","N","2014-03-14","201403140WPG"
"VAN",0,1,0,2,0,3,0,1,2,1,0,4,"A","N","2014-03-14","201403140WSH"
"WSH",0,1,2,1,0,4,0,1,0,2,0,3,"H","N","2014-03-14","201403140WSH"
"BOS",0,1,1,3,0,5,0,0,0,1,0,1,"H","N","2014-03-15","201403150BOS"
"CAR",0,0,0,1,0,1,0,1,1,3,0,5,"A","N","2014-03-15","201403150BOS"
"ANA",0,1,1,0,0,2,0,0,1,0,0,1,"A","N","2014-03-15","201403150LAK"
"LAK",0,0,1,0,0,1,0,1,1,0,0,2,"H","N","2014-03-15","201403150LAK"
"CBJ",0,0,1,0,1,2,0,0,0,1,0,1,"A","Y","2014-03-15","201403150MIN"
"MIN",0,0,0,1,0,1,0,0,1,0,1,2,"H","Y","2014-03-15","201403150MIN"
"MTL",1,1,0,3,0,5,0,1,1,2,0,4,"H","N","2014-03-15","201403150MTL"
"OTT",0,1,1,2,0,4,1,1,0,3,0,5,"A","N","2014-03-15","201403150MTL"
"NSH",0,0,1,0,0,1,0,1,2,1,0,4,"H","N","2014-03-15","201403150NSH"
"STL",0,1,2,1,0,4,0,0,1,0,0,1,"A","N","2014-03-15","201403150NSH"
"BUF",0,0,0,1,0,1,0,2,0,2,0,4,"A","N","2014-03-15","201403150NYI"
"NYI",0,2,0,2,0,4,0,0,0,1,0,1,"H","N","2014-03-15","201403150NYI"
"PHI",0,2,2,0,0,4,0,0,0,0,0,0,"H","N","2014-03-15","201403150PHI"
"PIT",0,0,0,0,0,0,0,2,2,0,0,4,"A","N","2014-03-15","201403150PHI"
"CGY",0,0,2,0,0,2,0,2,0,1,0,3,"A","N","2014-03-15","201403150PHX"
"PHX",0,2,0,1,0,3,0,0,2,0,0,2,"H","N","2014-03-15","201403150PHX"
"NJD",0,0,0,0,0,0,0,0,2,1,0,3,"A","N","2014-03-15","201403150TBL"
"TBL",0,0,2,1,0,3,0,0,0,0,0,0,"H","N","2014-03-15","201403150TBL"
"BUF",0,0,0,0,0,0,0,2,0,0,0,2,"H","N","2014-03-16","201403160BUF"
"MTL",0,2,0,0,0,2,0,0,0,0,0,0,"A","N","2014-03-16","201403160BUF"
"CAR",0,1,0,0,0,1,0,1,0,1,0,2,"H","N","2014-03-16","201403160CAR"
"EDM",0,1,0,1,0,2,0,1,0,0,0,1,"A","N","2014-03-16","201403160CAR"
"CHI",0,0,2,2,0,4,0,0,1,0,0,1,"H","N","2014-03-16","201403160CHI"
"DET",0,0,1,0,0,1,0,0,2,2,0,4,"A","N","2014-03-16","201403160CHI"
"FLA",0,1,0,2,0,3,0,2,0,1,1,4,"H","Y","2014-03-16","201403160FLA"
"VAN",0,2,0,1,1,4,0,1,0,2,0,3,"A","Y","2014-03-16","201403160FLA"
"NYR",0,0,0,0,0,0,0,1,0,0,0,1,"H","N","2014-03-16","201403160NYR"
"SJS",0,1,0,0,0,1,0,0,0,0,0,0,"A","N","2014-03-16","201403160NYR"
"COL",0,0,1,2,0,3,0,0,0,1,0,1,"A","N","2014-03-16","201403160OTT"
"OTT",0,0,0,1,0,1,0,0,1,2,0,3,"H","N","2014-03-16","201403160OTT"
"PHI",0,3,1,0,0,4,0,1,2,0,0,3,"A","N","2014-03-16","201403160PIT"
"PIT",0,1,2,0,0,3,0,3,1,0,0,4,"H","N","2014-03-16","201403160PIT"
"DAL",0,2,0,0,0,2,0,3,2,2,0,7,"A","N","2014-03-16","201403160WPG"
"WPG",0,3,2,2,0,7,0,2,0,0,0,2,"H","N","2014-03-16","201403160WPG"
"TOR",0,1,1,0,0,2,0,3,0,1,0,4,"A","N","2014-03-16","201403160WSH"
"WSH",0,3,0,1,0,4,0,1,1,0,0,2,"H","N","2014-03-16","201403160WSH"
"BOS",0,0,2,2,0,4,0,0,1,0,0,1,"H","N","2014-03-17","201403170BOS"
"MIN",0,0,1,0,0,1,0,0,2,2,0,4,"A","N","2014-03-17","201403170BOS"
"LAK",0,1,2,0,0,3,0,2,0,2,0,4,"H","N","2014-03-17","201403170LAK"
"PHX",0,2,0,2,0,4,0,1,2,0,0,3,"A","N","2014-03-17","201403170LAK"
"STL",0,0,1,2,0,3,0,0,0,1,0,1,"H","N","2014-03-17","201403170STL"
"WPG",0,0,0,1,0,1,0,0,1,2,0,3,"A","N","2014-03-17","201403170STL"
"TBL",0,1,2,1,0,4,0,0,0,3,0,3,"H","N","2014-03-17","201403170TBL"
"VAN",0,0,0,3,0,3,0,1,2,1,0,4,"A","N","2014-03-17","201403170TBL"
"ANA",0,1,0,1,0,2,0,2,0,1,0,3,"H","N","2014-03-18","201403180ANA"
"WSH",0,2,0,1,0,3,0,1,0,1,0,2,"A","N","2014-03-18","201403180ANA"
"CAR",0,1,2,0,0,3,0,0,0,1,0,1,"A","N","2014-03-18","201403180CBJ"
"CBJ",0,0,0,1,0,1,0,1,2,0,0,3,"H","N","2014-03-18","201403180CBJ"
"BUF",0,1,0,0,0,1,0,0,1,2,0,3,"A","N","2014-03-18","201403180CGY"
"CGY",0,0,1,2,0,3,0,1,0,0,0,1,"H","N","2014-03-18","201403180CGY"
"DET",0,1,0,2,0,3,0,0,0,2,0,2,"H","N","2014-03-18","201403180DET"
"TOR",0,0,0,2,0,2,0,1,0,2,0,3,"A","N","2014-03-18","201403180DET"
"EDM",0,1,2,2,0,5,0,0,1,0,0,1,"H","N","2014-03-18","201403180EDM"
"NSH",0,0,1,0,0,1,0,1,2,2,0,5,"A","N","2014-03-18","201403180EDM"
"COL",0,1,1,1,0,3,0,0,2,4,0,6,"A","N","2014-03-18","201403180MTL"
"MTL",0,0,2,4,0,6,0,1,1,1,0,3,"H","N","2014-03-18","201403180MTL"
"BOS",0,1,2,1,0,4,0,0,1,1,0,2,"A","N","2014-03-18","201403180NJD"
"NJD",0,0,1,1,0,2,0,1,2,1,0,4,"H","N","2014-03-18","201403180NJD"
"MIN",0,2,1,3,0,6,0,0,0,0,0,0,"A","N","2014-03-18","201403180NYI"
"NYI",0,0,0,0,0,0,0,2,1,3,0,6,"H","N","2014-03-18","201403180NYI"
"NYR",0,1,4,3,0,8,0,2,0,2,0,4,"A","N","2014-03-18","201403180OTT"
"OTT",0,2,0,2,0,4,0,1,4,3,0,8,"H","N","2014-03-18","201403180OTT"
"CHI",0,2,0,0,0,2,1,2,0,0,0,3,"A","N","2014-03-18","201403180PHI"
"PHI",1,2,0,0,0,3,0,2,0,0,0,2,"H","N","2014-03-18","201403180PHI"
"DAL",0,1,0,0,0,1,0,2,1,2,0,5,"A","N","2014-03-18","201403180PIT"
"PIT",0,2,1,2,0,5,0,1,0,0,0,1,"H","N","2014-03-18","201403180PIT"
"FLA",0,0,3,0,0,3,0,0,1,1,0,2,"A","N","2014-03-18","201403180SJS"
"SJS",0,0,1,1,0,2,0,0,3,0,0,3,"H","N","2014-03-18","201403180SJS"
"CHI",0,1,1,2,0,4,0,0,0,0,0,0,"H","N","2014-03-19","201403190CHI"
"STL",0,0,0,0,0,0,0,1,1,2,0,4,"A","N","2014-03-19","201403190CHI"
"TBL",0,3,1,1,0,5,0,2,0,1,0,3,"A","N","2014-03-19","201403190TOR"
"TOR",0,2,0,1,0,3,0,3,1,1,0,5,"H","N","2014-03-19","201403190TOR"
"NSH",0,0,0,0,0,0,0,0,0,2,0,2,"A","N","2014-03-19","201403190VAN"
"VAN",0,0,0,2,0,2,0,0,0,0,0,0,"H","N","2014-03-19","201403190VAN"
"COL",0,2,1,1,0,4,1,2,1,1,0,5,"A","N","2014-03-19","201403190WPG"
"WPG",1,2,1,1,0,5,0,2,1,1,0,4,"H","N","2014-03-19","201403190WPG"
"DET",1,1,1,2,0,5,0,0,3,1,0,4,"H","N","2014-03-20","201403200DET"
"PIT",0,0,3,1,0,4,1,1,1,2,0,5,"A","N","2014-03-20","201403200DET"
"BUF",0,0,1,2,0,3,0,1,0,0,0,1,"A","N","2014-03-20","201403200EDM"
"EDM",0,1,0,0,0,1,0,0,1,2,0,3,"H","N","2014-03-20","201403200EDM"
"LAK",0,1,0,0,1,2,0,0,0,1,0,1,"H","Y","2014-03-20","201403200LAK"
"WSH",0,0,0,1,0,1,0,1,0,0,1,2,"A","Y","2014-03-20","201403200LAK"
"CBJ",0,1,1,1,0,3,0,1,0,1,0,2,"A","N","2014-03-20","201403200MTL"
"MTL",0,1,0,1,0,2,0,1,1,1,0,3,"H","N","2014-03-20","201403200MTL"
"MIN",0,0,0,3,0,3,1,1,1,1,0,4,"A","N","2014-03-20","201403200NJD"
"NJD",1,1,1,1,0,4,0,0,0,3,0,3,"H","N","2014-03-20","201403200NJD"
"OTT",0,2,1,1,0,4,0,2,1,2,0,5,"H","N","2014-03-20","201403200OTT"
"TBL",0,2,1,2,0,5,0,2,1,1,0,4,"A","N","2014-03-20","201403200OTT"
"DAL",0,0,1,1,0,2,0,2,0,2,0,4,"A","N","2014-03-20","201403200PHI"
"PHI",0,2,0,2,0,4,0,0,1,1,0,2,"H","N","2014-03-20","201403200PHI"
"FLA",0,0,0,1,0,1,0,2,0,0,0,2,"A","N","2014-03-20","201403200PHX"
"PHX",0,2,0,0,0,2,0,0,0,1,0,1,"H","N","2014-03-20","201403200PHX"
"ANA",0,0,1,1,0,2,0,1,0,2,0,3,"A","N","2014-03-20","201403200SJS"
"SJS",0,1,0,2,0,3,0,0,1,1,0,2,"H","N","2014-03-20","201403200SJS"
"CBJ",0,0,0,1,0,1,0,0,0,3,0,3,"H","N","2014-03-21","201403210CBJ"
"NYR",0,0,0,3,0,3,0,0,0,1,0,1,"A","N","2014-03-21","201403210CBJ"
"CGY",0,1,3,1,0,5,0,2,2,2,0,6,"H","N","2014-03-21","201403210CGY"
"NSH",0,2,2,2,0,6,0,1,3,1,0,5,"A","N","2014-03-21","201403210CGY"
"CAR",0,0,1,1,0,2,0,0,2,1,0,3,"A","N","2014-03-21","201403210CHI"
"CHI",0,0,2,1,0,3,0,0,1,1,0,2,"H","N","2014-03-21","201403210CHI"
"BOS",0,1,1,0,0,2,0,0,0,0,0,0,"A","N","2014-03-21","201403210COL"
"COL",0,0,0,0,0,0,0,1,1,0,0,2,"H","N","2014-03-21","201403210COL"
"DAL",0,0,1,2,0,3,0,1,0,0,0,1,"H","N","2014-03-22","201403220DAL"
"OTT",0,1,0,0,0,1,0,0,1,2,0,3,"A","N","2014-03-22","201403220DAL"
"CGY",0,1,4,3,0,8,0,1,0,0,0,1,"A","N","2014-03-22","201403220EDM"
"EDM",0,1,0,0,0,1,0,1,4,3,0,8,"H","N","2014-03-22","201403220EDM"
"FLA",0,0,0,0,0,0,0,2,1,1,0,4,"A","N","2014-03-22","201403220LAK"
"LAK",0,2,1,1,0,4,0,0,0,0,0,0,"H","N","2014-03-22","201403220LAK"
"DET",0,1,1,1,0,3,0,1,0,1,0,2,"A","N","2014-03-22","201403220MIN"
"MIN",0,1,0,1,0,2,0,1,1,1,0,3,"H","N","2014-03-22","201403220MIN"
"NJD",0,0,0,0,0,0,0,0,1,1,0,2,"H","N","2014-03-22","201403220NJD"
"NYR",0,0,1,1,0,2,0,0,0,0,0,0,"A","N","2014-03-22","201403220NJD"
"PHI",0,0,2,2,0,4,0,1,0,0,0,1,"H","N","2014-03-22","201403220PHI"
"STL",0,1,0,0,0,1,0,0,2,2,0,4,"A","N","2014-03-22","201403220PHI"
"BOS",0,1,0,3,0,4,0,1,1,0,0,2,"A","N","2014-03-22","201403220PHX"
"PHX",0,1,1,0,0,2,0,1,0,3,0,4,"H","N","2014-03-22","201403220PHX"
"PIT",1,0,1,2,0,4,0,0,1,2,0,3,"H","N","2014-03-22","201403220PIT"
"TBL",0,0,1,2,0,3,1,0,1,2,0,4,"A","N","2014-03-22","201403220PIT"
"SJS",0,1,0,1,0,2,0,1,0,1,1,3,"H","Y","2014-03-22","201403220SJS"
"WSH",0,1,0,1,1,3,0,1,0,1,0,2,"A","Y","2014-03-22","201403220SJS"
"MTL",0,3,0,1,0,4,0,2,0,1,0,3,"A","N","2014-03-22","201403220TOR"
"TOR",0,2,0,1,0,3,0,3,0,1,0,4,"H","N","2014-03-22","201403220TOR"
"CAR",0,0,3,0,0,3,0,0,1,1,0,2,"A","N","2014-03-22","201403220WPG"
"WPG",0,0,1,1,0,2,0,0,3,0,0,3,"H","N","2014-03-22","201403220WPG"
"ANA",0,1,4,1,0,6,0,0,2,0,0,2,"H","N","2014-03-23","201403230ANA"
"FLA",0,0,2,0,0,2,0,1,4,1,0,6,"A","N","2014-03-23","201403230ANA"
"CHI",0,0,0,0,0,0,0,1,1,0,0,2,"H","N","2014-03-23","201403230CHI"
"NSH",0,1,1,0,0,2,0,0,0,0,0,0,"A","N","2014-03-23","201403230CHI"
"DET",0,2,0,1,0,3,1,0,1,2,0,4,"H","N","2014-03-23","201403230DET"
"MIN",1,0,1,2,0,4,0,2,0,1,0,3,"A","N","2014-03-23","201403230DET"
"NJD",0,1,2,0,0,3,0,0,1,1,0,2,"H","N","2014-03-23","201403230NJD"
"TOR",0,0,1,1,0,2,0,1,2,0,0,3,"A","N","2014-03-23","201403230NJD"
"CBJ",0,0,0,0,0,0,0,1,1,0,0,2,"A","N","2014-03-23","201403230NYI"
"NYI",0,1,1,0,0,2,0,0,0,0,0,0,"H","N","2014-03-23","201403230NYI"
"PIT",0,0,0,0,0,0,0,0,0,1,0,1,"H","N","2014-03-23","201403230PIT"
"STL",0,0,0,1,0,1,0,0,0,0,0,0,"A","N","2014-03-23","201403230PIT"
"BUF",0,2,0,0,0,2,0,2,1,1,0,4,"A","N","2014-03-23","201403230VAN"
"VAN",0,2,1,1,0,4,0,2,0,0,0,2,"H","N","2014-03-23","201403230VAN"
"BOS",0,0,0,1,0,1,0,1,0,0,1,2,"H","Y","2014-03-24","201403240BOS"
"MTL",0,1,0,0,1,2,0,0,0,1,0,1,"A","Y","2014-03-24","201403240BOS"
"CGY",0,0,1,0,1,2,0,1,0,0,0,1,"H","Y","2014-03-24","201403240CGY"
"SJS",0,1,0,0,0,1,0,0,1,0,1,2,"A","Y","2014-03-24","201403240CGY"
"DAL",0,1,1,0,0,2,0,0,0,1,0,1,"H","N","2014-03-24","201403240DAL"
"WPG",0,0,0,1,0,1,0,1,1,0,0,2,"A","N","2014-03-24","201403240DAL"
"NYR",1,0,2,1,0,4,0,2,1,0,0,3,"H","N","2014-03-24","201403240NYR"
"PHX",0,2,1,0,0,3,1,0,2,1,0,4,"A","N","2014-03-24","201403240NYR"
"LAK",0,0,2,1,0,3,0,0,0,2,0,2,"A","N","2014-03-24","201403240PHI"
"PHI",0,0,0,2,0,2,0,0,2,1,0,3,"H","N","2014-03-24","201403240PHI"
"OTT",0,1,2,0,1,4,0,1,1,1,0,3,"A","Y","2014-03-24","201403240TBL"
"TBL",0,1,1,1,0,3,0,1,2,0,1,4,"H","Y","2014-03-24","201403240TBL"
"CAR",0,2,2,0,0,4,0,4,1,0,0,5,"H","N","2014-03-25","201403250CAR"
"NYI",0,4,1,0,0,5,0,2,2,0,0,4,"A","N","2014-03-25","201403250CAR"
"CBJ",0,2,0,2,0,4,0,1,1,0,0,2,"H","N","2014-03-25","201403250CBJ"
"DET",0,1,1,0,0,2,0,2,0,2,0,4,"A","N","2014-03-25","201403250CBJ"
"CHI",0,1,2,1,0,4,0,0,1,1,0,2,"H","N","2014-03-25","201403250CHI"
"DAL",0,0,1,1,0,2,0,1,2,1,0,4,"A","N","2014-03-25","201403250CHI"
"EDM",0,1,0,1,0,2,0,0,3,2,0,5,"H","N","2014-03-25","201403250EDM"
"SJS",0,0,3,2,0,5,0,1,0,1,0,2,"A","N","2014-03-25","201403250EDM"
"FLA",0,0,2,0,1,3,0,0,2,0,0,2,"H","Y","2014-03-25","201403250FLA"
"OTT",0,0,2,0,0,2,0,0,2,0,1,3,"A","Y","2014-03-25","201403250FLA"
"BUF",0,0,0,0,0,0,0,0,0,2,0,2,"A","N","2014-03-25","201403250MTL"
"MTL",0,0,0,2,0,2,0,0,0,0,0,0,"H","N","2014-03-25","201403250MTL"
"COL",0,1,1,2,1,5,0,2,1,1,0,4,"A","Y","2014-03-25","201403250NSH"
"NSH",0,2,1,1,0,4,0,1,1,2,1,5,"H","Y","2014-03-25","201403250NSH"
"PHX",0,2,1,0,0,3,0,2,0,0,0,2,"A","N","2014-03-25","201403250PIT"
"PIT",0,2,0,0,0,2,0,2,1,0,0,3,"H","N","2014-03-25","201403250PIT"
"STL",0,2,2,1,0,5,0,1,0,2,0,3,"A","N","2014-03-25","201403250TOR"
"TOR",0,1,0,2,0,3,0,2,2,1,0,5,"H","N","2014-03-25","201403250TOR"
"LAK",0,0,1,3,1,5,0,2,1,1,0,4,"A","Y","2014-03-25","201403250WSH"
"WSH",0,2,1,1,0,4,0,0,1,3,1,5,"H","Y","2014-03-25","201403250WSH"
"ANA",0,1,0,2,0,3,0,0,2,0,0,2,"A","N","2014-03-26","201403260CGY"
"CGY",0,0,2,0,0,2,0,1,0,2,0,3,"H","N","2014-03-26","201403260CGY"
"MIN",0,1,0,1,0,2,0,1,2,2,0,5,"H","N","2014-03-26","201403260MIN"
"VAN",0,1,2,2,0,5,0,1,0,1,0,2,"A","N","2014-03-26","201403260MIN"
"NYR",0,1,1,1,0,3,0,0,0,1,0,1,"H","N","2014-03-26","201403260NYR"
"PHI",0,0,0,1,0,1,0,1,1,1,0,3,"A","N","2014-03-26","201403260NYR"
"BOS",0,1,0,2,0,3,0,0,0,0,0,0,"H","N","2014-03-27","201403270BOS"
"CHI",0,0,0,0,0,0,0,1,0,2,0,3,"A","N","2014-03-27","201403270BOS"
"COL",1,1,1,0,0,3,0,1,1,0,0,2,"H","N","2014-03-27","201403270COL"
"VAN",0,1,1,0,0,2,1,1,1,0,0,3,"A","N","2014-03-27","201403270COL"
"DET",0,0,1,3,0,4,0,2,1,2,0,5,"H","N","2014-03-27","201403270DET"
"MTL",0,2,1,2,0,5,0,0,1,3,0,4,"A","N","2014-03-27","201403270DET"
"CAR",0,1,2,0,0,3,0,0,0,0,0,0,"A","N","2014-03-27","201403270FLA"
"FLA",0,0,0,0,0,0,0,1,2,0,0,3,"H","N","2014-03-27","201403270FLA"
"NJD",0,0,1,1,0,2,0,1,1,0,1,3,"H","Y","2014-03-27","201403270NJD"
"PHX",0,1,1,0,1,3,0,0,1,1,0,2,"A","Y","2014-03-27","201403270NJD"
"BUF",0,0,1,0,0,1,0,4,1,1,0,6,"A","N","2014-03-27","201403270NSH"
"NSH",0,4,1,1,0,6,0,0,1,0,0,1,"H","N","2014-03-27","201403270NSH"
"LAK",0,1,1,1,0,3,0,0,2,0,0,2,"A","N","2014-03-27","201403270PIT"
"PIT",0,0,2,0,0,2,0,1,1,1,0,3,"H","N","2014-03-27","201403270PIT"
"SJS",0,2,1,0,0,3,0,1,2,1,0,4,"H","N","2014-03-27","201403270SJS"
"WPG",0,1,2,1,0,4,0,2,1,0,0,3,"A","N","2014-03-27","201403270SJS"
"MIN",0,0,0,1,0,1,0,2,1,2,0,5,"A","N","2014-03-27","201403270STL"
"STL",0,2,1,2,0,5,0,0,0,1,0,1,"H","N","2014-03-27","201403270STL"
"NYI",0,0,2,0,0,2,0,0,1,1,1,3,"A","Y","2014-03-27","201403270TBL"
"TBL",0,0,1,1,1,3,0,0,2,0,0,2,"H","Y","2014-03-27","201403270TBL"
"CBJ",0,0,0,1,0,1,0,0,0,2,0,2,"H","N","2014-03-28","201403280CBJ"
"PIT",0,0,0,2,0,2,0,0,0,1,0,1,"A","N","2014-03-28","201403280CBJ"
"CGY",0,2,2,0,0,4,0,0,3,0,0,3,"H","N","2014-03-28","201403280CGY"
"NYR",0,0,3,0,0,3,0,2,2,0,0,4,"A","N","2014-03-28","201403280CGY"
"DAL",0,2,3,2,0,7,0,0,2,1,0,3,"H","N","2014-03-28","201403280DAL"
"NSH",0,0,2,1,0,3,0,2,3,2,0,7,"A","N","2014-03-28","201403280DAL"
"ANA",0,1,1,1,0,3,1,1,1,1,0,4,"A","N","2014-03-28","201403280EDM"
"EDM",1,1,1,1,0,4,0,1,1,1,0,3,"H","N","2014-03-28","201403280EDM"
"CHI",0,0,2,1,0,3,0,2,1,2,0,5,"A","N","2014-03-28","201403280OTT"
"OTT",0,2,1,2,0,5,0,0,2,1,0,3,"H","N","2014-03-28","201403280OTT"
"PHI",0,1,1,2,0,4,0,0,1,1,0,2,"H","N","2014-03-28","201403280PHI"
"TOR",0,0,1,1,0,2,0,1,1,2,0,4,"A","N","2014-03-28","201403280PHI"
"BUF",0,2,0,1,0,3,1,2,0,1,0,4,"H","N","2014-03-29","201403290BUF"
"TBL",1,2,0,1,0,4,0,2,0,1,0,3,"A","N","2014-03-29","201403290BUF"
"CAR",0,0,1,1,0,2,1,0,1,1,0,3,"H","N","2014-03-29","201403290CAR"
"CBJ",1,0,1,1,0,3,0,0,1,1,0,2,"A","N","2014-03-29","201403290CAR"
"COL",0,2,1,0,0,3,0,1,1,0,0,2,"H","N","2014-03-29","201403290COL"
"SJS",0,1,1,0,0,2,0,2,1,0,0,3,"A","N","2014-03-29","201403290COL"
"FLA",0,0,1,0,0,1,0,2,1,1,0,4,"H","N","2014-03-29","201403290FLA"
"MTL",0,2,1,1,0,4,0,0,1,0,0,1,"A","N","2014-03-29","201403290FLA"
"LAK",0,3,0,1,0,4,0,0,0,2,0,2,"H","N","2014-03-29","201403290LAK"
"WPG",0,0,0,2,0,2,0,3,0,1,0,4,"A","N","2014-03-29","201403290LAK"
"NJD",0,0,1,0,0,1,0,0,1,0,1,2,"A","Y","2014-03-29","201403290NYI"
"NYI",0,0,1,0,1,2,0,0,1,0,0,1,"H","Y","2014-03-29","201403290NYI"
"MIN",0,0,0,3,0,3,0,1,0,0,0,1,"A","N","2014-03-29","201403290PHX"
"PHX",0,1,0,0,0,1,0,0,0,3,0,3,"H","N","2014-03-29","201403290PHX"
"DAL",0,1,2,1,0,4,0,0,1,1,0,2,"A","N","2014-03-29","201403290STL"
"STL",0,0,1,1,0,2,0,1,2,1,0,4,"H","N","2014-03-29","201403290STL"
"DET",0,0,3,1,0,4,0,1,1,0,0,2,"A","N","2014-03-29","201403290TOR"
"TOR",0,1,1,0,0,2,0,0,3,1,0,4,"H","N","2014-03-29","201403290TOR"
"ANA",0,2,1,2,0,5,0,1,0,0,0,1,"A","N","2014-03-29","201403290VAN"
"VAN",0,1,0,0,0,1,0,2,1,2,0,5,"H","N","2014-03-29","201403290VAN"
"BOS",0,0,3,1,0,4,0,0,1,1,0,2,"A","N","2014-03-29","201403290WSH"
"WSH",0,0,1,1,0,2,0,0,3,1,0,4,"H","N","2014-03-29","201403290WSH"
"DET",0,2,1,0,0,3,0,1,0,1,0,2,"H","N","2014-03-30","201403300DET"
"TBL",0,1,0,1,0,2,0,2,1,0,0,3,"A","N","2014-03-30","201403300DET"
"EDM",0,0,0,0,0,0,0,1,3,1,0,5,"H","N","2014-03-30","201403300EDM"
"NYR",0,1,3,1,0,5,0,0,0,0,0,0,"A","N","2014-03-30","201403300EDM"
"NSH",0,2,0,1,1,4,0,1,1,1,0,3,"H","Y","2014-03-30","201403300NSH"
"WSH",0,1,1,1,0,3,0,2,0,1,1,4,"A","Y","2014-03-30","201403300NSH"
"CGY",0,1,2,0,0,3,0,2,1,3,0,6,"A","N","2014-03-30","201403300OTT"
"OTT",0,2,1,3,0,6,0,1,2,0,0,3,"H","N","2014-03-30","201403300OTT"
"BOS",0,1,2,0,1,4,0,2,0,1,0,3,"A","Y","2014-03-30","201403300PHI"
"PHI",0,2,0,1,0,3,0,1,2,0,1,4,"H","Y","2014-03-30","201403300PHI"
"CHI",0,0,1,0,0,1,0,2,0,2,0,4,"A","N","2014-03-30","201403300PIT"
"PIT",0,2,0,2,0,4,0,0,1,0,0,1,"H","N","2014-03-30","201403300PIT"
"ANA",1,0,1,3,0,5,0,2,2,0,0,4,"H","N","2014-03-31","201403310ANA"
"WPG",0,2,2,0,0,4,1,0,1,3,0,5,"A","N","2014-03-31","201403310ANA"
"LAK",0,1,1,0,0,2,0,0,1,2,0,3,"H","N","2014-03-31","201403310LAK"
"MIN",0,0,1,2,0,3,0,1,1,0,0,2,"A","N","2014-03-31","201403310LAK"
"FLA",0,1,2,0,0,3,0,3,1,2,0,6,"A","N","2014-03-31","201403310NJD"
"NJD",0,3,1,2,0,6,0,1,2,0,0,3,"H","N","2014-03-31","201403310NJD"
"CAR",0,1,0,0,0,1,0,1,0,0,1,2,"A","Y","2014-03-31","201403310OTT"
"OTT",0,1,0,0,1,2,0,1,0,0,0,1,"H","Y","2014-03-31","201403310OTT"
"BUF",0,0,0,2,1,3,0,0,1,1,0,2,"H","Y","2014-04-01","201404010BUF"
"NJD",0,0,1,1,0,2,0,0,0,2,1,3,"A","Y","2014-04-01","201404010BUF"
"CBJ",0,0,2,0,0,2,1,0,0,2,0,3,"H","N","2014-04-01","201404010CBJ"
"COL",1,0,0,2,0,3,0,0,2,0,0,2,"A","N","2014-04-01","201404010CBJ"
"FLA",0,1,0,1,0,2,0,1,2,1,0,4,"A","N","2014-04-01","201404010NYI"
"NYI",0,1,2,1,0,4,0,1,0,1,0,2,"H","N","2014-04-01","201404010NYI"
"PHX",0,0,1,0,0,1,0,1,0,0,1,2,"H","Y","2014-04-01","201404010PHX"
"WPG",0,1,0,0,1,2,0,0,1,0,0,1,"A","Y","2014-04-01","201404010PHX"
"CAR",0,1,2,1,0,4,0,1,0,0,0,1,"A","N","2014-04-01","201404010PIT"
"PIT",0,1,0,0,0,1,0,1,2,1,0,4,"H","N","2014-04-01","201404010PIT"
"EDM",0,1,2,1,0,4,0,2,1,2,0,5,"A","N","2014-04-01","201404010SJS"
"SJS",0,2,1,2,0,5,0,1,2,1,0,4,"H","N","2014-04-01","201404010SJS"
"PHI",0,0,0,0,0,0,0,0,0,0,1,1,"A","Y","2014-04-01","201404010STL"
"STL",0,0,0,0,1,1,0,0,0,0,0,0,"H","Y","2014-04-01","201404010STL"
"MTL",0,1,0,0,0,1,0,0,1,2,0,3,"A","N","2014-04-01","201404010TBL"
"TBL",0,0,1,2,0,3,0,1,0,0,0,1,"H","N","2014-04-01","201404010TBL"
"CGY",0,0,1,1,0,2,0,0,1,2,0,3,"A","N","2014-04-01","201404010TOR"
"TOR",0,0,1,2,0,3,0,0,1,1,0,2,"H","N","2014-04-01","201404010TOR"
"NYR",0,2,0,1,0,3,0,0,1,0,0,1,"A","N","2014-04-01","201404010VAN"
"VAN",0,0,1,0,0,1,0,2,0,1,0,3,"H","N","2014-04-01","201404010VAN"
"DAL",0,1,2,2,0,5,0,0,0,0,0,0,"A","N","2014-04-01","201404010WSH"
"WSH",0,0,0,0,0,0,0,1,2,2,0,5,"H","N","2014-04-01","201404010WSH"
"ANA",0,0,0,3,0,3,0,0,1,1,0,2,"H","N","2014-04-02","201404020ANA"
"EDM",0,0,1,1,0,2,0,0,0,3,0,3,"A","N","2014-04-02","201404020ANA"
"BOS",0,1,0,1,0,2,0,0,1,2,0,3,"A","N","2014-04-02","201404020DET"
"DET",0,0,1,2,0,3,0,1,0,1,0,2,"H","N","2014-04-02","201404020DET"
"LAK",0,1,1,2,0,4,0,0,0,0,0,0,"H","N","2014-04-02","201404020LAK"
"PHX",0,0,0,0,0,0,0,1,1,2,0,4,"A","N","2014-04-02","201404020LAK"
"NYI",0,1,0,1,0,2,0,0,0,1,0,1,"A","N","2014-04-02","201404020OTT"
"OTT",0,0,0,1,0,1,0,1,0,1,0,2,"H","N","2014-04-02","201404020OTT"
"CAR",0,0,3,1,0,4,0,0,1,0,0,1,"H","N","2014-04-03","201404030CAR"
"DAL",0,0,1,0,0,1,0,0,3,1,0,4,"A","N","2014-04-03","201404030CAR"
"CHI",0,0,1,1,1,3,0,1,0,1,0,2,"H","Y","2014-04-03","201404030CHI"
"MIN",0,1,0,1,0,2,0,0,1,1,1,3,"A","Y","2014-04-03","201404030CHI"
"COL",0,0,1,1,1,3,0,1,1,0,0,2,"H","Y","2014-04-03","201404030COL"
"NYR",0,1,1,0,0,2,0,0,1,1,1,3,"A","Y","2014-04-03","201404030COL"
"CBJ",0,0,1,1,0,2,0,0,0,0,0,0,"A","N","2014-04-03","201404030PHI"
"PHI",0,0,0,0,0,0,0,0,1,1,0,2,"H","N","2014-04-03","201404030PHI"
"LAK",0,1,0,0,0,1,0,0,2,0,0,2,"A","N","2014-04-03","201404030SJS"
"SJS",0,0,2,0,0,2,0,1,0,0,0,1,"H","N","2014-04-03","201404030SJS"
"BUF",0,0,0,1,0,1,0,0,1,1,0,2,"A","N","2014-04-03","201404030STL"
"STL",0,0,1,1,0,2,0,0,0,1,0,1,"H","N","2014-04-03","201404030STL"
"CGY",0,2,0,2,0,4,0,0,1,0,0,1,"A","N","2014-04-03","201404030TBL"
"TBL",0,0,1,0,0,1,0,2,0,2,0,4,"H","N","2014-04-03","201404030TBL"
"BOS",0,1,0,2,0,3,1,2,1,0,0,4,"A","N","2014-04-03","201404030TOR"
"TOR",1,2,1,0,0,4,0,1,0,2,0,3,"H","N","2014-04-03","201404030TOR"
"PIT",0,1,1,2,0,4,0,0,2,0,0,2,"A","N","2014-04-03","201404030WPG"
"WPG",0,0,2,0,0,2,0,1,1,2,0,4,"H","N","2014-04-03","201404030WPG"
"ANA",0,1,1,0,0,2,0,4,1,0,0,5,"H","N","2014-04-04","201404040ANA"
"NSH",0,4,1,0,0,5,0,1,1,0,0,2,"A","N","2014-04-04","201404040ANA"
"CBJ",0,1,2,0,0,3,0,1,2,1,0,4,"H","N","2014-04-04","201404040CBJ"
"CHI",0,1,2,1,0,4,0,1,2,0,0,3,"A","N","2014-04-04","201404040CBJ"
"BUF",0,0,1,1,0,2,0,3,0,0,0,3,"A","N","2014-04-04","201404040DET"
"DET",0,3,0,0,0,3,0,0,1,1,0,2,"H","N","2014-04-04","201404040DET"
"CGY",0,0,2,0,0,2,0,0,1,0,0,1,"A","N","2014-04-04","201404040FLA"
"FLA",0,0,1,0,0,1,0,0,2,0,0,2,"H","N","2014-04-04","201404040FLA"
"NJD",0,0,1,1,0,2,0,1,0,0,0,1,"H","N","2014-04-04","201404040NJD"
"WSH",0,1,0,0,0,1,0,0,1,1,0,2,"A","N","2014-04-04","201404040NJD"
"MTL",0,3,2,2,0,7,0,3,0,1,0,4,"A","N","2014-04-04","201404040OTT"
"OTT",0,3,0,1,0,4,0,3,2,2,0,7,"H","N","2014-04-04","201404040OTT"
"EDM",0,1,0,1,1,3,0,0,1,1,0,2,"A","Y","2014-04-04","201404040PHX"
"PHX",0,0,1,1,0,2,0,1,0,1,1,3,"H","Y","2014-04-04","201404040PHX"
"BOS",0,1,1,3,0,5,0,0,2,0,0,2,"H","N","2014-04-05","201404050BOS"
"PHI",0,0,2,0,0,2,0,1,1,3,0,5,"A","N","2014-04-05","201404050BOS"
"CAR",0,0,1,0,0,1,0,1,1,1,0,3,"H","N","2014-04-05","201404050CAR"
"NJD",0,1,1,1,0,3,0,0,1,0,0,1,"A","N","2014-04-05","201404050CAR"
"MIN",0,3,1,0,0,4,0,0,0,0,0,0,"H","N","2014-04-05","201404050MIN"
"PIT",0,0,0,0,0,0,0,3,1,0,0,4,"A","N","2014-04-05","201404050MIN"
"DET",0,0,0,3,0,3,0,1,2,2,0,5,"A","N","2014-04-05","201404050MTL"
"MTL",0,1,2,2,0,5,0,0,0,3,0,3,"H","N","2014-04-05","201404050MTL"
"NYI",0,1,2,0,0,3,0,0,3,0,1,4,"H","Y","2014-04-05","201404050NYI"
"WSH",0,0,3,0,1,4,0,1,2,0,0,3,"A","Y","2014-04-05","201404050NYI"
"NYR",0,0,2,0,0,2,0,2,1,0,0,3,"H","N","2014-04-05","201404050NYR"
"OTT",0,2,1,0,0,3,0,0,2,0,0,2,"A","N","2014-04-05","201404050NYR"
"NSH",0,0,3,0,0,3,0,0,0,0,0,0,"A","N","2014-04-05","201404050SJS"
"SJS",0,0,0,0,0,0,0,0,3,0,0,3,"H","N","2014-04-05","201404050SJS"
"COL",0,0,3,1,0,4,0,0,0,0,0,0,"A","N","2014-04-05","201404050STL"
"STL",0,0,0,0,0,0,0,0,3,1,0,4,"H","N","2014-04-05","201404050STL"
"DAL",0,3,0,2,0,5,0,0,2,0,0,2,"A","N","2014-04-05","201404050TBL"
"TBL",0,0,2,0,0,2,0,3,0,2,0,5,"H","N","2014-04-05","201404050TBL"
"TOR",0,2,0,0,0,2,0,2,1,1,0,4,"H","N","2014-04-05","201404050TOR"
"WPG",0,2,1,1,0,4,0,2,0,0,0,2,"A","N","2014-04-05","201404050TOR"
"LAK",0,0,1,0,0,1,0,0,0,2,0,2,"A","N","2014-04-05","201404050VAN"
"VAN",0,0,0,2,0,2,0,0,1,0,0,1,"H","N","2014-04-05","201404050VAN"
"CBJ",0,2,2,0,0,4,0,0,0,0,0,0,"H","N","2014-04-06","201404060CBJ"
"NYI",0,0,0,0,0,0,0,2,2,0,0,4,"A","N","2014-04-06","201404060CBJ"
"CHI",0,0,2,2,0,4,0,1,0,1,0,2,"H","N","2014-04-06","201404060CHI"
"STL",0,1,0,1,0,2,0,0,2,2,0,4,"A","N","2014-04-06","201404060CHI"
"COL",0,0,0,2,0,2,0,0,2,0,1,3,"H","Y","2014-04-06","201404060COL"
"PIT",0,0,2,0,1,3,0,0,0,2,0,2,"A","Y","2014-04-06","201404060COL"
"ANA",0,1,0,1,0,2,0,0,3,1,0,4,"A","N","2014-04-06","201404060EDM"
"EDM",0,0,3,1,0,4,0,1,0,1,0,2,"H","N","2014-04-06","201404060EDM"
"DAL",0,1,1,0,0,2,0,0,2,1,0,3,"A","N","2014-04-06","201404060FLA"
"FLA",0,0,2,1,0,3,0,1,1,0,0,2,"H","N","2014-04-06","201404060FLA"
"BUF",0,0,0,2,0,2,0,1,3,1,0,5,"A","N","2014-04-06","201404060PHI"
"PHI",0,1,3,1,0,5,0,0,0,2,0,2,"H","N","2014-04-06","201404060PHI"
"CGY",0,0,0,1,0,1,0,0,0,0,0,0,"A","N","2014-04-07","201404070NJD"
"NJD",0,0,0,0,0,0,0,0,0,1,0,1,"H","N","2014-04-07","201404070NJD"
"ANA",0,1,1,1,0,3,0,0,0,0,0,0,"A","N","2014-04-07","201404070VAN"
"VAN",0,0,0,0,0,0,0,1,1,1,0,3,"H","N","2014-04-07","201404070VAN"
"MIN",0,0,1,0,0,1,0,0,0,0,0,0,"A","N","2014-04-07","201404070WPG"
"WPG",0,0,0,0,0,0,0,0,1,0,0,1,"H","N","2014-04-07","201404070WPG"
"BUF",0,0,1,1,0,2,0,0,1,3,0,4,"H","N","2014-04-08","201404080BUF"
"DET",0,0,1,3,0,4,0,0,1,1,0,2,"A","N","2014-04-08","201404080BUF"
"CBJ",1,1,1,1,0,4,0,2,0,1,0,3,"H","N","2014-04-08","201404080CBJ"
"PHX",0,2,0,1,0,3,1,1,1,1,0,4,"A","N","2014-04-08","201404080CBJ"
"DAL",0,1,1,0,1,3,0,0,1,1,0,2,"H","Y","2014-04-08","201404080DAL"
"NSH",0,0,1,1,0,2,0,1,1,0,1,3,"A","Y","2014-04-08","201404080DAL"
"COL",0,2,0,2,0,4,0,1,0,0,0,1,"A","N","2014-04-08","201404080EDM"
"EDM",0,1,0,0,0,1,0,2,0,2,0,4,"H","N","2014-04-08","201404080EDM"
"FLA",0,0,0,2,0,2,0,0,4,1,0,5,"H","N","2014-04-08","201404080FLA"
"PHI",0,0,4,1,0,5,0,0,0,2,0,2,"A","N","2014-04-08","201404080FLA"
"BOS",0,2,1,0,0,3,0,2,0,1,1,4,"A","Y","2014-04-08","201404080MIN"
"MIN",0,2,0,1,1,4,0,2,1,0,0,3,"H","Y","2014-04-08","201404080MIN"
"NYI",0,0,0,1,0,1,0,0,1,3,0,4,"H","N","2014-04-08","201404080NYI"
"OTT",0,0,1,3,0,4,0,0,0,1,0,1,"A","N","2014-04-08","201404080NYI"
"CAR",0,1,0,0,0,1,0,1,2,1,0,4,"A","N","2014-04-08","201404080NYR"
"NYR",0,1,2,1,0,4,0,1,0,0,0,1,"H","N","2014-04-08","201404080NYR"
"STL",0,0,1,0,0,1,0,1,2,1,0,4,"H","N","2014-04-08","201404080STL"
"WSH",0,1,2,1,0,4,0,0,1,0,0,1,"A","N","2014-04-08","201404080STL"
"TBL",0,0,2,1,0,3,0,0,0,0,0,0,"H","N","2014-04-08","201404080TBL"
"TOR",0,0,0,0,0,0,0,0,2,1,0,3,"A","N","2014-04-08","201404080TBL"
"ANA",0,1,3,1,0,5,0,1,1,0,0,2,"H","N","2014-04-09","201404090ANA"
"SJS",0,1,1,0,0,2,0,1,3,1,0,5,"A","N","2014-04-09","201404090ANA"
"CGY",0,1,2,0,1,4,0,0,2,1,0,3,"H","Y","2014-04-09","201404090CGY"
"LAK",0,0,2,1,0,3,0,1,2,0,1,4,"A","Y","2014-04-09","201404090CGY"
"CHI",1,0,0,2,0,3,0,0,0,2,0,2,"H","N","2014-04-09","201404090CHI"
"MTL",0,0,0,2,0,2,1,0,0,2,0,3,"A","N","2014-04-09","201404090CHI"
"CBJ",0,3,0,0,0,3,0,0,0,1,0,1,"A","N","2014-04-09","201404090DAL"
"DAL",0,0,0,1,0,1,0,3,0,0,0,3,"H","N","2014-04-09","201404090DAL"
"DET",0,1,1,1,0,3,0,0,2,1,1,4,"A","Y","2014-04-09","201404090PIT"
"PIT",0,0,2,1,1,4,0,1,1,1,0,3,"H","Y","2014-04-09","201404090PIT"
"CAR",0,0,1,1,0,2,0,1,2,2,0,5,"H","N","2014-04-10","201404100CAR"
"WSH",0,1,2,2,0,5,0,0,1,1,0,2,"A","N","2014-04-10","201404100CAR"
"EDM",0,0,0,0,0,0,0,2,1,0,0,3,"H","N","2014-04-10","201404100EDM"
"LAK",0,2,1,0,0,3,0,0,0,0,0,0,"A","N","2014-04-10","201404100EDM"
"FLA",0,1,1,2,0,4,0,0,1,1,0,2,"H","N","2014-04-10","201404100FLA"
"TOR",0,0,1,1,0,2,0,1,1,2,0,4,"A","N","2014-04-10","201404100FLA"
"MIN",0,1,2,1,0,4,0,0,2,0,0,2,"H","N","2014-04-10","201404100MIN"
"STL",0,0,2,0,0,2,0,1,2,1,0,4,"A","N","2014-04-10","201404100MIN"
"MTL",0,0,0,0,0,0,0,0,2,0,0,2,"H","N","2014-04-10","201404100MTL"
"NYI",0,0,2,0,0,2,0,0,0,0,0,0,"A","N","2014-04-10","201404100MTL"
"NSH",0,0,1,1,0,2,0,0,0,0,0,0,"H","N","2014-04-10","201404100NSH"
"PHX",0,0,0,0,0,0,0,0,1,1,0,2,"A","N","2014-04-10","201404100NSH"
"BUF",0,0,1,0,0,1,0,0,1,1,0,2,"A","N","2014-04-10","201404100NYR"
"NYR",0,0,1,1,0,2,0,0,1,0,0,1,"H","N","2014-04-10","201404100NYR"
"NJD",0,0,1,0,0,1,0,0,1,0,1,2,"A","Y","2014-04-10","201404100OTT"
"OTT",0,0,1,0,1,2,0,0,1,0,0,1,"H","Y","2014-04-10","201404100OTT"
"PHI",0,0,1,1,0,2,0,1,0,3,0,4,"A","N","2014-04-10","201404100TBL"
"TBL",0,1,0,3,0,4,0,0,1,1,0,2,"H","N","2014-04-10","201404100TBL"
"COL",0,1,0,3,0,4,0,1,0,1,0,2,"A","N","2014-04-10","201404100VAN"
"VAN",0,1,0,1,0,2,0,1,0,3,0,4,"H","N","2014-04-10","201404100VAN"
"BOS",0,1,0,0,0,1,0,0,0,1,1,2,"A","Y","2014-04-10","201404100WPG"
"WPG",0,0,0,1,1,2,0,1,0,0,0,1,"H","Y","2014-04-10","201404100WPG"
"CGY",0,0,3,0,0,3,0,2,1,2,0,5,"H","N","2014-04-11","201404110CGY"
"WPG",0,2,1,2,0,5,0,0,3,0,0,3,"A","N","2014-04-11","201404110CGY"
"DAL",0,0,2,1,0,3,0,0,0,0,0,0,"H","N","2014-04-11","201404110DAL"
"STL",0,0,0,0,0,0,0,0,2,1,0,3,"A","N","2014-04-11","201404110DAL"
"CAR",0,2,0,0,0,2,0,0,0,1,0,1,"A","N","2014-04-11","201404110DET"
"DET",0,0,0,1,0,1,0,2,0,0,0,2,"H","N","2014-04-11","201404110DET"
"NJD",0,2,0,0,0,2,0,1,0,1,1,3,"H","Y","2014-04-11","201404110NJD"
"NYI",0,1,0,1,1,3,0,2,0,0,0,2,"A","Y","2014-04-11","201404110NJD"
"COL",0,0,1,0,0,1,0,2,0,3,0,5,"A","N","2014-04-11","201404110SJS"
"SJS",0,2,0,3,0,5,0,0,1,0,0,1,"H","N","2014-04-11","201404110SJS"
"CBJ",0,0,1,1,0,2,0,0,3,0,0,3,"A","N","2014-04-11","201404110TBL"
"TBL",0,0,3,0,0,3,0,0,1,1,0,2,"H","N","2014-04-11","201404110TBL"
"CHI",0,0,0,0,0,0,0,2,2,0,0,4,"A","N","2014-04-11","201404110WSH"
"WSH",0,2,2,0,0,4,0,0,0,0,0,0,"H","N","2014-04-11","201404110WSH"
"BOS",0,2,1,1,0,4,0,0,1,0,0,1,"H","N","2014-04-12","201404120BOS"
"BUF",0,0,1,0,0,1,0,2,1,1,0,4,"A","N","2014-04-12","201404120BOS"
"EDM",0,2,2,1,0,5,0,0,1,1,0,2,"H","N","2014-04-12","201404120EDM"
"VAN",0,0,1,1,0,2,0,2,2,1,0,5,"A","N","2014-04-12","201404120EDM"
"CBJ",0,1,1,1,0,3,0,1,1,0,0,2,"A","N","2014-04-12","201404120FLA"
"FLA",0,1,1,0,0,2,0,1,1,1,0,3,"H","N","2014-04-12","201404120FLA"
"ANA",0,1,1,1,1,4,0,1,0,2,0,3,"A","Y","2014-04-12","201404120LAK"
"LAK",0,1,0,2,0,3,0,1,1,1,1,4,"H","Y","2014-04-12","201404120LAK"
"MTL",1,0,0,0,0,1,0,0,0,0,0,0,"H","N","2014-04-12","201404120MTL"
"NYR",0,0,0,0,0,0,1,0,0,0,0,1,"A","N","2014-04-12","201404120MTL"
"CHI",0,2,1,2,0,5,0,1,1,5,0,7,"A","N","2014-04-12","201404120NSH"
"NSH",0,1,1,5,0,7,0,2,1,2,0,5,"H","N","2014-04-12","201404120NSH"
"OTT",0,0,1,0,0,1,0,0,0,0,0,0,"H","N","2014-04-12","201404120OTT"
"TOR",0,0,0,0,0,0,0,0,1,0,0,1,"A","N","2014-04-12","201404120OTT"
"PHX",0,0,1,1,0,2,0,2,0,1,0,3,"H","N","2014-04-12","201404120PHX"
"SJS",0,2,0,1,0,3,0,0,1,1,0,2,"A","N","2014-04-12","201404120PHX"
"PHI",1,1,1,1,0,4,0,1,0,2,0,3,"A","N","2014-04-12","201404120PIT"
"PIT",0,1,0,2,0,3,1,1,1,1,0,4,"H","N","2014-04-12","201404120PIT"
"ANA",1,0,0,2,0,3,0,1,1,0,0,2,"H","N","2014-04-13","201404130ANA"
"COL",0,1,1,0,0,2,1,0,0,2,0,3,"A","N","2014-04-13","201404130ANA"
"BUF",0,1,1,1,0,3,0,0,1,2,1,4,"H","Y","2014-04-13","201404130BUF"
"NYI",0,0,1,2,1,4,0,1,1,1,0,3,"A","Y","2014-04-13","201404130BUF"
"MIN",0,2,1,0,0,3,0,1,4,2,0,7,"H","N","2014-04-13","201404130MIN"
"NSH",0,1,4,2,0,7,0,2,1,0,0,3,"A","N","2014-04-13","201404130MIN"
"BOS",0,1,0,1,0,2,0,1,0,2,0,3,"A","N","2014-04-13","201404130NJD"
"NJD",0,1,0,2,0,3,0,1,0,1,0,2,"H","N","2014-04-13","201404130NJD"
"CAR",0,3,1,1,1,6,0,1,3,1,0,5,"A","Y","2014-04-13","201404130PHI"
"PHI",0,1,3,1,0,5,0,3,1,1,1,6,"H","Y","2014-04-13","201404130PHI"
"DAL",0,1,0,0,0,1,0,0,1,1,0,2,"A","N","2014-04-13","201404130PHX"
"PHX",0,0,1,1,0,2,0,1,0,0,0,1,"H","N","2014-04-13","201404130PHX"
"OTT",0,1,1,0,1,3,0,1,1,0,0,2,"A","Y","2014-04-13","201404130PIT"
"PIT",0,1,1,0,0,2,0,1,1,0,1,3,"H","Y","2014-04-13","201404130PIT"
"DET",0,1,1,1,0,3,0,0,0,0,0,0,"A","N","2014-04-13","201404130STL"
"STL",0,0,0,0,0,0,0,1,1,1,0,3,"H","N","2014-04-13","201404130STL"
"CGY",0,0,1,0,0,1,0,2,3,0,0,5,"A","N","2014-04-13","201404130VAN"
"VAN",0,2,3,0,0,5,0,0,1,0,0,1,"H","N","2014-04-13","201404130VAN"
"TBL",0,0,0,0,1,1,0,0,0,0,0,0,"A","Y","2014-04-13","201404130WSH"
"WSH",0,0,0,0,0,0,0,0,0,0,1,1,"H","Y","2014-04-13","201404130WSH"
"ANA",0,3,1,0,0,4,0,0,2,1,0,3,"H","N","2014-04-16","201404160ANA"
"DAL",0,0,2,1,0,3,0,3,1,0,0,4,"A","N","2014-04-16","201404160ANA"
"CBJ",0,2,1,0,0,3,0,1,2,1,0,4,"A","N","2014-04-16","201404160PIT"
"PIT",0,1,2,1,0,4,0,2,1,0,0,3,"H","N","2014-04-16","201404160PIT"
"MTL",1,1,1,2,0,5,0,1,1,2,0,4,"A","N","2014-04-16","201404160TBL"
"TBL",0,1,1,2,0,4,1,1,1,2,0,5,"H","N","2014-04-16","201404160TBL"
"COL",1,1,1,2,0,5,0,1,3,0,0,4,"H","N","2014-04-17","201404170COL"
"MIN",0,1,3,0,0,4,1,1,1,2,0,5,"A","N","2014-04-17","201404170COL"
"NYR",0,1,0,3,0,4,0,1,0,0,0,1,"H","N","2014-04-17","201404170NYR"
"PHI",0,1,0,0,0,1,0,1,0,3,0,4,"A","N","2014-04-17","201404170NYR"
"LAK",0,0,0,3,0,3,0,3,2,1,0,6,"A","N","2014-04-17","201404170SJS"
"SJS",0,3,2,1,0,6,0,0,0,3,0,3,"H","N","2014-04-17","201404170SJS"
"CHI",0,3,0,0,0,3,1,2,0,1,0,4,"A","N","2014-04-17","201404170STL"
"STL",1,2,0,1,0,4,0,3,0,0,0,3,"H","N","2014-04-17","201404170STL"
"ANA",0,1,1,1,0,3,0,1,0,1,0,2,"H","N","2014-04-18","201404180ANA"
"DAL",0,1,0,1,0,2,0,1,1,1,0,3,"A","N","2014-04-18","201404180ANA"
"BOS",0,0,0,0,0,0,0,0,0,1,0,1,"H","N","2014-04-18","201404180BOS"
"DET",0,0,0,1,0,1,0,0,0,0,0,0,"A","N","2014-04-18","201404180BOS"
"MTL",0,0,2,2,0,4,0,0,0,1,0,1,"A","N","2014-04-18","201404180TBL"
"TBL",0,0,0,1,0,1,0,0,2,2,0,4,"H","N","2014-04-18","201404180TBL"
"COL",0,1,2,1,0,4,0,1,0,1,0,2,"H","N","2014-04-19","201404190COL"
"MIN",0,1,0,1,0,2,0,1,2,1,0,4,"A","N","2014-04-19","201404190COL"
"CBJ",1,1,1,1,0,4,0,3,0,0,0,3,"A","N","2014-04-19","201404190PIT"
"PIT",0,3,0,0,0,3,1,1,1,1,0,4,"H","N","2014-04-19","201404190PIT"
"CHI",0,0,1,2,0,3,1,2,0,1,0,4,"A","N","2014-04-19","201404190STL"
"STL",1,2,0,1,0,4,0,0,1,2,0,3,"H","N","2014-04-19","201404190STL"
"BOS",0,2,1,1,0,4,0,0,1,0,0,1,"H","N","2014-04-20","201404200BOS"
"DET",0,0,1,0,0,1,0,2,1,1,0,4,"A","N","2014-04-20","201404200BOS"
"MTL",0,1,1,1,0,3,0,0,1,1,0,2,"H","N","2014-04-20","201404200MTL"
"TBL",0,0,1,1,0,2,0,1,1,1,0,3,"A","N","2014-04-20","201404200MTL"
"NYR",0,2,0,0,0,2,0,1,2,1,0,4,"H","N","2014-04-20","201404200NYR"
"PHI",0,1,2,1,0,4,0,2,0,0,0,2,"A","N","2014-04-20","201404200NYR"
"LAK",0,2,0,0,0,2,0,0,3,4,0,7,"A","N","2014-04-20","201404200SJS"
"SJS",0,0,3,4,0,7,0,2,0,0,0,2,"H","N","2014-04-20","201404200SJS"
"CBJ",0,2,0,1,0,3,0,0,1,3,0,4,"H","N","2014-04-21","201404210CBJ"
"PIT",0,0,1,3,0,4,0,2,0,1,0,3,"A","N","2014-04-21","201404210CBJ"
"CHI",0,1,0,1,0,2,0,0,0,0,0,0,"H","N","2014-04-21","201404210CHI"
"STL",0,0,0,0,0,0,0,1,0,1,0,2,"A","N","2014-04-21","201404210CHI"
"ANA",0,0,0,0,0,0,0,1,1,1,0,3,"A","N","2014-04-21","201404210DAL"
"DAL",0,1,1,1,0,3,0,0,0,0,0,0,"H","N","2014-04-21","201404210DAL"
"COL",0,0,0,0,0,0,1,0,0,0,0,1,"A","N","2014-04-21","201404210MIN"
"MIN",1,0,0,0,0,1,0,0,0,0,0,0,"H","N","2014-04-21","201404210MIN"
"BOS",0,2,0,1,0,3,0,0,0,0,0,0,"A","N","2014-04-22","201404220DET"
"DET",0,0,0,0,0,0,0,2,0,1,0,3,"H","N","2014-04-22","201404220DET"
"LAK",0,0,2,1,0,3,1,1,1,1,0,4,"H","N","2014-04-22","201404220LAK"
"SJS",1,1,1,1,0,4,0,0,2,1,0,3,"A","N","2014-04-22","201404220LAK"
"MTL",0,2,1,1,0,4,0,0,1,2,0,3,"H","N","2014-04-22","201404220MTL"
"TBL",0,0,1,2,0,3,0,2,1,1,0,4,"A","N","2014-04-22","201404220MTL"
"NYR",0,2,1,1,0,4,0,1,0,0,0,1,"A","N","2014-04-22","201404220PHI"
"PHI",0,1,0,0,0,1,0,2,1,1,0,4,"H","N","2014-04-22","201404220PHI"
"CBJ",1,1,1,1,0,4,0,3,0,0,0,3,"H","N","2014-04-23","201404230CBJ"
"PIT",0,3,0,0,0,3,1,1,1,1,0,4,"A","N","2014-04-23","201404230CBJ"
"CHI",1,0,2,1,0,4,0,0,2,1,0,3,"H","N","2014-04-23","201404230CHI"
"STL",0,0,2,1,0,3,1,0,2,1,0,4,"A","N","2014-04-23","201404230CHI"
"ANA",0,2,0,0,0,2,0,0,2,2,0,4,"A","N","2014-04-23","201404230DAL"
"DAL",0,0,2,2,0,4,0,2,0,0,0,2,"H","N","2014-04-23","201404230DAL"
"BOS",1,0,1,1,0,3,0,1,1,0,0,2,"A","N","2014-04-24","201404240DET"
"DET",0,1,1,0,0,2,1,0,1,1,0,3,"H","N","2014-04-24","201404240DET"
"LAK",0,1,3,2,0,6,0,1,1,1,0,3,"H","N","2014-04-24","201404240LAK"
"SJS",0,1,1,1,0,3,0,1,3,2,0,6,"A","N","2014-04-24","201404240LAK"
"COL",0,0,1,0,0,1,0,1,1,0,0,2,"A","N","2014-04-24","201404240MIN"
"MIN",0,1,1,0,0,2,0,0,1,0,0,1,"H","N","2014-04-24","201404240MIN"
"ANA",0,2,1,3,0,6,0,1,1,0,0,2,"H","N","2014-04-25","201404250ANA"
"DAL",0,1,1,0,0,2,0,2,1,3,0,6,"A","N","2014-04-25","201404250ANA"
"NYR",0,1,0,0,0,1,0,1,1,0,0,2,"A","N","2014-04-25","201404250PHI"
"PHI",0,1,1,0,0,2,0,1,0,0,0,1,"H","N","2014-04-25","201404250PHI"
"CHI",1,1,1,0,0,3,0,0,1,1,0,2,"A","N","2014-04-25","201404250STL"
"STL",0,0,1,1,0,2,1,1,1,0,0,3,"H","N","2014-04-25","201404250STL"
"BOS",0,1,1,2,0,4,0,0,1,1,0,2,"H","N","2014-04-26","201404260BOS"
"DET",0,0,1,1,0,2,0,1,1,2,0,4,"A","N","2014-04-26","201404260BOS"
"COL",1,0,2,1,0,4,0,0,1,2,0,3,"H","N","2014-04-26","201404260COL"
"MIN",0,0,1,2,0,3,1,0,2,1,0,4,"A","N","2014-04-26","201404260COL"
"CBJ",0,1,0,0,0,1,0,0,1,2,0,3,"A","N","2014-04-26","201404260PIT"
"PIT",0,0,1,2,0,3,0,1,0,0,0,1,"H","N","2014-04-26","201404260PIT"
"LAK",0,2,1,0,0,3,0,0,0,0,0,0,"A","N","2014-04-26","201404260SJS"
"SJS",0,0,0,0,0,0,0,2,1,0,0,3,"H","N","2014-04-26","201404260SJS"
"CHI",0,1,0,4,0,5,0,1,0,0,0,1,"H","N","2014-04-27","201404270CHI"
"STL",0,1,0,0,0,1,0,1,0,4,0,5,"A","N","2014-04-27","201404270CHI"
"ANA",1,1,1,2,0,5,0,3,1,0,0,4,"A","N","2014-04-27","201404270DAL"
"DAL",0,3,1,0,0,4,1,1,1,2,0,5,"H","N","2014-04-27","201404270DAL"
"NYR",0,1,2,1,0,4,0,0,1,1,0,2,"H","N","2014-04-27","201404270NYR"
"PHI",0,0,1,1,0,2,0,1,2,1,0,4,"A","N","2014-04-27","201404270NYR"
"CBJ",0,0,0,3,0,3,0,2,2,0,0,4,"H","N","2014-04-28","201404280CBJ"
"PIT",0,2,2,0,0,4,0,0,0,3,0,3,"A","N","2014-04-28","201404280CBJ"
"LAK",0,1,0,3,0,4,0,0,1,0,0,1,"H","N","2014-04-28","201404280LAK"
"SJS",0,0,1,0,0,1,0,1,0,3,0,4,"A","N","2014-04-28","201404280LAK"
"COL",0,1,1,0,0,2,0,2,0,3,0,5,"A","N","2014-04-28","201404280MIN"
"MIN",0,2,0,3,0,5,0,1,1,0,0,2,"H","N","2014-04-28","201404280MIN"
"NYR",0,0,0,2,0,2,0,1,3,1,0,5,"A","N","2014-04-29","201404290PHI"
"PHI",0,1,3,1,0,5,0,0,0,2,0,2,"H","N","2014-04-29","201404290PHI"
"COL",0,2,0,2,0,4,1,1,1,2,0,5,"H","N","2014-04-30","201404300COL"
"MIN",1,1,1,2,0,5,0,2,0,2,0,4,"A","N","2014-04-30","201404300COL"
"NYR",0,0,2,0,0,2,0,0,0,1,0,1,"H","N","2014-04-30","201404300NYR"
"PHI",0,0,0,1,0,1,0,0,2,0,0,2,"A","N","2014-04-30","201404300NYR"
"LAK",0,0,2,3,0,5,0,0,1,0,0,1,"A","N","2014-04-30","201404300SJS"
"SJS",0,0,1,0,0,1,0,0,2,3,0,5,"H","N","2014-04-30","201404300SJS"
"BOS",0,0,0,3,0,3,1,1,1,1,0,4,"H","N","2014-05-01","201405010BOS"
"MTL",1,1,1,1,0,4,0,0,0,3,0,3,"A","N","2014-05-01","201405010BOS"
"CHI",0,1,1,3,0,5,0,0,0,2,0,2,"H","N","2014-05-02","201405020CHI"
"MIN",0,0,0,2,0,2,0,1,1,3,0,5,"A","N","2014-05-02","201405020CHI"
"NYR",1,2,0,0,0,3,0,0,2,0,0,2,"A","N","2014-05-02","201405020PIT"
"PIT",0,0,2,0,0,2,1,2,0,0,0,3,"H","N","2014-05-02","201405020PIT"
"ANA",0,1,0,1,0,2,1,1,0,1,0,3,"H","N","2014-05-03","201405030ANA"
"LAK",1,1,0,1,0,3,0,1,0,1,0,2,"A","N","2014-05-03","201405030ANA"
"BOS",0,1,0,4,0,5,0,0,2,1,0,3,"H","N","2014-05-03","201405030BOS"
"MTL",0,0,2,1,0,3,0,1,0,4,0,5,"A","N","2014-05-03","201405030BOS"
"CHI",0,1,1,2,0,4,0,0,0,1,0,1,"H","N","2014-05-04","201405040CHI"
"MIN",0,0,0,1,0,1,0,1,1,2,0,4,"A","N","2014-05-04","201405040CHI"
"NYR",0,0,0,0,0,0,0,0,1,2,0,3,"A","N","2014-05-04","201405040PIT"
"PIT",0,0,1,2,0,3,0,0,0,0,0,0,"H","N","2014-05-04","201405040PIT"
"ANA",0,1,0,0,0,1,0,2,0,1,0,3,"H","N","2014-05-05","201405050ANA"
"LAK",0,2,0,1,0,3,0,1,0,0,0,1,"A","N","2014-05-05","201405050ANA"
"NYR",0,0,0,0,0,0,0,0,2,0,0,2,"H","N","2014-05-05","201405050NYR"
"PIT",0,0,2,0,0,2,0,0,0,0,0,0,"A","N","2014-05-05","201405050NYR"
"CHI",0,0,0,0,0,0,0,0,0,4,0,4,"A","N","2014-05-06","201405060MIN"
"MIN",0,0,0,4,0,4,0,0,0,0,0,0,"H","N","2014-05-06","201405060MIN"
"BOS",0,0,1,1,0,2,0,2,1,1,0,4,"A","N","2014-05-06","201405060MTL"
"MTL",0,2,1,1,0,4,0,0,1,1,0,2,"H","N","2014-05-06","201405060MTL"
"NYR",0,0,1,1,0,2,0,1,1,2,0,4,"H","N","2014-05-07","201405070NYR"
"PIT",0,1,1,2,0,4,0,0,1,1,0,2,"A","N","2014-05-07","201405070NYR"
"ANA",0,1,1,1,0,3,0,0,1,1,0,2,"A","N","2014-05-08","201405080LAK"
"LAK",0,0,1,1,0,2,0,1,1,1,0,3,"H","N","2014-05-08","201405080LAK"
"BOS",1,0,0,0,0,1,0,0,0,0,0,0,"A","N","2014-05-08","201405080MTL"
"MTL",0,0,0,0,0,0,1,0,0,0,0,1,"H","N","2014-05-08","201405080MTL"
"CHI",0,1,1,0,0,2,0,1,2,1,0,4,"A","N","2014-05-09","201405090MIN"
"MIN",0,1,2,1,0,4,0,1,1,0,0,2,"H","N","2014-05-09","201405090MIN"
"NYR",0,2,2,1,0,5,0,0,1,0,0,1,"A","N","2014-05-09","201405090PIT"
"PIT",0,0,1,0,0,1,0,2,2,1,0,5,"H","N","2014-05-09","201405090PIT"
"BOS",0,1,2,1,0,4,0,0,1,1,0,2,"H","N","2014-05-10","201405100BOS"
"MTL",0,0,1,1,0,2,0,1,2,1,0,4,"A","N","2014-05-10","201405100BOS"
"ANA",0,2,0,0,0,2,0,0,0,0,0,0,"A","N","2014-05-10","201405100LAK"
"LAK",0,0,0,0,0,0,0,2,0,0,0,2,"H","N","2014-05-10","201405100LAK"
"CHI",0,0,1,1,0,2,0,1,0,0,0,1,"H","N","2014-05-11","201405110CHI"
"MIN",0,1,0,0,0,1,0,0,1,1,0,2,"A","N","2014-05-11","201405110CHI"
"NYR",0,2,1,0,0,3,0,1,0,0,0,1,"H","N","2014-05-11","201405110NYR"
"PIT",0,1,0,0,0,1,0,2,1,0,0,3,"A","N","2014-05-11","201405110NYR"
"ANA",0,1,3,0,0,4,0,1,1,1,0,3,"H","N","2014-05-12","201405120ANA"
"LAK",0,1,1,1,0,3,0,1,3,0,0,4,"A","N","2014-05-12","201405120ANA"
"BOS",0,0,0,0,0,0,0,1,2,1,0,4,"A","N","2014-05-12","201405120MTL"
"MTL",0,1,2,1,0,4,0,0,0,0,0,0,"H","N","2014-05-12","201405120MTL"
"CHI",1,1,0,0,0,2,0,0,1,0,0,1,"A","N","2014-05-13","201405130MIN"
"MIN",0,0,1,0,0,1,1,1,0,0,0,2,"H","N","2014-05-13","201405130MIN"
"NYR",0,1,1,0,0,2,0,0,1,0,0,1,"A","N","2014-05-13","201405130PIT"
"PIT",0,0,1,0,0,1,0,1,1,0,0,2,"H","N","2014-05-13","201405130PIT"
"BOS",0,0,1,0,0,1,0,1,1,1,0,3,"H","N","2014-05-14","201405140BOS"
"MTL",0,1,1,1,0,3,0,0,1,0,0,1,"A","N","2014-05-14","201405140BOS"
"ANA",0,0,1,0,0,1,0,1,1,0,0,2,"A","N","2014-05-14","201405140LAK"
"LAK",0,1,1,0,0,2,0,0,1,0,0,1,"H","N","2014-05-14","201405140LAK"
"ANA",0,0,1,1,0,2,0,3,2,1,0,6,"H","N","2014-05-16","201405160ANA"
"LAK",0,3,2,1,0,6,0,0,1,1,0,2,"A","N","2014-05-16","201405160ANA"
"MTL",0,0,1,1,0,2,0,2,2,3,0,7,"H","N","2014-05-17","201405170MTL"
"NYR",0,2,2,3,0,7,0,0,1,1,0,2,"A","N","2014-05-17","201405170MTL"
"CHI",0,1,1,1,0,3,0,0,1,0,0,1,"H","N","2014-05-18","201405180CHI"
"LAK",0,0,1,0,0,1,0,1,1,1,0,3,"A","N","2014-05-18","201405180CHI"
"MTL",0,1,0,0,0,1,0,2,1,0,0,3,"H","N","2014-05-19","201405190MTL"
"NYR",0,2,1,0,0,3,0,1,0,0,0,1,"A","N","2014-05-19","201405190MTL"
"CHI",0,1,1,0,0,2,0,0,1,5,0,6,"H","N","2014-05-21","201405210CHI"
"LAK",0,0,1,5,0,6,0,1,1,0,0,2,"A","N","2014-05-21","201405210CHI"
"MTL",1,0,1,1,0,3,0,1,0,1,0,2,"A","N","2014-05-22","201405220NYR"
"NYR",0,1,0,1,0,2,1,0,1,1,0,3,"H","N","2014-05-22","201405220NYR"
"CHI",0,2,0,1,0,3,0,1,2,1,0,4,"A","N","2014-05-24","201405240LAK"
"LAK",0,1,2,1,0,4,0,2,0,1,0,3,"H","N","2014-05-24","201405240LAK"
"MTL",0,0,1,1,0,2,1,1,1,0,0,3,"A","N","2014-05-25","201405250NYR"
"NYR",1,1,1,0,0,3,0,0,1,1,0,2,"H","N","2014-05-25","201405250NYR"
"CHI",0,0,1,1,0,2,0,3,1,1,0,5,"A","N","2014-05-26","201405260LAK"
"LAK",0,3,1,1,0,5,0,0,1,1,0,2,"H","N","2014-05-26","201405260LAK"
"MTL",0,2,3,2,0,7,0,1,3,0,0,4,"H","N","2014-05-27","201405270MTL"
"NYR",0,1,3,0,0,4,0,2,3,2,0,7,"A","N","2014-05-27","201405270MTL"
"CHI",1,3,0,1,0,5,0,2,2,0,0,4,"H","N","2014-05-28","201405280CHI"
"LAK",0,2,2,0,0,4,1,3,0,1,0,5,"A","N","2014-05-28","201405280CHI"
"MTL",0,0,0,0,0,0,0,0,1,0,0,1,"A","N","2014-05-29","201405290NYR"
"NYR",0,0,1,0,0,1,0,0,0,0,0,0,"H","N","2014-05-29","201405290NYR"
"CHI",0,0,2,2,0,4,0,1,0,2,0,3,"A","N","2014-05-30","201405300LAK"
"LAK",0,1,0,2,0,3,0,0,2,2,0,4,"H","N","2014-05-30","201405300LAK"
"CHI",0,3,1,0,0,4,1,2,1,1,0,5,"H","N","2014-06-01","201406010CHI"
"LAK",1,2,1,1,0,5,0,3,1,0,0,4,"A","N","2014-06-01","201406010CHI"
"LAK",1,1,1,0,0,3,0,2,0,0,0,2,"H","N","2014-06-04","201406040LAK"
"NYR",0,2,0,0,0,2,1,1,1,0,0,3,"A","N","2014-06-04","201406040LAK"
"LAK",1,0,2,2,0,5,0,2,2,0,0,4,"H","N","2014-06-07","201406070LAK"
"NYR",0,2,2,0,0,4,1,0,2,2,0,5,"A","N","2014-06-07","201406070LAK"
"LAK",0,1,2,0,0,3,0,0,0,0,0,0,"A","N","2014-06-09","201406090NYR"
"NYR",0,0,0,0,0,0,0,1,2,0,0,3,"H","N","2014-06-09","201406090NYR"
"LAK",0,0,1,0,0,1,0,1,1,0,0,2,"A","N","2014-06-11","201406110NYR"
"NYR",0,1,1,0,0,2,0,0,1,0,0,1,"H","N","2014-06-11","201406110NYR"
"LAK",1,1,0,1,0,3,0,0,2,0,0,2,"H","N","2014-06-13","201406130LAK"
"NYR",0,0,2,0,0,2,1,1,0,1,0,3,"A","N","2014-06-13","201406130LAK"
"BOS",0,1,0,1,0,2,0,0,0,1,0,1,"H","N","2014-10-08","201410080BOS"
"PHI",0,0,0,1,0,1,0,1,0,1,0,2,"A","N","2014-10-08","201410080BOS"
"CGY",0,0,2,0,0,2,0,1,2,1,0,4,"H","N","2014-10-08","201410080CGY"
"VAN",0,1,2,1,0,4,0,0,2,0,0,2,"A","N","2014-10-08","201410080CGY"
"LAK",0,0,0,0,0,0,0,1,3,0,0,4,"H","N","2014-10-08","201410080LAK"
"SJS",0,1,3,0,0,4,0,0,0,0,0,0,"A","N","2014-10-08","201410080LAK"
"MTL",0,1,1,2,0,4,0,2,0,1,0,3,"A","N","2014-10-08","201410080TOR"
"TOR",0,2,0,1,0,3,0,1,1,2,0,4,"H","N","2014-10-08","201410080TOR"
"ARI",0,1,0,1,0,2,0,4,1,1,0,6,"H","N","2014-10-09","201410090ARI"
"WPG",0,4,1,1,0,6,0,1,0,1,0,2,"A","N","2014-10-09","201410090ARI"
"BUF",0,0,1,0,0,1,0,0,1,2,0,3,"H","N","2014-10-09","201410090BUF"
"CBJ",0,0,1,2,0,3,0,0,1,0,0,1,"A","N","2014-10-09","201410090BUF"
"CHI",0,1,0,1,1,3,0,0,2,0,0,2,"A","Y","2014-10-09","201410090DAL"
"DAL",0,0,2,0,0,2,0,1,0,1,1,3,"H","Y","2014-10-09","201410090DAL"
"BOS",0,1,0,0,0,1,0,0,2,0,0,2,"A","N","2014-10-09","201410090DET"
"DET",0,0,2,0,0,2,0,1,0,0,0,1,"H","N","2014-10-09","201410090DET"
"CGY",0,2,0,3,0,5,0,1,1,0,0,2,"A","N","2014-10-09","201410090EDM"
"EDM",0,1,1,0,0,2,0,2,0,3,0,5,"H","N","2014-10-09","201410090EDM"
"COL",0,0,0,0,0,0,0,1,4,0,0,5,"A","N","2014-10-09","201410090MIN"
"MIN",0,1,4,0,0,5,0,0,0,0,0,0,"H","N","2014-10-09","201410090MIN"
"NSH",0,0,0,3,0,3,0,0,1,1,0,2,"H","N","2014-10-09","201410090NSH"
"OTT",0,0,1,1,0,2,0,0,0,3,0,3,"A","N","2014-10-09","201410090NSH"
"NJD",0,1,2,3,0,6,0,0,3,1,0,4,"A","N","2014-10-09","201410090PHI"
"PHI",0,0,3,1,0,4,0,1,2,3,0,6,"H","N","2014-10-09","201410090PHI"
"ANA",0,1,2,1,0,4,0,3,2,1,0,6,"A","N","2014-10-09","201410090PIT"
"PIT",0,3,2,1,0,6,0,1,2,1,0,4,"H","N","2014-10-09","201410090PIT"
"NYR",0,1,0,2,0,3,0,0,0,2,0,2,"A","N","2014-10-09","201410090STL"
"STL",0,0,0,2,0,2,0,1,0,2,0,3,"H","N","2014-10-09","201410090STL"
"FLA",0,0,1,1,0,2,1,0,1,1,0,3,"A","N","2014-10-09","201410090TBL"
"TBL",1,0,1,1,0,3,0,0,1,1,0,2,"H","N","2014-10-09","201410090TBL"
"MTL",0,0,0,1,1,2,0,1,0,0,0,1,"A","Y","2014-10-09","201410090WSH"
"WSH",0,1,0,0,0,1,0,0,0,1,1,2,"H","Y","2014-10-09","201410090WSH"
"CAR",0,0,0,3,0,3,0,2,1,2,0,5,"H","N","2014-10-10","201410100CAR"
"NYI",0,2,1,2,0,5,0,0,0,3,0,3,"A","N","2014-10-10","201410100CAR"
"ARI",1,1,1,0,0,3,0,2,0,0,0,2,"H","N","2014-10-11","201410110ARI"
"LAK",0,2,0,0,0,2,1,1,1,0,0,3,"A","N","2014-10-11","201410110ARI"
"BOS",0,0,0,0,0,0,0,2,1,1,0,4,"H","N","2014-10-11","201410110BOS"
"WSH",0,2,1,1,0,4,0,0,0,0,0,0,"A","N","2014-10-11","201410110BOS"
"CBJ",0,2,1,2,0,5,0,0,1,1,0,2,"H","N","2014-10-11","201410110CBJ"
"NYR",0,0,1,1,0,2,0,2,1,2,0,5,"A","N","2014-10-11","201410110CBJ"
"BUF",0,2,0,0,0,2,0,2,0,4,0,6,"A","N","2014-10-11","201410110CHI"
"CHI",0,2,0,4,0,6,0,2,0,0,0,2,"H","N","2014-10-11","201410110CHI"
"COL",0,0,0,0,0,0,0,1,1,1,0,3,"H","N","2014-10-11","201410110COL"
"MIN",0,1,1,1,0,3,0,0,0,0,0,0,"A","N","2014-10-11","201410110COL"
"ANA",0,0,1,2,0,3,0,0,1,1,0,2,"A","N","2014-10-11","201410110DET"
"DET",0,0,1,1,0,2,0,0,1,2,0,3,"H","N","2014-10-11","201410110DET"
"FLA",0,0,1,0,0,1,0,4,1,0,0,5,"H","N","2014-10-11","201410110FLA"
"NJD",0,4,1,0,0,5,0,0,1,0,0,1,"A","N","2014-10-11","201410110FLA"
"DAL",0,1,0,0,0,1,0,0,1,3,0,4,"A","N","2014-10-11","201410110NSH"
"NSH",0,0,1,3,0,4,0,1,0,0,0,1,"H","N","2014-10-11","201410110NSH"
"CAR",0,2,0,1,0,3,0,2,2,0,0,4,"A","N","2014-10-11","201410110NYI"
"NYI",0,2,2,0,0,4,0,2,0,1,0,3,"H","N","2014-10-11","201410110NYI"
"MTL",0,0,0,3,1,4,0,2,1,0,0,3,"A","Y","2014-10-11","201410110PHI"
"PHI",0,2,1,0,0,3,0,0,0,3,1,4,"H","Y","2014-10-11","201410110PHI"
"SJS",0,2,1,0,0,3,0,0,0,0,0,0,"H","N","2014-10-11","201410110SJS"
"WPG",0,0,0,0,0,0,0,2,1,0,0,3,"A","N","2014-10-11","201410110SJS"
"CGY",0,0,0,1,0,1,0,2,2,0,0,4,"A","N","2014-10-11","201410110STL"
"STL",0,2,2,0,0,4,0,0,0,1,0,1,"H","N","2014-10-11","201410110STL"
"OTT",0,0,0,2,1,3,0,1,0,1,0,2,"A","Y","2014-10-11","201410110TBL"
"TBL",0,1,0,1,0,2,0,0,0,2,1,3,"H","Y","2014-10-11","201410110TBL"
"PIT",0,3,1,1,0,5,0,0,1,1,0,2,"A","N","2014-10-11","201410110TOR"
"TOR",0,0,1,1,0,2,0,3,1,1,0,5,"H","N","2014-10-11","201410110TOR"
"EDM",0,2,2,0,0,4,0,1,2,1,1,5,"A","Y","2014-10-11","201410110VAN"
"VAN",0,1,2,1,1,5,0,2,2,0,0,4,"H","Y","2014-10-11","201410110VAN"
"LAK",0,2,2,0,0,4,0,0,1,0,0,1,"H","N","2014-10-12","201410120LAK"
"WPG",0,0,1,0,0,1,0,2,2,0,0,4,"A","N","2014-10-12","201410120LAK"
"NYR",0,1,1,1,0,3,0,1,5,0,0,6,"H","N","2014-10-12","201410120NYR"
"TOR",0,1,5,0,0,6,0,1,1,1,0,3,"A","N","2014-10-12","201410120NYR"
"BOS",0,0,1,0,0,1,0,0,1,1,0,2,"H","N","2014-10-13","201410130BOS"
"COL",0,0,1,1,0,2,0,0,1,0,0,1,"A","N","2014-10-13","201410130BOS"
"ANA",0,1,1,3,0,5,0,0,0,1,0,1,"A","N","2014-10-13","201410130BUF"
"BUF",0,0,0,1,0,1,0,1,1,3,0,5,"H","N","2014-10-13","201410130BUF"
"FLA",0,0,0,0,0,0,0,0,1,0,0,1,"H","N","2014-10-13","201410130FLA"
"OTT",0,0,1,0,0,1,0,0,0,0,0,0,"A","N","2014-10-13","201410130FLA"
"MTL",0,1,0,0,0,1,0,2,2,3,0,7,"A","N","2014-10-13","201410130TBL"
"TBL",0,2,2,3,0,7,0,1,0,0,0,1,"H","N","2014-10-13","201410130TBL"
"BUF",0,1,1,1,1,4,0,0,1,2,0,3,"A","Y","2014-10-14","201410140CAR"
"CAR",0,0,1,2,0,3,0,1,1,1,1,4,"H","Y","2014-10-14","201410140CAR"
"CBJ",0,0,2,0,0,2,0,2,0,2,0,4,"H","N","2014-10-14","201410140CBJ"
"DAL",0,2,0,2,0,4,0,0,2,0,0,2,"A","N","2014-10-14","201410140CBJ"
"EDM",0,0,0,1,0,1,0,3,2,1,0,6,"A","N","2014-10-14","201410140LAK"
"LAK",0,3,2,1,0,6,0,0,0,1,0,1,"H","N","2014-10-14","201410140LAK"
"CGY",0,1,1,0,1,3,0,1,1,0,0,2,"A","Y","2014-10-14","201410140NSH"
"NSH",0,1,1,0,0,2,0,1,1,0,1,3,"H","Y","2014-10-14","201410140NSH"
"NYI",0,1,1,4,0,6,0,1,1,1,0,3,"A","N","2014-10-14","201410140NYR"
"NYR",0,1,1,1,0,3,0,1,1,4,0,6,"H","N","2014-10-14","201410140NYR"
"ANA",0,2,1,0,1,4,0,0,2,1,0,3,"A","Y","2014-10-14","201410140PHI"
"PHI",0,0,2,1,0,3,0,2,1,0,1,4,"H","Y","2014-10-14","201410140PHI"
"NJD",0,0,1,1,0,2,0,0,0,1,0,1,"A","N","2014-10-14","201410140TBL"
"TBL",0,0,0,1,0,1,0,0,1,1,0,2,"H","N","2014-10-14","201410140TBL"
"COL",0,1,1,0,0,2,1,1,0,1,0,3,"A","N","2014-10-14","201410140TOR"
"TOR",1,1,0,1,0,3,0,1,1,0,0,2,"H","N","2014-10-14","201410140TOR"
"SJS",0,3,1,1,1,6,0,0,3,2,0,5,"A","Y","2014-10-14","201410140WSH"
"WSH",0,0,3,2,0,5,0,3,1,1,1,6,"H","Y","2014-10-14","201410140WSH"
"ARI",0,2,2,3,0,7,0,2,0,2,0,4,"H","N","2014-10-15","201410150ARI"
"EDM",0,2,0,2,0,4,0,2,2,3,0,7,"A","N","2014-10-15","201410150ARI"
"CGY",1,0,1,0,0,2,0,0,0,1,0,1,"A","N","2014-10-15","201410150CHI"
"CHI",0,0,0,1,0,1,1,0,1,0,0,2,"H","N","2014-10-15","201410150CHI"
"BOS",0,1,1,0,1,3,0,1,0,1,0,2,"A","Y","2014-10-15","201410150DET"
"DET",0,1,0,1,0,2,0,1,1,0,1,3,"H","Y","2014-10-15","201410150DET"
"LAK",0,0,0,0,1,1,0,0,0,0,0,0,"H","Y","2014-10-16","201410160LAK"
"STL",0,0,0,0,0,0,0,0,0,0,1,1,"A","Y","2014-10-16","201410160LAK"
"BOS",0,1,2,1,0,4,0,1,3,2,0,6,"A","N","2014-10-16","201410160MTL"
"MTL",0,1,3,2,0,6,0,1,2,1,0,4,"H","N","2014-10-16","201410160MTL"
"NYI",0,0,1,2,1,4,0,0,2,1,0,3,"H","Y","2014-10-16","201410160NYI"
"SJS",0,0,2,1,0,3,0,0,1,2,1,4,"A","Y","2014-10-16","201410160NYI"
"CAR",0,0,1,0,0,1,0,0,0,1,1,2,"A","Y","2014-10-16","201410160NYR"
"NYR",0,0,0,1,1,2,0,0,1,0,0,1,"H","Y","2014-10-16","201410160NYR"
"COL",0,3,0,0,0,3,0,1,1,3,0,5,"A","N","2014-10-16","201410160OTT"
"OTT",0,1,1,3,0,5,0,3,0,0,0,3,"H","N","2014-10-16","201410160OTT"
"DAL",0,0,1,2,0,3,0,2,0,0,0,2,"A","N","2014-10-16","201410160PIT"
"PIT",0,2,0,0,0,2,0,0,1,2,0,3,"H","N","2014-10-16","201410160PIT"
"NJD",0,2,0,0,0,2,0,2,1,3,0,6,"A","N","2014-10-16","201410160WSH"
"WSH",0,2,1,3,0,6,0,2,0,0,0,2,"H","N","2014-10-16","201410160WSH"
"ANA",0,0,0,2,0,2,0,0,1,0,0,1,"H","N","2014-10-17","201410170ANA"
"MIN",0,0,1,0,0,1,0,0,0,2,0,2,"A","N","2014-10-17","201410170ANA"
"BUF",0,0,0,0,0,0,0,0,1,0,0,1,"H","N","2014-10-17","201410170BUF"
"FLA",0,0,1,0,0,1,0,0,0,0,0,0,"A","N","2014-10-17","201410170BUF"
"CBJ",0,2,1,0,0,3,0,0,0,2,0,2,"H","N","2014-10-17","201410170CBJ"
"CGY",0,0,0,2,0,2,0,2,1,0,0,3,"A","N","2014-10-17","201410170CBJ"
"EDM",0,0,0,0,0,0,0,0,1,1,0,2,"H","N","2014-10-17","201410170EDM"
"VAN",0,0,1,1,0,2,0,0,0,0,0,0,"A","N","2014-10-17","201410170EDM"
"DET",0,1,2,1,0,4,0,0,0,1,0,1,"A","N","2014-10-17","201410170TOR"
"TOR",0,0,0,1,0,1,0,1,2,1,0,4,"H","N","2014-10-17","201410170TOR"
"NSH",0,1,0,1,0,2,0,0,0,0,0,0,"A","N","2014-10-17","201410170WPG"
"WPG",0,0,0,0,0,0,0,1,0,1,0,2,"H","N","2014-10-17","201410170WPG"
"ARI",0,0,0,1,0,1,0,1,2,3,0,6,"H","N","2014-10-18","201410180ARI"
"STL",0,1,2,3,0,6,0,0,0,1,0,1,"A","N","2014-10-18","201410180ARI"
"BOS",0,2,2,0,0,4,0,0,0,0,0,0,"A","N","2014-10-18","201410180BUF"
"BUF",0,0,0,0,0,0,0,2,2,0,0,4,"H","N","2014-10-18","201410180BUF"
"CHI",1,1,0,0,0,2,0,1,0,0,0,1,"H","N","2014-10-18","201410180CHI"
"NSH",0,1,0,0,0,1,1,1,0,0,0,2,"A","N","2014-10-18","201410180CHI"
"DAL",0,1,3,1,0,5,1,2,0,3,0,6,"H","N","2014-10-18","201410180DAL"
"PHI",1,2,0,3,0,6,0,1,3,1,0,5,"A","N","2014-10-18","201410180DAL"
"DET",1,0,0,0,0,1,0,0,0,0,0,0,"H","N","2014-10-18","201410180DET"
"TOR",0,0,0,0,0,0,1,0,0,0,0,1,"A","N","2014-10-18","201410180DET"
"COL",0,1,0,1,0,2,0,0,3,0,0,3,"A","N","2014-10-18","201410180MTL"
"MTL",0,0,3,0,0,3,0,1,0,1,0,2,"H","N","2014-10-18","201410180MTL"
"NJD",0,0,0,2,0,2,0,1,1,2,0,4,"H","N","2014-10-18","201410180NJD"
"SJS",0,1,1,2,0,4,0,0,0,2,0,2,"A","N","2014-10-18","201410180NJD"
"CBJ",0,0,2,0,0,2,0,1,1,1,0,3,"A","N","2014-10-18","201410180OTT"
"OTT",0,1,1,1,0,3,0,0,2,0,0,2,"H","N","2014-10-18","201410180OTT"
"NYI",0,1,0,0,0,1,0,0,2,1,0,3,"A","N","2014-10-18","201410180PIT"
"PIT",0,0,2,1,0,3,0,1,0,0,0,1,"H","N","2014-10-18","201410180PIT"
"TBL",0,2,1,1,0,4,0,1,1,0,0,2,"A","N","2014-10-18","201410180VAN"
"VAN",0,1,1,0,0,2,0,2,1,1,0,4,"H","N","2014-10-18","201410180VAN"
"FLA",0,0,0,1,0,1,0,1,0,0,1,2,"A","Y","2014-10-18","201410180WSH"
"WSH",0,1,0,0,1,2,0,0,0,1,0,1,"H","Y","2014-10-18","201410180WSH"
"ANA",0,2,1,0,0,3,0,0,0,0,0,0,"H","N","2014-10-19","201410190ANA"
"STL",0,0,0,0,0,0,0,2,1,0,0,3,"A","N","2014-10-19","201410190ANA"
"LAK",0,1,0,1,0,2,0,0,0,1,0,1,"H","N","2014-10-19","201410190LAK"
"MIN",0,0,0,1,0,1,0,1,0,1,0,2,"A","N","2014-10-19","201410190LAK"
"NYR",0,0,3,1,0,4,0,0,0,0,0,0,"H","N","2014-10-19","201410190NYR"
"SJS",0,0,0,0,0,0,0,0,3,1,0,4,"A","N","2014-10-19","201410190NYR"
"CGY",0,0,3,1,0,4,0,1,0,0,0,1,"A","N","2014-10-19","201410190WPG"
"WPG",0,1,0,0,0,1,0,0,3,1,0,4,"H","N","2014-10-19","201410190WPG"
"EDM",0,0,2,1,0,3,0,0,1,1,0,2,"H","N","2014-10-20","201410200EDM"
"TBL",0,0,1,1,0,2,0,0,2,1,0,3,"A","N","2014-10-20","201410200EDM"
"BOS",0,1,1,3,0,5,0,1,2,0,0,3,"H","N","2014-10-21","201410210BOS"
"SJS",0,1,2,0,0,3,0,1,1,3,0,5,"A","N","2014-10-21","201410210BOS"
"CGY",0,0,0,1,0,1,1,0,0,1,0,2,"H","N","2014-10-21","201410210CGY"
"TBL",1,0,0,1,0,2,0,0,0,1,0,1,"A","N","2014-10-21","201410210CGY"
"CHI",0,3,0,1,0,4,0,0,0,0,0,0,"H","N","2014-10-21","201410210CHI"
"PHI",0,0,0,0,0,0,0,3,0,1,0,4,"A","N","2014-10-21","201410210CHI"
"COL",0,0,3,0,0,3,1,2,1,0,0,4,"H","N","2014-10-21","201410210COL"
"FLA",1,2,1,0,0,4,0,0,3,0,0,3,"A","N","2014-10-21","201410210COL"
"DAL",0,3,3,0,0,6,0,0,2,1,0,3,"H","N","2014-10-21","201410210DAL"
"VAN",0,0,2,1,0,3,0,3,3,0,0,6,"A","N","2014-10-21","201410210DAL"
"DET",0,0,1,0,0,1,1,0,0,1,0,2,"A","N","2014-10-21","201410210MTL"
"MTL",1,0,0,1,0,2,0,0,1,0,0,1,"H","N","2014-10-21","201410210MTL"
"NJD",0,1,1,1,0,3,1,1,0,2,0,4,"H","N","2014-10-21","201410210NJD"
"NYR",1,1,0,2,0,4,0,1,1,1,0,3,"A","N","2014-10-21","201410210NJD"
"ARI",0,1,1,1,0,3,0,1,1,1,1,4,"A","Y","2014-10-21","201410210NSH"
"NSH",0,1,1,1,1,4,0,1,1,1,0,3,"H","Y","2014-10-21","201410210NSH"
"NYI",0,2,0,0,0,2,0,1,4,0,0,5,"H","N","2014-10-21","201410210NYI"
"TOR",0,1,4,0,0,5,0,2,0,0,0,2,"A","N","2014-10-21","201410210NYI"
"CAR",0,1,0,0,0,1,0,2,1,0,0,3,"A","N","2014-10-21","201410210WPG"
"WPG",0,2,1,0,0,3,0,1,0,0,0,1,"H","N","2014-10-21","201410210WPG"
"ANA",0,1,1,2,0,4,0,0,0,1,0,1,"H","N","2014-10-22","201410220ANA"
"BUF",0,0,0,1,0,1,0,1,1,2,0,4,"A","N","2014-10-22","201410220ANA"
"EDM",0,1,2,0,0,3,0,1,1,0,0,2,"H","N","2014-10-22","201410220EDM"
"WSH",0,1,1,0,0,2,0,1,2,0,0,3,"A","N","2014-10-22","201410220EDM"
"PHI",0,2,0,3,0,5,0,1,1,1,0,3,"A","N","2014-10-22","201410220PIT"
"PIT",0,1,1,1,0,3,0,2,0,3,0,5,"H","N","2014-10-22","201410220PIT"
"BOS",0,1,0,1,0,2,0,1,2,0,0,3,"H","N","2014-10-23","201410230BOS"
"NYI",0,1,2,0,0,3,0,1,0,1,0,2,"A","N","2014-10-23","201410230BOS"
"CAR",0,0,0,0,0,0,0,1,2,2,0,5,"A","N","2014-10-23","201410230CGY"
"CGY",0,1,2,2,0,5,0,0,0,0,0,0,"H","N","2014-10-23","201410230CGY"
"DET",1,1,0,2,0,4,0,2,1,0,0,3,"H","N","2014-10-23","201410230DET"
"PIT",0,2,1,0,0,3,1,1,0,2,0,4,"A","N","2014-10-23","201410230DET"
"BUF",0,0,0,0,0,0,0,1,1,0,0,2,"A","N","2014-10-23","201410230LAK"
"LAK",0,1,1,0,0,2,0,0,0,0,0,0,"H","N","2014-10-23","201410230LAK"
"ARI",0,0,0,0,0,0,0,0,2,0,0,2,"A","N","2014-10-23","201410230MIN"
"MIN",0,0,2,0,0,2,0,0,0,0,0,0,"H","N","2014-10-23","201410230MIN"
"CHI",0,1,0,1,0,2,0,1,1,1,0,3,"A","N","2014-10-23","201410230NSH"
"NSH",0,1,1,1,0,3,0,1,0,1,0,2,"H","N","2014-10-23","201410230NSH"
"CBJ",0,0,3,2,0,5,0,2,0,2,0,4,"A","N","2014-10-23","201410230SJS"
"SJS",0,2,0,2,0,4,0,0,3,2,0,5,"H","N","2014-10-23","201410230SJS"
"STL",0,0,1,0,0,1,0,1,0,3,0,4,"H","N","2014-10-23","201410230STL"
"VAN",0,1,0,3,0,4,0,0,1,0,0,1,"A","N","2014-10-23","201410230STL"
"ANA",0,2,1,1,0,4,0,1,0,0,0,1,"H","N","2014-10-24","201410240ANA"
"CBJ",0,1,0,0,0,1,0,2,1,1,0,4,"A","N","2014-10-24","201410240ANA"
"COL",0,1,2,4,0,7,0,2,0,1,0,3,"H","N","2014-10-24","201410240COL"
"VAN",0,2,0,1,0,3,0,1,2,4,0,7,"A","N","2014-10-24","201410240COL"
"CAR",0,0,2,1,0,3,0,0,2,4,0,6,"A","N","2014-10-24","201410240EDM"
"EDM",0,0,2,4,0,6,0,0,2,1,0,3,"H","N","2014-10-24","201410240EDM"
"DAL",0,0,2,0,1,3,0,1,0,1,0,2,"A","Y","2014-10-24","201410240NJD"
"NJD",0,1,0,1,0,2,0,0,2,0,1,3,"H","Y","2014-10-24","201410240NJD"
"TBL",0,1,3,0,0,4,0,0,1,1,0,2,"A","N","2014-10-24","201410240WPG"
"WPG",0,0,1,1,0,2,0,1,3,0,0,4,"H","N","2014-10-24","201410240WPG"
"ARI",1,0,0,1,0,2,0,0,0,1,0,1,"H","N","2014-10-25","201410250ARI"
"FLA",0,0,0,1,0,1,1,0,0,1,0,2,"A","N","2014-10-25","201410250ARI"
"CGY",0,1,0,0,0,1,0,1,1,1,0,3,"H","N","2014-10-25","201410250CGY"
"WSH",0,1,1,1,0,3,0,1,0,0,0,1,"A","N","2014-10-25","201410250CGY"
"MIN",0,4,2,1,0,7,0,1,1,0,0,2,"H","N","2014-10-25","201410250MIN"
"TBL",0,1,1,0,0,2,0,4,2,1,0,7,"A","N","2014-10-25","201410250MIN"
"MTL",0,1,1,1,0,3,0,1,0,0,0,1,"H","N","2014-10-25","201410250MTL"
"NYR",0,1,0,0,0,1,0,1,1,1,0,3,"A","N","2014-10-25","201410250MTL"
"NSH",0,0,0,0,0,0,0,1,0,2,0,3,"H","N","2014-10-25","201410250NSH"
"PIT",0,1,0,2,0,3,0,0,0,0,0,0,"A","N","2014-10-25","201410250NSH"
"DAL",0,1,3,1,0,5,0,2,2,3,0,7,"A","N","2014-10-25","201410250NYI"
"NYI",0,2,2,3,0,7,0,1,3,1,0,5,"H","N","2014-10-25","201410250NYI"
"NJD",1,0,2,0,0,3,0,0,1,1,0,2,"A","N","2014-10-25","201410250OTT"
"OTT",0,0,1,1,0,2,1,0,2,0,0,3,"H","N","2014-10-25","201410250OTT"
"DET",0,1,0,1,0,2,0,0,1,3,0,4,"A","N","2014-10-25","201410250PHI"
"PHI",0,0,1,3,0,4,0,1,0,1,0,2,"H","N","2014-10-25","201410250PHI"
"BUF",0,0,0,2,0,2,0,0,0,1,0,1,"A","N","2014-10-25","201410250SJS"
"SJS",0,0,0,1,0,1,0,0,0,2,0,2,"H","N","2014-10-25","201410250SJS"
"CHI",0,1,0,1,0,2,0,1,2,0,0,3,"A","N","2014-10-25","201410250STL"
"STL",0,1,2,0,0,3,0,1,0,1,0,2,"H","N","2014-10-25","201410250STL"
"BOS",0,1,1,2,0,4,0,0,0,1,0,1,"A","N","2014-10-25","201410250TOR"
"TOR",0,0,0,1,0,1,0,1,1,2,0,4,"H","N","2014-10-25","201410250TOR"
"ANA",0,0,0,1,0,1,0,2,1,1,0,4,"H","N","2014-10-26","201410260ANA"
"SJS",0,2,1,1,0,4,0,0,0,1,0,1,"A","N","2014-10-26","201410260ANA"
"CHI",0,0,2,0,0,2,0,0,1,0,0,1,"H","N","2014-10-26","201410260CHI"
"OTT",0,0,1,0,0,1,0,0,2,0,0,2,"A","N","2014-10-26","201410260CHI"
"CBJ",0,1,1,0,0,2,0,0,3,2,0,5,"A","N","2014-10-26","201410260LAK"
"LAK",0,0,3,2,0,5,0,1,1,0,0,2,"H","N","2014-10-26","201410260LAK"
"VAN",0,0,3,1,0,4,0,0,2,0,0,2,"H","N","2014-10-26","201410260VAN"
"WSH",0,0,2,0,0,2,0,0,3,1,0,4,"A","N","2014-10-26","201410260VAN"
"COL",0,1,0,0,0,1,1,1,0,0,0,2,"A","N","2014-10-26","201410260WPG"
"WPG",1,1,0,0,0,2,0,1,0,0,0,1,"H","N","2014-10-26","201410260WPG"
"EDM",0,1,1,1,0,3,0,0,0,0,0,0,"H","N","2014-10-27","201410270EDM"
"MTL",0,0,0,0,0,0,0,1,1,1,0,3,"A","N","2014-10-27","201410270EDM"
"MIN",0,0,3,1,0,4,0,0,0,5,0,5,"A","N","2014-10-27","201410270NYR"
"NYR",0,0,0,5,0,5,0,0,3,1,0,4,"H","N","2014-10-27","201410270NYR"
"BOS",0,1,2,0,0,3,0,1,0,3,0,4,"H","N","2014-10-28","201410280BOS"
"MIN",0,1,0,3,0,4,0,1,2,0,0,3,"A","N","2014-10-28","201410280BOS"
"CBJ",0,1,1,0,0,2,0,1,1,3,0,5,"H","N","2014-10-28","201410280CBJ"
"OTT",0,1,1,3,0,5,0,1,1,0,0,2,"A","N","2014-10-28","201410280CBJ"
"CGY",0,0,1,0,0,1,0,0,1,0,1,2,"H","Y","2014-10-28","201410280CGY"
"MTL",0,0,1,0,1,2,0,0,1,0,0,1,"A","Y","2014-10-28","201410280CGY"
"ANA",0,0,0,1,0,1,0,0,0,0,0,0,"A","N","2014-10-28","201410280CHI"
"CHI",0,0,0,0,0,0,0,0,0,1,0,1,"H","N","2014-10-28","201410280CHI"
"COL",0,0,1,1,0,2,0,1,0,1,1,3,"H","Y","2014-10-28","201410280COL"
"SJS",0,1,0,1,1,3,0,0,1,1,0,2,"A","Y","2014-10-28","201410280COL"
"DAL",0,1,1,1,0,3,1,1,1,1,0,4,"H","N","2014-10-28","201410280DAL"
"STL",1,1,1,1,0,4,0,1,1,1,0,3,"A","N","2014-10-28","201410280DAL"
"NYI",0,1,2,0,0,3,0,0,3,1,0,4,"H","N","2014-10-28","201410280NYI"
"WPG",0,0,3,1,0,4,0,1,2,0,0,3,"A","N","2014-10-28","201410280NYI"
"LAK",0,1,0,1,0,2,1,2,0,0,0,3,"A","N","2014-10-28","201410280PHI"
"PHI",1,2,0,0,0,3,0,1,0,1,0,2,"H","N","2014-10-28","201410280PHI"
"NJD",0,1,2,0,0,3,0,1,4,3,0,8,"A","N","2014-10-28","201410280PIT"
"PIT",0,1,4,3,0,8,0,1,2,0,0,3,"H","N","2014-10-28","201410280PIT"
"ARI",0,0,2,1,0,3,0,2,2,3,0,7,"A","N","2014-10-28","201410280TBL"
"TBL",0,2,2,3,0,7,0,0,2,1,0,3,"H","N","2014-10-28","201410280TBL"
"BUF",0,0,0,0,0,0,0,0,1,3,0,4,"A","N","2014-10-28","201410280TOR"
"TOR",0,0,1,3,0,4,0,0,0,0,0,0,"H","N","2014-10-28","201410280TOR"
"CAR",0,0,0,1,0,1,0,1,2,1,0,4,"A","N","2014-10-28","201410280VAN"
"VAN",0,1,2,1,0,4,0,0,0,1,0,1,"H","N","2014-10-28","201410280VAN"
"EDM",0,0,0,1,0,1,0,0,2,2,0,4,"H","N","2014-10-29","201410290EDM"
"NSH",0,0,2,2,0,4,0,0,0,1,0,1,"A","N","2014-10-29","201410290EDM"
"DET",0,0,1,3,0,4,0,0,2,0,0,2,"A","N","2014-10-29","201410290WSH"
"WSH",0,0,2,0,0,2,0,0,1,3,0,4,"H","N","2014-10-29","201410290WSH"
"BOS",1,0,1,1,0,3,0,0,2,0,0,2,"A","N","2014-10-30","201410300BUF"
"BUF",0,0,2,0,0,2,1,0,1,1,0,3,"H","N","2014-10-30","201410300BUF"
"COL",0,1,3,1,0,5,0,0,0,0,0,0,"H","N","2014-10-30","201410300COL"
"NYI",0,0,0,0,0,0,0,1,3,1,0,5,"A","N","2014-10-30","201410300COL"
"ARI",0,1,0,0,0,1,0,0,1,1,0,2,"A","N","2014-10-30","201410300FLA"
"FLA",0,0,1,1,0,2,0,1,0,0,0,1,"H","N","2014-10-30","201410300FLA"
"MIN",0,0,1,2,1,4,0,1,1,1,0,3,"H","Y","2014-10-30","201410300MIN"
"SJS",0,1,1,1,0,3,0,0,1,2,1,4,"A","Y","2014-10-30","201410300MIN"
"NJD",0,0,0,1,1,2,0,1,0,0,0,1,"H","Y","2014-10-30","201410300NJD"
"WPG",0,1,0,0,0,1,0,0,0,1,1,2,"A","Y","2014-10-30","201410300NJD"
"CHI",0,2,0,2,1,5,0,1,1,2,0,4,"A","Y","2014-10-30","201410300OTT"
"OTT",0,1,1,2,0,4,0,2,0,2,1,5,"H","Y","2014-10-30","201410300OTT"
"LAK",0,0,0,0,0,0,0,2,0,1,0,3,"A","N","2014-10-30","201410300PIT"
"PIT",0,2,0,1,0,3,0,0,0,0,0,0,"H","N","2014-10-30","201410300PIT"
"ANA",0,0,0,0,0,0,0,1,0,1,0,2,"A","N","2014-10-30","201410300STL"
"STL",0,1,0,1,0,2,0,0,0,0,0,0,"H","N","2014-10-30","201410300STL"
"PHI",0,1,0,2,0,3,0,1,1,2,0,4,"A","N","2014-10-30","201410300TBL"
"TBL",0,1,1,2,0,4,0,1,0,2,0,3,"H","N","2014-10-30","201410300TBL"
"MTL",0,0,0,2,0,2,1,0,1,1,0,3,"A","N","2014-10-30","201410300VAN"
"VAN",1,0,1,1,0,3,0,0,0,2,0,2,"H","N","2014-10-30","201410300VAN"
"CBJ",0,0,0,1,0,1,0,1,1,2,0,4,"H","N","2014-10-31","201410310CBJ"
"TOR",0,1,1,2,0,4,0,0,0,1,0,1,"A","N","2014-10-31","201410310CBJ"
"CGY",0,0,1,3,0,4,0,0,2,1,0,3,"H","N","2014-10-31","201410310CGY"
"NSH",0,0,2,1,0,3,0,0,1,3,0,4,"A","N","2014-10-31","201410310CGY"
"ANA",1,0,1,0,0,2,0,0,0,1,0,1,"A","N","2014-10-31","201410310DAL"
"DAL",0,0,0,1,0,1,1,0,1,0,0,2,"H","N","2014-10-31","201410310DAL"
"DET",0,4,0,1,0,5,0,0,1,1,0,2,"H","N","2014-10-31","201410310DET"
"LAK",0,0,1,1,0,2,0,4,0,1,0,5,"A","N","2014-10-31","201410310DET"
"BOS",0,1,2,1,0,4,0,1,0,1,0,2,"H","N","2014-11-01","201411010BOS"
"OTT",0,1,0,1,0,2,0,1,2,1,0,4,"A","N","2014-11-01","201411010BOS"
"ARI",0,0,0,0,0,0,0,2,1,0,0,3,"A","N","2014-11-01","201411010CAR"
"CAR",0,2,1,0,0,3,0,0,0,0,0,0,"H","N","2014-11-01","201411010CAR"
"EDM",0,1,1,0,0,2,0,1,1,1,0,3,"H","N","2014-11-01","201411010EDM"
"VAN",0,1,1,1,0,3,0,1,1,0,0,2,"A","N","2014-11-01","201411010EDM"
"FLA",0,1,0,1,0,2,0,0,0,1,0,1,"H","N","2014-11-01","201411010FLA"
"PHI",0,0,0,1,0,1,0,1,0,1,0,2,"A","N","2014-11-01","201411010FLA"
"DAL",0,0,1,0,0,1,0,0,3,1,0,4,"A","N","2014-11-01","201411010MIN"
"MIN",0,0,3,1,0,4,0,0,1,0,0,1,"H","N","2014-11-01","201411010MIN"
"CBJ",0,1,1,0,0,2,0,0,1,2,0,3,"A","N","2014-11-01","201411010NJD"
"NJD",0,0,1,2,0,3,0,1,1,0,0,2,"H","N","2014-11-01","201411010NJD"
"NYR",0,0,0,0,0,0,0,0,0,0,1,1,"H","Y","2014-11-01","201411010NYR"
"WPG",0,0,0,0,1,1,0,0,0,0,0,0,"A","Y","2014-11-01","201411010NYR"
"BUF",0,0,0,0,0,0,0,1,2,2,0,5,"A","N","2014-11-01","201411010PIT"
"PIT",0,1,2,2,0,5,0,0,0,0,0,0,"H","N","2014-11-01","201411010PIT"
"NYI",0,1,0,0,0,1,0,1,0,2,0,3,"A","N","2014-11-01","201411010SJS"
"SJS",0,1,0,2,0,3,0,1,0,0,0,1,"H","N","2014-11-01","201411010SJS"
"COL",0,0,0,2,0,2,0,1,0,1,1,3,"A","Y","2014-11-01","201411010STL"
"STL",0,1,0,1,1,3,0,0,0,2,0,2,"H","Y","2014-11-01","201411010STL"
"TBL",0,1,2,1,0,4,0,1,2,0,0,3,"H","N","2014-11-01","201411010TBL"
"WSH",0,1,2,0,0,3,0,1,2,1,0,4,"A","N","2014-11-01","201411010TBL"
"CHI",0,1,1,0,0,2,0,1,1,1,0,3,"A","N","2014-11-01","201411010TOR"
"TOR",0,1,1,1,0,3,0,1,1,0,0,2,"H","N","2014-11-01","201411010TOR"
"BUF",0,0,1,1,1,3,0,0,1,1,0,2,"H","Y","2014-11-02","201411020BUF"
"DET",0,0,1,1,0,2,0,0,1,1,1,3,"A","Y","2014-11-02","201411020BUF"
"CAR",0,1,2,0,0,3,0,0,1,1,0,2,"H","N","2014-11-02","201411020CAR"
"LAK",0,0,1,1,0,2,0,1,2,0,0,3,"A","N","2014-11-02","201411020CAR"
"CHI",0,0,0,0,0,0,0,1,0,0,0,1,"H","N","2014-11-02","201411020CHI"
"WPG",0,1,0,0,0,1,0,0,0,0,0,0,"A","N","2014-11-02","201411020CHI"
"ANA",0,1,2,0,0,3,0,2,0,0,0,2,"A","N","2014-11-02","201411020COL"
"COL",0,2,0,0,0,2,0,1,2,0,0,3,"H","N","2014-11-02","201411020COL"
"CGY",0,2,1,3,0,6,0,0,0,2,0,2,"A","N","2014-11-02","201411020MTL"
"MTL",0,0,0,2,0,2,0,2,1,3,0,6,"H","N","2014-11-02","201411020MTL"
"NSH",0,0,1,2,0,3,0,1,0,0,0,1,"A","N","2014-11-02","201411020VAN"
"VAN",0,1,0,0,0,1,0,0,1,2,0,3,"H","N","2014-11-02","201411020VAN"
"ARI",0,1,2,3,0,6,0,3,0,2,0,5,"A","N","2014-11-02","201411020WSH"
"WSH",0,3,0,2,0,5,0,1,2,3,0,6,"H","N","2014-11-02","201411020WSH"
"NYR",0,1,0,2,0,3,0,0,1,2,1,4,"H","Y","2014-11-03","201411030NYR"
"STL",0,0,1,2,1,4,0,1,0,2,0,3,"A","Y","2014-11-03","201411030NYR"
"ARI",0,2,1,0,0,3,0,0,1,1,0,2,"H","N","2014-11-04","201411040ARI"
"TOR",0,0,1,1,0,2,0,2,1,0,0,3,"A","N","2014-11-04","201411040ARI"
"BOS",1,0,1,0,0,2,0,0,1,0,0,1,"H","N","2014-11-04","201411040BOS"
"FLA",0,0,1,0,0,1,1,0,1,0,0,2,"A","N","2014-11-04","201411040BOS"
"CAR",0,2,1,1,0,4,0,1,0,1,0,2,"A","N","2014-11-04","201411040CBJ"
"CBJ",0,1,0,1,0,2,0,2,1,1,0,4,"H","N","2014-11-04","201411040CBJ"
"COL",0,2,0,0,0,2,0,0,1,4,0,5,"H","N","2014-11-04","201411040COL"
"VAN",0,0,1,4,0,5,0,2,0,0,0,2,"A","N","2014-11-04","201411040COL"
"DAL",0,1,0,0,0,1,0,0,1,2,0,3,"H","N","2014-11-04","201411040DAL"
"LAK",0,0,1,2,0,3,0,1,0,0,0,1,"A","N","2014-11-04","201411040DAL"
"MIN",0,0,0,1,0,1,0,1,2,1,0,4,"H","N","2014-11-04","201411040MIN"
"PIT",0,1,2,1,0,4,0,0,0,1,0,1,"A","N","2014-11-04","201411040MIN"
"CHI",0,1,1,3,0,5,0,0,0,0,0,0,"A","N","2014-11-04","201411040MTL"
"MTL",0,0,0,0,0,0,0,1,1,3,0,5,"H","N","2014-11-04","201411040MTL"
"NJD",0,0,0,0,0,0,0,0,0,1,0,1,"H","N","2014-11-04","201411040NJD"
"STL",0,0,0,1,0,1,0,0,0,0,0,0,"A","N","2014-11-04","201411040NJD"
"DET",0,0,0,1,0,1,0,0,1,2,0,3,"A","N","2014-11-04","201411040OTT"
"OTT",0,0,1,2,0,3,0,0,0,1,0,1,"H","N","2014-11-04","201411040OTT"
"EDM",0,0,1,0,0,1,0,2,2,0,0,4,"A","N","2014-11-04","201411040PHI"
"PHI",0,2,2,0,0,4,0,0,1,0,0,1,"H","N","2014-11-04","201411040PHI"
"NSH",0,0,1,0,0,1,0,2,0,1,0,3,"A","N","2014-11-04","201411040WPG"
"WPG",0,2,0,1,0,3,0,0,1,0,0,1,"H","N","2014-11-04","201411040WPG"
"CGY",1,1,1,1,0,4,0,1,2,0,0,3,"A","N","2014-11-04","201411040WSH"
"WSH",0,1,2,0,0,3,1,1,1,1,0,4,"H","N","2014-11-04","201411040WSH"
"ANA",0,0,2,0,0,2,1,1,1,0,0,3,"H","N","2014-11-05","201411050ANA"
"NYI",1,1,1,0,0,3,0,0,2,0,0,2,"A","N","2014-11-05","201411050ANA"
"BUF",0,0,0,1,0,1,0,0,0,1,1,2,"H","Y","2014-11-05","201411050BUF"
"MTL",0,0,0,1,1,2,0,0,0,1,0,1,"A","Y","2014-11-05","201411050BUF"
"DET",0,0,2,1,0,3,1,1,1,1,0,4,"A","N","2014-11-05","201411050NYR"
"NYR",1,1,1,1,0,4,0,0,2,1,0,3,"H","N","2014-11-05","201411050NYR"
"BOS",0,1,0,4,0,5,0,1,0,1,0,2,"H","N","2014-11-06","201411060BOS"
"EDM",0,1,0,1,0,2,0,1,0,4,0,5,"A","N","2014-11-06","201411060BOS"
"COL",0,1,1,1,1,4,0,1,1,1,0,3,"H","Y","2014-11-06","201411060COL"
"TOR",0,1,1,1,0,3,0,1,1,1,1,4,"A","Y","2014-11-06","201411060COL"
"DAL",0,0,1,1,0,2,0,0,2,1,0,3,"H","N","2014-11-06","201411060DAL"
"NSH",0,0,2,1,0,3,0,0,1,1,0,2,"A","N","2014-11-06","201411060DAL"
"LAK",0,1,0,0,0,1,0,1,0,0,1,2,"H","Y","2014-11-06","201411060LAK"
"NYI",0,1,0,0,1,2,0,1,0,0,0,1,"A","Y","2014-11-06","201411060LAK"
"MIN",0,0,0,0,0,0,0,0,2,1,0,3,"A","N","2014-11-06","201411060OTT"
"OTT",0,0,2,1,0,3,0,0,0,0,0,0,"H","N","2014-11-06","201411060OTT"
"FLA",0,0,1,0,0,1,0,2,2,0,0,4,"A","N","2014-11-06","201411060PHI"
"PHI",0,2,2,0,0,4,0,0,1,0,0,1,"H","N","2014-11-06","201411060PHI"
"SJS",0,1,1,0,0,2,0,1,2,0,0,3,"H","N","2014-11-06","201411060SJS"
"VAN",0,1,2,0,0,3,0,1,1,0,0,2,"A","N","2014-11-06","201411060SJS"
"NJD",0,0,0,3,0,3,0,1,1,2,0,4,"A","N","2014-11-06","201411060STL"
"STL",0,1,1,2,0,4,0,0,0,3,0,3,"H","N","2014-11-06","201411060STL"
"CGY",0,1,1,0,0,2,0,1,2,2,0,5,"A","N","2014-11-06","201411060TBL"
"TBL",0,1,2,2,0,5,0,1,1,0,0,2,"H","N","2014-11-06","201411060TBL"
"PIT",0,1,2,0,1,4,0,1,1,1,0,3,"A","Y","2014-11-06","201411060WPG"
"WPG",0,1,1,1,0,3,0,1,2,0,1,4,"H","Y","2014-11-06","201411060WPG"
"ANA",0,2,0,0,0,2,0,0,2,0,1,3,"H","Y","2014-11-07","201411070ANA"
"ARI",0,0,2,0,1,3,0,2,0,0,0,2,"A","Y","2014-11-07","201411070ANA"
"BUF",0,0,1,1,0,2,0,0,1,2,0,3,"H","N","2014-11-07","201411070BUF"
"EDM",0,0,1,2,0,3,0,0,1,1,0,2,"A","N","2014-11-07","201411070BUF"
"CAR",1,0,1,1,0,3,0,0,2,0,0,2,"H","N","2014-11-07","201411070CAR"
"CBJ",0,0,2,0,0,2,1,0,1,1,0,3,"A","N","2014-11-07","201411070CAR"
"CHI",0,1,1,0,0,2,0,0,3,0,0,3,"H","N","2014-11-07","201411070CHI"
"WSH",0,0,3,0,0,3,0,1,1,0,0,2,"A","N","2014-11-07","201411070CHI"
"DET",0,2,2,0,0,4,0,1,0,1,0,2,"H","N","2014-11-07","201411070DET"
"NJD",0,1,0,1,0,2,0,2,2,0,0,4,"A","N","2014-11-07","201411070DET"
"ARI",0,0,0,0,0,0,0,0,0,1,0,1,"H","N","2014-11-08","201411080ARI"
"NYI",0,0,0,1,0,1,0,0,0,0,0,0,"A","N","2014-11-08","201411080ARI"
"BUF",0,0,1,0,0,1,0,3,3,0,0,6,"H","N","2014-11-08","201411080BUF"
"PIT",0,3,3,0,0,6,0,0,1,0,0,1,"A","N","2014-11-08","201411080BUF"
"CBJ",0,0,2,2,0,4,0,4,2,1,0,7,"H","N","2014-11-08","201411080CBJ"
"TBL",0,4,2,1,0,7,0,0,2,2,0,4,"A","N","2014-11-08","201411080CBJ"
"DAL",0,2,1,0,0,3,0,1,0,4,0,5,"H","N","2014-11-08","201411080DAL"
"SJS",0,1,0,4,0,5,0,2,1,0,0,3,"A","N","2014-11-08","201411080DAL"
"CGY",0,0,3,3,0,6,0,1,3,0,0,4,"A","N","2014-11-08","201411080FLA"
"FLA",0,1,3,0,0,4,0,0,3,3,0,6,"H","N","2014-11-08","201411080FLA"
"LAK",0,3,1,1,0,5,0,0,0,1,0,1,"H","N","2014-11-08","201411080LAK"
"VAN",0,0,0,1,0,1,0,3,1,1,0,5,"A","N","2014-11-08","201411080LAK"
"MIN",0,0,1,0,0,1,0,0,2,2,0,4,"A","N","2014-11-08","201411080MTL"
"MTL",0,0,2,2,0,4,0,0,1,0,0,1,"H","N","2014-11-08","201411080MTL"
"OTT",0,1,0,0,0,1,0,1,0,0,1,2,"H","Y","2014-11-08","201411080OTT"
"WPG",0,1,0,0,1,2,0,1,0,0,0,1,"A","Y","2014-11-08","201411080OTT"
"COL",0,0,0,3,0,3,0,1,3,0,0,4,"A","N","2014-11-08","201411080PHI"
"PHI",0,1,3,0,0,4,0,0,0,3,0,3,"H","N","2014-11-08","201411080PHI"
"NSH",0,0,1,1,0,2,0,1,0,0,0,1,"A","N","2014-11-08","201411080STL"
"STL",0,1,0,0,0,1,0,0,1,1,0,2,"H","N","2014-11-08","201411080STL"
"NYR",0,2,1,1,0,4,0,3,0,2,0,5,"A","N","2014-11-08","201411080TOR"
"TOR",0,3,0,2,0,5,0,2,1,1,0,4,"H","N","2014-11-08","201411080TOR"
"CAR",0,1,0,2,0,3,1,2,1,0,0,4,"A","N","2014-11-08","201411080WSH"
"WSH",1,2,1,0,0,4,0,1,0,2,0,3,"H","N","2014-11-08","201411080WSH"
"ANA",0,0,1,0,0,1,0,0,1,0,1,2,"H","Y","2014-11-09","201411090ANA"
"VAN",0,0,1,0,1,2,0,0,1,0,0,1,"A","Y","2014-11-09","201411090ANA"
"CHI",0,3,0,2,0,5,0,1,1,0,0,2,"H","N","2014-11-09","201411090CHI"
"SJS",0,1,1,0,0,2,0,3,0,2,0,5,"A","N","2014-11-09","201411090CHI"
"DET",0,1,1,1,0,3,0,1,2,0,1,4,"H","Y","2014-11-09","201411090DET"
"TBL",0,1,2,0,1,4,0,1,1,1,0,3,"A","Y","2014-11-09","201411090DET"
"EDM",0,1,1,1,0,3,0,1,0,0,0,1,"A","N","2014-11-09","201411090NYR"
"NYR",0,1,0,0,0,1,0,1,1,1,0,3,"H","N","2014-11-09","201411090NYR"
"OTT",0,2,1,0,0,3,0,1,3,1,0,5,"H","N","2014-11-09","201411090OTT"
"TOR",0,1,3,1,0,5,0,2,1,0,0,3,"A","N","2014-11-09","201411090OTT"
"BOS",0,2,2,0,0,4,0,1,1,0,0,2,"H","N","2014-11-10","201411100BOS"
"NJD",0,1,1,0,0,2,0,2,2,0,0,4,"A","N","2014-11-10","201411100BOS"
"CAR",0,1,2,1,0,4,0,1,0,0,0,1,"H","N","2014-11-10","201411100CAR"
"CGY",0,1,0,0,0,1,0,1,2,1,0,4,"A","N","2014-11-10","201411100CAR"
"ARI",0,1,1,1,0,3,0,0,2,2,0,4,"H","N","2014-11-11","201411110ARI"
"DAL",0,0,2,2,0,4,0,1,1,1,0,3,"A","N","2014-11-11","201411110ARI"
"CHI",0,0,1,1,1,3,0,1,0,1,0,2,"H","Y","2014-11-11","201411110CHI"
"TBL",0,1,0,1,0,2,0,0,1,1,1,3,"A","Y","2014-11-11","201411110CHI"
"FLA",0,2,1,1,0,4,0,0,0,1,0,1,"H","N","2014-11-11","201411110FLA"
"SJS",0,0,0,1,0,1,0,2,1,1,0,4,"A","N","2014-11-11","201411110FLA"
"MTL",0,0,1,2,0,3,0,0,0,0,0,0,"H","N","2014-11-11","201411110MTL"
"WPG",0,0,0,0,0,0,0,0,1,2,0,3,"A","N","2014-11-11","201411110MTL"
"MIN",0,0,0,1,0,1,0,0,2,1,0,3,"A","N","2014-11-11","201411110NJD"
"NJD",0,0,2,1,0,3,0,0,0,1,0,1,"H","N","2014-11-11","201411110NJD"
"EDM",0,0,2,0,0,2,0,3,0,0,0,3,"A","N","2014-11-11","201411110NSH"
"NSH",0,3,0,0,0,3,0,0,2,0,0,2,"H","N","2014-11-11","201411110NSH"
"COL",0,0,0,0,0,0,0,2,2,2,0,6,"A","N","2014-11-11","201411110NYI"
"NYI",0,2,2,2,0,6,0,0,0,0,0,0,"H","N","2014-11-11","201411110NYI"
"NYR",0,3,1,1,0,5,0,0,0,0,0,0,"H","N","2014-11-11","201411110NYR"
"PIT",0,0,0,0,0,0,0,3,1,1,0,5,"A","N","2014-11-11","201411110NYR"
"BUF",0,0,0,1,0,1,0,1,2,3,0,6,"A","N","2014-11-11","201411110STL"
"STL",0,1,2,3,0,6,0,0,0,1,0,1,"H","N","2014-11-11","201411110STL"
"OTT",0,0,2,1,0,3,1,0,2,1,0,4,"A","N","2014-11-11","201411110VAN"
"VAN",1,0,2,1,0,4,0,0,2,1,0,3,"H","N","2014-11-11","201411110VAN"
"CBJ",0,1,1,0,0,2,0,3,0,1,0,4,"A","N","2014-11-11","201411110WSH"
"WSH",0,3,0,1,0,4,0,1,1,0,0,2,"H","N","2014-11-11","201411110WSH"
"ANA",0,0,2,3,1,6,0,2,1,2,0,5,"H","Y","2014-11-12","201411120ANA"
"LAK",0,2,1,2,0,5,0,0,2,3,1,6,"A","Y","2014-11-12","201411120ANA"
"BOS",0,0,1,0,0,1,0,1,4,1,0,6,"A","N","2014-11-12","201411120TOR"
"TOR",0,1,4,1,0,6,0,0,1,0,0,1,"H","N","2014-11-12","201411120TOR"
"CAR",0,0,1,0,0,1,0,1,1,1,0,3,"H","N","2014-11-13","201411130CAR"
"WPG",0,1,1,1,0,3,0,0,1,0,0,1,"A","N","2014-11-13","201411130CAR"
"ARI",0,1,2,0,0,3,0,1,3,1,0,5,"A","N","2014-11-13","201411130CGY"
"CGY",0,1,3,1,0,5,0,1,2,0,0,3,"H","N","2014-11-13","201411130CGY"
"EDM",0,0,1,2,0,3,1,3,0,0,0,4,"H","N","2014-11-13","201411130EDM"
"OTT",1,3,0,0,0,4,0,0,1,2,0,3,"A","N","2014-11-13","201411130EDM"
"DAL",0,1,1,0,0,2,0,0,0,0,0,0,"A","N","2014-11-13","201411130LAK"
"LAK",0,0,0,0,0,0,0,1,1,0,0,2,"H","N","2014-11-13","201411130LAK"
"BUF",0,2,0,1,0,3,0,4,1,1,0,6,"A","N","2014-11-13","201411130MIN"
"MIN",0,4,1,1,0,6,0,2,0,1,0,3,"H","N","2014-11-13","201411130MIN"
"BOS",0,1,0,0,0,1,0,0,3,2,0,5,"A","N","2014-11-13","201411130MTL"
"MTL",0,0,3,2,0,5,0,1,0,0,0,1,"H","N","2014-11-13","201411130MTL"
"COL",0,1,1,1,1,4,0,0,3,0,0,3,"A","Y","2014-11-13","201411130NYR"
"NYR",0,0,3,0,0,3,0,1,1,1,1,4,"H","Y","2014-11-13","201411130NYR"
"NSH",0,1,2,0,0,3,0,2,1,1,0,4,"A","N","2014-11-13","201411130STL"
"STL",0,2,1,1,0,4,0,1,2,0,0,3,"H","N","2014-11-13","201411130STL"
"SJS",0,0,2,0,0,2,0,0,0,1,0,1,"A","N","2014-11-13","201411130TBL"
"TBL",0,0,0,1,0,1,0,0,2,0,0,2,"H","N","2014-11-13","201411130TBL"
"CHI",0,1,0,0,0,1,0,1,2,1,0,4,"A","N","2014-11-14","201411140DET"
"DET",0,1,2,1,0,4,0,1,0,0,0,1,"H","N","2014-11-14","201411140DET"
"FLA",0,1,0,2,0,3,0,0,2,1,1,4,"H","Y","2014-11-14","201411140FLA"
"NYI",0,0,2,1,1,4,0,1,0,2,0,3,"A","Y","2014-11-14","201411140FLA"
"CBJ",0,2,2,0,0,4,0,1,1,1,0,3,"A","N","2014-11-14","201411140PHI"
"PHI",0,1,1,1,0,3,0,2,2,0,0,4,"H","N","2014-11-14","201411140PHI"
"PIT",0,0,1,1,0,2,0,0,0,1,0,1,"A","N","2014-11-14","201411140TOR"
"TOR",0,0,0,1,0,1,0,0,1,1,0,2,"H","N","2014-11-14","201411140TOR"
"ARI",0,1,3,1,0,5,0,0,0,0,0,0,"A","N","2014-11-14","201411140VAN"
"VAN",0,0,0,0,0,0,0,1,3,1,0,5,"H","N","2014-11-14","201411140VAN"
"NJD",0,0,0,1,0,1,0,0,0,0,0,0,"A","N","2014-11-14","201411140WSH"
"WSH",0,0,0,0,0,0,0,0,0,1,0,1,"H","N","2014-11-14","201411140WSH"
"BOS",0,2,0,0,0,2,0,1,0,0,0,1,"H","N","2014-11-15","201411150BOS"
"CAR",0,1,0,0,0,1,0,2,0,0,0,2,"A","N","2014-11-15","201411150BOS"
"BUF",0,2,2,2,0,6,0,0,2,0,0,2,"H","N","2014-11-15","201411150BUF"
"TOR",0,0,2,0,0,2,0,2,2,2,0,6,"A","N","2014-11-15","201411150BUF"
"CBJ",0,1,1,0,0,2,0,0,1,0,0,1,"H","N","2014-11-15","201411150CBJ"
"SJS",0,0,1,0,0,1,0,1,1,0,0,2,"A","N","2014-11-15","201411150CBJ"
"CGY",0,0,1,3,0,4,0,1,0,1,0,2,"H","N","2014-11-15","201411150CGY"
"OTT",0,1,0,1,0,2,0,0,1,3,0,4,"A","N","2014-11-15","201411150CGY"
"DAL",0,0,1,0,0,1,0,0,1,1,0,2,"H","N","2014-11-15","201411150DAL"
"MIN",0,0,1,1,0,2,0,0,1,0,0,1,"A","N","2014-11-15","201411150DAL"
"ANA",0,0,2,0,0,2,1,0,1,1,0,3,"A","N","2014-11-15","201411150LAK"
"LAK",1,0,1,1,0,3,0,0,2,0,0,2,"H","N","2014-11-15","201411150LAK"
"MTL",0,2,1,3,0,6,0,0,2,1,0,3,"H","N","2014-11-15","201411150MTL"
"PHI",0,0,2,1,0,3,0,2,1,3,0,6,"A","N","2014-11-15","201411150MTL"
"COL",0,1,0,2,0,3,0,1,0,1,0,2,"A","N","2014-11-15","201411150NJD"
"NJD",0,1,0,1,0,2,0,1,0,2,0,3,"H","N","2014-11-15","201411150NJD"
"NSH",0,0,1,1,0,2,0,0,1,0,0,1,"H","N","2014-11-15","201411150NSH"
"WPG",0,0,1,0,0,1,0,0,1,1,0,2,"A","N","2014-11-15","201411150NSH"
"NYR",0,2,0,0,0,2,0,1,1,0,1,3,"A","Y","2014-11-15","201411150PIT"
"PIT",0,1,1,0,1,3,0,2,0,0,0,2,"H","Y","2014-11-15","201411150PIT"
"STL",0,1,1,2,0,4,0,0,1,0,0,1,"H","N","2014-11-15","201411150STL"
"WSH",0,0,1,0,0,1,0,1,1,2,0,4,"A","N","2014-11-15","201411150STL"
"NYI",0,2,0,0,0,2,0,3,1,1,0,5,"A","N","2014-11-15","201411150TBL"
"TBL",0,3,1,1,0,5,0,2,0,0,0,2,"H","N","2014-11-15","201411150TBL"
"ANA",0,1,0,1,0,2,0,1,4,1,0,6,"H","N","2014-11-16","201411160ANA"
"FLA",0,1,4,1,0,6,0,1,0,1,0,2,"A","N","2014-11-16","201411160ANA"
"CAR",0,0,0,0,0,0,0,1,0,1,0,2,"H","N","2014-11-16","201411160CAR"
"SJS",0,1,0,1,0,2,0,0,0,0,0,0,"A","N","2014-11-16","201411160CAR"
"CHI",0,2,0,4,0,6,0,2,0,0,0,2,"H","N","2014-11-16","201411160CHI"
"DAL",0,2,0,0,0,2,0,2,0,4,0,6,"A","N","2014-11-16","201411160CHI"
"DET",0,0,0,1,0,1,0,0,2,2,0,4,"H","N","2014-11-16","201411160DET"
"MTL",0,0,2,2,0,4,0,0,0,1,0,1,"A","N","2014-11-16","201411160DET"
"ARI",0,1,0,1,0,2,0,0,0,1,0,1,"A","N","2014-11-16","201411160EDM"
"EDM",0,0,0,1,0,1,0,1,0,1,0,2,"H","N","2014-11-16","201411160EDM"
"MIN",1,3,0,0,0,4,0,0,0,3,0,3,"H","N","2014-11-16","201411160MIN"
"WPG",0,0,0,3,0,3,1,3,0,0,0,4,"A","N","2014-11-16","201411160MIN"
"NYR",0,0,1,0,0,1,0,2,2,1,0,5,"H","N","2014-11-17","201411170NYR"
"TBL",0,2,2,1,0,5,0,0,1,0,0,1,"A","N","2014-11-17","201411170NYR"
"ARI",0,0,1,0,0,1,1,1,0,0,0,2,"H","N","2014-11-18","201411180ARI"
"WSH",1,1,0,0,0,2,0,0,1,0,0,1,"A","N","2014-11-18","201411180ARI"
"BOS",0,1,1,0,0,2,0,0,0,0,0,0,"H","N","2014-11-18","201411180BOS"
"STL",0,0,0,0,0,0,0,1,1,0,0,2,"A","N","2014-11-18","201411180BOS"
"BUF",0,0,3,1,0,4,0,0,1,0,0,1,"H","N","2014-11-18","201411180BUF"
"SJS",0,0,1,0,0,1,0,0,3,1,0,4,"A","N","2014-11-18","201411180BUF"
"CBJ",0,0,0,0,0,0,0,1,1,3,0,5,"H","N","2014-11-18","201411180CBJ"
"DET",0,1,1,3,0,5,0,0,0,0,0,0,"A","N","2014-11-18","201411180CBJ"
"ANA",0,1,1,1,0,3,0,0,0,3,1,4,"A","Y","2014-11-18","201411180CGY"
"CGY",0,0,0,3,1,4,0,1,1,1,0,3,"H","Y","2014-11-18","201411180CGY"
"CAR",0,0,4,2,0,6,0,2,0,2,0,4,"A","N","2014-11-18","201411180DAL"
"DAL",0,2,0,2,0,4,0,0,4,2,0,6,"H","N","2014-11-18","201411180DAL"
"FLA",0,0,0,2,0,2,0,0,4,1,0,5,"A","N","2014-11-18","201411180LAK"
"LAK",0,0,4,1,0,5,0,0,0,2,0,2,"H","N","2014-11-18","201411180LAK"
"MTL",0,0,0,0,0,0,0,2,2,0,0,4,"H","N","2014-11-18","201411180MTL"
"PIT",0,2,2,0,0,4,0,0,0,0,0,0,"A","N","2014-11-18","201411180MTL"
"NYI",0,0,3,2,0,5,0,1,0,1,0,2,"H","N","2014-11-18","201411180NYI"
"TBL",0,1,0,1,0,2,0,0,3,2,0,5,"A","N","2014-11-18","201411180NYI"
"NSH",0,3,1,5,0,9,0,0,0,2,0,2,"A","N","2014-11-18","201411180TOR"
"TOR",0,0,0,2,0,2,0,3,1,5,0,9,"H","N","2014-11-18","201411180TOR"
"NJD",0,0,0,1,0,1,0,0,2,1,0,3,"A","N","2014-11-18","201411180WPG"
"WPG",0,0,2,1,0,3,0,0,0,1,0,1,"H","N","2014-11-18","201411180WPG"
"EDM",0,0,3,1,0,4,0,1,3,1,0,5,"H","N","2014-11-19","201411190EDM"
"VAN",0,1,3,1,0,5,0,0,3,1,0,4,"A","N","2014-11-19","201411190EDM"
"NYR",0,1,1,0,0,2,0,0,0,0,0,0,"H","N","2014-11-19","201411190NYR"
"PHI",0,0,0,0,0,0,0,1,1,0,0,2,"A","N","2014-11-19","201411190NYR"
"CGY",0,2,1,0,0,3,0,2,1,1,0,4,"H","N","2014-11-20","201411200CGY"
"CHI",0,2,1,1,0,4,0,2,1,0,0,3,"A","N","2014-11-20","201411200CGY"
"COL",0,0,1,1,0,2,0,0,2,1,0,3,"H","N","2014-11-20","201411200COL"
"WSH",0,0,2,1,0,3,0,0,1,1,0,2,"A","N","2014-11-20","201411200COL"
"ARI",0,1,0,0,0,1,0,0,0,3,0,3,"A","N","2014-11-20","201411200DAL"
"DAL",0,0,0,3,0,3,0,1,0,0,0,1,"H","N","2014-11-20","201411200DAL"
"CAR",0,1,1,0,0,2,0,1,2,0,0,3,"A","N","2014-11-20","201411200LAK"
"LAK",0,1,2,0,0,3,0,1,1,0,0,2,"H","N","2014-11-20","201411200LAK"
"MTL",0,0,2,2,0,4,0,1,0,0,0,1,"H","N","2014-11-20","201411200MTL"
"STL",0,1,0,0,0,1,0,0,2,2,0,4,"A","N","2014-11-20","201411200MTL"
"NSH",0,1,0,1,0,2,0,0,3,0,0,3,"A","N","2014-11-20","201411200OTT"
"OTT",0,0,3,0,0,3,0,1,0,1,0,2,"H","N","2014-11-20","201411200OTT"
"MIN",0,0,1,2,0,3,0,0,1,1,0,2,"A","N","2014-11-20","201411200PHI"
"PHI",0,0,1,1,0,2,0,0,1,2,0,3,"H","N","2014-11-20","201411200PHI"
"FLA",0,1,1,0,1,3,0,0,1,1,0,2,"A","Y","2014-11-20","201411200SJS"
"SJS",0,0,1,1,0,2,0,1,1,0,1,3,"H","Y","2014-11-20","201411200SJS"
"TBL",0,1,0,1,0,2,0,1,3,1,0,5,"A","N","2014-11-20","201411200TOR"
"TOR",0,1,3,1,0,5,0,1,0,1,0,2,"H","N","2014-11-20","201411200TOR"
"ANA",0,2,0,1,1,4,0,0,3,0,0,3,"A","Y","2014-11-20","201411200VAN"
"VAN",0,0,3,0,0,3,0,2,0,1,1,4,"H","Y","2014-11-20","201411200VAN"
"DET",0,0,2,2,0,4,0,0,3,0,0,3,"A","N","2014-11-20","201411200WPG"
"WPG",0,0,3,0,0,3,0,0,2,2,0,4,"H","N","2014-11-20","201411200WPG"
"BOS",0,0,0,3,1,4,0,2,0,1,0,3,"A","Y","2014-11-21","201411210CBJ"
"CBJ",0,2,0,1,0,3,0,0,0,3,1,4,"H","Y","2014-11-21","201411210CBJ"
"EDM",0,0,0,0,0,0,0,0,2,0,0,2,"H","N","2014-11-21","201411210EDM"
"NJD",0,0,2,0,0,2,0,0,0,0,0,0,"A","N","2014-11-21","201411210EDM"
"NYI",0,3,1,0,1,5,0,2,1,1,0,4,"A","Y","2014-11-21","201411210PIT"
"PIT",0,2,1,1,0,4,0,3,1,0,1,5,"H","Y","2014-11-21","201411210PIT"
"BOS",0,0,0,0,0,0,0,1,1,0,0,2,"H","N","2014-11-22","201411220BOS"
"MTL",0,1,1,0,0,2,0,0,0,0,0,0,"A","N","2014-11-22","201411220BOS"
"CGY",0,0,1,3,1,5,0,2,1,1,0,4,"H","Y","2014-11-22","201411220CGY"
"NJD",0,2,1,1,0,4,0,0,1,3,1,5,"A","Y","2014-11-22","201411220CGY"
"CAR",0,3,0,0,0,3,0,1,1,2,0,4,"A","N","2014-11-22","201411220COL"
"COL",0,1,1,2,0,4,0,3,0,0,0,3,"H","N","2014-11-22","201411220COL"
"DAL",0,3,2,0,0,5,0,0,3,1,0,4,"H","N","2014-11-22","201411220DAL"
"LAK",0,0,3,1,0,4,0,3,2,0,0,5,"A","N","2014-11-22","201411220DAL"
"CHI",0,3,3,1,0,7,0,0,0,1,0,1,"A","N","2014-11-22","201411220EDM"
"EDM",0,0,0,1,0,1,0,3,3,1,0,7,"H","N","2014-11-22","201411220EDM"
"FLA",0,0,0,2,0,2,0,0,1,1,1,3,"A","Y","2014-11-22","201411220NSH"
"NSH",0,0,1,1,1,3,0,0,0,2,0,2,"H","Y","2014-11-22","201411220NSH"
"NYI",0,0,1,3,0,4,0,1,0,0,0,1,"H","N","2014-11-22","201411220NYI"
"PIT",0,1,0,0,0,1,0,0,1,3,0,4,"A","N","2014-11-22","201411220NYI"
"OTT",0,1,1,0,0,2,0,2,1,0,0,3,"H","N","2014-11-22","201411220OTT"
"STL",0,2,1,0,0,3,0,1,1,0,0,2,"A","N","2014-11-22","201411220OTT"
"CBJ",0,1,0,1,0,2,0,2,1,1,0,4,"A","N","2014-11-22","201411220PHI"
"PHI",0,2,1,1,0,4,0,1,0,1,0,2,"H","N","2014-11-22","201411220PHI"
"ARI",0,2,0,1,1,4,0,0,2,1,0,3,"A","Y","2014-11-22","201411220SJS"
"SJS",0,0,2,1,0,3,0,2,0,1,1,4,"H","Y","2014-11-22","201411220SJS"
"MIN",0,0,1,0,0,1,0,0,2,0,0,2,"A","N","2014-11-22","201411220TBL"
"TBL",0,0,2,0,0,2,0,0,1,0,0,1,"H","N","2014-11-22","201411220TBL"
"DET",0,0,1,0,0,1,0,1,0,3,0,4,"A","N","2014-11-22","201411220TOR"
"TOR",0,1,0,3,0,4,0,0,1,0,0,1,"H","N","2014-11-22","201411220TOR"
"BUF",0,0,1,1,0,2,0,0,0,1,0,1,"A","N","2014-11-22","201411220WSH"
"WSH",0,0,0,1,0,1,0,0,1,1,0,2,"H","N","2014-11-22","201411220WSH"
"ANA",0,0,2,0,0,2,0,0,0,1,0,1,"H","N","2014-11-23","201411230ANA"
"ARI",0,0,0,1,0,1,0,0,2,0,0,2,"A","N","2014-11-23","201411230ANA"
"MTL",0,0,0,0,0,0,0,1,2,2,0,5,"A","N","2014-11-23","201411230NYR"
"NYR",0,1,2,2,0,5,0,0,0,0,0,0,"H","N","2014-11-23","201411230NYR"
"CHI",0,0,1,0,0,1,0,1,0,3,0,4,"A","N","2014-11-23","201411230VAN"
"VAN",0,1,0,3,0,4,0,0,1,0,0,1,"H","N","2014-11-23","201411230VAN"
"STL",0,0,2,2,0,4,0,1,1,0,0,2,"A","N","2014-11-23","201411230WPG"
"WPG",0,1,1,0,0,2,0,0,2,2,0,4,"H","N","2014-11-23","201411230WPG"
"BOS",0,0,2,0,0,2,1,1,1,0,0,3,"H","N","2014-11-24","201411240BOS"
"PIT",1,1,1,0,0,3,0,0,2,0,0,2,"A","N","2014-11-24","201411240BOS"
"DET",0,1,3,0,0,4,0,1,0,2,0,3,"H","N","2014-11-24","201411240DET"
"OTT",0,1,0,2,0,3,0,1,3,0,0,4,"A","N","2014-11-24","201411240DET"
"FLA",0,0,1,0,0,1,0,2,1,1,0,4,"H","N","2014-11-24","201411240FLA"
"MIN",0,2,1,1,0,4,0,0,1,0,0,1,"A","N","2014-11-24","201411240FLA"
"NYI",0,0,0,0,1,1,0,0,0,0,0,0,"H","Y","2014-11-24","201411240NYI"
"PHI",0,0,0,0,0,0,0,0,0,0,1,1,"A","Y","2014-11-24","201411240NYI"
"ANA",0,1,2,0,0,3,0,0,0,2,0,2,"H","N","2014-11-25","201411250ANA"
"CGY",0,0,0,2,0,2,0,1,2,0,0,3,"A","N","2014-11-25","201411250ANA"
"ARI",0,3,0,0,0,3,1,0,1,2,0,4,"H","N","2014-11-25","201411250ARI"
"COL",1,0,1,2,0,4,0,3,0,0,0,3,"A","N","2014-11-25","201411250ARI"
"CBJ",0,1,0,1,0,2,0,1,2,1,0,4,"H","N","2014-11-25","201411250CBJ"
"WPG",0,1,2,1,0,4,0,1,0,1,0,2,"A","N","2014-11-25","201411250CBJ"
"DAL",0,1,2,0,0,3,0,1,0,1,0,2,"H","N","2014-11-25","201411250DAL"
"EDM",0,1,0,1,0,2,0,1,2,0,0,3,"A","N","2014-11-25","201411250DAL"
"LAK",0,1,1,1,0,3,0,1,2,0,1,4,"A","Y","2014-11-25","201411250NSH"
"NSH",0,1,2,0,1,4,0,1,1,1,0,3,"H","Y","2014-11-25","201411250NSH"
"OTT",0,0,0,2,1,3,0,1,1,0,0,2,"A","Y","2014-11-25","201411250STL"
"STL",0,1,1,0,0,2,0,0,0,2,1,3,"H","Y","2014-11-25","201411250STL"
"NJD",0,0,0,0,0,0,0,0,1,1,0,2,"A","N","2014-11-25","201411250VAN"
"VAN",0,0,1,1,0,2,0,0,0,0,0,0,"H","N","2014-11-25","201411250VAN"
"BUF",0,0,0,1,0,1,0,1,1,0,0,2,"H","N","2014-11-26","201411260BUF"
"WPG",0,1,1,0,0,2,0,0,0,1,0,1,"A","N","2014-11-26","201411260BUF"
"CHI",0,0,2,1,0,3,0,0,1,1,0,2,"A","N","2014-11-26","201411260COL"
"COL",0,0,1,1,0,2,0,0,2,1,0,3,"H","N","2014-11-26","201411260COL"
"DET",0,1,3,1,0,5,0,0,1,1,0,2,"H","N","2014-11-26","201411260DET"
"PHI",0,0,1,1,0,2,0,1,3,1,0,5,"A","N","2014-11-26","201411260DET"
"CAR",0,0,0,0,0,0,0,1,0,0,0,1,"A","N","2014-11-26","201411260FLA"
"FLA",0,1,0,0,0,1,0,0,0,0,0,0,"H","N","2014-11-26","201411260FLA"
"LAK",0,4,0,0,0,4,0,0,0,0,0,0,"A","N","2014-11-26","201411260MIN"
"MIN",0,0,0,0,0,0,0,4,0,0,0,4,"H","N","2014-11-26","201411260MIN"
"NYI",1,2,0,0,0,3,0,1,1,0,0,2,"H","N","2014-11-26","201411260NYI"
"WSH",0,1,1,0,0,2,1,2,0,0,0,3,"A","N","2014-11-26","201411260NYI"
"PIT",1,2,1,0,0,4,0,0,3,0,0,3,"H","N","2014-11-26","201411260PIT"
"TOR",0,0,3,0,0,3,1,2,1,0,0,4,"A","N","2014-11-26","201411260PIT"
"CGY",0,0,1,1,0,2,0,0,0,0,0,0,"A","N","2014-11-26","201411260SJS"
"SJS",0,0,0,0,0,0,0,0,1,1,0,2,"H","N","2014-11-26","201411260SJS"
"NYR",0,2,0,1,0,3,0,2,1,1,0,4,"A","N","2014-11-26","201411260TBL"
"TBL",0,2,1,1,0,4,0,2,0,1,0,3,"H","N","2014-11-26","201411260TBL"
"EDM",0,0,0,0,0,0,1,0,0,0,0,1,"A","N","2014-11-27","201411270NSH"
"NSH",1,0,0,0,0,1,0,0,0,0,0,0,"H","N","2014-11-27","201411270NSH"
"ANA",0,1,0,0,0,1,0,2,1,1,0,4,"H","N","2014-11-28","201411280ANA"
"CHI",0,2,1,1,0,4,0,1,0,0,0,1,"A","N","2014-11-28","201411280ANA"
"BOS",1,0,0,1,0,2,0,1,0,0,0,1,"H","N","2014-11-28","201411280BOS"
"WPG",0,1,0,0,0,1,1,0,0,1,0,2,"A","N","2014-11-28","201411280BOS"
"BUF",0,1,0,1,0,2,0,0,0,1,0,1,"H","N","2014-11-28","201411280BUF"
"MTL",0,0,0,1,0,1,0,1,0,1,0,2,"A","N","2014-11-28","201411280BUF"
"CBJ",0,0,0,0,0,0,0,0,1,4,0,5,"H","N","2014-11-28","201411280CBJ"
"VAN",0,0,1,4,0,5,0,0,0,0,0,0,"A","N","2014-11-28","201411280CBJ"
"DAL",0,0,3,1,0,4,1,2,1,1,0,5,"H","N","2014-11-28","201411280DAL"
"MIN",1,2,1,1,0,5,0,0,3,1,0,4,"A","N","2014-11-28","201411280DAL"
"FLA",0,1,0,2,0,3,0,1,1,0,0,2,"H","N","2014-11-28","201411280FLA"
"OTT",0,1,1,0,0,2,0,1,0,2,0,3,"A","N","2014-11-28","201411280FLA"
"DET",0,1,2,1,1,5,0,3,1,0,0,4,"A","Y","2014-11-28","201411280NJD"
"NJD",0,3,1,0,0,4,0,1,2,1,1,5,"H","Y","2014-11-28","201411280NJD"
"NYR",0,1,1,1,0,3,0,0,0,0,0,0,"A","N","2014-11-28","201411280PHI"
"PHI",0,0,0,0,0,0,0,1,1,1,0,3,"H","N","2014-11-28","201411280PHI"
"CAR",0,1,1,2,0,4,0,1,1,0,0,2,"A","N","2014-11-28","201411280PIT"
"PIT",0,1,1,0,0,2,0,1,1,2,0,4,"H","N","2014-11-28","201411280PIT"
"EDM",0,0,2,1,0,3,1,1,0,2,0,4,"A","N","2014-11-28","201411280STL"
"STL",1,1,0,2,0,4,0,0,2,1,0,3,"H","N","2014-11-28","201411280STL"
"NYI",0,2,0,0,0,2,0,2,1,2,0,5,"A","N","2014-11-28","201411280WSH"
"WSH",0,2,1,2,0,5,0,2,0,0,0,2,"H","N","2014-11-28","201411280WSH"
"ARI",0,0,0,0,0,0,0,0,1,2,0,3,"H","N","2014-11-29","201411290ARI"
"CGY",0,0,1,2,0,3,0,0,0,0,0,0,"A","N","2014-11-29","201411290ARI"
"CAR",0,1,0,1,0,2,0,2,0,1,0,3,"H","N","2014-11-29","201411290CAR"
"PIT",0,2,0,1,0,3,0,1,0,1,0,2,"A","N","2014-11-29","201411290CAR"
"COL",0,2,1,2,0,5,0,2,0,0,0,2,"H","N","2014-11-29","201411290COL"
"DAL",0,2,0,0,0,2,0,2,1,2,0,5,"A","N","2014-11-29","201411290COL"
"CHI",0,2,1,1,0,4,0,0,1,0,0,1,"A","N","2014-11-29","201411290LAK"
"LAK",0,0,1,0,0,1,0,2,1,1,0,4,"H","N","2014-11-29","201411290LAK"
"MIN",0,0,2,0,0,2,0,0,1,1,1,3,"H","Y","2014-11-29","201411290MIN"
"STL",0,0,1,1,1,3,0,0,2,0,0,2,"A","Y","2014-11-29","201411290MIN"
"BUF",0,1,0,2,1,4,0,0,1,2,0,3,"A","Y","2014-11-29","201411290MTL"
"MTL",0,0,1,2,0,3,0,1,0,2,1,4,"H","Y","2014-11-29","201411290MTL"
"CBJ",0,0,0,1,0,1,0,0,1,1,0,2,"A","N","2014-11-29","201411290NSH"
"NSH",0,0,1,1,0,2,0,0,0,1,0,1,"H","N","2014-11-29","201411290NSH"
"NJD",0,1,0,0,0,1,0,1,1,1,0,3,"A","N","2014-11-29","201411290NYI"
"NYI",0,1,1,1,0,3,0,1,0,0,0,1,"H","N","2014-11-29","201411290NYI"
"NYR",0,1,1,3,0,5,0,1,1,0,0,2,"H","N","2014-11-29","201411290NYR"
"PHI",0,1,1,0,0,2,0,1,1,3,0,5,"A","N","2014-11-29","201411290NYR"
"ANA",0,1,1,2,0,4,0,3,2,1,0,6,"A","N","2014-11-29","201411290SJS"
"SJS",0,3,2,1,0,6,0,1,1,2,0,4,"H","N","2014-11-29","201411290SJS"
"OTT",0,1,0,0,0,1,0,0,1,3,0,4,"A","N","2014-11-29","201411290TBL"
"TBL",0,0,1,3,0,4,0,1,0,0,0,1,"H","N","2014-11-29","201411290TBL"
"TOR",0,2,3,1,0,6,0,0,1,1,0,2,"H","N","2014-11-29","201411290TOR"
"WSH",0,0,1,1,0,2,0,2,3,1,0,6,"A","N","2014-11-29","201411290TOR"
"DET",0,2,1,2,0,5,0,0,1,2,0,3,"H","N","2014-11-30","201411300DET"
"VAN",0,0,1,2,0,3,0,2,1,2,0,5,"A","N","2014-11-30","201411300DET"
"ANA",0,0,2,1,0,3,0,0,1,1,0,2,"H","N","2014-12-01","201412010ANA"
"BOS",0,0,1,1,0,2,0,0,2,1,0,3,"A","N","2014-12-01","201412010ANA"
"CBJ",0,1,0,1,0,2,0,0,1,0,0,1,"H","N","2014-12-01","201412010CBJ"
"FLA",0,0,1,0,0,1,0,1,0,1,0,2,"A","N","2014-12-01","201412010CBJ"
"COL",0,1,2,0,0,3,0,1,2,1,0,4,"H","N","2014-12-01","201412010COL"
"MTL",0,1,2,1,0,4,0,1,2,0,0,3,"A","N","2014-12-01","201412010COL"
"ARI",0,0,4,1,0,5,0,1,0,1,0,2,"A","N","2014-12-01","201412010EDM"
"EDM",0,1,0,1,0,2,0,0,4,1,0,5,"H","N","2014-12-01","201412010EDM"
"NYR",0,1,2,0,0,3,0,2,1,3,0,6,"H","N","2014-12-01","201412010NYR"
"TBL",0,2,1,3,0,6,0,1,2,0,0,3,"A","N","2014-12-01","201412010NYR"
"BUF",0,0,0,1,1,2,0,0,0,1,0,1,"H","Y","2014-12-02","201412020BUF"
"TBL",0,0,0,1,0,1,0,0,0,1,1,2,"A","Y","2014-12-02","201412020BUF"
"CAR",0,1,0,1,0,2,0,0,0,1,0,1,"H","N","2014-12-02","201412020CAR"
"NSH",0,0,0,1,0,1,0,1,0,1,0,2,"A","N","2014-12-02","201412020CAR"
"ARI",0,1,1,0,0,2,0,2,1,2,0,5,"A","N","2014-12-02","201412020CGY"
"CGY",0,2,1,2,0,5,0,1,1,0,0,2,"H","N","2014-12-02","201412020CGY"
"DET",0,1,0,2,0,3,0,1,1,2,0,4,"H","N","2014-12-02","201412020DET"
"FLA",0,1,1,2,0,4,0,1,0,2,0,3,"A","N","2014-12-02","201412020DET"
"BOS",0,0,0,0,0,0,0,1,0,1,0,2,"A","N","2014-12-02","201412020LAK"
"LAK",0,1,0,1,0,2,0,0,0,0,0,0,"H","N","2014-12-02","201412020LAK"
"NYI",1,0,1,1,0,3,0,1,0,1,0,2,"H","N","2014-12-02","201412020NYI"
"OTT",0,1,0,1,0,2,1,0,1,1,0,3,"A","N","2014-12-02","201412020NYI"
"NJD",0,0,0,0,0,0,0,0,0,1,0,1,"A","N","2014-12-02","201412020PIT"
"PIT",0,0,0,1,0,1,0,0,0,0,0,0,"H","N","2014-12-02","201412020PIT"
"PHI",0,1,0,0,0,1,0,0,1,1,0,2,"A","N","2014-12-02","201412020SJS"
"SJS",0,0,1,1,0,2,0,1,0,0,0,1,"H","N","2014-12-02","201412020SJS"
"DAL",0,0,1,2,0,3,0,2,2,1,0,5,"A","N","2014-12-02","201412020TOR"
"TOR",0,2,2,1,0,5,0,0,1,2,0,3,"H","N","2014-12-02","201412020TOR"
"VAN",0,1,2,1,0,4,0,0,2,1,0,3,"A","N","2014-12-02","201412020WSH"
"WSH",0,0,2,1,0,3,0,1,2,1,0,4,"H","N","2014-12-02","201412020WSH"
"ANA",0,0,3,1,1,5,0,0,3,1,0,4,"H","Y","2014-12-03","201412030ANA"
"PHI",0,0,3,1,0,4,0,0,3,1,1,5,"A","Y","2014-12-03","201412030ANA"
"CHI",0,1,0,3,0,4,0,0,1,0,0,1,"H","N","2014-12-03","201412030CHI"
"STL",0,0,1,0,0,1,0,1,0,3,0,4,"A","N","2014-12-03","201412030CHI"
"MIN",0,1,1,0,0,2,0,0,0,1,0,1,"H","N","2014-12-03","201412030MIN"
"MTL",0,0,0,1,0,1,0,1,1,0,0,2,"A","N","2014-12-03","201412030MIN"
"EDM",0,1,0,1,0,2,1,1,0,1,0,3,"A","N","2014-12-03","201412030WPG"
"WPG",1,1,0,1,0,3,0,1,0,1,0,2,"H","N","2014-12-03","201412030WPG"
"ARI",0,0,0,0,0,0,0,1,2,1,0,4,"H","N","2014-12-04","201412040ARI"
"LAK",0,1,2,1,0,4,0,0,0,0,0,0,"A","N","2014-12-04","201412040ARI"
"CAR",0,0,0,1,0,1,0,1,0,1,0,2,"H","N","2014-12-04","201412040CAR"
"WSH",0,1,0,1,0,2,0,0,0,1,0,1,"A","N","2014-12-04","201412040CAR"
"CGY",1,0,1,2,0,4,0,0,2,1,0,3,"H","N","2014-12-04","201412040CGY"
"COL",0,0,2,1,0,3,1,0,1,2,0,4,"A","N","2014-12-04","201412040CGY"
"DAL",0,1,1,0,0,2,0,3,0,2,0,5,"A","N","2014-12-04","201412040DET"
"DET",0,3,0,2,0,5,0,1,1,0,0,2,"H","N","2014-12-04","201412040DET"
"CBJ",0,2,1,0,1,4,0,0,3,0,0,3,"A","Y","2014-12-04","201412040FLA"
"FLA",0,0,3,0,0,3,0,2,1,0,1,4,"H","Y","2014-12-04","201412040FLA"
"NSH",0,2,1,1,0,4,0,1,1,1,0,3,"H","N","2014-12-04","201412040NSH"
"STL",0,1,1,1,0,3,0,2,1,1,0,4,"A","N","2014-12-04","201412040NSH"
"NYI",0,0,1,1,0,2,0,0,1,0,0,1,"A","N","2014-12-04","201412040OTT"
"OTT",0,0,1,0,0,1,0,0,1,1,0,2,"H","N","2014-12-04","201412040OTT"
"PIT",0,0,0,0,0,0,0,1,2,0,0,3,"H","N","2014-12-04","201412040PIT"
"VAN",0,1,2,0,0,3,0,0,0,0,0,0,"A","N","2014-12-04","201412040PIT"
"BOS",0,2,2,0,0,4,0,0,4,3,0,7,"A","N","2014-12-04","201412040SJS"
"SJS",0,0,4,3,0,7,0,2,2,0,0,4,"H","N","2014-12-04","201412040SJS"
"BUF",0,0,0,0,0,0,0,1,3,1,0,5,"A","N","2014-12-04","201412040TBL"
"TBL",0,1,3,1,0,5,0,0,0,0,0,0,"H","N","2014-12-04","201412040TBL"
"NJD",0,1,2,2,0,5,0,0,2,1,0,3,"A","N","2014-12-04","201412040TOR"
"TOR",0,0,2,1,0,3,0,1,2,2,0,5,"H","N","2014-12-04","201412040TOR"
"CHI",0,2,0,2,0,4,0,1,2,0,0,3,"H","N","2014-12-05","201412050CHI"
"MTL",0,1,2,0,0,3,0,2,0,2,0,4,"A","N","2014-12-05","201412050CHI"
"ANA",0,2,1,2,0,5,0,0,3,1,0,4,"A","N","2014-12-05","201412050MIN"
"MIN",0,0,3,1,0,4,0,2,1,2,0,5,"H","N","2014-12-05","201412050MIN"
"COL",0,1,0,1,0,2,0,2,1,3,0,6,"A","N","2014-12-05","201412050WPG"
"WPG",0,2,1,3,0,6,0,1,0,1,0,2,"H","N","2014-12-05","201412050WPG"
"ARI",0,1,0,1,0,2,0,2,3,0,0,5,"H","N","2014-12-06","201412060ARI"
"BOS",0,2,3,0,0,5,0,1,0,1,0,2,"A","N","2014-12-06","201412060ARI"
"CGY",0,1,1,0,0,2,0,0,2,1,0,3,"H","N","2014-12-06","201412060CGY"
"SJS",0,0,2,1,0,3,0,1,1,0,0,2,"A","N","2014-12-06","201412060CGY"
"DAL",0,1,2,1,0,4,0,0,0,1,0,1,"H","N","2014-12-06","201412060DAL"
"MTL",0,0,0,1,0,1,0,1,2,1,0,4,"A","N","2014-12-06","201412060DAL"
"DET",0,0,2,1,0,3,0,2,0,0,0,2,"H","N","2014-12-06","201412060DET"
"NYR",0,2,0,0,0,2,0,0,2,1,0,3,"A","N","2014-12-06","201412060DET"
"BUF",0,0,2,0,0,2,0,1,2,0,0,3,"A","N","2014-12-06","201412060FLA"
"FLA",0,1,2,0,0,3,0,0,2,0,0,2,"H","N","2014-12-06","201412060FLA"
"LAK",0,0,0,1,0,1,0,1,1,0,0,2,"H","N","2014-12-06","201412060LAK"
"PHI",0,1,1,0,0,2,0,0,0,1,0,1,"A","N","2014-12-06","201412060LAK"
"NJD",0,1,0,0,0,1,0,1,2,1,0,4,"H","N","2014-12-06","201412060NJD"
"WSH",0,1,2,1,0,4,0,1,0,0,0,1,"A","N","2014-12-06","201412060NJD"
"CHI",0,1,1,1,0,3,0,0,0,1,0,1,"A","N","2014-12-06","201412060NSH"
"NSH",0,0,0,1,0,1,0,1,1,1,0,3,"H","N","2014-12-06","201412060NSH"
"NYI",0,3,1,0,0,4,0,0,3,3,0,6,"H","N","2014-12-06","201412060NYI"
"STL",0,0,3,3,0,6,0,3,1,0,0,4,"A","N","2014-12-06","201412060NYI"
"OTT",0,0,2,0,0,2,0,1,1,1,0,3,"A","N","2014-12-06","201412060PIT"
"PIT",0,1,1,1,0,3,0,0,2,0,0,2,"H","N","2014-12-06","201412060PIT"
"CBJ",0,2,0,1,0,3,0,0,0,1,0,1,"A","N","2014-12-06","201412060TBL"
"TBL",0,0,0,1,0,1,0,2,0,1,0,3,"H","N","2014-12-06","201412060TBL"
"TOR",0,2,2,1,0,5,0,0,1,1,0,2,"H","N","2014-12-06","201412060TOR"
"VAN",0,0,1,1,0,2,0,2,2,1,0,5,"A","N","2014-12-06","201412060TOR"
"CAR",0,0,1,0,0,1,0,2,1,0,0,3,"H","N","2014-12-07","201412070CAR"
"DET",0,2,1,0,0,3,0,0,1,0,0,1,"A","N","2014-12-07","201412070CAR"
"EDM",0,0,1,1,0,2,0,0,1,0,0,1,"H","N","2014-12-07","201412070EDM"
"SJS",0,0,1,0,0,1,0,0,1,1,0,2,"A","N","2014-12-07","201412070EDM"
"OTT",1,0,3,0,0,4,0,2,1,0,0,3,"H","N","2014-12-07","201412070OTT"
"VAN",0,2,1,0,0,3,1,0,3,0,0,4,"A","N","2014-12-07","201412070OTT"
"ANA",1,1,2,0,0,4,0,1,1,1,0,3,"A","N","2014-12-07","201412070WPG"
"WPG",0,1,1,1,0,3,1,1,2,0,0,4,"H","N","2014-12-07","201412070WPG"
"CAR",0,0,1,0,0,1,0,0,2,0,0,2,"H","N","2014-12-08","201412080CAR"
"NJD",0,0,2,0,0,2,0,0,1,0,0,1,"A","N","2014-12-08","201412080CAR"
"NYR",1,0,2,1,0,4,0,1,0,2,0,3,"H","N","2014-12-08","201412080NYR"
"PIT",0,1,0,2,0,3,1,0,2,1,0,4,"A","N","2014-12-08","201412080NYR"
"FLA",0,0,1,1,0,2,0,2,0,2,0,4,"A","N","2014-12-08","201412080STL"
"STL",0,2,0,2,0,4,0,0,1,1,0,2,"H","N","2014-12-08","201412080STL"
"BUF",0,0,0,1,0,1,0,0,0,0,0,0,"H","N","2014-12-09","201412090BUF"
"LAK",0,0,0,0,0,0,0,0,0,1,0,1,"A","N","2014-12-09","201412090BUF"
"CBJ",1,1,1,0,0,3,0,1,0,1,0,2,"H","N","2014-12-09","201412090CBJ"
"PHI",0,1,0,1,0,2,1,1,1,0,0,3,"A","N","2014-12-09","201412090CBJ"
"COL",0,0,0,0,0,0,0,1,0,2,0,3,"H","N","2014-12-09","201412090COL"
"NSH",0,1,0,2,0,3,0,0,0,0,0,0,"A","N","2014-12-09","201412090COL"
"DAL",0,1,1,0,0,2,0,2,3,0,0,5,"H","N","2014-12-09","201412090DAL"
"WPG",0,2,3,0,0,5,0,1,1,0,0,2,"A","N","2014-12-09","201412090DAL"
"MIN",0,0,1,4,0,5,0,3,1,0,0,4,"H","N","2014-12-09","201412090MIN"
"NYI",0,3,1,0,0,4,0,0,1,4,0,5,"A","N","2014-12-09","201412090MIN"
"MTL",0,0,1,2,0,3,0,0,1,0,0,1,"H","N","2014-12-09","201412090MTL"
"VAN",0,0,1,0,0,1,0,0,1,2,0,3,"A","N","2014-12-09","201412090MTL"
"CHI",0,0,1,1,1,3,0,1,0,1,0,2,"A","Y","2014-12-09","201412090NJD"
"NJD",0,1,0,1,0,2,0,0,1,1,1,3,"H","Y","2014-12-09","201412090NJD"
"EDM",0,2,0,0,0,2,0,2,2,1,0,5,"A","N","2014-12-09","201412090SJS"
"SJS",0,2,2,1,0,5,0,2,0,0,0,2,"H","N","2014-12-09","201412090SJS"
"TBL",0,1,1,1,0,3,0,2,1,2,0,5,"H","N","2014-12-09","201412090TBL"
"WSH",0,2,1,2,0,5,0,1,1,1,0,3,"A","N","2014-12-09","201412090TBL"
"CGY",0,0,0,1,0,1,0,1,1,2,0,4,"A","N","2014-12-09","201412090TOR"
"TOR",0,1,1,2,0,4,0,0,0,1,0,1,"H","N","2014-12-09","201412090TOR"
"ANA",0,1,1,0,0,2,0,0,0,1,0,1,"H","N","2014-12-10","201412100ANA"
"EDM",0,0,0,1,0,1,0,1,1,0,0,2,"A","N","2014-12-10","201412100ANA"
"DET",0,0,1,0,0,1,0,0,0,1,1,2,"H","Y","2014-12-10","201412100DET"
"TOR",0,0,0,1,1,2,0,0,1,0,0,1,"A","Y","2014-12-10","201412100DET"
"ARI",0,1,0,0,0,1,0,3,0,2,0,5,"H","N","2014-12-11","201412110ARI"
"NSH",0,3,0,2,0,5,0,1,0,0,0,1,"A","N","2014-12-11","201412110ARI"
"BOS",0,0,1,1,0,2,0,2,1,0,0,3,"H","N","2014-12-11","201412110BOS"
"CHI",0,2,1,0,0,3,0,0,1,1,0,2,"A","N","2014-12-11","201412110BOS"
"BUF",0,0,2,2,0,4,0,0,2,1,0,3,"H","N","2014-12-11","201412110BUF"
"CGY",0,0,2,1,0,3,0,0,2,2,0,4,"A","N","2014-12-11","201412110BUF"
"COL",0,0,1,2,1,4,0,0,2,1,0,3,"H","Y","2014-12-11","201412110COL"
"WPG",0,0,2,1,0,3,0,0,1,2,1,4,"A","Y","2014-12-11","201412110COL"
"LAK",0,0,2,3,0,5,0,0,1,2,0,3,"A","N","2014-12-11","201412110OTT"
"OTT",0,0,1,2,0,3,0,0,2,3,0,5,"H","N","2014-12-11","201412110OTT"
"NJD",0,0,1,0,0,1,0,2,0,2,0,4,"A","N","2014-12-11","201412110PHI"
"PHI",0,2,0,2,0,4,0,0,1,0,0,1,"H","N","2014-12-11","201412110PHI"
"MIN",0,0,0,1,0,1,0,0,1,1,0,2,"A","N","2014-12-11","201412110SJS"
"SJS",0,0,1,1,0,2,0,0,0,1,0,1,"H","N","2014-12-11","201412110SJS"
"NYI",0,0,2,1,0,3,0,2,0,4,0,6,"A","N","2014-12-11","201412110STL"
"STL",0,2,0,4,0,6,0,0,2,1,0,3,"H","N","2014-12-11","201412110STL"
"CAR",0,0,0,1,0,1,0,0,0,2,0,2,"A","N","2014-12-11","201412110TBL"
"TBL",0,0,0,2,0,2,0,0,0,1,0,1,"H","N","2014-12-11","201412110TBL"
"CBJ",1,1,0,1,0,3,0,1,0,1,0,2,"A","N","2014-12-11","201412110WSH"
"WSH",0,1,0,1,0,2,1,1,0,1,0,3,"H","N","2014-12-11","201412110WSH"
"DET",0,2,0,0,0,2,0,2,0,0,1,3,"H","Y","2014-12-12","201412120DET"
"FLA",0,2,0,0,1,3,0,2,0,0,0,2,"A","Y","2014-12-12","201412120DET"
"ANA",0,1,2,1,0,4,0,0,1,1,0,2,"A","N","2014-12-12","201412120EDM"
"EDM",0,0,1,1,0,2,0,1,2,1,0,4,"H","N","2014-12-12","201412120EDM"
"LAK",0,0,0,2,0,2,0,1,2,3,0,6,"A","N","2014-12-12","201412120MTL"
"MTL",0,1,2,3,0,6,0,0,0,2,0,2,"H","N","2014-12-12","201412120MTL"
"CGY",0,1,0,0,0,1,0,2,0,1,0,3,"A","N","2014-12-12","201412120PIT"
"PIT",0,2,0,1,0,3,0,1,0,0,0,1,"H","N","2014-12-12","201412120PIT"
"ARI",0,1,2,0,0,3,0,1,1,1,1,4,"H","Y","2014-12-13","201412130ARI"
"MIN",0,1,1,1,1,4,0,1,2,0,0,3,"A","Y","2014-12-13","201412130ARI"
"BOS",0,1,1,0,0,2,0,0,1,1,1,3,"H","Y","2014-12-13","201412130BOS"
"OTT",0,0,1,1,1,3,0,1,1,0,0,2,"A","Y","2014-12-13","201412130BOS"
"BUF",1,2,0,1,0,4,0,0,2,1,0,3,"H","N","2014-12-13","201412130BUF"
"FLA",0,0,2,1,0,3,1,2,0,1,0,4,"A","N","2014-12-13","201412130BUF"
"CBJ",0,1,0,2,1,4,0,0,1,2,0,3,"H","Y","2014-12-13","201412130CBJ"
"PIT",0,0,1,2,0,3,0,1,0,2,1,4,"A","Y","2014-12-13","201412130CBJ"
"COL",0,1,1,0,0,2,1,1,1,0,0,3,"H","N","2014-12-13","201412130COL"
"STL",1,1,1,0,0,3,0,1,1,0,0,2,"A","N","2014-12-13","201412130COL"
"DAL",0,2,2,0,0,4,0,0,2,1,0,3,"H","N","2014-12-13","201412130DAL"
"NJD",0,0,2,1,0,3,0,2,2,0,0,4,"A","N","2014-12-13","201412130DAL"
"CHI",0,0,1,1,0,2,0,0,1,2,0,3,"A","N","2014-12-13","201412130NYI"
"NYI",0,0,1,2,0,3,0,0,1,1,0,2,"H","N","2014-12-13","201412130NYI"
"CAR",0,0,1,0,0,1,0,2,3,0,0,5,"A","N","2014-12-13","201412130PHI"
"PHI",0,2,3,0,0,5,0,0,1,0,0,1,"H","N","2014-12-13","201412130PHI"
"NSH",0,0,0,0,0,0,0,1,0,1,0,2,"A","N","2014-12-13","201412130SJS"
"SJS",0,1,0,1,0,2,0,0,0,0,0,0,"H","N","2014-12-13","201412130SJS"
"DET",0,1,0,0,0,1,0,1,1,2,0,4,"A","N","2014-12-13","201412130TOR"
"TOR",0,1,1,2,0,4,0,1,0,0,0,1,"H","N","2014-12-13","201412130TOR"
"NYR",0,3,2,0,0,5,0,0,0,1,0,1,"A","N","2014-12-13","201412130VAN"
"VAN",0,0,0,1,0,1,0,3,2,0,0,5,"H","N","2014-12-13","201412130VAN"
"ANA",0,0,3,1,0,4,0,1,0,0,0,1,"A","N","2014-12-13","201412130WPG"
"WPG",0,1,0,0,0,1,0,0,3,1,0,4,"H","N","2014-12-13","201412130WPG"
"TBL",0,0,0,2,0,2,0,0,2,2,0,4,"A","N","2014-12-13","201412130WSH"
"WSH",0,0,2,2,0,4,0,0,0,2,0,2,"H","N","2014-12-13","201412130WSH"
"CGY",0,0,1,0,0,1,0,0,1,1,0,2,"A","N","2014-12-14","201412140CHI"
"CHI",0,0,1,1,0,2,0,0,1,0,0,1,"H","N","2014-12-14","201412140CHI"
"EDM",0,0,0,0,0,0,0,1,0,1,0,2,"H","N","2014-12-14","201412140EDM"
"NYR",0,1,0,1,0,2,0,0,0,0,0,0,"A","N","2014-12-14","201412140EDM"
"LAK",0,0,2,1,0,3,0,2,0,1,1,4,"A","Y","2014-12-14","201412140TOR"
"TOR",0,2,0,1,1,4,0,0,2,1,0,3,"H","Y","2014-12-14","201412140TOR"
"BUF",0,0,3,1,1,5,0,1,1,2,0,4,"H","Y","2014-12-15","201412150BUF"
"OTT",0,1,1,2,0,4,0,0,3,1,1,5,"A","Y","2014-12-15","201412150BUF"
"NJD",0,2,0,0,0,2,0,0,1,1,1,3,"A","Y","2014-12-15","201412150NYI"
"NYI",0,0,1,1,1,3,0,2,0,0,0,2,"H","Y","2014-12-15","201412150NYI"
"PIT",0,1,2,1,0,4,0,1,0,1,0,2,"H","N","2014-12-15","201412150PIT"
"TBL",0,1,0,1,0,2,0,1,2,1,0,4,"A","N","2014-12-15","201412150PIT"
"ARI",1,0,1,0,0,2,0,1,0,0,0,1,"H","N","2014-12-16","201412160ARI"
"EDM",0,1,0,0,0,1,1,0,1,0,0,2,"A","N","2014-12-16","201412160ARI"
"CGY",0,0,1,1,0,2,0,2,2,1,0,5,"H","N","2014-12-16","201412160CGY"
"NYR",0,2,2,1,0,5,0,0,1,1,0,2,"A","N","2014-12-16","201412160CGY"
"CHI",0,0,3,2,0,5,0,1,0,2,0,3,"H","N","2014-12-16","201412160CHI"
"MIN",0,1,0,2,0,3,0,0,3,2,0,5,"A","N","2014-12-16","201412160CHI"
"CBJ",0,0,0,0,1,1,0,0,0,0,0,0,"A","Y","2014-12-16","201412160DET"
"DET",0,0,0,0,0,0,0,0,0,0,1,1,"H","Y","2014-12-16","201412160DET"
"FLA",0,1,0,0,1,2,0,0,1,0,0,1,"H","Y","2014-12-16","201412160FLA"
"WSH",0,0,1,0,0,1,0,1,0,0,1,2,"A","Y","2014-12-16","201412160FLA"
"CAR",0,0,0,1,0,1,0,1,1,2,0,4,"A","N","2014-12-16","201412160MTL"
"MTL",0,1,1,2,0,4,0,0,0,1,0,1,"H","N","2014-12-16","201412160MTL"
"BOS",0,0,1,1,0,2,0,0,1,1,1,3,"A","Y","2014-12-16","201412160NSH"
"NSH",0,0,1,1,1,3,0,0,1,1,0,2,"H","Y","2014-12-16","201412160NSH"
"PHI",0,1,0,0,0,1,0,0,2,1,0,3,"H","N","2014-12-16","201412160PHI"
"TBL",0,0,2,1,0,3,0,1,0,0,0,1,"A","N","2014-12-16","201412160PHI"
"LAK",0,0,2,0,0,2,0,0,1,4,0,5,"A","N","2014-12-16","201412160STL"
"STL",0,0,1,4,0,5,0,0,2,0,0,2,"H","N","2014-12-16","201412160STL"
"ANA",0,0,1,1,0,2,0,1,1,4,0,6,"A","N","2014-12-16","201412160TOR"
"TOR",0,1,1,4,0,6,0,0,1,1,0,2,"H","N","2014-12-16","201412160TOR"
"BUF",0,1,0,0,0,1,0,0,3,2,0,5,"A","N","2014-12-16","201412160WPG"
"WPG",0,0,3,2,0,5,0,1,0,0,0,1,"H","N","2014-12-16","201412160WPG"
"BOS",1,2,0,0,0,3,0,1,0,1,0,2,"A","N","2014-12-17","201412170MIN"
"MIN",0,1,0,1,0,2,1,2,0,0,0,3,"H","N","2014-12-17","201412170MIN"
"NJD",0,0,0,0,0,0,0,1,0,1,0,2,"H","N","2014-12-17","201412170NJD"
"OTT",0,1,0,1,0,2,0,0,0,0,0,0,"A","N","2014-12-17","201412170NJD"
"DAL",0,0,1,1,0,2,0,0,0,0,0,0,"A","N","2014-12-17","201412170VAN"
"VAN",0,0,0,0,0,0,0,0,1,1,0,2,"H","N","2014-12-17","201412170VAN"
"CAR",0,2,0,2,0,4,0,0,1,0,0,1,"H","N","2014-12-18","201412180CAR"
"TOR",0,0,1,0,0,1,0,2,0,2,0,4,"A","N","2014-12-18","201412180CAR"
"CBJ",0,0,2,2,0,4,1,2,0,2,0,5,"H","N","2014-12-18","201412180CBJ"
"WSH",1,2,0,2,0,5,0,0,2,2,0,4,"A","N","2014-12-18","201412180CBJ"
"LAK",0,1,2,3,0,6,0,3,1,0,0,4,"H","N","2014-12-18","201412180LAK"
"STL",0,3,1,0,0,4,0,1,2,3,0,6,"A","N","2014-12-18","201412180LAK"
"ANA",0,1,0,1,0,2,0,0,0,1,0,1,"A","N","2014-12-18","201412180MTL"
"MTL",0,0,0,1,0,1,0,1,0,1,0,2,"H","N","2014-12-18","201412180MTL"
"FLA",0,1,0,0,1,2,0,0,1,0,0,1,"A","Y","2014-12-18","201412180PHI"
"PHI",0,0,1,0,0,1,0,1,0,0,1,2,"H","Y","2014-12-18","201412180PHI"
"COL",0,0,0,0,0,0,1,0,0,0,0,1,"A","N","2014-12-18","201412180PIT"
"PIT",1,0,0,0,0,1,0,0,0,0,0,0,"H","N","2014-12-18","201412180PIT"
"EDM",0,1,2,0,0,3,0,0,2,2,0,4,"A","N","2014-12-18","201412180SJS"
"SJS",0,0,2,2,0,4,0,1,2,0,0,3,"H","N","2014-12-18","201412180SJS"
"CGY",0,0,1,0,0,1,0,0,2,0,0,2,"H","N","2014-12-19","201412190CGY"
"DAL",0,0,2,0,0,2,0,0,1,0,0,1,"A","N","2014-12-19","201412190CGY"
"DET",0,1,0,0,0,1,0,1,1,0,0,2,"H","N","2014-12-19","201412190DET"
"NYI",0,1,1,0,0,2,0,1,0,0,0,1,"A","N","2014-12-19","201412190DET"
"NJD",0,2,0,0,1,3,0,0,1,1,0,2,"H","Y","2014-12-19","201412190NJD"
"TBL",0,0,1,1,0,2,0,2,0,0,1,3,"A","Y","2014-12-19","201412190NJD"
"ANA",0,0,1,1,0,2,0,2,2,2,0,6,"A","N","2014-12-19","201412190OTT"
"OTT",0,2,2,2,0,6,0,0,1,1,0,2,"H","N","2014-12-19","201412190OTT"
"BOS",0,0,1,0,0,1,0,1,1,0,0,2,"A","N","2014-12-19","201412190WPG"
"WPG",0,1,1,0,0,2,0,0,1,0,0,1,"H","N","2014-12-19","201412190WPG"
"BUF",0,0,0,1,0,1,0,2,0,3,0,5,"H","N","2014-12-20","201412200BUF"
"COL",0,2,0,3,0,5,0,0,0,1,0,1,"A","N","2014-12-20","201412200BUF"
"CAR",0,1,0,1,0,2,0,0,0,2,1,3,"H","Y","2014-12-20","201412200CAR"
"NYR",0,0,0,2,1,3,0,1,0,1,0,2,"A","Y","2014-12-20","201412200CAR"
"CBJ",0,1,0,1,1,3,0,0,1,1,0,2,"H","Y","2014-12-20","201412200CBJ"
"CHI",0,0,1,1,0,2,0,1,0,1,1,3,"A","Y","2014-12-20","201412200CBJ"
"ARI",0,0,2,0,0,2,0,1,1,2,0,4,"A","N","2014-12-20","201412200LAK"
"LAK",0,1,1,2,0,4,0,0,2,0,0,2,"H","N","2014-12-20","201412200LAK"
"MIN",0,2,1,2,0,5,1,3,0,2,0,6,"H","N","2014-12-20","201412200MIN"
"NSH",1,3,0,2,0,6,0,2,1,2,0,5,"A","N","2014-12-20","201412200MIN"
"MTL",0,1,1,2,0,4,0,1,0,0,0,1,"H","N","2014-12-20","201412200MTL"
"OTT",0,1,0,0,0,1,0,1,1,2,0,4,"A","N","2014-12-20","201412200MTL"
"NJD",0,0,0,0,0,0,0,0,2,2,0,4,"H","N","2014-12-20","201412200NJD"
"WSH",0,0,2,2,0,4,0,0,0,0,0,0,"A","N","2014-12-20","201412200NJD"
"NYI",0,0,0,3,0,3,0,0,0,1,0,1,"H","N","2014-12-20","201412200NYI"
"TBL",0,0,0,1,0,1,0,0,0,3,0,3,"A","N","2014-12-20","201412200NYI"
"FLA",0,1,0,0,0,1,0,2,0,1,0,3,"A","N","2014-12-20","201412200PIT"
"PIT",0,2,0,1,0,3,0,1,0,0,0,1,"H","N","2014-12-20","201412200PIT"
"SJS",1,0,1,1,0,3,0,0,2,0,0,2,"H","N","2014-12-20","201412200SJS"
"STL",0,0,2,0,0,2,1,0,1,1,0,3,"A","N","2014-12-20","201412200SJS"
"PHI",0,3,2,2,0,7,0,3,0,1,0,4,"A","N","2014-12-20","201412200TOR"
"TOR",0,3,0,1,0,4,0,3,2,2,0,7,"H","N","2014-12-20","201412200TOR"
"CGY",0,0,1,1,0,2,1,2,0,0,0,3,"A","N","2014-12-20","201412200VAN"
"VAN",1,2,0,0,0,3,0,0,1,1,0,2,"H","N","2014-12-20","201412200VAN"
"BOS",1,1,1,1,0,4,0,0,2,1,0,3,"H","N","2014-12-21","201412210BOS"
"BUF",0,0,2,1,0,3,1,1,1,1,0,4,"A","N","2014-12-21","201412210BOS"
"CHI",0,2,0,2,0,4,0,0,0,0,0,0,"H","N","2014-12-21","201412210CHI"
"TOR",0,0,0,0,0,0,0,2,0,2,0,4,"A","N","2014-12-21","201412210CHI"
"COL",0,0,0,1,1,2,0,0,0,1,0,1,"A","Y","2014-12-21","201412210DET"
"DET",0,0,0,1,0,1,0,0,0,1,1,2,"H","Y","2014-12-21","201412210DET"
"DAL",0,2,1,2,1,6,0,1,4,0,0,5,"A","Y","2014-12-21","201412210EDM"
"EDM",0,1,4,0,0,5,0,2,1,2,1,6,"H","Y","2014-12-21","201412210EDM"
"CAR",0,0,0,0,0,0,0,1,0,0,0,1,"A","N","2014-12-21","201412210NYR"
"NYR",0,1,0,0,0,1,0,0,0,0,0,0,"H","N","2014-12-21","201412210NYR"
"PHI",1,1,0,2,0,4,0,2,1,0,0,3,"A","N","2014-12-21","201412210WPG"
"WPG",0,2,1,0,0,3,1,1,0,2,0,4,"H","N","2014-12-21","201412210WPG"
"ANA",1,0,1,1,0,3,0,0,0,2,0,2,"H","N","2014-12-22","201412220ANA"
"SJS",0,0,0,2,0,2,1,0,1,1,0,3,"A","N","2014-12-22","201412220ANA"
"CBJ",0,0,0,1,0,1,0,0,2,3,0,5,"H","N","2014-12-22","201412220CBJ"
"NSH",0,0,2,3,0,5,0,0,0,1,0,1,"A","N","2014-12-22","201412220CBJ"
"FLA",0,0,1,2,1,4,0,1,0,2,0,3,"H","Y","2014-12-22","201412220FLA"
"PIT",0,1,0,2,0,3,0,0,1,2,1,4,"A","Y","2014-12-22","201412220FLA"
"CGY",1,0,1,2,0,4,0,2,1,0,0,3,"A","N","2014-12-22","201412220LAK"
"LAK",0,2,1,0,0,3,1,0,1,2,0,4,"H","N","2014-12-22","201412220LAK"
"ARI",0,0,1,0,0,1,0,3,2,2,0,7,"A","N","2014-12-22","201412220VAN"
"VAN",0,3,2,2,0,7,0,0,1,0,0,1,"H","N","2014-12-22","201412220VAN"
"OTT",0,0,1,0,0,1,0,0,2,0,0,2,"A","N","2014-12-22","201412220WSH"
"WSH",0,0,2,0,0,2,0,0,1,0,0,1,"H","N","2014-12-22","201412220WSH"
"BOS",0,2,2,1,0,5,0,2,0,1,0,3,"H","N","2014-12-23","201412230BOS"
"NSH",0,2,0,1,0,3,0,2,2,1,0,5,"A","N","2014-12-23","201412230BOS"
"CHI",0,0,1,0,0,1,0,3,1,1,0,5,"H","N","2014-12-23","201412230CHI"
"WPG",0,3,1,1,0,5,0,0,1,0,0,1,"A","N","2014-12-23","201412230CHI"
"COL",0,2,3,0,0,5,0,0,0,0,0,0,"H","N","2014-12-23","201412230COL"
"STL",0,0,0,0,0,0,0,2,3,0,0,5,"A","N","2014-12-23","201412230COL"
"DAL",0,0,0,0,0,0,0,1,2,1,0,4,"H","N","2014-12-23","201412230DAL"
"TOR",0,1,2,1,0,4,0,0,0,0,0,0,"A","N","2014-12-23","201412230DAL"
"BUF",0,2,1,0,0,3,0,1,1,4,0,6,"A","N","2014-12-23","201412230DET"
"DET",0,1,1,4,0,6,0,2,1,0,0,3,"H","N","2014-12-23","201412230DET"
"ARI",0,2,1,2,0,5,0,1,0,0,0,1,"A","N","2014-12-23","201412230EDM"
"EDM",0,1,0,0,0,1,0,2,1,2,0,5,"H","N","2014-12-23","201412230EDM"
"MIN",0,1,1,0,0,2,0,2,1,2,0,5,"H","N","2014-12-23","201412230MIN"
"PHI",0,2,1,2,0,5,0,1,1,0,0,2,"A","N","2014-12-23","201412230MIN"
"CAR",0,0,0,1,1,2,0,1,0,0,0,1,"A","Y","2014-12-23","201412230NJD"
"NJD",0,1,0,0,0,1,0,0,0,1,1,2,"H","Y","2014-12-23","201412230NJD"
"MTL",0,0,2,1,0,3,0,1,0,0,0,1,"A","N","2014-12-23","201412230NYI"
"NYI",0,1,0,0,0,1,0,0,2,1,0,3,"H","N","2014-12-23","201412230NYI"
"NYR",0,1,1,2,0,4,0,0,0,2,0,2,"H","N","2014-12-23","201412230NYR"
"WSH",0,0,0,2,0,2,0,1,1,2,0,4,"A","N","2014-12-23","201412230NYR"
"PIT",0,0,1,2,0,3,0,2,2,0,0,4,"A","N","2014-12-23","201412230TBL"
"TBL",0,2,2,0,0,4,0,0,1,2,0,3,"H","N","2014-12-23","201412230TBL"
"ANA",0,1,0,0,0,1,0,1,0,0,1,2,"A","Y","2014-12-27","201412270ARI"
"ARI",0,1,0,0,1,2,0,1,0,0,0,1,"H","Y","2014-12-27","201412270ARI"
"BUF",0,0,0,3,1,4,0,1,2,0,0,3,"H","Y","2014-12-27","201412270BUF"
"NYI",0,1,2,0,0,3,0,0,0,3,1,4,"A","Y","2014-12-27","201412270BUF"
"BOS",0,1,1,0,0,2,0,1,4,1,0,6,"A","N","2014-12-27","201412270CBJ"
"CBJ",0,1,4,1,0,6,0,1,1,0,0,2,"H","N","2014-12-27","201412270CBJ"
"CGY",0,3,0,1,0,4,0,0,0,1,0,1,"H","N","2014-12-27","201412270CGY"
"EDM",0,0,0,1,0,1,0,3,0,1,0,4,"A","N","2014-12-27","201412270CGY"
"CHI",0,2,1,2,0,5,0,2,0,0,0,2,"A","N","2014-12-27","201412270COL"
"COL",0,2,0,0,0,2,0,2,1,2,0,5,"H","N","2014-12-27","201412270COL"
"LAK",0,1,1,1,0,3,0,1,0,0,0,1,"H","N","2014-12-27","201412270LAK"
"SJS",0,1,0,0,0,1,0,1,1,1,0,3,"A","N","2014-12-27","201412270LAK"
"MIN",0,1,0,2,0,3,1,0,1,2,0,4,"H","N","2014-12-27","201412270MIN"
"WPG",1,0,1,2,0,4,0,1,0,2,0,3,"A","N","2014-12-27","201412270MIN"
"NSH",0,1,2,1,0,4,0,0,1,0,0,1,"H","N","2014-12-27","201412270NSH"
"PHI",0,0,1,0,0,1,0,1,2,1,0,4,"A","N","2014-12-27","201412270NSH"
"NJD",0,0,1,0,0,1,0,1,1,1,0,3,"A","N","2014-12-27","201412270NYR"
"NYR",0,1,1,1,0,3,0,0,1,0,0,1,"H","N","2014-12-27","201412270NYR"
"DET",1,1,0,1,0,3,0,1,1,0,0,2,"A","N","2014-12-27","201412270OTT"
"OTT",0,1,1,0,0,2,1,1,0,1,0,3,"H","N","2014-12-27","201412270OTT"
"PIT",0,0,0,0,0,0,0,1,0,2,0,3,"H","N","2014-12-27","201412270PIT"
"WSH",0,1,0,2,0,3,0,0,0,0,0,0,"A","N","2014-12-27","201412270PIT"
"DAL",0,2,2,0,0,4,0,2,0,1,0,3,"A","N","2014-12-27","201412270STL"
"STL",0,2,0,1,0,3,0,2,2,0,0,4,"H","N","2014-12-27","201412270STL"
"CAR",0,0,0,1,0,1,0,1,0,1,0,2,"A","N","2014-12-27","201412270TBL"
"TBL",0,1,0,1,0,2,0,0,0,1,0,1,"H","N","2014-12-27","201412270TBL"
"ANA",1,0,0,1,0,2,0,0,1,0,0,1,"H","N","2014-12-28","201412280ANA"
"VAN",0,0,1,0,0,1,1,0,0,1,0,2,"A","N","2014-12-28","201412280ANA"
"FLA",0,0,2,4,0,6,0,0,4,0,0,4,"H","N","2014-12-28","201412280FLA"
"TOR",0,0,4,0,0,4,0,0,2,4,0,6,"A","N","2014-12-28","201412280FLA"
"ARI",0,1,1,2,0,4,0,0,0,2,0,2,"H","N","2014-12-29","201412290ARI"
"PHI",0,0,0,2,0,2,0,1,1,2,0,4,"A","N","2014-12-29","201412290ARI"
"BOS",0,3,0,2,0,5,0,1,1,0,0,2,"H","N","2014-12-29","201412290BOS"
"DET",0,1,1,0,0,2,0,3,0,2,0,5,"A","N","2014-12-29","201412290BOS"
"CAR",0,0,0,1,0,1,0,0,2,1,0,3,"H","N","2014-12-29","201412290CAR"
"MTL",0,0,2,1,0,3,0,0,0,1,0,1,"A","N","2014-12-29","201412290CAR"
"CGY",0,2,0,0,0,2,0,0,1,0,0,1,"H","N","2014-12-29","201412290CGY"
"LAK",0,0,1,0,0,1,0,2,0,0,0,2,"A","N","2014-12-29","201412290CGY"
"CHI",0,0,3,1,1,5,0,2,2,0,0,4,"H","Y","2014-12-29","201412290CHI"
"NSH",0,2,2,0,0,4,0,0,3,1,1,5,"A","Y","2014-12-29","201412290CHI"
"DAL",0,2,1,0,0,3,0,2,0,0,0,2,"H","N","2014-12-29","201412290DAL"
"NYR",0,2,0,0,0,2,0,2,1,0,0,3,"A","N","2014-12-29","201412290DAL"
"NJD",0,0,2,1,0,3,0,1,0,0,0,1,"H","N","2014-12-29","201412290NJD"
"PIT",0,1,0,0,0,1,0,0,2,1,0,3,"A","N","2014-12-29","201412290NJD"
"NYI",1,1,1,1,0,4,0,0,0,3,0,3,"H","N","2014-12-29","201412290NYI"
"WSH",0,0,0,3,0,3,1,1,1,1,0,4,"A","N","2014-12-29","201412290NYI"
"BUF",0,0,2,0,0,2,0,1,1,3,0,5,"A","N","2014-12-29","201412290OTT"
"OTT",0,1,1,3,0,5,0,0,2,0,0,2,"H","N","2014-12-29","201412290OTT"
"COL",0,0,0,0,0,0,0,0,2,1,0,3,"A","N","2014-12-29","201412290STL"
"STL",0,0,2,1,0,3,0,0,0,0,0,0,"H","N","2014-12-29","201412290STL"
"TBL",0,0,2,1,0,3,0,2,0,0,0,2,"H","N","2014-12-29","201412290TBL"
"TOR",0,2,0,0,0,2,0,0,2,1,0,3,"A","N","2014-12-29","201412290TBL"
"MIN",0,0,3,0,0,3,0,1,1,0,0,2,"A","N","2014-12-29","201412290WPG"
"WPG",0,1,1,0,0,2,0,0,3,0,0,3,"H","N","2014-12-29","201412290WPG"
"EDM",0,1,1,0,1,3,0,0,0,2,0,2,"H","Y","2014-12-30","201412300EDM"
"LAK",0,0,0,2,0,2,0,1,1,0,1,3,"A","Y","2014-12-30","201412300EDM"
"FLA",0,0,0,1,0,1,0,0,1,0,1,2,"H","Y","2014-12-30","201412300FLA"
"MTL",0,0,1,0,1,2,0,0,0,1,0,1,"A","Y","2014-12-30","201412300FLA"
"NSH",0,1,1,1,0,3,0,0,2,0,0,2,"H","N","2014-12-30","201412300NSH"
"STL",0,0,2,0,0,2,0,1,1,1,0,3,"A","N","2014-12-30","201412300NSH"
"SJS",0,0,1,0,0,1,0,1,2,0,0,3,"H","N","2014-12-30","201412300SJS"
"VAN",0,1,2,0,0,3,0,0,1,0,0,1,"A","N","2014-12-30","201412300SJS"
"ANA",0,0,0,0,0,0,0,1,0,2,0,3,"H","N","2014-12-31","201412310ANA"
"SJS",0,1,0,2,0,3,0,0,0,0,0,0,"A","N","2014-12-31","201412310ANA"
"BOS",0,0,3,0,0,3,0,1,2,0,1,4,"H","Y","2014-12-31","201412310BOS"
"TOR",0,1,2,0,1,4,0,0,3,0,0,3,"A","Y","2014-12-31","201412310BOS"
"BUF",0,1,0,0,0,1,0,1,1,3,0,5,"H","N","2014-12-31","201412310BUF"
"TBL",0,1,1,3,0,5,0,1,0,0,0,1,"A","N","2014-12-31","201412310BUF"
"CBJ",0,0,1,2,0,3,0,1,0,0,0,1,"H","N","2014-12-31","201412310CBJ"
"MIN",0,1,0,0,0,1,0,0,1,2,0,3,"A","N","2014-12-31","201412310CBJ"
"CGY",1,0,1,2,0,4,0,1,1,1,0,3,"H","N","2014-12-31","201412310CGY"
"EDM",0,1,1,1,0,3,1,0,1,2,0,4,"A","N","2014-12-31","201412310CGY"
"COL",1,0,2,1,0,4,0,1,0,2,0,3,"H","N","2014-12-31","201412310COL"
"PHI",0,1,0,2,0,3,1,0,2,1,0,4,"A","N","2014-12-31","201412310COL"
"ARI",0,0,0,0,0,0,0,0,2,4,0,6,"A","N","2014-12-31","201412310DAL"
"DAL",0,0,2,4,0,6,0,0,0,0,0,0,"H","N","2014-12-31","201412310DAL"
"DET",0,0,1,2,0,3,0,0,1,0,0,1,"H","N","2014-12-31","201412310DET"
"NJD",0,0,1,0,0,1,0,0,1,2,0,3,"A","N","2014-12-31","201412310DET"
"FLA",0,0,1,1,0,2,0,1,2,2,0,5,"H","N","2014-12-31","201412310FLA"
"NYR",0,1,2,2,0,5,0,0,1,1,0,2,"A","N","2014-12-31","201412310FLA"
"CAR",0,1,0,0,0,1,0,1,0,1,0,2,"A","N","2014-12-31","201412310PIT"
"PIT",0,1,0,1,0,2,0,1,0,0,0,1,"H","N","2014-12-31","201412310PIT"
"NYI",0,2,1,2,0,5,0,0,1,1,0,2,"A","N","2014-12-31","201412310WPG"
"WPG",0,0,1,1,0,2,0,2,1,2,0,5,"H","N","2014-12-31","201412310WPG"
"LAK",0,0,1,2,0,3,0,1,1,0,0,2,"A","N","2015-01-01","201501010VAN"
"VAN",0,1,1,0,0,2,0,0,1,2,0,3,"H","N","2015-01-01","201501010VAN"
"CHI",0,1,1,0,0,2,0,2,0,1,0,3,"A","N","2015-01-01","201501010WSH"
"WSH",0,2,0,1,0,3,0,1,1,0,0,2,"H","N","2015-01-01","201501010WSH"
"ANA",0,1,2,1,0,4,0,0,3,0,0,3,"H","N","2015-01-02","201501020ANA"
"STL",0,0,3,0,0,3,0,1,2,1,0,4,"A","N","2015-01-02","201501020ANA"
"BUF",0,0,0,0,0,0,0,2,0,0,0,2,"H","N","2015-01-02","201501020BUF"
"FLA",0,2,0,0,0,2,0,0,0,0,0,0,"A","N","2015-01-02","201501020BUF"
"CAR",0,1,1,0,0,2,0,0,0,1,0,1,"H","N","2015-01-02","201501020CAR"
"PHI",0,0,0,1,0,1,0,1,1,0,0,2,"A","N","2015-01-02","201501020CAR"
"CGY",0,0,0,1,0,1,0,1,0,1,0,2,"H","N","2015-01-02","201501020CGY"
"NYI",0,1,0,1,0,2,0,0,0,1,0,1,"A","N","2015-01-02","201501020CGY"
"COL",0,0,1,0,1,2,0,0,0,1,0,1,"H","Y","2015-01-02","201501020COL"
"EDM",0,0,0,1,0,1,0,0,1,0,1,2,"A","Y","2015-01-02","201501020COL"
"MIN",0,0,1,2,0,3,0,0,0,1,0,1,"H","N","2015-01-02","201501020MIN"
"TOR",0,0,0,1,0,1,0,0,1,2,0,3,"A","N","2015-01-02","201501020MIN"
"MTL",0,0,2,2,0,4,0,0,0,2,0,2,"A","N","2015-01-02","201501020NJD"
"NJD",0,0,0,2,0,2,0,0,2,2,0,4,"H","N","2015-01-02","201501020NJD"
"PIT",0,3,1,2,0,6,0,1,1,1,0,3,"H","N","2015-01-02","201501020PIT"
"TBL",0,1,1,1,0,3,0,3,1,2,0,6,"A","N","2015-01-02","201501020PIT"
"ARI",0,1,3,2,0,6,0,0,2,1,0,3,"H","N","2015-01-03","201501030ARI"
"CBJ",0,0,2,1,0,3,0,1,3,2,0,6,"A","N","2015-01-03","201501030ARI"
"BOS",0,0,1,1,0,2,1,0,1,1,0,3,"H","N","2015-01-03","201501030BOS"
"OTT",1,0,1,1,0,3,0,0,1,1,0,2,"A","N","2015-01-03","201501030BOS"
"DAL",0,1,5,1,0,7,0,0,1,0,0,1,"H","N","2015-01-03","201501030DAL"
"MIN",0,0,1,0,0,1,0,1,5,1,0,7,"A","N","2015-01-03","201501030DAL"
"LAK",0,1,2,3,0,6,1,3,2,1,0,7,"H","N","2015-01-03","201501030LAK"
"NSH",1,3,2,1,0,7,0,1,2,3,0,6,"A","N","2015-01-03","201501030LAK"
"NJD",0,3,2,0,0,5,0,0,1,1,0,2,"H","N","2015-01-03","201501030NJD"
"PHI",0,0,1,1,0,2,0,3,2,0,0,5,"A","N","2015-01-03","201501030NJD"
"BUF",0,0,1,0,0,1,0,4,2,0,0,6,"A","N","2015-01-03","201501030NYR"
"NYR",0,4,2,0,0,6,0,0,1,0,0,1,"H","N","2015-01-03","201501030NYR"
"MTL",0,2,1,1,0,4,0,1,0,0,0,1,"A","N","2015-01-03","201501030PIT"
"PIT",0,1,0,0,0,1,0,2,1,1,0,4,"H","N","2015-01-03","201501030PIT"
"SJS",0,2,0,0,0,2,0,2,2,3,0,7,"H","N","2015-01-03","201501030SJS"
"STL",0,2,2,3,0,7,0,2,0,0,0,2,"A","N","2015-01-03","201501030SJS"
"DET",0,0,0,1,0,1,0,0,1,3,0,4,"A","N","2015-01-03","201501030VAN"
"VAN",0,0,1,3,0,4,0,0,0,1,0,1,"H","N","2015-01-03","201501030VAN"
"TOR",0,0,1,0,0,1,0,0,3,2,0,5,"A","N","2015-01-03","201501030WPG"
"WPG",0,0,3,2,0,5,0,0,1,0,0,1,"H","N","2015-01-03","201501030WPG"
"ANA",0,1,1,1,1,4,0,0,3,0,0,3,"H","Y","2015-01-04","201501040ANA"
"NSH",0,0,3,0,0,3,0,1,1,1,1,4,"A","Y","2015-01-04","201501040ANA"
"BOS",0,0,1,0,0,1,0,1,0,0,1,2,"A","Y","2015-01-04","201501040CAR"
"CAR",0,1,0,0,1,2,0,0,1,0,0,1,"H","Y","2015-01-04","201501040CAR"
"CHI",1,1,2,1,0,5,0,1,2,1,0,4,"H","N","2015-01-04","201501040CHI"
"DAL",0,1,2,1,0,4,1,1,2,1,0,5,"A","N","2015-01-04","201501040CHI"
"CBJ",0,1,2,1,0,4,0,1,2,0,0,3,"A","N","2015-01-04","201501040COL"
"COL",0,1,2,0,0,3,0,1,2,1,0,4,"H","N","2015-01-04","201501040COL"
"EDM",0,1,1,3,0,5,0,0,1,1,0,2,"H","N","2015-01-04","201501040EDM"
"NYI",0,0,1,1,0,2,0,1,1,3,0,5,"A","N","2015-01-04","201501040EDM"
"OTT",0,1,1,0,0,2,0,0,3,1,0,4,"H","N","2015-01-04","201501040OTT"
"TBL",0,0,3,1,0,4,0,1,1,0,0,2,"A","N","2015-01-04","201501040OTT"
"FLA",0,0,2,1,0,3,0,0,3,1,0,4,"A","N","2015-01-04","201501040WSH"
"WSH",0,0,3,1,0,4,0,0,2,1,0,3,"H","N","2015-01-04","201501040WSH"
"SJS",0,1,1,1,0,3,0,1,0,1,0,2,"A","N","2015-01-05","201501050WPG"
"WPG",0,1,0,1,0,2,0,1,1,1,0,3,"H","N","2015-01-05","201501050WPG"
"ARI",0,0,0,0,0,0,0,1,3,2,0,6,"H","N","2015-01-06","201501060ARI"
"STL",0,1,3,2,0,6,0,0,0,0,0,0,"A","N","2015-01-06","201501060ARI"
"CHI",0,0,0,0,0,0,0,2,0,0,0,2,"H","N","2015-01-06","201501060CHI"
"COL",0,2,0,0,0,2,0,0,0,0,0,0,"A","N","2015-01-06","201501060CHI"
"CBJ",0,2,1,1,0,4,0,0,2,0,0,2,"A","N","2015-01-06","201501060DAL"
"DAL",0,0,2,0,0,2,0,2,1,1,0,4,"H","N","2015-01-06","201501060DAL"
"DET",0,0,2,2,0,4,0,1,0,1,0,2,"A","N","2015-01-06","201501060EDM"
"EDM",0,1,0,1,0,2,0,0,2,2,0,4,"H","N","2015-01-06","201501060EDM"
"MIN",0,2,0,1,0,3,1,0,1,2,0,4,"H","N","2015-01-06","201501060MIN"
"SJS",1,0,1,2,0,4,0,2,0,1,0,3,"A","N","2015-01-06","201501060MIN"
"MTL",0,1,0,1,0,2,0,0,4,0,0,4,"H","N","2015-01-06","201501060MTL"
"TBL",0,0,4,0,0,4,0,1,0,1,0,2,"A","N","2015-01-06","201501060MTL"
"BUF",0,0,1,0,0,1,0,3,0,1,0,4,"A","N","2015-01-06","201501060NJD"
"NJD",0,3,0,1,0,4,0,0,1,0,0,1,"H","N","2015-01-06","201501060NJD"
"CAR",0,1,0,1,0,2,0,0,0,3,0,3,"A","N","2015-01-06","201501060NSH"
"NSH",0,0,0,3,0,3,0,1,0,1,0,2,"H","N","2015-01-06","201501060NSH"
"OTT",0,0,0,1,0,1,0,0,0,1,1,2,"A","Y","2015-01-06","201501060PHI"
"PHI",0,0,0,1,1,2,0,0,0,1,0,1,"H","Y","2015-01-06","201501060PHI"
"NYI",0,1,0,1,0,2,0,1,2,0,0,3,"A","N","2015-01-06","201501060VAN"
"VAN",0,1,2,0,0,3,0,1,0,1,0,2,"H","N","2015-01-06","201501060VAN"
"ANA",0,0,0,1,0,1,0,0,1,3,0,4,"H","N","2015-01-07","201501070ANA"
"NYR",0,0,1,3,0,4,0,0,0,1,0,1,"A","N","2015-01-07","201501070ANA"
"CGY",0,1,0,1,0,2,0,1,1,1,0,3,"H","N","2015-01-07","201501070CGY"
"DET",0,1,1,1,0,3,0,1,0,1,0,2,"A","N","2015-01-07","201501070CGY"
"BOS",1,1,1,0,0,3,0,1,0,1,0,2,"A","N","2015-01-07","201501070PIT"
"PIT",0,1,0,1,0,2,1,1,1,0,0,3,"H","N","2015-01-07","201501070PIT"
"TOR",0,0,2,0,0,2,0,1,3,2,0,6,"H","N","2015-01-07","201501070TOR"
"WSH",0,1,3,2,0,6,0,0,2,0,0,2,"A","N","2015-01-07","201501070TOR"
"ARI",0,2,1,1,0,4,0,0,0,1,0,1,"H","N","2015-01-08","201501080ARI"
"WPG",0,0,0,1,0,1,0,2,1,1,0,4,"A","N","2015-01-08","201501080ARI"
"BOS",0,1,1,1,0,3,0,0,0,0,0,0,"H","N","2015-01-08","201501080BOS"
"NJD",0,0,0,0,0,0,0,1,1,1,0,3,"A","N","2015-01-08","201501080BOS"
"BUF",0,0,1,1,0,2,0,0,4,1,0,5,"A","N","2015-01-08","201501080CAR"
"CAR",0,0,4,1,0,5,0,0,1,1,0,2,"H","N","2015-01-08","201501080CAR"
"COL",0,2,1,2,0,5,0,0,1,1,0,2,"H","N","2015-01-08","201501080COL"
"OTT",0,0,1,1,0,2,0,2,1,2,0,5,"A","N","2015-01-08","201501080COL"
"LAK",0,2,0,1,0,3,0,1,3,0,0,4,"H","N","2015-01-08","201501080LAK"
"NYR",0,1,3,0,0,4,0,2,0,1,0,3,"A","N","2015-01-08","201501080LAK"
"CHI",0,2,0,2,0,4,0,0,1,1,0,2,"A","N","2015-01-08","201501080MIN"
"MIN",0,0,1,1,0,2,0,2,0,2,0,4,"H","N","2015-01-08","201501080MIN"
"DAL",0,0,2,0,0,2,1,1,1,0,0,3,"A","N","2015-01-08","201501080NSH"
"NSH",1,1,1,0,0,3,0,0,2,0,0,2,"H","N","2015-01-08","201501080NSH"
"PHI",1,1,0,1,0,3,0,1,0,1,0,2,"H","N","2015-01-08","201501080PHI"
"WSH",0,1,0,1,0,2,1,1,0,1,0,3,"A","N","2015-01-08","201501080PHI"
"SJS",0,1,1,0,0,2,0,3,2,2,0,7,"A","N","2015-01-08","201501080STL"
"STL",0,3,2,2,0,7,0,1,1,0,0,2,"H","N","2015-01-08","201501080STL"
"FLA",0,1,2,0,0,3,0,1,0,0,0,1,"A","N","2015-01-08","201501080VAN"
"VAN",0,1,0,0,0,1,0,1,2,0,0,3,"H","N","2015-01-08","201501080VAN"
"CGY",0,2,2,1,0,5,0,2,2,2,0,6,"H","N","2015-01-09","201501090CGY"
"FLA",0,2,2,2,0,6,0,2,2,1,0,5,"A","N","2015-01-09","201501090CGY"
"CHI",0,1,1,0,0,2,0,2,1,2,0,5,"A","N","2015-01-09","201501090EDM"
"EDM",0,2,1,2,0,5,0,1,1,0,0,2,"H","N","2015-01-09","201501090EDM"
"NJD",0,0,1,1,0,2,1,0,0,2,0,3,"H","N","2015-01-09","201501090NJD"
"NYI",1,0,0,2,0,3,0,0,1,1,0,2,"A","N","2015-01-09","201501090NJD"
"BUF",0,0,1,0,0,1,0,1,0,1,0,2,"A","N","2015-01-09","201501090TBL"
"TBL",0,1,0,1,0,2,0,0,1,0,0,1,"H","N","2015-01-09","201501090TBL"
"CBJ",0,1,1,0,0,2,0,4,0,1,0,5,"A","N","2015-01-09","201501090TOR"
"TOR",0,4,0,1,0,5,0,1,1,0,0,2,"H","N","2015-01-09","201501090TOR"
"ARI",0,1,0,0,0,1,0,2,1,2,0,5,"H","N","2015-01-10","201501100ARI"
"OTT",0,2,1,2,0,5,0,1,0,0,0,1,"A","N","2015-01-10","201501100ARI"
"CBJ",0,1,0,1,0,2,0,1,3,1,0,5,"H","N","2015-01-10","201501100CBJ"
"NYI",0,1,3,1,0,5,0,1,0,1,0,2,"A","N","2015-01-10","201501100CBJ"
"COL",0,0,3,1,0,4,0,2,0,1,0,3,"H","N","2015-01-10","201501100COL"
"DAL",0,2,0,1,0,3,0,0,3,1,0,4,"A","N","2015-01-10","201501100COL"
"LAK",0,2,0,2,0,4,0,3,0,1,1,5,"H","Y","2015-01-10","201501100LAK"
"WPG",0,3,0,1,1,5,0,2,0,2,0,4,"A","Y","2015-01-10","201501100LAK"
"MIN",0,1,0,0,0,1,0,1,0,2,0,3,"H","N","2015-01-10","201501100MIN"
"NSH",0,1,0,2,0,3,0,1,0,0,0,1,"A","N","2015-01-10","201501100MIN"
"MTL",0,1,0,0,0,1,1,0,1,0,0,2,"H","N","2015-01-10","201501100MTL"
"PIT",1,0,1,0,0,2,0,1,0,0,0,1,"A","N","2015-01-10","201501100MTL"
"BOS",0,1,0,2,0,3,0,0,0,1,0,1,"A","N","2015-01-10","201501100PHI"
"PHI",0,0,0,1,0,1,0,1,0,2,0,3,"H","N","2015-01-10","201501100PHI"
"NYR",0,2,0,1,0,3,0,0,0,1,0,1,"A","N","2015-01-10","201501100SJS"
"SJS",0,0,0,1,0,1,0,2,0,1,0,3,"H","N","2015-01-10","201501100SJS"
"CAR",0,3,1,0,0,4,0,1,2,1,1,5,"A","Y","2015-01-10","201501100STL"
"STL",0,1,2,1,1,5,0,3,1,0,0,4,"H","Y","2015-01-10","201501100STL"
"CGY",0,1,0,0,0,1,0,0,0,0,0,0,"A","N","2015-01-10","201501100VAN"
"VAN",0,0,0,0,0,0,0,1,0,0,0,1,"H","N","2015-01-10","201501100VAN"
"DET",0,0,1,0,0,1,0,1,2,0,0,3,"A","N","2015-01-10","201501100WSH"
"WSH",0,1,2,0,0,3,0,0,1,0,0,1,"H","N","2015-01-10","201501100WSH"
"ANA",0,1,1,2,1,5,0,3,1,0,0,4,"H","Y","2015-01-11","201501110ANA"
"WPG",0,3,1,0,0,4,0,1,1,2,1,5,"A","Y","2015-01-11","201501110ANA"
"CHI",0,2,2,0,0,4,0,0,0,1,0,1,"H","N","2015-01-11","201501110CHI"
"MIN",0,0,0,1,0,1,0,2,2,0,0,4,"A","N","2015-01-11","201501110CHI"
"EDM",0,0,1,1,0,2,0,1,1,2,0,4,"H","N","2015-01-11","201501110EDM"
"FLA",0,1,1,2,0,4,0,0,1,1,0,2,"A","N","2015-01-11","201501110EDM"
"LAK",0,1,0,1,0,2,0,0,0,0,0,0,"H","N","2015-01-12","201501120LAK"
"TOR",0,0,0,0,0,0,0,1,0,1,0,2,"A","N","2015-01-12","201501120LAK"
"PHI",0,2,5,0,0,7,0,1,1,1,0,3,"H","N","2015-01-12","201501120PHI"
"TBL",0,1,1,1,0,3,0,2,5,0,0,7,"A","N","2015-01-12","201501120PHI"
"COL",0,0,1,0,0,1,0,1,1,0,0,2,"A","N","2015-01-12","201501120WSH"
"WSH",0,1,1,0,0,2,0,0,1,0,0,1,"H","N","2015-01-12","201501120WSH"
"ARI",0,1,1,0,0,2,0,0,2,1,0,3,"H","N","2015-01-13","201501130ARI"
"SJS",0,0,2,1,0,3,0,1,1,0,0,2,"A","N","2015-01-13","201501130ARI"
"BOS",0,1,2,1,0,4,0,1,1,1,0,3,"H","N","2015-01-13","201501130BOS"
"TBL",0,1,1,1,0,3,0,1,2,1,0,4,"A","N","2015-01-13","201501130BOS"
"BUF",0,0,1,0,0,1,0,1,2,0,0,3,"H","N","2015-01-13","201501130BUF"
"DET",0,1,2,0,0,3,0,0,1,0,0,1,"A","N","2015-01-13","201501130BUF"
"CAR",0,1,1,0,1,3,0,0,0,2,0,2,"H","Y","2015-01-13","201501130CAR"
"COL",0,0,0,2,0,2,0,1,1,0,1,3,"A","Y","2015-01-13","201501130CAR"
"DAL",0,1,4,0,0,5,0,3,0,1,0,4,"H","N","2015-01-13","201501130DAL"
"OTT",0,3,0,1,0,4,0,1,4,0,0,5,"A","N","2015-01-13","201501130DAL"
"NSH",0,2,0,3,0,5,0,0,1,0,0,1,"H","N","2015-01-13","201501130NSH"
"VAN",0,0,1,0,0,1,0,2,0,3,0,5,"A","N","2015-01-13","201501130NSH"
"NYI",0,0,3,0,0,3,0,0,0,0,0,0,"A","N","2015-01-13","201501130NYR"
"NYR",0,0,0,0,0,0,0,0,3,0,0,3,"H","N","2015-01-13","201501130NYR"
"MIN",0,0,1,1,0,2,0,2,1,4,0,7,"A","N","2015-01-13","201501130PIT"
"PIT",0,2,1,4,0,7,0,0,1,1,0,2,"H","N","2015-01-13","201501130PIT"
"EDM",0,0,0,2,0,2,0,2,1,1,0,4,"A","N","2015-01-13","201501130STL"
"STL",0,2,1,1,0,4,0,0,0,2,0,2,"H","N","2015-01-13","201501130STL"
"FLA",0,0,1,1,0,2,0,2,4,2,0,8,"A","N","2015-01-13","201501130WPG"
"WPG",0,2,4,2,0,8,0,0,1,1,0,2,"H","N","2015-01-13","201501130WPG"
"ANA",0,1,2,1,0,4,0,0,0,0,0,0,"H","N","2015-01-14","201501140ANA"
"TOR",0,0,0,0,0,0,0,1,2,1,0,4,"A","N","2015-01-14","201501140ANA"
"CBJ",0,1,0,1,0,2,0,0,0,3,0,3,"H","N","2015-01-14","201501140CBJ"
"MTL",0,0,0,3,0,3,0,1,0,1,0,2,"A","N","2015-01-14","201501140CBJ"
"LAK",0,0,1,2,0,3,0,1,4,0,0,5,"H","N","2015-01-14","201501140LAK"
"NJD",0,1,4,0,0,5,0,0,1,2,0,3,"A","N","2015-01-14","201501140LAK"
"PHI",0,0,0,0,0,0,0,1,0,0,0,1,"A","N","2015-01-14","201501140WSH"
"WSH",0,1,0,0,0,1,0,0,0,0,0,0,"H","N","2015-01-14","201501140WSH"
"ARI",0,0,1,0,0,1,0,0,1,3,0,4,"H","N","2015-01-15","201501150ARI"
"CGY",0,0,1,3,0,4,0,0,1,0,0,1,"A","N","2015-01-15","201501150ARI"
"BOS",0,1,1,1,0,3,0,0,0,0,0,0,"H","N","2015-01-15","201501150BOS"
"NYR",0,0,0,0,0,0,0,1,1,1,0,3,"A","N","2015-01-15","201501150BOS"
"BUF",0,0,0,0,0,0,0,2,3,2,0,7,"H","N","2015-01-15","201501150BUF"
"MIN",0,2,3,2,0,7,0,0,0,0,0,0,"A","N","2015-01-15","201501150BUF"
"DAL",0,0,0,1,0,1,0,1,0,1,0,2,"H","N","2015-01-15","201501150DAL"
"WPG",0,1,0,1,0,2,0,0,0,1,0,1,"A","N","2015-01-15","201501150DAL"
"COL",0,1,1,2,0,4,0,1,1,0,0,2,"A","N","2015-01-15","201501150FLA"
"FLA",0,1,1,0,0,2,0,1,1,2,0,4,"H","N","2015-01-15","201501150FLA"
"MTL",0,1,0,0,0,1,0,2,1,1,0,4,"A","N","2015-01-15","201501150OTT"
"OTT",0,2,1,1,0,4,0,1,0,0,0,1,"H","N","2015-01-15","201501150OTT"
"PHI",0,0,0,0,0,0,0,2,2,0,0,4,"H","N","2015-01-15","201501150PHI"
"VAN",0,2,2,0,0,4,0,0,0,0,0,0,"A","N","2015-01-15","201501150PHI"
"SJS",0,2,0,1,0,3,0,1,0,0,0,1,"H","N","2015-01-15","201501150SJS"
"TOR",0,1,0,0,0,1,0,2,0,1,0,3,"A","N","2015-01-15","201501150SJS"
"DET",1,0,2,0,0,3,0,0,0,2,0,2,"A","N","2015-01-15","201501150STL"
"STL",0,0,0,2,0,2,1,0,2,0,0,3,"H","N","2015-01-15","201501150STL"
"EDM",0,1,1,0,0,2,0,0,1,2,0,3,"A","N","2015-01-15","201501150TBL"
"TBL",0,0,1,2,0,3,0,1,1,0,0,2,"H","N","2015-01-15","201501150TBL"
"ANA",0,1,2,2,0,5,0,1,0,0,0,1,"H","N","2015-01-16","201501160ANA"
"NJD",0,1,0,0,0,1,0,1,2,2,0,5,"A","N","2015-01-16","201501160ANA"
"CAR",0,0,0,0,0,0,0,0,3,0,0,3,"H","N","2015-01-16","201501160CAR"
"VAN",0,0,3,0,0,3,0,0,0,0,0,0,"A","N","2015-01-16","201501160CAR"
"CBJ",0,0,0,1,0,1,0,0,2,0,0,2,"H","N","2015-01-16","201501160CBJ"
"NYR",0,0,2,0,0,2,0,0,0,1,0,1,"A","N","2015-01-16","201501160CBJ"
"CHI",0,1,0,1,0,2,0,1,0,3,0,4,"H","N","2015-01-16","201501160CHI"
"WPG",0,1,0,3,0,4,0,1,0,1,0,2,"A","N","2015-01-16","201501160CHI"
"NSH",0,1,1,2,0,4,0,0,2,1,0,3,"H","N","2015-01-16","201501160NSH"
"WSH",0,0,2,1,0,3,0,1,1,2,0,4,"A","N","2015-01-16","201501160NSH"
"NYI",0,1,1,4,0,6,0,2,1,0,0,3,"H","N","2015-01-16","201501160NYI"
"PIT",0,2,1,0,0,3,0,1,1,4,0,6,"A","N","2015-01-16","201501160NYI"
"BOS",0,1,0,0,0,1,0,1,0,2,0,3,"H","N","2015-01-17","201501170BOS"
"CBJ",0,1,0,2,0,3,0,1,0,0,0,1,"A","N","2015-01-17","201501170BOS"
"BUF",0,1,1,1,0,3,0,0,2,2,0,4,"H","N","2015-01-17","201501170BUF"
"PHI",0,0,2,2,0,4,0,1,1,1,0,3,"A","N","2015-01-17","201501170BUF"
"DAL",0,2,1,2,0,5,0,0,2,2,0,4,"H","N","2015-01-17","201501170DAL"
"WSH",0,0,2,2,0,4,0,2,1,2,0,5,"A","N","2015-01-17","201501170DAL"
"DET",0,3,2,0,0,5,0,1,0,1,0,2,"H","N","2015-01-17","201501170DET"
"NSH",0,1,0,1,0,2,0,3,2,0,0,5,"A","N","2015-01-17","201501170DET"
"EDM",0,0,1,1,1,3,0,0,2,0,0,2,"A","Y","2015-01-17","201501170FLA"
"FLA",0,0,2,0,0,2,0,0,1,1,1,3,"H","Y","2015-01-17","201501170FLA"
"ANA",0,0,1,1,1,3,0,0,2,0,0,2,"A","Y","2015-01-17","201501170LAK"
"LAK",0,0,2,0,0,2,0,0,1,1,1,3,"H","Y","2015-01-17","201501170LAK"
"ARI",0,0,1,0,0,1,0,1,1,1,0,3,"A","N","2015-01-17","201501170MIN"
"MIN",0,1,1,1,0,3,0,0,1,0,0,1,"H","N","2015-01-17","201501170MIN"
"MTL",0,1,2,3,0,6,0,0,2,2,0,4,"H","N","2015-01-17","201501170MTL"
"NYI",0,0,2,2,0,4,0,1,2,3,0,6,"A","N","2015-01-17","201501170MTL"
"CAR",0,1,0,2,0,3,0,0,1,1,0,2,"A","N","2015-01-17","201501170OTT"
"OTT",0,0,1,1,0,2,0,1,0,2,0,3,"H","N","2015-01-17","201501170OTT"
"CGY",1,2,1,0,0,4,0,0,3,0,0,3,"A","N","2015-01-17","201501170SJS"
"SJS",0,0,3,0,0,3,1,2,1,0,0,4,"H","N","2015-01-17","201501170SJS"
"STL",0,1,0,2,0,3,0,0,0,0,0,0,"H","N","2015-01-17","201501170STL"
"TOR",0,0,0,0,0,0,0,1,0,2,0,3,"A","N","2015-01-17","201501170STL"
"COL",0,0,1,1,0,2,0,1,0,1,1,3,"A","Y","2015-01-17","201501170TBL"
"TBL",0,1,0,1,1,3,0,0,1,1,0,2,"H","Y","2015-01-17","201501170TBL"
"CHI",0,2,1,0,0,3,0,3,0,3,0,6,"H","N","2015-01-18","201501180CHI"
"DAL",0,3,0,3,0,6,0,2,1,0,0,3,"A","N","2015-01-18","201501180CHI"
"BUF",0,3,0,1,0,4,0,0,3,3,0,6,"A","N","2015-01-18","201501180DET"
"DET",0,0,3,3,0,6,0,3,0,1,0,4,"H","N","2015-01-18","201501180DET"
"NYR",0,2,2,1,0,5,0,1,0,1,0,2,"A","N","2015-01-18","201501180PIT"
"PIT",0,1,0,1,0,2,0,2,2,1,0,5,"H","N","2015-01-18","201501180PIT"
"ARI",0,1,0,2,0,3,0,1,1,1,1,4,"A","Y","2015-01-18","201501180WPG"
"WPG",0,1,1,1,1,4,0,1,0,2,0,3,"H","Y","2015-01-18","201501180WPG"
"FLA",0,0,0,1,0,1,0,2,0,0,0,2,"H","N","2015-01-19","201501190FLA"
"VAN",0,2,0,0,0,2,0,0,0,1,0,1,"A","N","2015-01-19","201501190FLA"
"CGY",1,0,0,1,0,2,0,0,0,1,0,1,"A","N","2015-01-19","201501190LAK"
"LAK",0,0,0,1,0,1,1,0,0,1,0,2,"H","N","2015-01-19","201501190LAK"
"CBJ",0,1,0,2,0,3,0,1,0,0,0,1,"A","N","2015-01-19","201501190MIN"
"MIN",0,1,0,0,0,1,0,1,0,2,0,3,"H","N","2015-01-19","201501190MIN"
"NYI",0,2,3,2,0,7,0,0,2,2,0,4,"H","N","2015-01-19","201501190NYI"
"PHI",0,0,2,2,0,4,0,2,3,2,0,7,"A","N","2015-01-19","201501190NYI"
"NJD",0,2,1,2,0,5,0,1,1,0,0,2,"A","N","2015-01-19","201501190SJS"
"SJS",0,1,1,0,0,2,0,2,1,2,0,5,"H","N","2015-01-19","201501190SJS"
"COL",0,1,0,0,0,1,0,1,2,0,0,3,"A","N","2015-01-19","201501190STL"
"STL",0,1,2,0,0,3,0,1,0,0,0,1,"H","N","2015-01-19","201501190STL"
"CAR",0,2,1,1,0,4,0,0,0,1,0,1,"A","N","2015-01-19","201501190TOR"
"TOR",0,0,0,1,0,1,0,2,1,1,0,4,"H","N","2015-01-19","201501190TOR"
"ARI",0,0,1,0,0,1,0,2,3,1,0,6,"A","N","2015-01-20","201501200CHI"
"CHI",0,2,3,1,0,6,0,0,1,0,0,1,"H","N","2015-01-20","201501200CHI"
"BOS",0,0,2,1,0,3,0,0,1,0,0,1,"A","N","2015-01-20","201501200DAL"
"DAL",0,0,1,0,0,1,0,0,2,1,0,3,"H","N","2015-01-20","201501200DAL"
"DET",0,2,2,0,1,5,0,1,0,3,0,4,"H","Y","2015-01-20","201501200DET"
"MIN",0,1,0,3,0,4,0,2,2,0,1,5,"A","Y","2015-01-20","201501200DET"
"MTL",1,0,0,1,0,2,0,0,1,0,0,1,"H","N","2015-01-20","201501200MTL"
"NSH",0,0,1,0,0,1,1,0,0,1,0,2,"A","N","2015-01-20","201501200MTL"
"NYR",1,0,1,1,0,3,0,0,2,0,0,2,"H","N","2015-01-20","201501200NYR"
"OTT",0,0,2,0,0,2,1,0,1,1,0,3,"A","N","2015-01-20","201501200NYR"
"PHI",1,1,0,1,0,3,0,0,1,1,0,2,"H","N","2015-01-20","201501200PHI"
"PIT",0,0,1,1,0,2,1,1,0,1,0,3,"A","N","2015-01-20","201501200PHI"
"TBL",0,0,1,3,0,4,0,0,0,1,0,1,"H","N","2015-01-20","201501200TBL"
"VAN",0,0,0,1,0,1,0,0,1,3,0,4,"A","N","2015-01-20","201501200TBL"
"EDM",0,1,1,2,1,5,0,3,0,1,0,4,"A","Y","2015-01-20","201501200WSH"
"WSH",0,3,0,1,0,4,0,1,1,2,1,5,"H","Y","2015-01-20","201501200WSH"
"ANA",0,3,1,2,0,6,0,0,2,1,0,3,"H","N","2015-01-21","201501210ANA"
"CGY",0,0,2,1,0,3,0,3,1,2,0,6,"A","N","2015-01-21","201501210ANA"
"BOS",0,0,1,1,0,2,0,1,0,1,1,3,"A","Y","2015-01-21","201501210COL"
"COL",0,1,0,1,1,3,0,0,1,1,0,2,"H","Y","2015-01-21","201501210COL"
"OTT",0,3,0,1,0,4,0,0,1,2,0,3,"H","N","2015-01-21","201501210OTT"
"TOR",0,0,1,2,0,3,0,3,0,1,0,4,"A","N","2015-01-21","201501210OTT"
"CHI",0,1,1,0,1,3,0,0,2,0,0,2,"A","Y","2015-01-21","201501210PIT"
"PIT",0,0,2,0,0,2,0,1,1,0,1,3,"H","Y","2015-01-21","201501210PIT"
"LAK",0,0,1,1,0,2,0,1,1,2,0,4,"A","N","2015-01-21","201501210SJS"
"SJS",0,1,1,2,0,4,0,0,1,1,0,2,"H","N","2015-01-21","201501210SJS"
"CBJ",0,0,0,0,0,0,0,2,2,0,0,4,"A","N","2015-01-21","201501210WPG"
"WPG",0,2,2,0,0,4,0,0,0,0,0,0,"H","N","2015-01-21","201501210WPG"
"CAR",0,2,1,1,0,4,0,1,1,0,0,2,"H","N","2015-01-27","201501270CAR"
"TBL",0,1,1,0,0,2,0,2,1,1,0,4,"A","N","2015-01-27","201501270CAR"
"CBJ",0,0,3,1,0,4,0,0,2,1,0,3,"H","N","2015-01-27","201501270CBJ"
"WSH",0,0,2,1,0,3,0,0,3,1,0,4,"A","N","2015-01-27","201501270CBJ"
"BUF",0,1,0,0,0,1,0,1,0,3,0,4,"A","N","2015-01-27","201501270CGY"
"CGY",0,1,0,3,0,4,0,1,0,0,0,1,"H","N","2015-01-27","201501270CGY"
"EDM",0,0,1,0,0,1,0,1,0,1,0,2,"H","N","2015-01-27","201501270EDM"
"MIN",0,1,0,1,0,2,0,0,1,0,0,1,"A","N","2015-01-27","201501270EDM"
"DET",0,1,4,0,0,5,0,2,1,1,0,4,"A","N","2015-01-27","201501270FLA"
"FLA",0,2,1,1,0,4,0,1,4,0,0,5,"H","N","2015-01-27","201501270FLA"
"DAL",0,1,1,0,0,2,0,2,1,0,0,3,"A","N","2015-01-27","201501270MTL"
"MTL",0,2,1,0,0,3,0,1,1,0,0,2,"H","N","2015-01-27","201501270MTL"
"COL",0,1,1,1,0,3,1,0,2,1,0,4,"A","N","2015-01-27","201501270NSH"
"NSH",1,0,2,1,0,4,0,1,1,1,0,3,"H","N","2015-01-27","201501270NSH"
"NYI",0,1,1,2,0,4,0,0,0,1,0,1,"H","N","2015-01-27","201501270NYI"
"NYR",0,0,0,1,0,1,0,1,1,2,0,4,"A","N","2015-01-27","201501270NYI"
"ARI",0,2,1,0,0,3,0,1,2,0,1,4,"A","Y","2015-01-27","201501270PHI"
"PHI",0,1,2,0,1,4,0,2,1,0,0,3,"H","Y","2015-01-27","201501270PHI"
"PIT",0,1,1,3,0,5,0,0,2,1,0,3,"H","N","2015-01-27","201501270PIT"
"WPG",0,0,2,1,0,3,0,1,1,3,0,5,"A","N","2015-01-27","201501270PIT"
"ANA",0,1,1,2,0,4,0,0,0,0,0,0,"A","N","2015-01-27","201501270VAN"
"VAN",0,0,0,0,0,0,0,1,1,2,0,4,"H","N","2015-01-27","201501270VAN"
"CHI",0,2,0,1,0,3,0,1,1,2,0,4,"A","N","2015-01-28","201501280LAK"
"LAK",0,1,1,2,0,4,0,2,0,1,0,3,"H","N","2015-01-28","201501280LAK"
"NJD",0,0,0,1,1,2,0,0,0,1,0,1,"H","Y","2015-01-28","201501280NJD"
"TOR",0,0,0,1,0,1,0,0,0,1,1,2,"A","Y","2015-01-28","201501280NJD"
"PIT",0,0,0,0,0,0,0,1,1,2,0,4,"A","N","2015-01-28","201501280WSH"
"WSH",0,1,1,2,0,4,0,0,0,0,0,0,"H","N","2015-01-28","201501280WSH"
"CGY",0,0,0,0,0,0,0,1,0,0,0,1,"H","N","2015-01-29","201501290CGY"
"MIN",0,1,0,0,0,1,0,0,0,0,0,0,"A","N","2015-01-29","201501290CGY"
"BUF",0,1,0,1,0,2,0,2,0,1,0,3,"A","N","2015-01-29","201501290EDM"
"EDM",0,2,0,1,0,3,0,1,0,1,0,2,"H","N","2015-01-29","201501290EDM"
"CBJ",0,0,2,0,0,2,0,0,2,1,0,3,"A","N","2015-01-29","201501290FLA"
"FLA",0,0,2,1,0,3,0,0,2,0,0,2,"H","N","2015-01-29","201501290FLA"
"BOS",0,2,1,2,0,5,0,0,2,0,0,2,"A","N","2015-01-29","201501290NYI"
"NYI",0,0,2,0,0,2,0,2,1,2,0,5,"H","N","2015-01-29","201501290NYI"
"MTL",0,0,0,1,0,1,0,0,0,0,0,0,"A","N","2015-01-29","201501290NYR"
"NYR",0,0,0,0,0,0,0,0,0,1,0,1,"H","N","2015-01-29","201501290NYR"
"DAL",0,3,0,3,0,6,0,2,0,1,0,3,"A","N","2015-01-29","201501290OTT"
"OTT",0,2,0,1,0,3,0,3,0,3,0,6,"H","N","2015-01-29","201501290OTT"
"PHI",0,2,1,2,0,5,0,2,0,0,0,2,"H","N","2015-01-29","201501290PHI"
"WPG",0,2,0,0,0,2,0,2,1,2,0,5,"A","N","2015-01-29","201501290PHI"
"ANA",0,1,0,2,0,3,0,1,5,0,0,6,"A","N","2015-01-29","201501290SJS"
"SJS",0,1,5,0,0,6,0,1,0,2,0,3,"H","N","2015-01-29","201501290SJS"
"NSH",0,1,2,1,0,4,0,0,4,0,1,5,"A","Y","2015-01-29","201501290STL"
"STL",0,0,4,0,1,5,0,1,2,1,0,4,"H","Y","2015-01-29","201501290STL"
"DET",0,1,0,0,0,1,0,2,3,0,0,5,"A","N","2015-01-29","201501290TBL"
"TBL",0,2,3,0,0,5,0,1,0,0,0,1,"H","N","2015-01-29","201501290TBL"
"ARI",0,0,0,3,0,3,0,1,0,0,0,1,"A","N","2015-01-29","201501290TOR"
"TOR",0,1,0,0,0,1,0,0,0,3,0,3,"H","N","2015-01-29","201501290TOR"
"ANA",0,0,0,1,0,1,0,1,2,1,0,4,"H","N","2015-01-30","201501300ANA"
"CHI",0,1,2,1,0,4,0,0,0,1,0,1,"A","N","2015-01-30","201501300ANA"
"CAR",0,1,1,0,0,2,0,2,0,0,1,3,"H","Y","2015-01-30","201501300CAR"
"STL",0,2,0,0,1,3,0,1,1,0,0,2,"A","Y","2015-01-30","201501300CAR"
"COL",0,1,0,2,0,3,0,0,0,0,0,0,"H","N","2015-01-30","201501300COL"
"NSH",0,0,0,0,0,0,0,1,0,2,0,3,"A","N","2015-01-30","201501300COL"
"NJD",0,0,0,1,0,1,1,0,0,1,0,2,"H","N","2015-01-30","201501300NJD"
"PIT",1,0,0,1,0,2,0,0,0,1,0,1,"A","N","2015-01-30","201501300NJD"
"BUF",0,1,1,0,0,2,0,1,2,2,0,5,"A","N","2015-01-30","201501300VAN"
"VAN",0,1,2,2,0,5,0,1,1,0,0,2,"H","N","2015-01-30","201501300VAN"
"BOS",0,0,1,2,0,3,0,0,0,1,0,1,"H","N","2015-01-31","201501310BOS"
"LAK",0,0,0,1,0,1,0,0,1,2,0,3,"A","N","2015-01-31","201501310BOS"
"CGY",0,0,0,4,0,4,0,2,0,0,0,2,"H","N","2015-01-31","201501310CGY"
"EDM",0,2,0,0,0,2,0,0,0,4,0,4,"A","N","2015-01-31","201501310CGY"
"DET",0,1,1,2,0,4,0,0,0,1,0,1,"H","N","2015-01-31","201501310DET"
"NYI",0,0,0,1,0,1,0,1,1,2,0,4,"A","N","2015-01-31","201501310DET"
"MTL",1,0,0,0,0,1,0,0,0,0,0,0,"H","N","2015-01-31","201501310MTL"
"WSH",0,0,0,0,0,0,1,0,0,0,0,1,"A","N","2015-01-31","201501310MTL"
"FLA",0,0,0,1,0,1,0,2,0,1,0,3,"A","N","2015-01-31","201501310NJD"
"NJD",0,2,0,1,0,3,0,0,0,1,0,1,"H","N","2015-01-31","201501310NJD"
"CAR",0,0,1,0,0,1,0,2,0,2,0,4,"A","N","2015-01-31","201501310NYR"
"NYR",0,2,0,2,0,4,0,0,1,0,0,1,"H","N","2015-01-31","201501310NYR"
"ARI",0,1,0,1,0,2,0,1,2,4,0,7,"A","N","2015-01-31","201501310OTT"
"OTT",0,1,2,4,0,7,0,1,0,1,0,2,"H","N","2015-01-31","201501310OTT"
"PHI",0,1,0,0,0,1,0,0,0,0,0,0,"H","N","2015-01-31","201501310PHI"
"TOR",0,0,0,0,0,0,0,1,0,0,0,1,"A","N","2015-01-31","201501310PHI"
"CHI",0,0,0,0,0,0,0,1,0,1,0,2,"A","N","2015-01-31","201501310SJS"
"SJS",0,1,0,1,0,2,0,0,0,0,0,0,"H","N","2015-01-31","201501310SJS"
"CBJ",0,0,0,1,0,1,0,1,0,2,0,3,"A","N","2015-01-31","201501310TBL"
"TBL",0,1,0,2,0,3,0,0,0,1,0,1,"H","N","2015-01-31","201501310TBL"
"DAL",0,1,2,2,0,5,0,0,1,1,0,2,"A","N","2015-01-31","201501310WPG"
"WPG",0,0,1,1,0,2,0,1,2,2,0,5,"H","N","2015-01-31","201501310WPG"
"ARI",0,0,1,2,0,3,0,2,0,0,0,2,"A","N","2015-02-01","201502010MTL"
"MTL",0,2,0,0,0,2,0,0,1,2,0,3,"H","N","2015-02-01","201502010MTL"
"NSH",0,2,1,1,0,4,0,0,0,0,0,0,"A","N","2015-02-01","201502010PIT"
"PIT",0,0,0,0,0,0,0,2,1,1,0,4,"H","N","2015-02-01","201502010PIT"
"MIN",0,0,2,2,0,4,0,0,0,2,0,2,"A","N","2015-02-01","201502010VAN"
"VAN",0,0,0,2,0,2,0,0,2,2,0,4,"H","N","2015-02-01","201502010VAN"
"STL",0,1,2,1,0,4,0,1,1,1,0,3,"A","N","2015-02-01","201502010WSH"
"WSH",0,1,1,1,0,3,0,1,2,1,0,4,"H","N","2015-02-01","201502010WSH"
"CGY",0,1,1,3,0,5,0,1,0,1,0,2,"H","N","2015-02-02","201502020CGY"
"WPG",0,1,0,1,0,2,0,1,1,3,0,5,"A","N","2015-02-02","201502020CGY"
"FLA",0,1,2,0,0,3,0,1,2,3,0,6,"A","N","2015-02-02","201502020NYR"
"NYR",0,1,2,3,0,6,0,1,2,0,0,3,"H","N","2015-02-02","201502020NYR"
"EDM",0,1,2,1,1,5,0,1,0,3,0,4,"A","Y","2015-02-02","201502020SJS"
"SJS",0,1,0,3,0,4,0,1,2,1,1,5,"H","Y","2015-02-02","201502020SJS"
"ANA",1,0,2,2,0,5,0,0,2,2,0,4,"H","N","2015-02-03","201502030ANA"
"CAR",0,0,2,2,0,4,1,0,2,2,0,5,"A","N","2015-02-03","201502030ANA"
"ARI",0,1,2,1,0,4,0,0,1,0,0,1,"A","N","2015-02-03","201502030CBJ"
"CBJ",0,0,1,0,0,1,0,1,2,1,0,4,"H","N","2015-02-03","201502030CBJ"
"COL",0,0,0,2,1,3,0,1,1,0,0,2,"A","Y","2015-02-03","201502030DAL"
"DAL",0,1,1,0,0,2,0,0,0,2,1,3,"H","Y","2015-02-03","201502030DAL"
"CHI",0,0,0,0,0,0,0,2,1,0,0,3,"A","N","2015-02-03","201502030MIN"
"MIN",0,2,1,0,0,3,0,0,0,0,0,0,"H","N","2015-02-03","201502030MIN"
"BUF",0,3,0,0,0,3,0,1,0,1,0,2,"A","N","2015-02-03","201502030MTL"
"MTL",0,1,0,1,0,2,0,3,0,0,0,3,"H","N","2015-02-03","201502030MTL"
"NJD",0,0,1,1,0,2,0,0,1,0,0,1,"H","N","2015-02-03","201502030NJD"
"OTT",0,0,1,0,0,1,0,0,1,1,0,2,"A","N","2015-02-03","201502030NJD"
"NSH",0,2,0,2,0,4,0,0,1,2,0,3,"H","N","2015-02-03","201502030NSH"
"TOR",0,0,1,2,0,3,0,2,0,2,0,4,"A","N","2015-02-03","201502030NSH"
"FLA",0,1,1,2,0,4,0,1,1,0,0,2,"A","N","2015-02-03","201502030NYI"
"NYI",0,1,1,0,0,2,0,1,1,2,0,4,"H","N","2015-02-03","201502030NYI"
"STL",1,0,0,1,0,2,0,1,0,0,0,1,"H","N","2015-02-03","201502030STL"
"TBL",0,1,0,0,0,1,1,0,0,1,0,2,"A","N","2015-02-03","201502030STL"
"VAN",1,1,0,1,0,3,0,1,0,1,0,2,"H","N","2015-02-03","201502030VAN"
"WPG",0,1,0,1,0,2,1,1,0,1,0,3,"A","N","2015-02-03","201502030VAN"
"LAK",0,0,0,0,0,0,0,1,1,2,0,4,"A","N","2015-02-03","201502030WSH"
"WSH",0,1,1,2,0,4,0,0,0,0,0,0,"H","N","2015-02-03","201502030WSH"
"CGY",0,0,3,0,0,3,0,0,0,1,0,1,"H","N","2015-02-04","201502040CGY"
"SJS",0,0,0,1,0,1,0,0,3,0,0,3,"A","N","2015-02-04","201502040CGY"
"EDM",0,0,0,0,0,0,0,0,2,0,0,2,"H","N","2015-02-04","201502040EDM"
"PIT",0,0,2,0,0,2,0,0,0,0,0,0,"A","N","2015-02-04","201502040EDM"
"BOS",0,2,0,0,0,2,0,1,2,0,0,3,"A","N","2015-02-04","201502040NYR"
"NYR",0,1,2,0,0,3,0,2,0,0,0,2,"H","N","2015-02-04","201502040NYR"
"ARI",0,1,0,0,0,1,0,1,0,0,1,2,"H","Y","2015-02-05","201502050ARI"
"CAR",0,1,0,0,1,2,0,1,0,0,0,1,"A","Y","2015-02-05","201502050ARI"
"BUF",0,0,0,0,0,0,0,0,1,2,0,3,"H","N","2015-02-05","201502050BUF"
"STL",0,0,1,2,0,3,0,0,0,0,0,0,"A","N","2015-02-05","201502050BUF"
"COL",0,0,0,0,0,0,0,0,1,2,0,3,"H","N","2015-02-05","201502050COL"
"DET",0,0,1,2,0,3,0,0,0,0,0,0,"A","N","2015-02-05","201502050COL"
"DAL",0,0,2,1,0,3,0,2,0,3,0,5,"H","N","2015-02-05","201502050DAL"
"TBL",0,2,0,3,0,5,0,0,2,1,0,3,"A","N","2015-02-05","201502050DAL"
"FLA",0,1,0,2,0,3,0,1,0,1,0,2,"H","N","2015-02-05","201502050FLA"
"LAK",0,1,0,1,0,2,0,1,0,2,0,3,"A","N","2015-02-05","201502050FLA"
"ANA",0,2,2,1,0,5,0,0,0,2,0,2,"A","N","2015-02-05","201502050NSH"
"NSH",0,0,0,2,0,2,0,2,2,1,0,5,"H","N","2015-02-05","201502050NSH"
"OTT",0,0,1,0,0,1,0,0,2,0,0,2,"H","N","2015-02-05","201502050OTT"
"WSH",0,0,2,0,0,2,0,0,1,0,0,1,"A","N","2015-02-05","201502050OTT"
"NYI",0,0,2,0,1,3,0,1,1,0,0,2,"A","Y","2015-02-05","201502050PHI"
"PHI",0,1,1,0,0,2,0,0,2,0,1,3,"H","Y","2015-02-05","201502050PHI"
"SJS",0,1,2,2,0,5,0,0,0,1,0,1,"A","N","2015-02-05","201502050VAN"
"VAN",0,0,0,1,0,1,0,1,2,2,0,5,"H","N","2015-02-05","201502050VAN"
"CBJ",0,2,3,2,0,7,0,0,1,0,0,1,"H","N","2015-02-06","201502060CBJ"
"STL",0,0,1,0,0,1,0,2,3,2,0,7,"A","N","2015-02-06","201502060CBJ"
"CGY",0,0,0,0,0,0,0,2,1,1,0,4,"H","N","2015-02-06","201502060CGY"
"PIT",0,2,1,1,0,4,0,0,0,0,0,0,"A","N","2015-02-06","201502060CGY"
"NJD",0,1,2,1,0,4,0,0,0,1,0,1,"H","N","2015-02-06","201502060NJD"
"TOR",0,0,0,1,0,1,0,1,2,1,0,4,"A","N","2015-02-06","201502060NJD"
"CHI",1,0,1,0,0,2,0,1,0,0,0,1,"A","N","2015-02-06","201502060WPG"
"WPG",0,1,0,0,0,1,1,0,1,0,0,2,"H","N","2015-02-06","201502060WPG"
"ANA",0,1,0,1,0,2,0,0,1,1,1,3,"A","Y","2015-02-06","201502060WSH"
"WSH",0,0,1,1,1,3,0,1,0,1,0,2,"H","Y","2015-02-06","201502060WSH"
"ARI",0,0,0,1,0,1,0,0,1,2,0,3,"H","N","2015-02-07","201502070ARI"
"DET",0,0,1,2,0,3,0,0,0,1,0,1,"A","N","2015-02-07","201502070ARI"
"BOS",0,1,0,1,0,2,0,1,0,0,0,1,"H","N","2015-02-07","201502070BOS"
"NYI",0,1,0,0,0,1,0,1,0,1,0,2,"A","N","2015-02-07","201502070BOS"
"BUF",0,1,2,0,0,3,0,0,1,1,0,2,"H","N","2015-02-07","201502070BUF"
"DAL",0,0,1,1,0,2,0,1,2,0,0,3,"A","N","2015-02-07","201502070BUF"
"COL",0,0,0,0,0,0,0,1,0,0,0,1,"A","N","2015-02-07","201502070MIN"
"MIN",0,1,0,0,0,1,0,0,0,0,0,0,"H","N","2015-02-07","201502070MIN"
"MTL",0,0,3,3,0,6,0,1,0,1,0,2,"H","N","2015-02-07","201502070MTL"
"NJD",0,1,0,1,0,2,0,0,3,3,0,6,"A","N","2015-02-07","201502070MTL"
"NSH",0,0,2,1,0,3,0,0,1,1,0,2,"H","N","2015-02-07","201502070NSH"
"NYR",0,0,1,1,0,2,0,0,2,1,0,3,"A","N","2015-02-07","201502070NSH"
"CBJ",0,0,0,4,0,4,0,0,0,1,0,1,"A","N","2015-02-07","201502070OTT"
"OTT",0,0,0,1,0,1,0,0,0,4,0,4,"H","N","2015-02-07","201502070OTT"
"CAR",0,1,2,2,0,5,0,0,1,3,0,4,"A","N","2015-02-07","201502070SJS"
"SJS",0,0,1,3,0,4,0,1,2,2,0,5,"H","N","2015-02-07","201502070SJS"
"LAK",0,3,0,1,0,4,0,0,1,1,0,2,"A","N","2015-02-07","201502070TBL"
"TBL",0,0,1,1,0,2,0,3,0,1,0,4,"H","N","2015-02-07","201502070TBL"
"EDM",0,0,0,1,0,1,0,0,3,2,0,5,"A","N","2015-02-07","201502070TOR"
"TOR",0,0,3,2,0,5,0,0,0,1,0,1,"H","N","2015-02-07","201502070TOR"
"PIT",0,0,0,0,0,0,0,2,2,1,0,5,"A","N","2015-02-07","201502070VAN"
"VAN",0,2,2,1,0,5,0,0,0,0,0,0,"H","N","2015-02-07","201502070VAN"
"BOS",0,0,0,1,0,1,0,0,1,2,0,3,"H","N","2015-02-08","201502080BOS"
"MTL",0,0,1,2,0,3,0,0,0,1,0,1,"A","N","2015-02-08","201502080BOS"
"BUF",0,0,2,0,0,2,0,1,2,0,0,3,"H","N","2015-02-08","201502080BUF"
"NYI",0,1,2,0,0,3,0,0,2,0,0,2,"A","N","2015-02-08","201502080BUF"
"FLA",0,0,2,0,0,2,0,0,0,2,1,3,"H","Y","2015-02-08","201502080FLA"
"NSH",0,0,0,2,1,3,0,0,2,0,0,2,"A","Y","2015-02-08","201502080FLA"
"DAL",1,0,2,0,0,3,0,0,1,1,0,2,"A","N","2015-02-08","201502080NYR"
"NYR",0,0,1,1,0,2,1,0,2,0,0,3,"H","N","2015-02-08","201502080NYR"
"CHI",0,1,1,2,0,4,0,0,2,0,0,2,"A","N","2015-02-08","201502080STL"
"STL",0,0,2,0,0,2,0,1,1,2,0,4,"H","N","2015-02-08","201502080STL"
"ANA",0,0,1,2,0,3,0,3,1,1,0,5,"A","N","2015-02-08","201502080TBL"
"TBL",0,3,1,1,0,5,0,0,1,2,0,3,"H","N","2015-02-08","201502080TBL"
"COL",0,1,0,2,0,3,0,0,4,1,0,5,"A","N","2015-02-08","201502080WPG"
"WPG",0,0,4,1,0,5,0,1,0,2,0,3,"H","N","2015-02-08","201502080WPG"
"PHI",0,0,1,2,0,3,0,0,1,0,0,1,"A","N","2015-02-08","201502080WSH"
"WSH",0,0,1,0,0,1,0,0,1,2,0,3,"H","N","2015-02-08","201502080WSH"
"CBJ",0,1,1,1,0,3,0,2,1,1,0,4,"H","N","2015-02-09","201502090CBJ"
"LAK",0,2,1,1,0,4,0,1,1,1,0,3,"A","N","2015-02-09","201502090CBJ"
"ARI",0,0,1,1,1,3,0,0,1,1,0,2,"A","Y","2015-02-09","201502090CHI"
"CHI",0,0,1,1,0,2,0,0,1,1,1,3,"H","Y","2015-02-09","201502090CHI"
"MIN",0,3,2,0,0,5,0,1,1,1,0,3,"H","N","2015-02-09","201502090MIN"
"VAN",0,1,1,1,0,3,0,3,2,0,0,5,"A","N","2015-02-09","201502090MIN"
"EDM",0,1,1,0,0,2,0,1,0,0,0,1,"A","N","2015-02-09","201502090NJD"
"NJD",0,1,0,0,0,1,0,1,1,0,0,2,"H","N","2015-02-09","201502090NJD"
"CGY",0,1,1,2,0,4,0,0,1,0,0,1,"A","N","2015-02-09","201502090SJS"
"SJS",0,0,1,0,0,1,0,1,1,2,0,4,"H","N","2015-02-09","201502090SJS"
"BOS",0,1,2,0,0,3,0,3,1,1,0,5,"H","N","2015-02-10","201502100BOS"
"DAL",0,3,1,1,0,5,0,1,2,0,0,3,"A","N","2015-02-10","201502100BOS"
"BUF",0,0,0,1,0,1,0,1,0,1,0,2,"H","N","2015-02-10","201502100BUF"
"OTT",0,1,0,1,0,2,0,0,0,1,0,1,"A","N","2015-02-10","201502100BUF"
"ANA",0,0,2,0,0,2,0,2,3,1,0,6,"A","N","2015-02-10","201502100FLA"
"FLA",0,2,3,1,0,6,0,0,2,0,0,2,"H","N","2015-02-10","201502100FLA"
"MTL",1,0,0,1,0,2,0,1,0,0,0,1,"H","N","2015-02-10","201502100MTL"
"PHI",0,1,0,0,0,1,1,0,0,1,0,2,"A","N","2015-02-10","201502100MTL"
"NSH",1,0,2,0,0,3,0,0,0,2,0,2,"H","N","2015-02-10","201502100NSH"
"TBL",0,0,0,2,0,2,1,0,2,0,0,3,"A","N","2015-02-10","201502100NSH"
"EDM",0,1,1,0,0,2,0,1,1,1,0,3,"A","N","2015-02-10","201502100NYI"
"NYI",0,1,1,1,0,3,0,1,1,0,0,2,"H","N","2015-02-10","201502100NYI"
"ARI",0,1,0,0,0,1,0,1,1,0,0,2,"A","N","2015-02-10","201502100STL"
"STL",0,1,1,0,0,2,0,1,0,0,0,1,"H","N","2015-02-10","201502100STL"
"NYR",0,2,2,1,0,5,0,1,1,2,0,4,"A","N","2015-02-10","201502100TOR"
"TOR",0,1,1,2,0,4,0,2,2,1,0,5,"H","N","2015-02-10","201502100TOR"
"MIN",0,0,0,1,0,1,1,0,0,1,0,2,"A","N","2015-02-10","201502100WPG"
"WPG",1,0,0,1,0,2,0,0,0,1,0,1,"H","N","2015-02-10","201502100WPG"
"CHI",0,0,1,3,0,4,1,0,3,1,0,5,"H","N","2015-02-11","201502110CHI"
"VAN",1,0,3,1,0,5,0,0,1,3,0,4,"A","N","2015-02-11","201502110CHI"
"DET",0,0,1,0,0,1,0,2,2,0,0,4,"A","N","2015-02-11","201502110PIT"
"PIT",0,2,2,0,0,4,0,0,1,0,0,1,"H","N","2015-02-11","201502110PIT"
"SJS",0,0,3,1,0,4,1,1,1,2,0,5,"H","N","2015-02-11","201502110SJS"
"WSH",1,1,1,2,0,5,0,0,3,1,0,4,"A","N","2015-02-11","201502110SJS"
"ANA",0,0,2,0,0,2,0,0,1,0,0,1,"A","N","2015-02-12","201502120CAR"
"CAR",0,0,1,0,0,1,0,0,2,0,0,2,"H","N","2015-02-12","201502120CAR"
"COL",0,0,1,2,0,3,0,1,2,3,0,6,"H","N","2015-02-12","201502120COL"
"NYR",0,1,2,3,0,6,0,0,1,2,0,3,"A","N","2015-02-12","201502120COL"
"CGY",0,0,2,1,0,3,0,1,1,3,0,5,"A","N","2015-02-12","201502120LAK"
"LAK",0,1,1,3,0,5,0,0,2,1,0,3,"H","N","2015-02-12","201502120LAK"
"FLA",0,0,1,0,0,1,0,1,1,0,0,2,"A","N","2015-02-12","201502120MIN"
"MIN",0,1,1,0,0,2,0,0,1,0,0,1,"H","N","2015-02-12","201502120MIN"
"EDM",1,0,2,1,0,4,0,1,1,1,0,3,"A","N","2015-02-12","201502120MTL"
"MTL",0,1,1,1,0,3,1,0,2,1,0,4,"H","N","2015-02-12","201502120MTL"
"NSH",0,1,1,1,0,3,0,1,0,0,0,1,"H","N","2015-02-12","201502120NSH"
"WPG",0,1,0,0,0,1,0,1,1,1,0,3,"A","N","2015-02-12","201502120NSH"
"NYI",0,2,1,0,0,3,0,0,2,0,0,2,"H","N","2015-02-12","201502120NYI"
"TOR",0,0,2,0,0,2,0,2,1,0,0,3,"A","N","2015-02-12","201502120NYI"
"OTT",0,0,0,4,0,4,0,2,1,1,1,5,"H","Y","2015-02-12","201502120OTT"
"PIT",0,2,1,1,1,5,0,0,0,4,0,4,"A","Y","2015-02-12","201502120OTT"
"STL",0,2,3,1,0,6,0,0,2,1,0,3,"A","N","2015-02-12","201502120TBL"
"TBL",0,0,2,1,0,3,0,2,3,1,0,6,"H","N","2015-02-12","201502120TBL"
"ARI",0,2,0,0,0,2,0,0,2,2,0,4,"H","N","2015-02-13","201502130ARI"
"SJS",0,0,2,2,0,4,0,2,0,0,0,2,"A","N","2015-02-13","201502130ARI"
"CBJ",1,0,1,2,0,4,0,1,1,1,0,3,"H","N","2015-02-13","201502130CBJ"
"PHI",0,1,1,1,0,3,1,0,1,2,0,4,"A","N","2015-02-13","201502130CBJ"
"CHI",0,0,0,3,0,3,0,1,0,0,0,1,"H","N","2015-02-13","201502130CHI"
"NJD",0,1,0,0,0,1,0,0,0,3,0,3,"A","N","2015-02-13","201502130CHI"
"DAL",0,2,0,0,0,2,0,0,0,0,0,0,"H","N","2015-02-13","201502130DAL"
"FLA",0,0,0,0,0,0,0,2,0,0,0,2,"A","N","2015-02-13","201502130DAL"
"BOS",0,1,0,1,0,2,0,2,1,2,0,5,"A","N","2015-02-13","201502130VAN"
"VAN",0,2,1,2,0,5,0,1,0,1,0,2,"H","N","2015-02-13","201502130VAN"
"ARI",0,0,1,0,0,1,0,0,1,4,0,5,"H","N","2015-02-14","201502140ARI"
"NYR",0,0,1,4,0,5,0,0,1,0,0,1,"A","N","2015-02-14","201502140ARI"
"CGY",0,0,2,1,0,3,0,1,1,0,0,2,"H","N","2015-02-14","201502140CGY"
"VAN",0,1,1,0,0,2,0,0,2,1,0,3,"A","N","2015-02-14","201502140CGY"
"COL",0,1,1,2,0,4,0,0,0,1,0,1,"H","N","2015-02-14","201502140COL"
"DAL",0,0,0,1,0,1,0,1,1,2,0,4,"A","N","2015-02-14","201502140COL"
"DET",0,1,2,1,0,4,0,1,2,1,1,5,"H","Y","2015-02-14","201502140DET"
"WPG",0,1,2,1,1,5,0,1,2,1,0,4,"A","Y","2015-02-14","201502140DET"
"LAK",0,0,1,2,0,3,0,0,0,1,0,1,"H","N","2015-02-14","201502140LAK"
"WSH",0,0,0,1,0,1,0,0,1,2,0,3,"A","N","2015-02-14","201502140LAK"
"CAR",0,1,2,0,0,3,0,3,1,2,0,6,"A","N","2015-02-14","201502140MIN"
"MIN",0,3,1,2,0,6,0,1,2,0,0,3,"H","N","2015-02-14","201502140MIN"
"MTL",0,1,0,0,1,2,0,1,0,0,0,1,"H","Y","2015-02-14","201502140MTL"
"TOR",0,1,0,0,0,1,0,1,0,0,1,2,"A","Y","2015-02-14","201502140MTL"
"NJD",0,0,1,0,0,1,0,1,0,2,0,3,"A","N","2015-02-14","201502140NSH"
"NSH",0,1,0,2,0,3,0,0,1,0,0,1,"H","N","2015-02-14","201502140NSH"
"CBJ",0,2,1,0,0,3,0,2,1,3,0,6,"A","N","2015-02-14","201502140NYI"
"NYI",0,2,1,3,0,6,0,2,1,0,0,3,"H","N","2015-02-14","201502140NYI"
"EDM",0,1,1,0,0,2,0,1,4,2,0,7,"A","N","2015-02-14","201502140OTT"
"OTT",0,1,4,2,0,7,0,1,1,0,0,2,"H","N","2015-02-14","201502140OTT"
"ANA",0,2,1,0,0,3,0,2,2,1,0,5,"H","N","2015-02-15","201502150ANA"
"WSH",0,2,2,1,0,5,0,2,1,0,0,3,"A","N","2015-02-15","201502150ANA"
"BUF",0,0,1,0,0,1,0,1,0,1,0,2,"H","N","2015-02-15","201502150BUF"
"PHI",0,1,0,1,0,2,0,0,1,0,0,1,"A","N","2015-02-15","201502150BUF"
"CHI",0,0,1,0,1,2,0,0,0,1,0,1,"H","Y","2015-02-15","201502150CHI"
"PIT",0,0,0,1,0,1,0,0,1,0,1,2,"A","Y","2015-02-15","201502150CHI"
"FLA",0,0,0,1,0,1,0,0,1,0,1,2,"H","Y","2015-02-15","201502150FLA"
"STL",0,0,1,0,1,2,0,0,0,1,0,1,"A","Y","2015-02-15","201502150FLA"
"SJS",0,0,1,1,0,2,0,1,1,3,0,5,"H","N","2015-02-15","201502150SJS"
"TBL",0,1,1,3,0,5,0,0,1,1,0,2,"A","N","2015-02-15","201502150SJS"
"BOS",0,2,1,0,0,3,1,0,1,2,0,4,"A","N","2015-02-16","201502160CGY"
"CGY",1,0,1,2,0,4,0,2,1,0,0,3,"H","N","2015-02-16","201502160CGY"
"ARI",0,1,0,1,0,2,0,3,2,0,0,5,"A","N","2015-02-16","201502160COL"
"COL",0,3,2,0,0,5,0,1,0,1,0,2,"H","N","2015-02-16","201502160COL"
"DET",0,0,0,0,0,0,0,0,0,2,0,2,"H","N","2015-02-16","201502160DET"
"MTL",0,0,0,2,0,2,0,0,0,0,0,0,"A","N","2015-02-16","201502160DET"
"LAK",0,0,1,2,0,3,0,1,0,1,0,2,"H","N","2015-02-16","201502160LAK"
"TBL",0,1,0,1,0,2,0,0,1,2,0,3,"A","N","2015-02-16","201502160LAK"
"NYI",0,2,2,1,0,5,0,1,2,3,0,6,"H","N","2015-02-16","201502160NYI"
"NYR",0,1,2,3,0,6,0,2,2,1,0,5,"A","N","2015-02-16","201502160NYI"
"CAR",0,1,3,2,0,6,0,1,2,0,0,3,"A","N","2015-02-16","201502160OTT"
"OTT",0,1,2,0,0,3,0,1,3,2,0,6,"H","N","2015-02-16","201502160OTT"
"MIN",0,1,0,1,0,2,0,0,1,2,0,3,"A","N","2015-02-16","201502160VAN"
"VAN",0,0,1,2,0,3,0,1,0,1,0,2,"H","N","2015-02-16","201502160VAN"
"EDM",0,2,0,2,0,4,0,1,1,2,1,5,"A","Y","2015-02-16","201502160WPG"
"WPG",0,1,1,2,1,5,0,2,0,2,0,4,"H","Y","2015-02-16","201502160WPG"
"CAR",0,0,0,1,0,1,0,1,1,2,0,4,"H","N","2015-02-17","201502170CAR"
"NYI",0,1,1,2,0,4,0,0,0,1,0,1,"A","N","2015-02-17","201502170CAR"
"BUF",0,0,0,1,0,1,0,1,0,0,1,2,"A","Y","2015-02-17","201502170NJD"
"NJD",0,1,0,0,1,2,0,0,0,1,0,1,"H","Y","2015-02-17","201502170NJD"
"NSH",0,2,3,0,0,5,0,1,0,0,0,1,"H","N","2015-02-17","201502170NSH"
"SJS",0,1,0,0,0,1,0,2,3,0,0,5,"A","N","2015-02-17","201502170NSH"
"CBJ",0,2,0,3,0,5,0,0,2,0,0,2,"A","N","2015-02-17","201502170PHI"
"PHI",0,0,2,0,0,2,0,2,0,3,0,5,"H","N","2015-02-17","201502170PHI"
"PIT",0,0,1,0,0,1,0,1,0,2,0,3,"H","N","2015-02-17","201502170PIT"
"WSH",0,1,0,2,0,3,0,0,1,0,0,1,"A","N","2015-02-17","201502170PIT"
"DAL",0,3,1,0,0,4,0,0,0,1,0,1,"A","N","2015-02-17","201502170STL"
"STL",0,0,0,1,0,1,0,3,1,0,0,4,"H","N","2015-02-17","201502170STL"
"FLA",0,1,2,0,0,3,0,1,0,1,0,2,"A","N","2015-02-17","201502170TOR"
"TOR",0,1,0,1,0,2,0,1,2,0,0,3,"H","N","2015-02-17","201502170TOR"
"ANA",0,1,0,0,0,1,0,0,4,0,0,4,"H","N","2015-02-18","201502180ANA"
"TBL",0,0,4,0,0,4,0,1,0,0,0,1,"A","N","2015-02-18","201502180ANA"
"CGY",0,1,0,1,0,2,1,2,0,0,0,3,"H","N","2015-02-18","201502180CGY"
"MIN",1,2,0,0,0,3,0,1,0,1,0,2,"A","N","2015-02-18","201502180CGY"
"CHI",0,0,1,1,0,2,0,0,1,1,1,3,"H","Y","2015-02-18","201502180CHI"
"DET",0,0,1,1,1,3,0,0,1,1,0,2,"A","Y","2015-02-18","201502180CHI"
"COL",0,1,0,0,0,1,0,0,3,1,0,4,"H","N","2015-02-18","201502180COL"
"LAK",0,0,3,1,0,4,0,1,0,0,0,1,"A","N","2015-02-18","201502180COL"
"BOS",0,1,2,0,0,3,0,2,1,0,1,4,"A","Y","2015-02-18","201502180EDM"
"EDM",0,2,1,0,1,4,0,1,2,0,0,3,"H","Y","2015-02-18","201502180EDM"
"MTL",0,0,1,1,0,2,0,0,2,2,0,4,"A","N","2015-02-18","201502180OTT"
"OTT",0,0,2,2,0,4,0,0,1,1,0,2,"H","N","2015-02-18","201502180OTT"
"DAL",0,0,1,1,0,2,0,1,2,2,0,5,"H","N","2015-02-19","201502190DAL"
"SJS",0,1,2,2,0,5,0,0,1,1,0,2,"A","N","2015-02-19","201502190DAL"
"FLA",0,0,1,1,1,3,0,0,2,0,0,2,"A","Y","2015-02-19","201502190MTL"
"MTL",0,0,2,0,0,2,0,0,1,1,1,3,"H","Y","2015-02-19","201502190MTL"
"NSH",0,1,1,0,0,2,0,3,0,2,0,5,"A","N","2015-02-19","201502190NYI"
"NYI",0,3,0,2,0,5,0,1,1,0,0,2,"H","N","2015-02-19","201502190NYI"
"NYR",0,1,1,2,0,4,0,0,2,2,1,5,"H","Y","2015-02-19","201502190NYR"
"VAN",0,0,2,2,1,5,0,1,1,2,0,4,"A","Y","2015-02-19","201502190NYR"
"BUF",0,1,1,0,1,3,0,1,1,0,0,2,"A","Y","2015-02-19","201502190PHI"
"PHI",0,1,1,0,0,2,0,1,1,0,1,3,"H","Y","2015-02-19","201502190PHI"
"CBJ",0,1,0,1,0,2,0,0,1,0,0,1,"A","N","2015-02-19","201502190PIT"
"PIT",0,0,1,0,0,1,0,1,0,1,0,2,"H","N","2015-02-19","201502190PIT"
"WPG",0,0,1,0,0,1,0,2,2,1,0,5,"A","N","2015-02-19","201502190WSH"
"WSH",0,2,2,1,0,5,0,0,1,0,0,1,"H","N","2015-02-19","201502190WSH"
"BUF",0,1,0,0,0,1,0,1,2,0,0,3,"H","N","2015-02-20","201502200BUF"
"NYR",0,1,2,0,0,3,0,1,0,0,0,1,"A","N","2015-02-20","201502200BUF"
"CAR",0,2,0,0,0,2,0,1,0,0,0,1,"H","N","2015-02-20","201502200CAR"
"TOR",0,1,0,0,0,1,0,2,0,0,0,2,"A","N","2015-02-20","201502200CAR"
"ANA",0,0,1,5,0,6,0,1,1,1,0,3,"A","N","2015-02-20","201502200CGY"
"CGY",0,1,1,1,0,3,0,0,1,5,0,6,"H","N","2015-02-20","201502200CGY"
"CHI",0,0,1,0,0,1,0,1,0,3,0,4,"H","N","2015-02-20","201502200CHI"
"COL",0,1,0,3,0,4,0,0,1,0,0,1,"A","N","2015-02-20","201502200CHI"
"EDM",0,0,0,0,0,0,0,2,1,1,0,4,"H","N","2015-02-20","201502200EDM"
"MIN",0,2,1,1,0,4,0,0,0,0,0,0,"A","N","2015-02-20","201502200EDM"
"NJD",0,1,2,1,0,4,0,0,1,1,0,2,"H","N","2015-02-20","201502200NJD"
"VAN",0,0,1,1,0,2,0,1,2,1,0,4,"A","N","2015-02-20","201502200NJD"
"BOS",0,1,0,0,0,1,0,0,4,1,0,5,"A","N","2015-02-20","201502200STL"
"STL",0,0,4,1,0,5,0,1,0,0,0,1,"H","N","2015-02-20","201502200STL"
"ARI",0,1,0,1,0,2,0,0,2,2,0,4,"H","N","2015-02-21","201502210ARI"
"TBL",0,0,2,2,0,4,0,1,0,1,0,2,"A","N","2015-02-21","201502210ARI"
"DAL",0,1,3,2,0,6,1,1,1,4,0,7,"H","N","2015-02-21","201502210DAL"
"DET",1,1,1,4,0,7,0,1,3,2,0,6,"A","N","2015-02-21","201502210DAL"
"ANA",0,1,0,1,0,2,0,0,1,0,0,1,"A","N","2015-02-21","201502210EDM"
"EDM",0,0,1,0,0,1,0,1,0,1,0,2,"H","N","2015-02-21","201502210EDM"
"CBJ",0,1,0,0,0,1,0,2,0,1,0,3,"A","N","2015-02-21","201502210MTL"
"MTL",0,2,0,1,0,3,0,1,0,0,0,1,"H","N","2015-02-21","201502210MTL"
"CAR",0,0,0,1,0,1,0,3,0,0,0,3,"A","N","2015-02-21","201502210NJD"
"NJD",0,3,0,0,0,3,0,0,0,1,0,1,"H","N","2015-02-21","201502210NJD"
"FLA",0,1,0,0,0,1,0,1,1,2,0,4,"A","N","2015-02-21","201502210OTT"
"OTT",0,1,1,2,0,4,0,1,0,0,0,1,"H","N","2015-02-21","201502210OTT"
"NSH",0,1,0,1,0,2,0,1,1,0,1,3,"A","Y","2015-02-21","201502210PHI"
"PHI",0,1,1,0,1,3,0,1,0,1,0,2,"H","Y","2015-02-21","201502210PHI"
"LAK",0,1,0,1,0,2,0,1,0,0,0,1,"A","N","2015-02-21","201502210SJS"
"SJS",0,1,0,0,0,1,0,1,0,1,0,2,"H","N","2015-02-21","201502210SJS"
"PIT",0,1,2,1,0,4,0,0,0,2,0,2,"A","N","2015-02-21","201502210STL"
"STL",0,0,0,2,0,2,0,1,2,1,0,4,"H","N","2015-02-21","201502210STL"
"TOR",1,1,1,1,0,4,0,2,1,0,0,3,"H","N","2015-02-21","201502210TOR"
"WPG",0,2,1,0,0,3,1,1,1,1,0,4,"A","N","2015-02-21","201502210TOR"
"NYI",0,1,0,1,0,2,0,1,0,1,1,3,"A","Y","2015-02-21","201502210WSH"
"WSH",0,1,0,1,1,3,0,1,0,1,0,2,"H","Y","2015-02-21","201502210WSH"
"BUF",0,0,1,0,0,1,0,0,0,1,1,2,"H","Y","2015-02-22","201502220BUF"
"NSH",0,0,0,1,1,2,0,0,1,0,0,1,"A","Y","2015-02-22","201502220BUF"
"BOS",0,2,4,0,0,6,0,1,0,1,0,2,"A","N","2015-02-22","201502220CHI"
"CHI",0,1,0,1,0,2,0,2,4,0,0,6,"H","N","2015-02-22","201502220CHI"
"COL",0,1,3,1,0,5,0,1,1,2,0,4,"H","N","2015-02-22","201502220COL"
"TBL",0,1,1,2,0,4,0,1,3,1,0,5,"A","N","2015-02-22","201502220COL"
"DAL",0,0,1,1,0,2,0,0,0,6,0,6,"A","N","2015-02-22","201502220MIN"
"MIN",0,0,0,6,0,6,0,0,1,1,0,2,"H","N","2015-02-22","201502220MIN"
"NYI",0,0,0,0,0,0,0,0,3,1,0,4,"H","N","2015-02-22","201502220NYI"
"VAN",0,0,3,1,0,4,0,0,0,0,0,0,"A","N","2015-02-22","201502220NYI"
"CBJ",0,0,2,1,0,3,0,2,1,0,1,4,"A","Y","2015-02-22","201502220NYR"
"NYR",0,2,1,0,1,4,0,0,2,1,0,3,"H","Y","2015-02-22","201502220NYR"
"PHI",0,1,1,1,0,3,0,0,2,0,0,2,"H","N","2015-02-22","201502220PHI"
"WSH",0,0,2,0,0,2,0,1,1,1,0,3,"A","N","2015-02-22","201502220PHI"
"FLA",0,0,0,1,0,1,0,1,1,3,0,5,"A","N","2015-02-22","201502220PIT"
"PIT",0,1,1,3,0,5,0,0,0,1,0,1,"H","N","2015-02-22","201502220PIT"
"ANA",0,0,0,3,1,4,0,0,2,1,0,3,"H","Y","2015-02-23","201502230ANA"
"DET",0,0,2,1,0,3,0,0,0,3,1,4,"A","Y","2015-02-23","201502230ANA"
"ARI",0,0,0,0,0,0,0,1,0,2,0,3,"A","N","2015-02-23","201502230NJD"
"NJD",0,1,0,2,0,3,0,0,0,0,0,0,"H","N","2015-02-23","201502230NJD"
"BOS",0,1,0,0,0,1,0,1,0,1,0,2,"H","N","2015-02-24","201502240BOS"
"VAN",0,1,0,1,0,2,0,1,0,0,0,1,"A","N","2015-02-24","201502240BOS"
"CAR",0,1,2,1,0,4,0,1,0,0,0,1,"H","N","2015-02-24","201502240CAR"
"PHI",0,1,0,0,0,1,0,1,2,1,0,4,"A","N","2015-02-24","201502240CAR"
"BUF",0,2,2,0,0,4,0,0,2,0,0,2,"A","N","2015-02-24","201502240CBJ"
"CBJ",0,0,2,0,0,2,0,2,2,0,0,4,"H","N","2015-02-24","201502240CBJ"
"CHI",0,1,1,0,1,3,0,0,0,2,0,2,"H","Y","2015-02-24","201502240CHI"
"FLA",0,0,0,2,0,2,0,1,1,0,1,3,"A","Y","2015-02-24","201502240CHI"
"DET",0,0,0,0,0,0,0,1,0,0,0,1,"A","N","2015-02-24","201502240LAK"
"LAK",0,1,0,0,0,1,0,0,0,0,0,0,"H","N","2015-02-24","201502240LAK"
"EDM",0,2,0,0,0,2,0,1,0,0,0,1,"A","N","2015-02-24","201502240MIN"
"MIN",0,1,0,0,0,1,0,2,0,0,0,2,"H","N","2015-02-24","201502240MIN"
"COL",0,1,0,1,0,2,0,1,2,2,0,5,"A","N","2015-02-24","201502240NSH"
"NSH",0,1,2,2,0,5,0,1,0,1,0,2,"H","N","2015-02-24","201502240NSH"
"ARI",0,0,1,0,0,1,0,0,1,4,0,5,"A","N","2015-02-24","201502240NYI"
"NYI",0,0,1,4,0,5,0,0,1,0,0,1,"H","N","2015-02-24","201502240NYI"
"CGY",0,0,0,0,0,0,0,0,0,1,0,1,"A","N","2015-02-24","201502240NYR"
"NYR",0,0,0,1,0,1,0,0,0,0,0,0,"H","N","2015-02-24","201502240NYR"
"MTL",0,1,3,1,0,5,0,0,2,0,0,2,"A","N","2015-02-24","201502240STL"
"STL",0,0,2,0,0,2,0,1,3,1,0,5,"H","N","2015-02-24","201502240STL"
"DAL",0,0,1,1,0,2,0,1,1,2,0,4,"A","N","2015-02-24","201502240WPG"
"WPG",0,1,1,2,0,4,0,0,1,1,0,2,"H","N","2015-02-24","201502240WPG"
"ANA",0,0,0,0,0,0,0,1,1,1,0,3,"H","N","2015-02-25","201502250ANA"
"OTT",0,1,1,1,0,3,0,0,0,0,0,0,"A","N","2015-02-25","201502250ANA"
"CGY",0,0,1,2,0,3,0,1,0,0,0,1,"A","N","2015-02-25","201502250NJD"
"NJD",0,1,0,0,0,1,0,0,1,2,0,3,"H","N","2015-02-25","201502250NJD"
"PIT",0,2,1,1,0,4,0,1,0,2,0,3,"A","N","2015-02-25","201502250WSH"
"WSH",0,1,0,2,0,3,0,2,1,1,0,4,"H","N","2015-02-25","201502250WSH"
"BUF",0,1,1,4,0,6,0,1,1,1,0,3,"H","N","2015-02-26","201502260BUF"
"VAN",0,1,1,1,0,3,0,1,1,4,0,6,"A","N","2015-02-26","201502260BUF"
"CBJ",0,1,0,1,0,2,0,3,0,2,0,5,"H","N","2015-02-26","201502260CBJ"
"MTL",0,3,0,2,0,5,0,1,0,1,0,2,"A","N","2015-02-26","201502260CBJ"
"CHI",0,1,1,1,0,3,0,0,0,0,0,0,"A","N","2015-02-26","201502260FLA"
"FLA",0,0,0,0,0,0,0,1,1,1,0,3,"H","N","2015-02-26","201502260FLA"
"LAK",0,0,0,0,0,0,0,0,0,1,0,1,"H","N","2015-02-26","201502260LAK"
"OTT",0,0,0,1,0,1,0,0,0,0,0,0,"A","N","2015-02-26","201502260LAK"
"MIN",0,1,2,1,0,4,0,0,2,0,0,2,"A","N","2015-02-26","201502260NSH"
"NSH",0,0,2,0,0,2,0,1,2,1,0,4,"H","N","2015-02-26","201502260NSH"
"ARI",0,3,0,0,0,3,0,1,2,1,0,4,"A","N","2015-02-26","201502260NYR"
"NYR",0,1,2,1,0,4,0,3,0,0,0,3,"H","N","2015-02-26","201502260NYR"
"DET",0,0,1,2,0,3,0,1,1,0,0,2,"A","N","2015-02-26","201502260SJS"
"SJS",0,1,1,0,0,2,0,0,1,2,0,3,"H","N","2015-02-26","201502260SJS"
"PHI",0,0,0,2,0,2,0,1,1,1,0,3,"A","N","2015-02-26","201502260TOR"
"TOR",0,1,1,1,0,3,0,0,0,2,0,2,"H","N","2015-02-26","201502260TOR"
"STL",0,0,1,0,1,2,0,0,0,1,0,1,"A","Y","2015-02-26","201502260WPG"
"WPG",0,0,0,1,0,1,0,0,1,0,1,2,"H","Y","2015-02-26","201502260WPG"
"ANA",0,0,0,4,0,4,0,1,1,0,0,2,"H","N","2015-02-27","201502270ANA"
"LAK",0,1,1,0,0,2,0,0,0,4,0,4,"A","N","2015-02-27","201502270ANA"
"CAR",0,1,1,1,0,3,0,0,0,0,0,0,"H","N","2015-02-27","201502270CAR"
"WSH",0,0,0,0,0,0,0,1,1,1,0,3,"A","N","2015-02-27","201502270CAR"
"COL",0,0,1,3,1,5,0,0,2,2,0,4,"A","Y","2015-02-27","201502270DAL"
"DAL",0,0,2,2,0,4,0,0,1,3,1,5,"H","Y","2015-02-27","201502270DAL"
"BOS",1,1,0,1,0,3,0,0,0,2,0,2,"A","N","2015-02-27","201502270NJD"
"NJD",0,0,0,2,0,2,1,1,0,1,0,3,"H","N","2015-02-27","201502270NJD"
"CGY",0,0,0,1,0,1,0,1,0,1,0,2,"A","N","2015-02-27","201502270NYI"
"NYI",0,1,0,1,0,2,0,0,0,1,0,1,"H","N","2015-02-27","201502270NYI"
"CHI",0,0,0,0,0,0,0,0,2,2,0,4,"A","N","2015-02-27","201502270TBL"
"TBL",0,0,2,2,0,4,0,0,0,0,0,0,"H","N","2015-02-27","201502270TBL"
"ARI",0,0,0,1,0,1,0,2,2,0,0,4,"A","N","2015-02-28","201502280BOS"
"BOS",0,2,2,0,0,4,0,0,0,1,0,1,"H","N","2015-02-28","201502280BOS"
"CBJ",0,0,0,0,0,0,0,1,0,1,0,2,"H","N","2015-02-28","201502280CBJ"
"NJD",0,1,0,1,0,2,0,0,0,0,0,0,"A","N","2015-02-28","201502280CBJ"
"COL",0,0,1,0,0,1,0,1,1,1,0,3,"H","N","2015-02-28","201502280COL"
"MIN",0,1,1,1,0,3,0,0,1,0,0,1,"A","N","2015-02-28","201502280COL"
"EDM",0,0,1,0,0,1,0,1,0,1,0,2,"H","N","2015-02-28","201502280EDM"
"STL",0,1,0,1,0,2,0,0,1,0,0,1,"A","N","2015-02-28","201502280EDM"
"BUF",0,2,0,1,0,3,0,0,3,2,0,5,"A","N","2015-02-28","201502280FLA"
"FLA",0,0,3,2,0,5,0,2,0,1,0,3,"H","N","2015-02-28","201502280FLA"
"MTL",0,2,0,2,0,4,0,0,0,0,0,0,"H","N","2015-02-28","201502280MTL"
"TOR",0,0,0,0,0,0,0,2,0,2,0,4,"A","N","2015-02-28","201502280MTL"
"DET",0,1,1,2,0,4,0,0,3,0,0,3,"A","N","2015-02-28","201502280NSH"
"NSH",0,0,3,0,0,3,0,1,1,2,0,4,"H","N","2015-02-28","201502280NSH"
"CAR",0,1,4,0,0,5,0,1,1,1,0,3,"A","N","2015-02-28","201502280NYI"
"NYI",0,1,1,1,0,3,0,1,4,0,0,5,"H","N","2015-02-28","201502280NYI"
"NYR",0,1,1,0,0,2,0,1,1,2,0,4,"A","N","2015-02-28","201502280PHI"
"PHI",0,1,1,2,0,4,0,1,1,0,0,2,"H","N","2015-02-28","201502280PHI"
"OTT",0,0,1,3,0,4,0,1,1,0,0,2,"A","N","2015-02-28","201502280SJS"
"SJS",0,1,1,0,0,2,0,0,1,3,0,4,"H","N","2015-02-28","201502280SJS"
"ANA",0,1,0,2,0,3,0,0,1,0,0,1,"A","N","2015-03-01","201503010DAL"
"DAL",0,0,1,0,0,1,0,1,0,2,0,3,"H","N","2015-03-01","201503010DAL"
"FLA",0,1,2,1,0,4,0,1,0,2,0,3,"H","N","2015-03-01","201503010FLA"
"TBL",0,1,0,2,0,3,0,1,2,1,0,4,"A","N","2015-03-01","201503010FLA"
"CBJ",0,1,0,2,0,3,0,1,3,1,0,5,"A","N","2015-03-01","201503010PIT"
"PIT",0,1,3,1,0,5,0,1,0,2,0,3,"H","N","2015-03-01","201503010PIT"
"STL",0,2,0,3,0,5,0,2,2,1,1,6,"A","Y","2015-03-01","201503010VAN"
"VAN",0,2,2,1,1,6,0,2,0,3,0,5,"H","Y","2015-03-01","201503010VAN"
"LAK",0,0,1,1,0,2,0,1,3,1,0,5,"A","N","2015-03-01","201503010WPG"
"WPG",0,1,3,1,0,5,0,0,1,1,0,2,"H","N","2015-03-01","201503010WPG"
"TOR",0,0,0,0,0,0,0,1,1,2,0,4,"A","N","2015-03-01","201503010WSH"
"WSH",0,1,1,2,0,4,0,0,0,0,0,0,"H","N","2015-03-01","201503010WSH"
"CAR",0,0,0,2,0,2,0,1,3,1,0,5,"A","N","2015-03-02","201503020CHI"
"CHI",0,1,3,1,0,5,0,0,0,2,0,2,"H","N","2015-03-02","201503020CHI"
"NSH",0,0,1,0,0,1,0,1,1,2,0,4,"A","N","2015-03-02","201503020NYR"
"NYR",0,1,1,2,0,4,0,0,1,0,0,1,"H","N","2015-03-02","201503020NYR"
"MTL",0,0,0,0,0,0,0,2,1,1,0,4,"A","N","2015-03-02","201503020SJS"
"SJS",0,2,1,1,0,4,0,0,0,0,0,0,"H","N","2015-03-02","201503020SJS"
"ANA",0,1,1,2,0,4,0,0,1,0,0,1,"A","N","2015-03-03","201503030ARI"
"ARI",0,0,1,0,0,1,0,1,1,2,0,4,"H","N","2015-03-03","201503030ARI"
"CBJ",0,0,2,1,0,3,0,2,1,2,0,5,"H","N","2015-03-03","201503030CBJ"
"WSH",0,2,1,2,0,5,0,0,2,1,0,3,"A","N","2015-03-03","201503030CBJ"
"DAL",1,0,0,2,0,3,0,1,0,1,0,2,"H","N","2015-03-03","201503030DAL"
"NYI",0,1,0,1,0,2,1,0,0,2,0,3,"A","N","2015-03-03","201503030DAL"
"EDM",0,0,1,1,0,2,0,2,2,1,0,5,"H","N","2015-03-03","201503030EDM"
"LAK",0,2,2,1,0,5,0,0,1,1,0,2,"A","N","2015-03-03","201503030EDM"
"FLA",0,1,1,0,0,2,0,0,1,2,0,3,"H","N","2015-03-03","201503030FLA"
"TOR",0,0,1,2,0,3,0,1,1,0,0,2,"A","N","2015-03-03","201503030FLA"
"MIN",0,0,2,0,1,3,0,0,2,0,0,2,"H","Y","2015-03-03","201503030MIN"
"OTT",0,0,2,0,0,2,0,0,2,0,1,3,"A","Y","2015-03-03","201503030MIN"
"NJD",0,2,0,1,0,3,0,0,1,0,0,1,"H","N","2015-03-03","201503030NJD"
"NSH",0,0,1,0,0,1,0,2,0,1,0,3,"A","N","2015-03-03","201503030NJD"
"CGY",1,1,1,0,0,3,0,0,0,2,0,2,"A","N","2015-03-03","201503030PHI"
"PHI",0,0,0,2,0,2,1,1,1,0,0,3,"H","N","2015-03-03","201503030PHI"
"BUF",0,0,0,0,0,0,0,1,2,0,0,3,"A","N","2015-03-03","201503030TBL"
"TBL",0,1,2,0,0,3,0,0,0,0,0,0,"H","N","2015-03-03","201503030TBL"
"SJS",0,3,1,2,0,6,0,0,2,0,0,2,"A","N","2015-03-03","201503030VAN"
"VAN",0,0,2,0,0,2,0,3,1,2,0,6,"H","N","2015-03-03","201503030VAN"
"ANA",0,1,1,1,0,3,0,0,0,1,0,1,"H","N","2015-03-04","201503040ANA"
"MTL",0,0,0,1,0,1,0,1,1,1,0,3,"A","N","2015-03-04","201503040ANA"
"COL",0,0,2,1,0,3,0,0,0,1,0,1,"H","N","2015-03-04","201503040COL"
"PIT",0,0,0,1,0,1,0,0,2,1,0,3,"A","N","2015-03-04","201503040COL"
"DET",1,1,0,0,0,2,0,1,0,0,0,1,"H","N","2015-03-04","201503040DET"
"NYR",0,1,0,0,0,1,1,1,0,0,0,2,"A","N","2015-03-04","201503040DET"
"OTT",0,1,2,0,0,3,0,0,0,1,0,1,"A","N","2015-03-04","201503040WPG"
"WPG",0,0,0,1,0,1,0,1,2,0,0,3,"H","N","2015-03-04","201503040WPG"
"ARI",0,1,0,1,1,3,0,0,0,2,0,2,"H","Y","2015-03-05","201503050ARI"
"VAN",0,0,0,2,0,2,0,1,0,1,1,3,"A","Y","2015-03-05","201503050ARI"
"BOS",0,1,1,1,0,3,0,1,1,1,1,4,"H","Y","2015-03-05","201503050BOS"
"CGY",0,1,1,1,1,4,0,1,1,1,0,3,"A","Y","2015-03-05","201503050BOS"
"DAL",0,2,0,1,1,4,0,1,2,0,0,3,"A","Y","2015-03-05","201503050FLA"
"FLA",0,1,2,0,0,3,0,2,0,1,1,4,"H","Y","2015-03-05","201503050FLA"
"LAK",0,2,0,1,1,4,0,0,2,1,0,3,"H","Y","2015-03-05","201503050LAK"
"MTL",0,0,2,1,0,3,0,2,0,1,1,4,"A","Y","2015-03-05","201503050LAK"
"NSH",0,1,0,2,0,3,0,2,0,2,0,4,"H","N","2015-03-05","201503050NSH"
"NYI",0,2,0,2,0,4,0,1,0,2,0,3,"A","N","2015-03-05","201503050NSH"
"PHI",0,0,0,3,0,3,0,1,0,0,0,1,"H","N","2015-03-05","201503050PHI"
"STL",0,1,0,0,0,1,0,0,0,3,0,3,"A","N","2015-03-05","201503050PHI"
"TBL",0,2,0,2,0,4,0,0,1,1,0,2,"H","N","2015-03-05","201503050TBL"
"TOR",0,0,1,1,0,2,0,2,0,2,0,4,"A","N","2015-03-05","201503050TBL"
"MIN",0,0,0,2,0,2,0,1,0,0,0,1,"A","N","2015-03-05","201503050WSH"
"WSH",0,1,0,0,0,1,0,0,0,2,0,2,"H","N","2015-03-05","201503050WSH"
"ANA",0,0,0,2,0,2,0,0,3,2,0,5,"H","N","2015-03-06","201503060ANA"
"PIT",0,0,3,2,0,5,0,0,0,2,0,2,"A","N","2015-03-06","201503060ANA"
"CAR",0,0,1,0,0,1,0,1,0,2,0,3,"H","N","2015-03-06","201503060CAR"
"MIN",0,1,0,2,0,3,0,0,1,0,0,1,"A","N","2015-03-06","201503060CAR"
"CHI",0,0,0,1,1,2,0,1,0,0,0,1,"H","Y","2015-03-06","201503060CHI"
"EDM",0,1,0,0,0,1,0,0,0,1,1,2,"A","Y","2015-03-06","201503060CHI"
"CGY",0,1,2,2,0,5,0,2,0,0,0,2,"A","N","2015-03-06","201503060DET"
"DET",0,2,0,0,0,2,0,1,2,2,0,5,"H","N","2015-03-06","201503060DET"
"CBJ",0,1,2,0,0,3,0,0,1,1,0,2,"A","N","2015-03-06","201503060NJD"
"NJD",0,0,1,1,0,2,0,1,2,0,0,3,"H","N","2015-03-06","201503060NJD"
"BUF",0,2,0,0,0,2,0,0,1,2,0,3,"A","N","2015-03-06","201503060OTT"
"OTT",0,0,1,2,0,3,0,2,0,0,0,2,"H","N","2015-03-06","201503060OTT"
"ARI",0,0,0,0,0,0,0,0,1,1,0,2,"H","N","2015-03-07","201503070ARI"
"MTL",0,0,1,1,0,2,0,0,0,0,0,0,"A","N","2015-03-07","201503070ARI"
"BOS",1,1,0,1,0,3,0,0,1,1,0,2,"H","N","2015-03-07","201503070BOS"
"PHI",0,0,1,1,0,2,1,1,0,1,0,3,"A","N","2015-03-07","201503070BOS"
"CBJ",0,0,0,0,0,0,0,3,0,1,0,4,"H","N","2015-03-07","201503070CBJ"
"COL",0,3,0,1,0,4,0,0,0,0,0,0,"A","N","2015-03-07","201503070CBJ"
"FLA",0,1,1,1,1,4,0,0,2,1,0,3,"H","Y","2015-03-07","201503070FLA"
"NYI",0,0,2,1,0,3,0,1,1,1,1,4,"A","Y","2015-03-07","201503070FLA"
"LAK",0,0,0,0,0,0,1,0,0,0,0,1,"H","N","2015-03-07","201503070LAK"
"PIT",1,0,0,0,0,1,0,0,0,0,0,0,"A","N","2015-03-07","201503070LAK"
"NSH",0,0,1,0,0,1,0,1,1,1,0,3,"H","N","2015-03-07","201503070NSH"
"WPG",0,1,1,1,0,3,0,0,1,0,0,1,"A","N","2015-03-07","201503070NSH"
"SJS",0,2,0,0,0,2,0,1,1,1,0,3,"H","N","2015-03-07","201503070SJS"
"VAN",0,1,1,1,0,3,0,2,0,0,0,2,"A","N","2015-03-07","201503070SJS"
"DAL",0,1,2,1,0,4,0,2,0,3,0,5,"A","N","2015-03-07","201503070TBL"
"TBL",0,2,0,3,0,5,0,1,2,1,0,4,"H","N","2015-03-07","201503070TBL"
"STL",0,3,2,1,0,6,0,0,0,1,0,1,"A","N","2015-03-07","201503070TOR"
"TOR",0,0,0,1,0,1,0,3,2,1,0,6,"H","N","2015-03-07","201503070TOR"
"BUF",0,1,0,0,0,1,0,1,3,2,0,6,"A","N","2015-03-07","201503070WSH"
"WSH",0,1,3,2,0,6,0,1,0,0,0,1,"H","N","2015-03-07","201503070WSH"
"BOS",0,2,2,1,0,5,0,1,0,2,0,3,"H","N","2015-03-08","201503080BOS"
"DET",0,1,0,2,0,3,0,2,2,1,0,5,"A","N","2015-03-08","201503080BOS"
"CAR",0,0,3,4,0,7,0,1,2,1,0,4,"H","N","2015-03-08","201503080CAR"
"EDM",0,1,2,1,0,4,0,0,3,4,0,7,"A","N","2015-03-08","201503080CAR"
"CHI",0,0,0,0,0,0,1,0,0,0,0,1,"H","N","2015-03-08","201503080CHI"
"NYR",1,0,0,0,0,1,0,0,0,0,0,0,"A","N","2015-03-08","201503080CHI"
"COL",0,1,1,1,0,3,0,0,0,2,0,2,"A","N","2015-03-08","201503080MIN"
"MIN",0,0,0,2,0,2,0,1,1,1,0,3,"H","N","2015-03-08","201503080MIN"
"NJD",0,1,2,2,0,5,0,1,0,1,0,2,"H","N","2015-03-08","201503080NJD"
"PHI",0,1,0,1,0,2,0,1,2,2,0,5,"A","N","2015-03-08","201503080NJD"
"CGY",0,0,0,4,0,4,0,2,2,0,1,5,"A","Y","2015-03-08","201503080OTT"
"OTT",0,2,2,0,1,5,0,0,0,4,0,4,"H","Y","2015-03-08","201503080OTT"
"ARI",0,0,0,1,0,1,1,0,1,0,0,2,"H","N","2015-03-09","201503090ARI"
"NSH",1,0,1,0,0,2,0,0,0,1,0,1,"A","N","2015-03-09","201503090ARI"
"DET",0,0,2,3,0,5,0,1,0,1,0,2,"H","N","2015-03-09","201503090DET"
"EDM",0,1,0,1,0,2,0,0,2,3,0,5,"A","N","2015-03-09","201503090DET"
"PIT",0,0,0,1,0,1,0,1,0,0,1,2,"A","Y","2015-03-09","201503090SJS"
"SJS",0,1,0,0,1,2,0,0,0,1,0,1,"H","Y","2015-03-09","201503090SJS"
"NYI",1,0,0,3,0,4,0,1,1,1,0,3,"A","N","2015-03-09","201503090TOR"
"TOR",0,1,1,1,0,3,1,0,0,3,0,4,"H","N","2015-03-09","201503090TOR"
"ANA",0,0,0,1,0,1,0,1,0,1,0,2,"A","N","2015-03-09","201503090VAN"
"VAN",0,1,0,1,0,2,0,0,0,1,0,1,"H","N","2015-03-09","201503090VAN"
"CAR",0,3,0,0,0,3,0,1,1,1,1,4,"H","Y","2015-03-10","201503100CAR"
"CBJ",0,1,1,1,1,4,0,3,0,0,0,3,"A","Y","2015-03-10","201503100CAR"
"COL",0,1,0,1,0,2,0,3,1,1,0,5,"H","N","2015-03-10","201503100COL"
"LAK",0,3,1,1,0,5,0,1,0,1,0,2,"A","N","2015-03-10","201503100COL"
"MIN",0,1,3,2,0,6,0,0,1,1,0,2,"H","N","2015-03-10","201503100MIN"
"NJD",0,0,1,1,0,2,0,1,3,2,0,6,"A","N","2015-03-10","201503100MIN"
"MTL",0,0,0,0,0,0,1,0,0,0,0,1,"H","N","2015-03-10","201503100MTL"
"TBL",1,0,0,0,0,1,0,0,0,0,0,0,"A","N","2015-03-10","201503100MTL"
"NYI",0,1,0,0,0,1,0,0,1,1,0,2,"H","N","2015-03-10","201503100NYI"
"NYR",0,0,1,1,0,2,0,1,0,0,0,1,"A","N","2015-03-10","201503100NYI"
"BOS",0,0,3,0,0,3,0,0,0,1,0,1,"A","N","2015-03-10","201503100OTT"
"OTT",0,0,0,1,0,1,0,0,3,0,0,3,"H","N","2015-03-10","201503100OTT"
"DAL",0,1,0,1,0,2,0,1,0,0,0,1,"A","N","2015-03-10","201503100PHI"
"PHI",0,1,0,0,0,1,0,1,0,1,0,2,"H","N","2015-03-10","201503100PHI"
"STL",0,1,3,1,0,5,0,1,0,3,0,4,"H","N","2015-03-10","201503100STL"
"WPG",0,1,0,3,0,4,0,1,3,1,0,5,"A","N","2015-03-10","201503100STL"
"ANA",0,2,1,0,0,3,0,2,3,1,0,6,"A","N","2015-03-11","201503110CGY"
"CGY",0,2,3,1,0,6,0,2,1,0,0,3,"H","N","2015-03-11","201503110CGY"
"BUF",0,2,1,0,0,3,0,2,0,1,1,4,"A","Y","2015-03-11","201503110TOR"
"TOR",0,2,0,1,1,4,0,2,1,0,0,3,"H","Y","2015-03-11","201503110TOR"
"NYR",0,2,0,1,0,3,0,1,0,0,0,1,"A","N","2015-03-11","201503110WSH"
"WSH",0,1,0,0,0,1,0,2,0,1,0,3,"H","N","2015-03-11","201503110WSH"
"ARI",0,1,0,0,0,1,0,1,0,1,0,2,"H","N","2015-03-12","201503120ARI"
"CHI",0,1,0,1,0,2,0,1,0,0,0,1,"A","N","2015-03-12","201503120ARI"
"BOS",0,1,0,1,1,3,0,1,0,1,0,2,"H","Y","2015-03-12","201503120BOS"
"TBL",0,1,0,1,0,2,0,1,0,1,1,3,"A","Y","2015-03-12","201503120BOS"
"CAR",0,1,0,2,0,3,0,3,0,2,0,5,"H","N","2015-03-12","201503120CAR"
"DAL",0,3,0,2,0,5,0,1,0,2,0,3,"A","N","2015-03-12","201503120CAR"
"COL",0,0,1,0,1,2,0,0,1,0,0,1,"H","Y","2015-03-12","201503120COL"
"NJD",0,0,1,0,0,1,0,0,1,0,1,2,"A","Y","2015-03-12","201503120COL"
"CBJ",0,2,1,0,0,3,0,1,0,0,0,1,"A","N","2015-03-12","201503120DET"
"DET",0,1,0,0,0,1,0,2,1,0,0,3,"H","N","2015-03-12","201503120DET"
"FLA",0,1,1,2,0,4,0,0,1,1,0,2,"H","N","2015-03-12","201503120FLA"
"WPG",0,0,1,1,0,2,0,1,1,2,0,4,"A","N","2015-03-12","201503120FLA"
"MTL",0,2,0,0,0,2,0,0,2,3,0,5,"H","N","2015-03-12","201503120MTL"
"OTT",0,0,2,3,0,5,0,2,0,0,0,2,"A","N","2015-03-12","201503120MTL"
"EDM",0,0,2,2,0,4,0,3,1,2,0,6,"A","N","2015-03-12","201503120PIT"
"PIT",0,3,1,2,0,6,0,0,2,2,0,4,"H","N","2015-03-12","201503120PIT"
"NSH",0,0,0,0,0,0,0,0,1,1,0,2,"A","N","2015-03-12","201503120SJS"
"SJS",0,0,1,1,0,2,0,0,0,0,0,0,"H","N","2015-03-12","201503120SJS"
"PHI",0,0,0,0,0,0,0,0,0,0,1,1,"A","Y","2015-03-12","201503120STL"
"STL",0,0,0,0,1,1,0,0,0,0,0,0,"H","Y","2015-03-12","201503120STL"
"LAK",0,1,1,2,0,4,0,0,0,0,0,0,"A","N","2015-03-12","201503120VAN"
"VAN",0,0,0,0,0,0,0,1,1,2,0,4,"H","N","2015-03-12","201503120VAN"
"CBJ",0,2,1,1,1,5,0,0,3,1,0,4,"H","Y","2015-03-13","201503130CBJ"
"EDM",0,0,3,1,0,4,0,2,1,1,1,5,"A","Y","2015-03-13","201503130CBJ"
"CGY",0,4,2,0,0,6,0,1,1,1,0,3,"H","N","2015-03-13","201503130CGY"
"TOR",0,1,1,1,0,3,0,4,2,0,0,6,"A","N","2015-03-13","201503130CGY"
"ANA",0,1,1,0,0,2,0,0,1,0,0,1,"A","N","2015-03-13","201503130MIN"
"MIN",0,0,1,0,0,1,0,1,1,0,0,2,"H","N","2015-03-13","201503130MIN"
"NYI",0,0,0,1,0,1,0,0,2,0,0,2,"H","N","2015-03-13","201503130NYI"
"OTT",0,0,2,0,0,2,0,0,0,1,0,1,"A","N","2015-03-13","201503130NYI"
"DAL",0,2,2,0,0,4,0,1,0,1,0,2,"A","N","2015-03-13","201503130WSH"
"WSH",0,1,0,1,0,2,0,2,2,0,0,4,"H","N","2015-03-13","201503130WSH"
"ARI",0,0,0,1,0,1,0,0,1,3,0,4,"H","N","2015-03-14","201503140ARI"
"NJD",0,0,1,3,0,4,0,0,0,1,0,1,"A","N","2015-03-14","201503140ARI"
"BUF",0,0,0,0,0,0,0,0,0,2,0,2,"H","N","2015-03-14","201503140BUF"
"NYR",0,0,0,2,0,2,0,0,0,0,0,0,"A","N","2015-03-14","201503140BUF"
"CAR",0,0,0,0,0,0,0,0,1,1,0,2,"H","N","2015-03-14","201503140CAR"
"FLA",0,0,1,1,0,2,0,0,0,0,0,0,"A","N","2015-03-14","201503140CAR"
"CGY",0,0,0,2,0,2,0,0,2,1,0,3,"A","N","2015-03-14","201503140COL"
"COL",0,0,2,1,0,3,0,0,0,2,0,2,"H","N","2015-03-14","201503140COL"
"LAK",0,1,0,0,0,1,0,0,0,2,0,2,"H","N","2015-03-14","201503140LAK"
"NSH",0,0,0,2,0,2,0,1,0,0,0,1,"A","N","2015-03-14","201503140LAK"
"MTL",0,0,2,1,0,3,0,0,0,1,0,1,"A","N","2015-03-14","201503140NYI"
"NYI",0,0,0,1,0,1,0,0,2,1,0,3,"H","N","2015-03-14","201503140NYI"
"DET",0,0,1,1,0,2,0,2,1,4,0,7,"A","N","2015-03-14","201503140PHI"
"PHI",0,2,1,4,0,7,0,0,1,1,0,2,"H","N","2015-03-14","201503140PHI"
"BOS",0,1,0,1,0,2,0,0,0,0,0,0,"A","N","2015-03-14","201503140PIT"
"PIT",0,0,0,0,0,0,0,1,0,1,0,2,"H","N","2015-03-14","201503140PIT"
"CHI",0,1,1,4,0,6,0,1,1,0,0,2,"A","N","2015-03-14","201503140SJS"
"SJS",0,1,1,0,0,2,0,1,1,4,0,6,"H","N","2015-03-14","201503140SJS"
"MIN",0,0,1,2,0,3,0,0,1,0,0,1,"A","N","2015-03-14","201503140STL"
"STL",0,0,1,0,0,1,0,0,1,2,0,3,"H","N","2015-03-14","201503140STL"
"TBL",0,0,0,1,0,1,0,0,0,2,0,2,"H","N","2015-03-14","201503140TBL"
"WPG",0,0,0,2,0,2,0,0,0,1,0,1,"A","N","2015-03-14","201503140TBL"
"TOR",0,0,0,1,0,1,0,1,2,1,0,4,"A","N","2015-03-14","201503140VAN"
"VAN",0,1,2,1,0,4,0,0,0,1,0,1,"H","N","2015-03-14","201503140VAN"
"ANA",0,0,0,4,0,4,0,0,2,0,0,2,"H","N","2015-03-15","201503150ANA"
"NSH",0,0,2,0,0,2,0,0,0,4,0,4,"A","N","2015-03-15","201503150ANA"
"CAR",0,0,3,0,0,3,0,1,1,0,0,2,"A","N","2015-03-15","201503150CBJ"
"CBJ",0,1,1,0,0,2,0,0,3,0,0,3,"H","N","2015-03-15","201503150CBJ"
"DAL",0,0,0,0,0,0,0,0,0,3,0,3,"H","N","2015-03-15","201503150DAL"
"STL",0,0,0,3,0,3,0,0,0,0,0,0,"A","N","2015-03-15","201503150DAL"
"FLA",0,0,0,1,0,1,0,1,0,1,0,2,"A","N","2015-03-15","201503150NYR"
"NYR",0,1,0,1,0,2,0,0,0,1,0,1,"H","N","2015-03-15","201503150NYR"
"OTT",0,0,1,0,1,2,0,0,1,0,0,1,"H","Y","2015-03-15","201503150OTT"
"PHI",0,0,1,0,0,1,0,0,1,0,1,2,"A","Y","2015-03-15","201503150OTT"
"DET",0,2,2,1,0,5,0,0,0,1,0,1,"A","N","2015-03-15","201503150PIT"
"PIT",0,0,0,1,0,1,0,2,2,1,0,5,"H","N","2015-03-15","201503150PIT"
"BOS",0,0,0,0,0,0,0,1,1,0,0,2,"A","N","2015-03-15","201503150WSH"
"WSH",0,1,1,0,0,2,0,0,0,0,0,0,"H","N","2015-03-15","201503150WSH"
"BUF",0,2,0,1,0,3,0,1,1,1,1,4,"H","Y","2015-03-16","201503160BUF"
"WSH",0,1,1,1,1,4,0,2,0,1,0,3,"A","Y","2015-03-16","201503160BUF"
"EDM",0,4,0,0,0,4,0,1,0,0,0,1,"H","N","2015-03-16","201503160EDM"
"TOR",0,1,0,0,0,1,0,4,0,0,0,4,"A","N","2015-03-16","201503160EDM"
"ARI",0,0,0,0,0,0,0,0,1,0,0,1,"A","N","2015-03-16","201503160LAK"
"LAK",0,0,1,0,0,1,0,0,0,0,0,0,"H","N","2015-03-16","201503160LAK"
"MTL",0,0,1,1,0,2,0,2,1,1,0,4,"A","N","2015-03-16","201503160TBL"
"TBL",0,2,1,1,0,4,0,0,1,1,0,2,"H","N","2015-03-16","201503160TBL"
"BOS",0,1,0,0,0,1,0,0,0,1,1,2,"H","Y","2015-03-17","201503170BOS"
"BUF",0,0,0,1,1,2,0,1,0,0,0,1,"A","Y","2015-03-17","201503170BOS"
"CAR",0,1,0,0,0,1,1,0,1,0,0,2,"H","N","2015-03-17","201503170CAR"
"OTT",1,0,1,0,0,2,0,1,0,0,0,1,"A","N","2015-03-17","201503170CAR"
"CGY",0,0,0,0,0,0,0,0,1,3,0,4,"H","N","2015-03-17","201503170CGY"
"STL",0,0,1,3,0,4,0,0,0,0,0,0,"A","N","2015-03-17","201503170CGY"
"CHI",0,2,1,1,0,4,0,0,0,1,0,1,"H","N","2015-03-17","201503170CHI"
"NYI",0,0,0,1,0,1,0,2,1,1,0,4,"A","N","2015-03-17","201503170CHI"
"FLA",0,0,2,0,0,2,0,0,3,0,0,3,"H","N","2015-03-17","201503170FLA"
"MTL",0,0,3,0,0,3,0,0,2,0,0,2,"A","N","2015-03-17","201503170FLA"
"NJD",0,0,1,1,0,2,0,0,0,0,0,0,"H","N","2015-03-17","201503170NJD"
"PIT",0,0,0,0,0,0,0,0,1,1,0,2,"A","N","2015-03-17","201503170NJD"
"MIN",1,1,0,1,0,3,0,0,2,0,0,2,"A","N","2015-03-17","201503170NSH"
"NSH",0,0,2,0,0,2,1,1,0,1,0,3,"H","N","2015-03-17","201503170NSH"
"PHI",0,0,1,0,0,1,0,0,1,3,0,4,"A","N","2015-03-17","201503170VAN"
"VAN",0,0,1,3,0,4,0,0,1,0,0,1,"H","N","2015-03-17","201503170VAN"
"SJS",0,0,1,1,0,2,0,3,1,1,0,5,"A","N","2015-03-17","201503170WPG"
"WPG",0,3,1,1,0,5,0,0,1,1,0,2,"H","N","2015-03-17","201503170WPG"
"ANA",1,0,0,2,0,3,0,1,0,1,0,2,"H","N","2015-03-18","201503180ANA"
"LAK",0,1,0,1,0,2,1,0,0,2,0,3,"A","N","2015-03-18","201503180ANA"
"CBJ",0,1,1,1,1,4,0,0,1,2,0,3,"A","Y","2015-03-18","201503180EDM"
"EDM",0,0,1,2,0,3,0,1,1,1,1,4,"H","Y","2015-03-18","201503180EDM"
"CHI",0,0,0,1,0,1,0,0,0,0,0,0,"A","N","2015-03-18","201503180NYR"
"NYR",0,0,0,0,0,0,0,0,0,1,0,1,"H","N","2015-03-18","201503180NYR"
"ARI",0,1,0,1,0,2,0,2,1,2,0,5,"H","N","2015-03-19","201503190ARI"
"COL",0,2,1,2,0,5,0,1,0,1,0,2,"A","N","2015-03-19","201503190ARI"
"CGY",0,0,2,2,0,4,0,0,1,0,0,1,"H","N","2015-03-19","201503190CGY"
"PHI",0,0,1,0,0,1,0,0,2,2,0,4,"A","N","2015-03-19","201503190CGY"
"DAL",0,0,2,0,0,2,0,0,1,0,0,1,"H","N","2015-03-19","201503190DAL"
"PIT",0,0,1,0,0,1,0,0,2,0,0,2,"A","N","2015-03-19","201503190DAL"
"DET",0,0,0,1,0,1,0,0,2,1,0,3,"A","N","2015-03-19","201503190FLA"
"FLA",0,0,2,1,0,3,0,0,0,1,0,1,"H","N","2015-03-19","201503190FLA"
"MIN",0,0,1,1,0,2,0,0,2,1,0,3,"H","N","2015-03-19","201503190MIN"
"WSH",0,0,2,1,0,3,0,0,1,1,0,2,"A","N","2015-03-19","201503190MIN"
"CAR",0,0,0,0,0,0,0,2,1,1,0,4,"A","N","2015-03-19","201503190MTL"
"MTL",0,2,1,1,0,4,0,0,0,0,0,0,"H","N","2015-03-19","201503190MTL"
"BOS",0,2,2,0,0,4,0,2,2,2,0,6,"A","N","2015-03-19","201503190OTT"
"OTT",0,2,2,2,0,6,0,2,2,0,0,4,"H","N","2015-03-19","201503190OTT"
"SJS",0,1,3,0,0,4,0,0,1,0,0,1,"A","N","2015-03-19","201503190TOR"
"TOR",0,0,1,0,0,1,0,1,3,0,0,4,"H","N","2015-03-19","201503190TOR"
"CBJ",0,0,3,3,0,6,0,0,2,0,0,2,"A","N","2015-03-19","201503190VAN"
"VAN",0,0,2,0,0,2,0,0,3,3,0,6,"H","N","2015-03-19","201503190VAN"
"STL",0,0,1,0,0,1,0,0,0,1,1,2,"A","Y","2015-03-19","201503190WPG"
"WPG",0,0,0,1,1,2,0,0,1,0,0,1,"H","Y","2015-03-19","201503190WPG"
"ANA",1,1,0,1,0,3,0,0,0,2,0,2,"H","N","2015-03-20","201503200ANA"
"COL",0,0,0,2,0,2,1,1,0,1,0,3,"A","N","2015-03-20","201503200ANA"
"BUF",0,0,0,1,0,1,0,0,2,1,0,3,"H","N","2015-03-20","201503200BUF"
"NJD",0,0,2,1,0,3,0,0,0,1,0,1,"A","N","2015-03-20","201503200BUF"
"DET",0,0,1,0,0,1,0,0,1,2,0,3,"A","N","2015-03-20","201503200TBL"
"TBL",0,0,1,2,0,3,0,0,1,0,0,1,"H","N","2015-03-20","201503200TBL"
"ARI",0,1,0,0,0,1,0,0,2,1,0,3,"H","N","2015-03-21","201503210ARI"
"PIT",0,0,2,1,0,3,0,1,0,0,0,1,"A","N","2015-03-21","201503210ARI"
"CAR",0,1,0,1,0,2,0,0,2,0,1,3,"H","Y","2015-03-21","201503210CAR"
"NYR",0,0,2,0,1,3,0,1,0,1,0,2,"A","Y","2015-03-21","201503210CAR"
"CBJ",1,1,0,1,0,3,0,1,1,0,0,2,"A","N","2015-03-21","201503210CGY"
"CGY",0,1,1,0,0,2,1,1,0,1,0,3,"H","N","2015-03-21","201503210CGY"
"CHI",0,0,0,0,0,0,0,2,0,2,0,4,"A","N","2015-03-21","201503210DAL"
"DAL",0,2,0,2,0,4,0,0,0,0,0,0,"H","N","2015-03-21","201503210DAL"
"EDM",1,3,1,0,0,5,0,3,0,1,0,4,"H","N","2015-03-21","201503210EDM"
"PHI",0,3,0,1,0,4,1,3,1,0,0,5,"A","N","2015-03-21","201503210EDM"
"BOS",0,0,1,0,0,1,0,1,0,0,1,2,"A","Y","2015-03-21","201503210FLA"
"FLA",0,1,0,0,1,2,0,0,1,0,0,1,"H","Y","2015-03-21","201503210FLA"
"LAK",0,0,1,0,0,1,0,0,1,3,0,4,"H","N","2015-03-21","201503210LAK"
"VAN",0,0,1,3,0,4,0,0,1,0,0,1,"A","N","2015-03-21","201503210LAK"
"MIN",0,2,3,1,0,6,0,0,2,1,0,3,"H","N","2015-03-21","201503210MIN"
"STL",0,0,2,1,0,3,0,2,3,1,0,6,"A","N","2015-03-21","201503210MIN"
"MTL",0,1,0,1,0,2,0,0,0,0,0,0,"H","N","2015-03-21","201503210MTL"
"SJS",0,0,0,0,0,0,0,1,0,1,0,2,"A","N","2015-03-21","201503210MTL"
"NJD",0,0,0,0,0,0,0,1,0,2,0,3,"H","N","2015-03-21","201503210NJD"
"NYI",0,1,0,2,0,3,0,0,0,0,0,0,"A","N","2015-03-21","201503210NJD"
"BUF",0,0,0,0,0,0,0,0,1,2,0,3,"A","N","2015-03-21","201503210NSH"
"NSH",0,0,1,2,0,3,0,0,0,0,0,0,"H","N","2015-03-21","201503210NSH"
"OTT",0,2,2,1,0,5,0,0,3,0,0,3,"H","N","2015-03-21","201503210OTT"
"TOR",0,0,3,0,0,3,0,2,2,1,0,5,"A","N","2015-03-21","201503210OTT"
"WPG",0,1,1,1,0,3,0,0,0,0,0,0,"H","N","2015-03-21","201503210WPG"
"WSH",0,0,0,0,0,0,0,1,1,1,0,3,"A","N","2015-03-21","201503210WPG"
"ARI",0,1,0,0,0,1,0,1,0,2,0,3,"H","N","2015-03-22","201503220ARI"
"VAN",0,1,0,2,0,3,0,1,0,0,0,1,"A","N","2015-03-22","201503220ARI"
"DET",1,0,0,1,0,2,0,0,1,0,0,1,"H","N","2015-03-22","201503220DET"
"STL",0,0,1,0,0,1,1,0,0,1,0,2,"A","N","2015-03-22","201503220DET"
"ANA",0,2,0,0,0,2,0,3,2,2,0,7,"A","N","2015-03-22","201503220NYR"
"NYR",0,3,2,2,0,7,0,2,0,0,0,2,"H","N","2015-03-22","201503220NYR"
"BOS",0,1,0,2,0,3,0,3,1,1,0,5,"A","N","2015-03-22","201503220TBL"
"TBL",0,3,1,1,0,5,0,1,0,2,0,3,"H","N","2015-03-22","201503220TBL"
"CAR",0,0,1,0,0,1,0,2,0,1,0,3,"H","N","2015-03-23","201503230CAR"
"CHI",0,2,0,1,0,3,0,0,1,0,0,1,"A","N","2015-03-23","201503230CAR"
"CGY",0,2,0,1,0,3,0,1,0,1,0,2,"H","N","2015-03-23","201503230CGY"
"COL",0,1,0,1,0,2,0,2,0,1,0,3,"A","N","2015-03-23","201503230CGY"
"BUF",0,1,1,1,0,3,0,1,0,3,0,4,"A","N","2015-03-23","201503230DAL"
"DAL",0,1,0,3,0,4,0,1,1,1,0,3,"H","N","2015-03-23","201503230DAL"
"EDM",0,0,0,1,0,1,0,1,2,1,0,4,"H","N","2015-03-23","201503230EDM"
"WPG",0,1,2,1,0,4,0,0,0,1,0,1,"A","N","2015-03-23","201503230EDM"
"LAK",0,2,0,1,0,3,0,0,1,0,0,1,"A","N","2015-03-23","201503230NJD"
"NJD",0,0,1,0,0,1,0,2,0,1,0,3,"H","N","2015-03-23","201503230NJD"
"OTT",0,1,0,4,0,5,0,0,2,0,0,2,"H","N","2015-03-23","201503230OTT"
"SJS",0,0,2,0,0,2,0,1,0,4,0,5,"A","N","2015-03-23","201503230OTT"
"MIN",0,1,0,1,0,2,0,0,0,1,0,1,"A","N","2015-03-23","201503230TOR"
"TOR",0,0,0,1,0,1,0,1,0,1,0,2,"H","N","2015-03-23","201503230TOR"
"ANA",0,2,1,0,0,3,0,1,3,1,0,5,"A","N","2015-03-24","201503240CBJ"
"CBJ",0,1,3,1,0,5,0,2,1,0,0,3,"H","N","2015-03-24","201503240CBJ"
"ARI",1,1,2,1,0,5,0,0,2,2,0,4,"A","N","2015-03-24","201503240DET"
"DET",0,0,2,2,0,4,1,1,2,1,0,5,"H","N","2015-03-24","201503240DET"
"MTL",0,0,2,0,0,2,1,1,0,1,0,3,"A","N","2015-03-24","201503240NSH"
"NSH",1,1,0,1,0,3,0,0,2,0,0,2,"H","N","2015-03-24","201503240NSH"
"MIN",0,0,0,1,1,2,0,0,1,0,0,1,"A","Y","2015-03-24","201503240NYI"
"NYI",0,0,1,0,0,1,0,0,0,1,1,2,"H","Y","2015-03-24","201503240NYI"
"LAK",0,1,1,2,0,4,0,1,0,1,0,2,"A","N","2015-03-24","201503240NYR"
"NYR",0,1,0,1,0,2,0,1,1,2,0,4,"H","N","2015-03-24","201503240NYR"
"PIT",0,0,2,0,0,2,1,0,2,0,0,3,"H","N","2015-03-24","201503240PIT"
"STL",1,0,2,0,0,3,0,0,2,0,0,2,"A","N","2015-03-24","201503240PIT"
"FLA",0,0,3,0,0,3,0,2,0,2,0,4,"A","N","2015-03-24","201503240TBL"
"TBL",0,2,0,2,0,4,0,0,3,0,0,3,"H","N","2015-03-24","201503240TBL"
"VAN",0,0,3,2,0,5,0,1,1,0,0,2,"H","N","2015-03-24","201503240VAN"
"WPG",0,1,1,0,0,2,0,0,3,2,0,5,"A","N","2015-03-24","201503240VAN"
"CGY",0,0,2,1,0,3,0,0,3,0,1,4,"H","Y","2015-03-25","201503250CGY"
"DAL",0,0,3,0,1,4,0,0,2,1,0,3,"A","Y","2015-03-25","201503250CGY"
"COL",0,0,2,1,0,3,0,3,0,1,0,4,"A","N","2015-03-25","201503250EDM"
"EDM",0,3,0,1,0,4,0,0,2,1,0,3,"H","N","2015-03-25","201503250EDM"
"CHI",0,0,0,1,0,1,0,1,2,1,0,4,"A","N","2015-03-25","201503250PHI"
"PHI",0,1,2,1,0,4,0,0,0,1,0,1,"H","N","2015-03-25","201503250PHI"
"ANA",1,0,1,1,0,3,0,0,1,1,0,2,"A","N","2015-03-26","201503260BOS"
"BOS",0,0,1,1,0,2,1,0,1,1,0,3,"H","N","2015-03-26","201503260BOS"
"ARI",1,1,2,0,0,4,0,1,1,1,0,3,"A","N","2015-03-26","201503260BUF"
"BUF",0,1,1,1,0,3,1,1,2,0,0,4,"H","N","2015-03-26","201503260BUF"
"CAR",0,2,2,1,0,5,0,1,0,1,0,2,"H","N","2015-03-26","201503260CAR"
"PIT",0,1,0,1,0,2,0,2,2,1,0,5,"A","N","2015-03-26","201503260CAR"
"DET",0,2,0,2,0,4,0,3,0,3,0,6,"H","N","2015-03-26","201503260DET"
"SJS",0,3,0,3,0,6,0,2,0,2,0,4,"A","N","2015-03-26","201503260DET"
"LAK",0,0,1,2,0,3,0,0,1,1,0,2,"A","N","2015-03-26","201503260NYI"
"NYI",0,0,1,1,0,2,0,0,1,2,0,3,"H","N","2015-03-26","201503260NYI"
"NYR",0,3,2,0,0,5,0,1,0,0,0,1,"A","N","2015-03-26","201503260OTT"
"OTT",0,1,0,0,0,1,0,3,2,0,0,5,"H","N","2015-03-26","201503260OTT"
"NSH",0,2,1,0,0,3,0,1,1,0,0,2,"A","N","2015-03-26","201503260TBL"
"TBL",0,1,1,0,0,2,0,2,1,0,0,3,"H","N","2015-03-26","201503260TBL"
"FLA",0,0,3,1,0,4,0,0,0,1,0,1,"A","N","2015-03-26","201503260TOR"
"TOR",0,0,0,1,0,1,0,0,3,1,0,4,"H","N","2015-03-26","201503260TOR"
"COL",0,0,3,1,0,4,0,0,0,1,0,1,"A","N","2015-03-26","201503260VAN"
"VAN",0,0,0,1,0,1,0,0,3,1,0,4,"H","N","2015-03-26","201503260VAN"
"MTL",0,0,1,1,0,2,0,1,3,1,0,5,"A","N","2015-03-26","201503260WPG"
"WPG",0,1,3,1,0,5,0,0,1,1,0,2,"H","N","2015-03-26","201503260WPG"
"NJD",0,0,1,1,0,2,1,1,1,0,0,3,"A","N","2015-03-26","201503260WSH"
"WSH",1,1,1,0,0,3,0,0,1,1,0,2,"H","N","2015-03-26","201503260WSH"
"CBJ",0,4,0,1,0,5,0,2,0,0,0,2,"A","N","2015-03-27","201503270CHI"
"CHI",0,2,0,0,0,2,0,4,0,1,0,5,"H","N","2015-03-27","201503270CHI"
"DAL",0,0,0,0,0,0,0,1,0,3,0,4,"A","N","2015-03-27","201503270EDM"
"EDM",0,1,0,3,0,4,0,0,0,0,0,0,"H","N","2015-03-27","201503270EDM"
"CGY",0,1,0,1,0,2,0,1,0,3,0,4,"A","N","2015-03-27","201503270MIN"
"MIN",0,1,0,3,0,4,0,1,0,1,0,2,"H","N","2015-03-27","201503270MIN"
"BOS",0,3,1,0,0,4,0,0,1,1,0,2,"H","N","2015-03-28","201503280BOS"
"NYR",0,0,1,1,0,2,0,3,1,0,0,4,"A","N","2015-03-28","201503280BOS"
"CAR",0,0,1,2,0,3,0,1,0,0,0,1,"H","N","2015-03-28","201503280CAR"
"NJD",0,1,0,0,0,1,0,0,1,2,0,3,"A","N","2015-03-28","201503280CAR"
"BUF",0,0,0,3,0,3,0,2,2,1,0,5,"A","N","2015-03-28","201503280COL"
"COL",0,2,2,1,0,5,0,0,0,3,0,3,"H","N","2015-03-28","201503280COL"
"DET",0,0,3,1,0,4,0,0,0,0,0,0,"H","N","2015-03-28","201503280DET"
"TBL",0,0,0,0,0,0,0,0,3,1,0,4,"A","N","2015-03-28","201503280DET"
"LAK",0,0,1,0,0,1,0,2,0,2,0,4,"A","N","2015-03-28","201503280MIN"
"MIN",0,2,0,2,0,4,0,0,1,0,0,1,"H","N","2015-03-28","201503280MIN"
"FLA",0,0,2,0,0,2,1,1,1,0,0,3,"A","N","2015-03-28","201503280MTL"
"MTL",1,1,1,0,0,3,0,0,2,0,0,2,"H","N","2015-03-28","201503280MTL"
"ANA",0,1,2,0,0,3,0,1,0,1,0,2,"A","N","2015-03-28","201503280NYI"
"NYI",0,1,0,1,0,2,0,1,2,0,0,3,"H","N","2015-03-28","201503280NYI"
"PHI",0,1,0,1,0,2,0,2,0,0,1,3,"H","Y","2015-03-28","201503280PHI"
"SJS",0,2,0,0,1,3,0,1,0,1,0,2,"A","Y","2015-03-28","201503280PHI"
"ARI",0,0,0,2,0,2,0,0,0,3,0,3,"A","N","2015-03-28","201503280PIT"
"PIT",0,0,0,3,0,3,0,0,0,2,0,2,"H","N","2015-03-28","201503280PIT"
"CBJ",0,1,2,1,0,4,0,0,2,0,0,2,"A","N","2015-03-28","201503280STL"
"STL",0,0,2,0,0,2,0,1,2,1,0,4,"H","N","2015-03-28","201503280STL"
"OTT",0,0,2,1,0,3,1,0,0,3,0,4,"A","N","2015-03-28","201503280TOR"
"TOR",1,0,0,3,0,4,0,0,2,1,0,3,"H","N","2015-03-28","201503280TOR"
"DAL",1,1,0,2,0,4,0,1,1,1,0,3,"A","N","2015-03-28","201503280VAN"
"VAN",0,1,1,1,0,3,1,1,0,2,0,4,"H","N","2015-03-28","201503280VAN"
"NSH",0,3,1,0,0,4,0,0,2,1,0,3,"A","N","2015-03-28","201503280WSH"
"WSH",0,0,2,1,0,3,0,3,1,0,0,4,"H","N","2015-03-28","201503280WSH"
"BOS",1,1,0,0,0,2,0,0,1,0,0,1,"A","N","2015-03-29","201503290CAR"
"CAR",0,0,1,0,0,1,1,1,0,0,0,2,"H","N","2015-03-29","201503290CAR"
"ANA",0,1,0,1,0,2,0,0,0,1,0,1,"A","N","2015-03-29","201503290NJD"
"NJD",0,0,0,1,0,1,0,1,0,1,0,2,"H","N","2015-03-29","201503290NJD"
"CGY",0,2,2,1,0,5,0,1,0,1,0,2,"A","N","2015-03-29","201503290NSH"
"NSH",0,1,0,1,0,2,0,2,2,1,0,5,"H","N","2015-03-29","201503290NSH"
"DET",0,3,1,0,0,4,0,3,2,0,0,5,"A","N","2015-03-29","201503290NYI"
"NYI",0,3,2,0,0,5,0,3,1,0,0,4,"H","N","2015-03-29","201503290NYI"
"NYR",0,2,0,0,0,2,0,1,1,3,0,5,"H","N","2015-03-29","201503290NYR"
"WSH",0,1,1,3,0,5,0,2,0,0,0,2,"A","N","2015-03-29","201503290NYR"
"FLA",0,0,2,2,0,4,0,0,0,2,0,2,"A","N","2015-03-29","201503290OTT"
"OTT",0,0,0,2,0,2,0,0,2,2,0,4,"H","N","2015-03-29","201503290OTT"
"PIT",0,2,0,0,1,3,0,0,2,0,0,2,"H","Y","2015-03-29","201503290PIT"
"SJS",0,0,2,0,0,2,0,2,0,0,1,3,"A","Y","2015-03-29","201503290PIT"
"CHI",0,1,1,2,0,4,0,0,3,0,0,3,"A","N","2015-03-29","201503290WPG"
"WPG",0,0,3,0,0,3,0,1,1,2,0,4,"H","N","2015-03-29","201503290WPG"
"ARI",0,1,0,0,0,1,0,0,2,2,0,4,"H","N","2015-03-30","201503300ARI"
"BUF",0,0,2,2,0,4,0,1,0,0,0,1,"A","N","2015-03-30","201503300ARI"
"CHI",0,1,2,1,0,4,0,1,0,0,0,1,"H","N","2015-03-30","201503300CHI"
"LAK",0,1,0,0,0,1,0,1,2,1,0,4,"A","N","2015-03-30","201503300CHI"
"COL",0,1,0,0,0,1,0,1,1,2,0,4,"H","N","2015-03-30","201503300COL"
"EDM",0,1,1,2,0,4,0,1,0,0,0,1,"A","N","2015-03-30","201503300COL"
"CGY",0,1,3,1,0,5,0,2,0,1,0,3,"A","N","2015-03-30","201503300DAL"
"DAL",0,2,0,1,0,3,0,1,3,1,0,5,"H","N","2015-03-30","201503300DAL"
"MTL",0,0,1,2,0,3,0,0,3,2,0,5,"H","N","2015-03-30","201503300MTL"
"TBL",0,0,3,2,0,5,0,0,1,2,0,3,"A","N","2015-03-30","201503300MTL"
"STL",0,0,1,0,0,1,0,0,2,2,0,4,"H","N","2015-03-30","201503300STL"
"VAN",0,0,2,2,0,4,0,0,1,0,0,1,"A","N","2015-03-30","201503300STL"
"BOS",0,1,0,2,0,3,0,0,2,0,0,2,"H","N","2015-03-31","201503310BOS"
"FLA",0,0,2,0,0,2,0,1,0,2,0,3,"A","N","2015-03-31","201503310BOS"
"CBJ",1,0,2,0,0,3,0,1,0,1,0,2,"H","N","2015-03-31","201503310CBJ"
"NJD",0,1,0,1,0,2,1,0,2,0,0,3,"A","N","2015-03-31","201503310CBJ"
"DET",0,0,1,0,0,1,0,0,0,1,1,2,"H","Y","2015-03-31","201503310DET"
"OTT",0,0,0,1,1,2,0,0,1,0,0,1,"A","Y","2015-03-31","201503310DET"
"NSH",0,2,1,1,0,4,0,0,2,2,1,5,"H","Y","2015-03-31","201503310NSH"
"VAN",0,0,2,2,1,5,0,2,1,1,0,4,"A","Y","2015-03-31","201503310NSH"
"TBL",0,1,0,0,0,1,0,2,0,1,0,3,"A","N","2015-03-31","201503310TOR"
"TOR",0,2,0,1,0,3,0,1,0,0,0,1,"H","N","2015-03-31","201503310TOR"
"NYR",0,1,1,1,0,3,0,1,1,0,0,2,"A","N","2015-03-31","201503310WPG"
"WPG",0,1,1,0,0,2,0,1,1,1,0,3,"H","N","2015-03-31","201503310WPG"
"CAR",0,0,2,0,0,2,0,2,2,0,0,4,"A","N","2015-03-31","201503310WSH"
"WSH",0,2,2,0,0,4,0,0,2,0,0,2,"H","N","2015-03-31","201503310WSH"
"ANA",0,2,2,1,0,5,0,0,1,0,0,1,"H","N","2015-04-01","201504010ANA"
"EDM",0,0,1,0,0,1,0,2,2,1,0,5,"A","N","2015-04-01","201504010ANA"
"BUF",0,1,1,2,0,4,0,1,2,0,0,3,"H","N","2015-04-01","201504010BUF"
"TOR",0,1,2,0,0,3,0,1,1,2,0,4,"A","N","2015-04-01","201504010BUF"
"PHI",0,1,1,2,0,4,0,1,0,0,0,1,"A","N","2015-04-01","201504010PIT"
"PIT",0,1,0,0,0,1,0,1,1,2,0,4,"H","N","2015-04-01","201504010PIT"
"COL",0,0,0,1,0,1,0,0,1,4,0,5,"A","N","2015-04-01","201504010SJS"
"SJS",0,0,1,4,0,5,0,0,0,1,0,1,"H","N","2015-04-01","201504010SJS"
"CBJ",0,1,0,2,1,4,0,1,1,1,0,3,"H","Y","2015-04-02","201504020CBJ"
"NYI",0,1,1,1,0,3,0,1,0,2,1,4,"A","Y","2015-04-02","201504020CBJ"
"CHI",0,1,0,2,0,3,0,1,0,0,0,1,"H","N","2015-04-02","201504020CHI"
"VAN",0,1,0,0,0,1,0,1,0,2,0,3,"A","N","2015-04-02","201504020CHI"
"BOS",0,0,0,3,0,3,0,0,1,1,0,2,"A","N","2015-04-02","201504020DET"
"DET",0,0,1,1,0,2,0,0,0,3,0,3,"H","N","2015-04-02","201504020DET"
"CAR",0,0,0,1,0,1,0,1,3,2,0,6,"A","N","2015-04-02","201504020FLA"
"FLA",0,1,3,2,0,6,0,0,0,1,0,1,"H","N","2015-04-02","201504020FLA"
"EDM",0,0,1,1,0,2,0,3,2,3,0,8,"A","N","2015-04-02","201504020LAK"
"LAK",0,3,2,3,0,8,0,0,1,1,0,2,"H","N","2015-04-02","201504020LAK"
"MIN",0,0,1,1,0,2,0,2,0,1,0,3,"H","N","2015-04-02","201504020MIN"
"NYR",0,2,0,1,0,3,0,0,1,1,0,2,"A","N","2015-04-02","201504020MIN"
"MTL",0,0,3,1,0,4,0,0,2,2,1,5,"H","Y","2015-04-02","201504020MTL"
"WSH",0,0,2,2,1,5,0,0,3,1,0,4,"A","Y","2015-04-02","201504020MTL"
"OTT",1,1,0,0,0,2,0,1,0,0,0,1,"H","N","2015-04-02","201504020OTT"
"TBL",0,1,0,0,0,1,1,1,0,0,0,2,"A","N","2015-04-02","201504020OTT"
"CGY",0,0,1,0,0,1,0,1,1,2,0,4,"A","N","2015-04-02","201504020STL"
"STL",0,1,1,2,0,4,0,0,1,0,0,1,"H","N","2015-04-02","201504020STL"
"ANA",0,2,0,0,0,2,0,1,1,2,0,4,"H","N","2015-04-03","201504030ANA"
"COL",0,1,1,2,0,4,0,2,0,0,0,2,"A","N","2015-04-03","201504030ANA"
"BUF",0,0,1,2,0,3,0,2,0,2,0,4,"H","N","2015-04-03","201504030BUF"
"CHI",0,2,0,2,0,4,0,0,1,2,0,3,"A","N","2015-04-03","201504030BUF"
"DAL",0,1,4,0,0,5,0,1,3,3,0,7,"H","N","2015-04-03","201504030DAL"
"STL",0,1,3,3,0,7,0,1,4,0,0,5,"A","N","2015-04-03","201504030DAL"
"MTL",0,2,0,0,0,2,0,1,1,0,1,3,"A","Y","2015-04-03","201504030NJD"
"NJD",0,1,1,0,1,3,0,2,0,0,0,2,"H","Y","2015-04-03","201504030NJD"
"ARI",0,0,1,0,0,1,0,2,0,1,0,3,"A","N","2015-04-03","201504030SJS"
"SJS",0,2,0,1,0,3,0,0,1,0,0,1,"H","N","2015-04-03","201504030SJS"
"ARI",0,2,1,2,0,5,0,1,1,1,0,3,"H","N","2015-04-04","201504040ARI"
"SJS",0,1,1,1,0,3,0,2,1,2,0,5,"A","N","2015-04-04","201504040ARI"
"BOS",0,0,1,0,1,2,0,0,1,0,0,1,"H","Y","2015-04-04","201504040BOS"
"TOR",0,0,1,0,0,1,0,0,1,0,1,2,"A","Y","2015-04-04","201504040BOS"
"CAR",0,1,1,0,1,3,0,0,1,1,0,2,"H","Y","2015-04-04","201504040CAR"
"PHI",0,0,1,1,0,2,0,1,1,0,1,3,"A","Y","2015-04-04","201504040CAR"
"CBJ",0,0,2,3,0,5,0,1,1,1,0,3,"H","N","2015-04-04","201504040CBJ"
"PIT",0,1,1,1,0,3,0,0,2,3,0,5,"A","N","2015-04-04","201504040CBJ"
"CGY",0,1,1,2,0,4,0,0,0,0,0,0,"A","N","2015-04-04","201504040EDM"
"EDM",0,0,0,0,0,0,0,1,1,2,0,4,"H","N","2015-04-04","201504040EDM"
"FLA",0,0,0,0,0,0,0,0,2,2,0,4,"H","N","2015-04-04","201504040FLA"
"TBL",0,0,2,2,0,4,0,0,0,0,0,0,"A","N","2015-04-04","201504040FLA"
"COL",0,0,1,0,0,1,0,1,1,1,0,3,"A","N","2015-04-04","201504040LAK"
"LAK",0,1,1,1,0,3,0,0,1,0,0,1,"H","N","2015-04-04","201504040LAK"
"DET",0,1,1,0,1,3,0,1,0,1,0,2,"A","Y","2015-04-04","201504040MIN"
"MIN",0,1,0,1,0,2,0,1,1,0,1,3,"H","Y","2015-04-04","201504040MIN"
"DAL",1,0,1,2,0,4,0,1,0,2,0,3,"A","N","2015-04-04","201504040NSH"
"NSH",0,1,0,2,0,3,1,0,1,2,0,4,"H","N","2015-04-04","201504040NSH"
"BUF",0,0,0,0,0,0,0,1,0,2,0,3,"A","N","2015-04-04","201504040NYI"
"NYI",0,1,0,2,0,3,0,0,0,0,0,0,"H","N","2015-04-04","201504040NYI"
"NJD",0,0,0,1,0,1,0,3,1,2,0,6,"A","N","2015-04-04","201504040NYR"
"NYR",0,3,1,2,0,6,0,0,0,1,0,1,"H","N","2015-04-04","201504040NYR"
"OTT",1,3,0,0,0,4,0,0,1,2,0,3,"H","N","2015-04-04","201504040OTT"
"WSH",0,0,1,2,0,3,1,3,0,0,0,4,"A","N","2015-04-04","201504040OTT"
"VAN",0,2,1,1,0,4,0,3,1,1,0,5,"A","N","2015-04-04","201504040WPG"
"WPG",0,3,1,1,0,5,0,2,1,1,0,4,"H","N","2015-04-04","201504040WPG"
"CHI",0,1,0,0,0,1,0,0,2,0,0,2,"H","N","2015-04-05","201504050CHI"
"STL",0,0,2,0,0,2,0,1,0,0,0,1,"A","N","2015-04-05","201504050CHI"
"DET",0,0,1,0,0,1,0,1,1,0,0,2,"H","N","2015-04-05","201504050DET"
"WSH",0,1,1,0,0,2,0,0,1,0,0,1,"A","N","2015-04-05","201504050DET"
"FLA",0,0,1,0,0,1,0,1,3,0,0,4,"H","N","2015-04-05","201504050FLA"
"MTL",0,1,3,0,0,4,0,0,1,0,0,1,"A","N","2015-04-05","201504050FLA"
"PHI",0,1,1,2,0,4,0,1,0,0,0,1,"H","N","2015-04-05","201504050PHI"
"PIT",0,1,0,0,0,1,0,1,1,2,0,4,"A","N","2015-04-05","201504050PHI"
"OTT",0,0,1,1,0,2,0,1,1,0,1,3,"A","Y","2015-04-05","201504050TOR"
"TOR",0,1,1,0,1,3,0,0,1,1,0,2,"H","Y","2015-04-05","201504050TOR"
"BUF",0,2,2,0,0,4,0,0,1,2,0,3,"H","N","2015-04-06","201504060BUF"
"CAR",0,0,1,2,0,3,0,2,2,0,0,4,"A","N","2015-04-06","201504060BUF"
"MIN",0,0,0,0,0,0,0,1,1,0,0,2,"H","N","2015-04-06","201504060MIN"
"WPG",0,1,1,0,0,2,0,0,0,0,0,0,"A","N","2015-04-06","201504060MIN"
"CBJ",0,1,1,1,0,3,1,1,1,1,0,4,"A","N","2015-04-06","201504060NYR"
"NYR",1,1,1,1,0,4,0,1,1,1,0,3,"H","N","2015-04-06","201504060NYR"
"DAL",0,2,1,2,0,5,0,0,1,0,0,1,"A","N","2015-04-06","201504060SJS"
"SJS",0,0,1,0,0,1,0,2,1,2,0,5,"H","N","2015-04-06","201504060SJS"
"LAK",0,1,0,0,0,1,0,0,0,1,1,2,"A","Y","2015-04-06","201504060VAN"
"VAN",0,0,0,1,1,2,0,1,0,0,0,1,"H","Y","2015-04-06","201504060VAN"
"ARI",0,0,1,1,0,2,0,1,0,2,0,3,"A","N","2015-04-07","201504070CGY"
"CGY",0,1,0,2,0,3,0,0,1,1,0,2,"H","N","2015-04-07","201504070CGY"
"CHI",0,0,0,1,0,1,0,0,0,2,0,2,"H","N","2015-04-07","201504070CHI"
"MIN",0,0,0,2,0,2,0,0,0,1,0,1,"A","N","2015-04-07","201504070CHI"
"COL",0,0,2,1,0,3,0,1,0,1,0,2,"H","N","2015-04-07","201504070COL"
"NSH",0,1,0,1,0,2,0,0,2,1,0,3,"A","N","2015-04-07","201504070COL"
"CAR",0,0,2,0,0,2,0,0,1,2,0,3,"A","N","2015-04-07","201504070DET"
"DET",0,0,1,2,0,3,0,0,2,0,0,2,"H","N","2015-04-07","201504070DET"
"EDM",0,0,2,2,0,4,0,0,1,1,0,2,"H","N","2015-04-07","201504070EDM"
"LAK",0,0,1,1,0,2,0,0,2,2,0,4,"A","N","2015-04-07","201504070EDM"
"NJD",0,1,0,1,0,2,0,2,0,2,0,4,"H","N","2015-04-07","201504070NJD"
"NYR",0,2,0,2,0,4,0,1,0,1,0,2,"A","N","2015-04-07","201504070NJD"
"OTT",1,0,1,2,0,4,0,3,0,0,0,3,"H","N","2015-04-07","201504070OTT"
"PIT",0,3,0,0,0,3,1,0,1,2,0,4,"A","N","2015-04-07","201504070OTT"
"NYI",0,0,1,3,0,4,0,2,1,2,0,5,"A","N","2015-04-07","201504070PHI"
"PHI",0,2,1,2,0,5,0,0,1,3,0,4,"H","N","2015-04-07","201504070PHI"
"STL",0,0,0,0,0,0,0,0,1,0,0,1,"H","N","2015-04-07","201504070STL"
"WPG",0,0,1,0,0,1,0,0,0,0,0,0,"A","N","2015-04-07","201504070STL"
"ANA",0,0,0,0,0,0,0,0,3,1,0,4,"H","N","2015-04-08","201504080ANA"
"DAL",0,0,3,1,0,4,0,0,0,0,0,0,"A","N","2015-04-08","201504080ANA"
"CBJ",0,3,2,0,0,5,0,0,0,0,0,0,"H","N","2015-04-08","201504080CBJ"
"TOR",0,0,0,0,0,0,0,3,2,0,0,5,"A","N","2015-04-08","201504080CBJ"
"BOS",0,0,0,0,0,0,0,2,1,0,0,3,"A","N","2015-04-08","201504080WSH"
"WSH",0,2,1,0,0,3,0,0,0,0,0,0,"H","N","2015-04-08","201504080WSH"
"CGY",0,2,0,1,0,3,0,0,0,1,0,1,"H","N","2015-04-09","201504090CGY"
"LAK",0,0,0,1,0,1,0,2,0,1,0,3,"A","N","2015-04-09","201504090CGY"
"COL",0,0,0,0,1,1,0,0,0,0,0,0,"H","Y","2015-04-09","201504090COL"
"WPG",0,0,0,0,0,0,0,0,0,0,1,1,"A","Y","2015-04-09","201504090COL"
"EDM",0,0,1,0,0,1,0,0,0,3,0,3,"H","N","2015-04-09","201504090EDM"
"SJS",0,0,0,3,0,3,0,0,1,0,0,1,"A","N","2015-04-09","201504090EDM"
"BOS",0,0,1,1,0,2,0,0,1,3,0,4,"A","N","2015-04-09","201504090FLA"
"FLA",0,0,1,3,0,4,0,0,1,1,0,2,"H","N","2015-04-09","201504090FLA"
"DET",0,1,1,1,0,3,1,1,1,1,0,4,"A","N","2015-04-09","201504090MTL"
"MTL",1,1,1,1,0,4,0,1,1,1,0,3,"H","N","2015-04-09","201504090MTL"
"MIN",0,0,2,2,0,4,0,2,0,0,0,2,"A","N","2015-04-09","201504090NSH"
"NSH",0,2,0,0,0,2,0,0,2,2,0,4,"H","N","2015-04-09","201504090NSH"
"NYR",0,0,0,0,0,0,0,0,2,1,0,3,"H","N","2015-04-09","201504090NYR"
"OTT",0,0,2,1,0,3,0,0,0,0,0,0,"A","N","2015-04-09","201504090NYR"
"CAR",0,1,0,2,0,3,0,0,0,1,0,1,"A","N","2015-04-09","201504090PHI"
"PHI",0,0,0,1,0,1,0,1,0,2,0,3,"H","N","2015-04-09","201504090PHI"
"CHI",0,0,0,1,0,1,0,0,1,1,0,2,"A","N","2015-04-09","201504090STL"
"STL",0,0,1,1,0,2,0,0,0,1,0,1,"H","N","2015-04-09","201504090STL"
"NJD",0,1,2,0,0,3,1,2,1,0,0,4,"A","N","2015-04-09","201504090TBL"
"TBL",1,2,1,0,0,4,0,1,2,0,0,3,"H","N","2015-04-09","201504090TBL"
"ARI",0,0,0,0,0,0,0,1,3,1,0,5,"A","N","2015-04-09","201504090VAN"
"VAN",0,1,3,1,0,5,0,0,0,0,0,0,"H","N","2015-04-09","201504090VAN"
"BUF",0,1,1,0,0,2,0,2,0,2,0,4,"A","N","2015-04-10","201504100CBJ"
"CBJ",0,2,0,2,0,4,0,1,1,0,0,2,"H","N","2015-04-10","201504100CBJ"
"NYI",0,1,0,2,0,3,0,0,1,0,0,1,"A","N","2015-04-10","201504100PIT"
"PIT",0,0,1,0,0,1,0,1,0,2,0,3,"H","N","2015-04-10","201504100PIT"
"ANA",0,1,1,0,0,2,0,0,0,1,0,1,"A","N","2015-04-11","201504110ARI"
"ARI",0,0,0,1,0,1,0,1,1,0,0,2,"H","N","2015-04-11","201504110ARI"
"BUF",0,0,0,0,0,0,0,0,1,1,0,2,"H","N","2015-04-11","201504110BUF"
"PIT",0,0,1,1,0,2,0,0,0,0,0,0,"A","N","2015-04-11","201504110BUF"
"CAR",0,0,0,0,0,0,0,1,0,1,0,2,"H","N","2015-04-11","201504110CAR"
"DET",0,1,0,1,0,2,0,0,0,0,0,0,"A","N","2015-04-11","201504110CAR"
"CHI",0,0,1,1,0,2,0,1,1,1,0,3,"A","N","2015-04-11","201504110COL"
"COL",0,1,1,1,0,3,0,0,1,1,0,2,"H","N","2015-04-11","201504110COL"
"DAL",0,2,0,2,0,4,0,1,0,0,0,1,"H","N","2015-04-11","201504110DAL"
"NSH",0,1,0,0,0,1,0,2,0,2,0,4,"A","N","2015-04-11","201504110DAL"
"FLA",0,0,1,2,0,3,0,0,1,1,0,2,"H","N","2015-04-11","201504110FLA"
"NJD",0,0,1,1,0,2,0,0,1,2,0,3,"A","N","2015-04-11","201504110FLA"
"LAK",0,0,1,3,0,4,0,1,0,0,0,1,"H","N","2015-04-11","201504110LAK"
"SJS",0,1,0,0,0,1,0,0,1,3,0,4,"A","N","2015-04-11","201504110LAK"
"CBJ",0,1,0,3,1,5,0,0,1,3,0,4,"A","Y","2015-04-11","201504110NYI"
"NYI",0,0,1,3,0,4,0,1,0,3,1,5,"H","Y","2015-04-11","201504110NYI"
"OTT",0,1,1,1,0,3,0,0,1,0,0,1,"A","N","2015-04-11","201504110PHI"
"PHI",0,0,1,0,0,1,0,1,1,1,0,3,"H","N","2015-04-11","201504110PHI"
"MIN",0,0,1,1,0,2,0,0,3,1,0,4,"A","N","2015-04-11","201504110STL"
"STL",0,0,3,1,0,4,0,0,1,1,0,2,"H","N","2015-04-11","201504110STL"
"BOS",0,0,1,1,0,2,0,0,1,1,1,3,"A","Y","2015-04-11","201504110TBL"
"TBL",0,0,1,1,1,3,0,0,1,1,0,2,"H","Y","2015-04-11","201504110TBL"
"MTL",0,1,2,0,1,4,0,2,1,0,0,3,"A","Y","2015-04-11","201504110TOR"
"TOR",0,2,1,0,0,3,0,1,2,0,1,4,"H","Y","2015-04-11","201504110TOR"
"EDM",0,2,3,0,0,5,1,1,2,2,0,6,"A","N","2015-04-11","201504110VAN"
"VAN",1,1,2,2,0,6,0,2,3,0,0,5,"H","N","2015-04-11","201504110VAN"
"CGY",0,1,0,0,0,1,0,1,0,4,0,5,"A","N","2015-04-11","201504110WPG"
"WPG",0,1,0,4,0,5,0,1,0,0,0,1,"H","N","2015-04-11","201504110WPG"
"NYR",0,2,1,1,0,4,0,0,1,1,0,2,"A","N","2015-04-11","201504110WSH"
"WSH",0,0,1,1,0,2,0,2,1,1,0,4,"H","N","2015-04-11","201504110WSH"
"MTL",0,0,4,0,0,4,0,1,2,0,0,3,"H","N","2015-04-15","201504150MTL"
"OTT",0,1,2,0,0,3,0,0,4,0,0,4,"A","N","2015-04-15","201504150MTL"
"CHI",1,0,3,0,0,4,0,3,0,0,0,3,"A","N","2015-04-15","201504150NSH"
"NSH",0,3,0,0,0,3,1,0,3,0,0,4,"H","N","2015-04-15","201504150NSH"
"CGY",0,0,0,2,0,2,0,0,1,0,0,1,"A","N","2015-04-15","201504150VAN"
"VAN",0,0,1,0,0,1,0,0,0,2,0,2,"H","N","2015-04-15","201504150VAN"
"NYI",0,1,2,1,0,4,0,1,0,0,0,1,"A","N","2015-04-15","201504150WSH"
"WSH",0,1,0,0,0,1,0,1,2,1,0,4,"H","N","2015-04-15","201504150WSH"
"ANA",0,1,0,3,0,4,0,1,1,0,0,2,"H","N","2015-04-16","201504160ANA"
"WPG",0,1,1,0,0,2,0,1,0,3,0,4,"A","N","2015-04-16","201504160ANA"
"NYR",0,2,0,0,0,2,0,0,1,0,0,1,"H","N","2015-04-16","201504160NYR"
"PIT",0,0,1,0,0,1,0,2,0,0,0,2,"A","N","2015-04-16","201504160NYR"
"MIN",0,1,1,2,0,4,0,0,0,2,0,2,"A","N","2015-04-16","201504160STL"
"STL",0,0,0,2,0,2,0,1,1,2,0,4,"H","N","2015-04-16","201504160STL"
"DET",0,1,1,1,0,3,0,1,0,1,0,2,"A","N","2015-04-16","201504160TBL"
"TBL",0,1,0,1,0,2,0,1,1,1,0,3,"H","N","2015-04-16","201504160TBL"
"MTL",1,0,2,0,0,3,0,1,0,1,0,2,"H","N","2015-04-17","201504170MTL"
"OTT",0,1,0,1,0,2,1,0,2,0,0,3,"A","N","2015-04-17","201504170MTL"
"CHI",0,1,1,0,0,2,0,2,1,3,0,6,"A","N","2015-04-17","201504170NSH"
"NSH",0,2,1,3,0,6,0,1,1,0,0,2,"H","N","2015-04-17","201504170NSH"
"CGY",0,0,0,1,0,1,0,2,0,2,0,4,"A","N","2015-04-17","201504170VAN"
"VAN",0,2,0,2,0,4,0,0,0,1,0,1,"H","N","2015-04-17","201504170VAN"
"NYI",0,1,2,0,0,3,0,0,2,2,0,4,"A","N","2015-04-17","201504170WSH"
"WSH",0,0,2,2,0,4,0,1,2,0,0,3,"H","N","2015-04-17","201504170WSH"
"ANA",0,0,0,2,0,2,0,0,1,0,0,1,"H","N","2015-04-18","201504180ANA"
"WPG",0,0,1,0,0,1,0,0,0,2,0,2,"A","N","2015-04-18","201504180ANA"
"NYR",0,1,0,2,0,3,0,0,3,1,0,4,"H","N","2015-04-18","201504180NYR"
"PIT",0,0,3,1,0,4,0,1,0,2,0,3,"A","N","2015-04-18","201504180NYR"
"MIN",0,0,0,1,0,1,0,2,0,2,0,4,"A","N","2015-04-18","201504180STL"
"STL",0,2,0,2,0,4,0,0,0,1,0,1,"H","N","2015-04-18","201504180STL"
"DET",0,0,0,1,0,1,0,1,3,1,0,5,"A","N","2015-04-18","201504180TBL"
"TBL",0,1,3,1,0,5,0,0,0,1,0,1,"H","N","2015-04-18","201504180TBL"
"CGY",0,2,0,2,0,4,0,1,0,1,0,2,"H","N","2015-04-19","201504190CGY"
"VAN",0,1,0,1,0,2,0,2,0,2,0,4,"A","N","2015-04-19","201504190CGY"
"CHI",0,1,3,0,0,4,0,1,1,0,0,2,"H","N","2015-04-19","201504190CHI"
"NSH",0,1,1,0,0,2,0,1,3,0,0,4,"A","N","2015-04-19","201504190CHI"
"NYI",1,0,1,0,0,2,0,0,0,1,0,1,"H","N","2015-04-19","201504190NYI"
"WSH",0,0,0,1,0,1,1,0,1,0,0,2,"A","N","2015-04-19","201504190NYI"
"MTL",1,0,0,1,0,2,0,1,0,0,0,1,"A","N","2015-04-19","201504190OTT"
"OTT",0,1,0,0,0,1,1,0,0,1,0,2,"H","N","2015-04-19","201504190OTT"
"MIN",0,0,2,1,0,3,0,0,0,0,0,0,"H","N","2015-04-20","201504200MIN"
"STL",0,0,0,0,0,0,0,0,2,1,0,3,"A","N","2015-04-20","201504200MIN"
"NYR",0,1,1,0,0,2,0,0,0,1,0,1,"A","N","2015-04-20","201504200PIT"
"PIT",0,0,0,1,0,1,0,1,1,0,0,2,"H","N","2015-04-20","201504200PIT"
"ANA",1,1,2,1,0,5,0,1,3,0,0,4,"A","N","2015-04-20","201504200WPG"
"WPG",0,1,3,0,0,4,1,1,2,1,0,5,"H","N","2015-04-20","201504200WPG"
"CGY",0,3,0,0,0,3,0,1,0,0,0,1,"H","N","2015-04-21","201504210CGY"
"VAN",0,1,0,0,0,1,0,3,0,0,0,3,"A","N","2015-04-21","201504210CGY"
"CHI",1,1,0,1,0,3,0,1,1,0,0,2,"H","N","2015-04-21","201504210CHI"
"NSH",0,1,1,0,0,2,1,1,0,1,0,3,"A","N","2015-04-21","201504210CHI"
"DET",0,1,0,2,0,3,0,0,0,0,0,0,"H","N","2015-04-21","201504210DET"
"TBL",0,0,0,0,0,0,0,1,0,2,0,3,"A","N","2015-04-21","201504210DET"
"NYI",0,1,0,0,0,1,1,1,0,0,0,2,"H","N","2015-04-21","201504210NYI"
"WSH",1,1,0,0,0,2,0,1,0,0,0,1,"A","N","2015-04-21","201504210NYI"
"MIN",0,0,1,0,0,1,0,3,3,0,0,6,"H","N","2015-04-22","201504220MIN"
"STL",0,3,3,0,0,6,0,0,1,0,0,1,"A","N","2015-04-22","201504220MIN"
"MTL",0,0,0,0,0,0,0,0,0,1,0,1,"A","N","2015-04-22","201504220OTT"
"OTT",0,0,0,1,0,1,0,0,0,0,0,0,"H","N","2015-04-22","201504220OTT"
"NYR",1,0,1,0,0,2,0,1,0,0,0,1,"A","N","2015-04-22","201504220PIT"
"PIT",0,1,0,0,0,1,1,0,1,0,0,2,"H","N","2015-04-22","201504220PIT"
"ANA",0,1,1,3,0,5,0,1,0,1,0,2,"A","N","2015-04-22","201504220WPG"
"WPG",0,1,0,1,0,2,0,1,1,3,0,5,"H","N","2015-04-22","201504220WPG"
"DET",0,0,2,0,0,2,1,0,0,2,0,3,"H","N","2015-04-23","201504230DET"
"TBL",1,0,0,2,0,3,0,0,2,0,0,2,"A","N","2015-04-23","201504230DET"
"CHI",0,1,0,1,0,2,0,1,0,4,0,5,"A","N","2015-04-23","201504230NSH"
"NSH",0,1,0,4,0,5,0,1,0,1,0,2,"H","N","2015-04-23","201504230NSH"
"CGY",0,1,0,0,0,1,0,0,1,1,0,2,"A","N","2015-04-23","201504230VAN"
"VAN",0,0,1,1,0,2,0,1,0,0,0,1,"H","N","2015-04-23","201504230VAN"
"NYI",0,1,0,0,0,1,0,1,1,3,0,5,"A","N","2015-04-23","201504230WSH"
"WSH",0,1,1,3,0,5,0,1,0,0,0,1,"H","N","2015-04-23","201504230WSH"
"MTL",0,0,0,1,0,1,0,2,1,2,0,5,"H","N","2015-04-24","201504240MTL"
"OTT",0,2,1,2,0,5,0,0,0,1,0,1,"A","N","2015-04-24","201504240MTL"
"NYR",1,1,0,0,0,2,0,0,1,0,0,1,"H","N","2015-04-24","201504240NYR"
"PIT",0,0,1,0,0,1,1,1,0,0,0,2,"A","N","2015-04-24","201504240NYR"
"MIN",0,1,2,1,0,4,0,1,0,0,0,1,"A","N","2015-04-24","201504240STL"
"STL",0,1,0,0,0,1,0,1,2,1,0,4,"H","N","2015-04-24","201504240STL"
"CGY",0,1,2,4,0,7,0,3,1,0,0,4,"H","N","2015-04-25","201504250CGY"
"VAN",0,3,1,0,0,4,0,1,2,4,0,7,"A","N","2015-04-25","201504250CGY"
"CHI",0,3,0,1,0,4,0,3,0,0,0,3,"H","N","2015-04-25","201504250CHI"
"NSH",0,3,0,0,0,3,0,3,0,1,0,4,"A","N","2015-04-25","201504250CHI"
"NYI",0,1,0,2,0,3,0,1,0,0,0,1,"H","N","2015-04-25","201504250NYI"
"WSH",0,1,0,0,0,1,0,1,0,2,0,3,"A","N","2015-04-25","201504250NYI"
"DET",0,1,1,2,0,4,0,0,0,0,0,0,"A","N","2015-04-25","201504250TBL"
"TBL",0,0,0,0,0,0,0,1,1,2,0,4,"H","N","2015-04-25","201504250TBL"
"MIN",0,1,1,2,0,4,0,0,1,0,0,1,"H","N","2015-04-26","201504260MIN"
"STL",0,0,1,0,0,1,0,1,1,2,0,4,"A","N","2015-04-26","201504260MIN"
"MTL",0,1,0,1,0,2,0,0,0,0,0,0,"A","N","2015-04-26","201504260OTT"
"OTT",0,0,0,0,0,0,0,1,0,1,0,2,"H","N","2015-04-26","201504260OTT"
"DET",0,0,1,1,0,2,0,2,1,2,0,5,"H","N","2015-04-27","201504270DET"
"TBL",0,2,1,2,0,5,0,0,1,1,0,2,"A","N","2015-04-27","201504270DET"
"NYI",0,0,0,1,0,1,0,0,1,1,0,2,"A","N","2015-04-27","201504270WSH"
"WSH",0,0,1,1,0,2,0,0,0,1,0,1,"H","N","2015-04-27","201504270WSH"
"DET",0,0,0,0,0,0,0,0,0,2,0,2,"A","N","2015-04-29","201504290TBL"
"TBL",0,0,0,2,0,2,0,0,0,0,0,0,"H","N","2015-04-29","201504290TBL"
"ANA",0,2,2,2,0,6,0,0,0,1,0,1,"H","N","2015-04-30","201504300ANA"
"CGY",0,0,0,1,0,1,0,2,2,2,0,6,"A","N","2015-04-30","201504300ANA"
"NYR",0,0,0,1,0,1,0,1,0,1,0,2,"H","N","2015-04-30","201504300NYR"
"WSH",0,1,0,1,0,2,0,0,0,1,0,1,"A","N","2015-04-30","201504300NYR"
"CHI",0,3,1,0,0,4,0,0,3,0,0,3,"H","N","2015-05-01","201505010CHI"
"MIN",0,0,3,0,0,3,0,3,1,0,0,4,"A","N","2015-05-01","201505010CHI"
"MTL",0,0,0,1,0,1,1,0,0,1,0,2,"H","N","2015-05-01","201505010MTL"
"TBL",1,0,0,1,0,2,0,0,0,1,0,1,"A","N","2015-05-01","201505010MTL"
"NYR",0,2,0,1,0,3,0,0,1,1,0,2,"H","N","2015-05-02","201505020NYR"
"WSH",0,0,1,1,0,2,0,2,0,1,0,3,"A","N","2015-05-02","201505020NYR"
"ANA",0,1,0,2,0,3,0,0,0,0,0,0,"H","N","2015-05-03","201505030ANA"
"CGY",0,0,0,0,0,0,0,1,0,2,0,3,"A","N","2015-05-03","201505030ANA"
"CHI",0,0,2,2,0,4,0,0,0,1,0,1,"H","N","2015-05-03","201505030CHI"
"MIN",0,0,0,1,0,1,0,0,2,2,0,4,"A","N","2015-05-03","201505030CHI"
"MTL",0,1,0,1,0,2,0,1,3,2,0,6,"H","N","2015-05-03","201505030MTL"
"TBL",0,1,3,2,0,6,0,1,0,1,0,2,"A","N","2015-05-03","201505030MTL"
"NYR",0,0,0,0,0,0,0,0,1,0,0,1,"A","N","2015-05-04","201505040WSH"
"WSH",0,0,1,0,0,1,0,0,0,0,0,0,"H","N","2015-05-04","201505040WSH"
"ANA",0,2,1,0,0,3,1,1,1,1,0,4,"A","N","2015-05-05","201505050CGY"
"CGY",1,1,1,1,0,4,0,2,1,0,0,3,"H","N","2015-05-05","201505050CGY"
"CHI",0,1,0,0,0,1,0,0,0,0,0,0,"A","N","2015-05-05","201505050MIN"
"MIN",0,0,0,0,0,0,0,1,0,0,0,1,"H","N","2015-05-05","201505050MIN"
"MTL",0,0,0,1,0,1,0,1,0,1,0,2,"A","N","2015-05-06","201505060TBL"
"TBL",0,1,0,1,0,2,0,0,0,1,0,1,"H","N","2015-05-06","201505060TBL"
"NYR",0,0,1,0,0,1,0,0,1,1,0,2,"A","N","2015-05-06","201505060WSH"
"WSH",0,0,1,1,0,2,0,0,1,0,0,1,"H","N","2015-05-06","201505060WSH"
"CHI",0,1,1,2,0,4,0,0,1,2,0,3,"A","N","2015-05-07","201505070MIN"
"MIN",0,0,1,2,0,3,0,1,1,2,0,4,"H","N","2015-05-07","201505070MIN"
"MTL",0,2,3,1,0,6,0,0,1,1,0,2,"A","N","2015-05-07","201505070TBL"
"TBL",0,0,1,1,0,2,0,2,3,1,0,6,"H","N","2015-05-07","201505070TBL"
"ANA",0,1,1,2,0,4,0,2,0,0,0,2,"A","N","2015-05-08","201505080CGY"
"CGY",0,2,0,0,0,2,0,1,1,2,0,4,"H","N","2015-05-08","201505080CGY"
"NYR",1,0,0,1,0,2,0,0,0,1,0,1,"H","N","2015-05-08","201505080NYR"
"WSH",0,0,0,1,0,1,1,0,0,1,0,2,"A","N","2015-05-08","201505080NYR"
"MTL",0,1,0,1,0,2,0,0,0,1,0,1,"H","N","2015-05-09","201505090MTL"
"TBL",0,0,0,1,0,1,0,1,0,1,0,2,"A","N","2015-05-09","201505090MTL"
"ANA",1,0,1,1,0,3,0,1,1,0,0,2,"H","N","2015-05-10","201505100ANA"
"CGY",0,1,1,0,0,2,1,0,1,1,0,3,"A","N","2015-05-10","201505100ANA"
"NYR",0,2,0,2,0,4,0,0,1,2,0,3,"A","N","2015-05-10","201505100WSH"
"WSH",0,0,1,2,0,3,0,2,0,2,0,4,"H","N","2015-05-10","201505100WSH"
"MTL",0,0,0,1,0,1,0,1,2,1,0,4,"A","N","2015-05-12","201505120TBL"
"TBL",0,1,2,1,0,4,0,0,0,1,0,1,"H","N","2015-05-12","201505120TBL"
"NYR",1,0,1,0,0,2,0,1,0,0,0,1,"H","N","2015-05-13","201505130NYR"
"WSH",0,1,0,0,0,1,1,0,1,0,0,2,"A","N","2015-05-13","201505130NYR"
"NYR",0,0,1,1,0,2,0,0,0,1,0,1,"H","N","2015-05-16","201505160NYR"
"TBL",0,0,0,1,0,1,0,0,1,1,0,2,"A","N","2015-05-16","201505160NYR"
"ANA",0,1,1,2,0,4,0,0,1,0,0,1,"H","N","2015-05-17","201505170ANA"
"CHI",0,0,1,0,0,1,0,1,1,2,0,4,"A","N","2015-05-17","201505170ANA"
"NYR",0,1,1,0,0,2,0,2,1,3,0,6,"H","N","2015-05-18","201505180NYR"
"TBL",0,2,1,3,0,6,0,1,1,0,0,2,"A","N","2015-05-18","201505180NYR"
"ANA",0,1,1,0,0,2,1,2,0,0,0,3,"H","N","2015-05-19","201505190ANA"
"CHI",1,2,0,0,0,3,0,1,1,0,0,2,"A","N","2015-05-19","201505190ANA"
"NYR",0,2,1,2,0,5,1,1,3,1,0,6,"A","N","2015-05-20","201505200TBL"
"TBL",1,1,3,1,0,6,0,2,1,2,0,5,"H","N","2015-05-20","201505200TBL"
"ANA",0,1,1,0,0,2,0,1,0,0,0,1,"A","N","2015-05-21","201505210CHI"
"CHI",0,1,0,0,0,1,0,1,1,0,0,2,"H","N","2015-05-21","201505210CHI"
"NYR",0,1,2,2,0,5,0,0,1,0,0,1,"A","N","2015-05-22","201505220TBL"
"TBL",0,0,1,0,0,1,0,1,2,2,0,5,"H","N","2015-05-22","201505220TBL"
"ANA",0,0,1,3,0,4,1,1,0,3,0,5,"A","N","2015-05-23","201505230CHI"
"CHI",1,1,0,3,0,5,0,0,1,3,0,4,"H","N","2015-05-23","201505230CHI"
"NYR",0,0,0,0,0,0,0,0,2,0,0,2,"H","N","2015-05-24","201505240NYR"
"TBL",0,0,2,0,0,2,0,0,0,0,0,0,"A","N","2015-05-24","201505240NYR"
"ANA",1,3,0,1,0,5,0,0,2,2,0,4,"H","N","2015-05-25","201505250ANA"
"CHI",0,0,2,2,0,4,1,3,0,1,0,5,"A","N","2015-05-25","201505250ANA"
"NYR",0,2,0,5,0,7,0,1,0,2,0,3,"A","N","2015-05-26","201505260TBL"
"TBL",0,1,0,2,0,3,0,2,0,5,0,7,"H","N","2015-05-26","201505260TBL"
"ANA",0,0,1,1,0,2,0,0,3,2,0,5,"A","N","2015-05-27","201505270CHI"
"CHI",0,0,3,2,0,5,0,0,1,1,0,2,"H","N","2015-05-27","201505270CHI"
"NYR",0,0,0,0,0,0,0,0,0,2,0,2,"H","N","2015-05-29","201505290NYR"
"TBL",0,0,0,2,0,2,0,0,0,0,0,0,"A","N","2015-05-29","201505290NYR"
"ANA",0,0,1,2,0,3,0,2,2,1,0,5,"H","N","2015-05-30","201505300ANA"
"CHI",0,2,2,1,0,5,0,0,1,2,0,3,"A","N","2015-05-30","201505300ANA"
"CHI",0,0,0,2,0,2,0,1,0,0,0,1,"A","N","2015-06-03","201506030TBL"
"TBL",0,1,0,0,0,1,0,0,0,2,0,2,"H","N","2015-06-03","201506030TBL"
"CHI",0,0,2,1,0,3,0,1,2,1,0,4,"A","N","2015-06-06","201506060TBL"
"TBL",0,1,2,1,0,4,0,0,2,1,0,3,"H","N","2015-06-06","201506060TBL"
"CHI",0,1,0,1,0,2,0,1,0,2,0,3,"H","N","2015-06-08","201506080CHI"
"TBL",0,1,0,2,0,3,0,1,0,1,0,2,"A","N","2015-06-08","201506080CHI"
"CHI",0,0,1,1,0,2,0,0,1,0,0,1,"H","N","2015-06-10","201506100CHI"
"TBL",0,0,1,0,0,1,0,0,1,1,0,2,"A","N","2015-06-10","201506100CHI"
"CHI",0,1,0,1,0,2,0,0,1,0,0,1,"A","N","2015-06-13","201506130TBL"
"TBL",0,0,1,0,0,1,0,1,0,1,0,2,"H","N","2015-06-13","201506130TBL"
"CHI",0,0,1,1,0,2,0,0,0,0,0,0,"H","N","2015-06-15","201506150CHI"
"TBL",0,0,0,0,0,0,0,0,1,1,0,2,"A","N","2015-06-15","201506150CHI"
"CGY",0,0,1,0,0,1,0,2,1,2,0,5,"H","N","2015-10-07","201510070CGY"
"VAN",0,2,1,2,0,5,0,0,1,0,0,1,"A","N","2015-10-07","201510070CGY"
"CHI",0,1,1,0,0,2,0,3,0,0,0,3,"H","N","2015-10-07","201510070CHI"
"NYR",0,3,0,0,0,3,0,1,1,0,0,2,"A","N","2015-10-07","201510070CHI"
"LAK",0,1,0,0,0,1,0,2,2,1,0,5,"H","N","2015-10-07","201510070LAK"
"SJS",0,2,2,1,0,5,0,1,0,0,0,1,"A","N","2015-10-07","201510070LAK"
"MTL",0,1,0,2,0,3,0,0,1,0,0,1,"A","N","2015-10-07","201510070TOR"
"TOR",0,0,1,0,0,1,0,1,0,2,0,3,"H","N","2015-10-07","201510070TOR"
"BOS",0,1,0,1,0,2,0,0,3,3,0,6,"H","N","2015-10-08","201510080BOS"
"WPG",0,0,3,3,0,6,0,1,0,1,0,2,"A","N","2015-10-08","201510080BOS"
"BUF",0,0,0,1,0,1,0,1,1,1,0,3,"H","N","2015-10-08","201510080BUF"
"OTT",0,1,1,1,0,3,0,0,0,1,0,1,"A","N","2015-10-08","201510080BUF"
"COL",0,3,1,0,0,4,0,0,1,4,0,5,"H","N","2015-10-08","201510080COL"
"MIN",0,0,1,4,0,5,0,3,1,0,0,4,"A","N","2015-10-08","201510080COL"
"DAL",0,1,1,1,0,3,0,0,0,0,0,0,"H","N","2015-10-08","201510080DAL"
"PIT",0,0,0,0,0,0,0,1,1,1,0,3,"A","N","2015-10-08","201510080DAL"
"CAR",0,0,0,1,0,1,0,2,0,0,0,2,"A","N","2015-10-08","201510080NSH"
"NSH",0,2,0,0,0,2,0,0,0,1,0,1,"H","N","2015-10-08","201510080NSH"
"EDM",0,1,0,0,0,1,0,0,1,2,0,3,"A","N","2015-10-08","201510080STL"
"STL",0,0,1,2,0,3,0,1,0,0,0,1,"H","N","2015-10-08","201510080STL"
"PHI",0,0,2,0,0,2,1,0,2,0,0,3,"A","N","2015-10-08","201510080TBL"
"TBL",1,0,2,0,0,3,0,0,2,0,0,2,"H","N","2015-10-08","201510080TBL"
"CBJ",0,0,1,1,0,2,0,1,0,3,0,4,"H","N","2015-10-09","201510090CBJ"
"NYR",0,1,0,3,0,4,0,0,1,1,0,2,"A","N","2015-10-09","201510090CBJ"
"DET",0,2,2,0,0,4,0,0,0,0,0,0,"H","N","2015-10-09","201510090DET"
"TOR",0,0,0,0,0,0,0,2,2,0,0,4,"A","N","2015-10-09","201510090DET"
"ARI",0,2,2,0,0,4,0,0,1,0,0,1,"A","N","2015-10-09","201510090LAK"
"LAK",0,0,1,0,0,1,0,2,2,0,0,4,"H","N","2015-10-09","201510090LAK"
"NJD",0,0,1,0,0,1,0,0,3,0,0,3,"H","N","2015-10-09","201510090NJD"
"WPG",0,0,3,0,0,3,0,0,1,0,0,1,"A","N","2015-10-09","201510090NJD"
"CHI",1,1,1,0,0,3,0,0,1,1,0,2,"A","N","2015-10-09","201510090NYI"
"NYI",0,0,1,1,0,2,1,1,1,0,0,3,"H","N","2015-10-09","201510090NYI"
"ARI",0,0,2,0,0,2,0,0,1,0,0,1,"H","N","2015-10-10","201510100ARI"
"PIT",0,0,1,0,0,1,0,0,2,0,0,2,"A","N","2015-10-10","201510100ARI"
"BOS",0,0,1,1,0,2,0,1,2,1,0,4,"H","N","2015-10-10","201510100BOS"
"MTL",0,1,2,1,0,4,0,0,1,1,0,2,"A","N","2015-10-10","201510100BOS"
"BUF",0,0,1,0,0,1,0,0,2,2,0,4,"H","N","2015-10-10","201510100BUF"
"TBL",0,0,2,2,0,4,0,0,1,0,0,1,"A","N","2015-10-10","201510100BUF"
"CAR",0,0,2,1,0,3,0,0,1,3,0,4,"H","N","2015-10-10","201510100CAR"
"DET",0,0,1,3,0,4,0,0,2,1,0,3,"A","N","2015-10-10","201510100CAR"
"CHI",0,1,2,1,0,4,0,0,0,1,0,1,"H","N","2015-10-10","201510100CHI"
"NYI",0,0,0,1,0,1,0,1,2,1,0,4,"A","N","2015-10-10","201510100CHI"
"COL",0,1,2,3,0,6,0,2,1,0,0,3,"H","N","2015-10-10","201510100COL"
"DAL",0,2,1,0,0,3,0,1,2,3,0,6,"A","N","2015-10-10","201510100COL"
"FLA",0,4,1,2,0,7,0,0,1,0,0,1,"H","N","2015-10-10","201510100FLA"
"PHI",0,0,1,0,0,1,0,4,1,2,0,7,"A","N","2015-10-10","201510100FLA"
"MIN",0,1,2,0,0,3,0,0,1,1,0,2,"H","N","2015-10-10","201510100MIN"
"STL",0,0,1,1,0,2,0,1,2,0,0,3,"A","N","2015-10-10","201510100MIN"
"EDM",0,0,0,0,0,0,0,0,1,1,0,2,"A","N","2015-10-10","201510100NSH"
"NSH",0,0,1,1,0,2,0,0,0,0,0,0,"H","N","2015-10-10","201510100NSH"
"CBJ",0,0,0,2,0,2,0,3,1,1,0,5,"A","N","2015-10-10","201510100NYR"
"NYR",0,3,1,1,0,5,0,0,0,2,0,2,"H","N","2015-10-10","201510100NYR"
"ANA",0,0,0,0,0,0,0,0,1,1,0,2,"A","N","2015-10-10","201510100SJS"
"SJS",0,0,1,1,0,2,0,0,0,0,0,0,"H","N","2015-10-10","201510100SJS"
"OTT",0,0,3,1,1,5,0,0,2,2,0,4,"A","Y","2015-10-10","201510100TOR"
"TOR",0,0,2,2,0,4,0,0,3,1,1,5,"H","Y","2015-10-10","201510100TOR"
"CGY",1,1,0,1,0,3,0,0,2,0,0,2,"A","N","2015-10-10","201510100VAN"
"VAN",0,0,2,0,0,2,1,1,0,1,0,3,"H","N","2015-10-10","201510100VAN"
"NJD",0,2,0,1,0,3,0,2,0,3,0,5,"A","N","2015-10-10","201510100WSH"
"WSH",0,2,0,3,0,5,0,2,0,1,0,3,"H","N","2015-10-10","201510100WSH"
"MTL",0,2,0,1,0,3,0,0,1,0,0,1,"A","N","2015-10-11","201510110OTT"
"OTT",0,0,1,0,0,1,0,2,0,1,0,3,"H","N","2015-10-11","201510110OTT"
"ANA",0,0,1,0,0,1,0,0,1,0,1,2,"H","Y","2015-10-12","201510120ANA"
"VAN",0,0,1,0,1,2,0,0,1,0,0,1,"A","Y","2015-10-12","201510120ANA"
"BOS",0,2,1,0,0,3,0,2,2,2,0,6,"H","N","2015-10-12","201510120BOS"
"TBL",0,2,2,2,0,6,0,2,1,0,0,3,"A","N","2015-10-12","201510120BOS"
"BUF",0,0,1,3,0,4,0,0,0,2,0,2,"H","N","2015-10-12","201510120BUF"
"CBJ",0,0,0,2,0,2,0,0,1,3,0,4,"A","N","2015-10-12","201510120BUF"
"NYI",0,1,2,1,0,4,0,0,1,1,0,2,"H","N","2015-10-12","201510120NYI"
"WPG",0,0,1,1,0,2,0,1,2,1,0,4,"A","N","2015-10-12","201510120NYI"
"FLA",0,0,0,0,0,0,0,1,0,0,0,1,"A","N","2015-10-12","201510120PHI"
"PHI",0,1,0,0,0,1,0,0,0,0,0,0,"H","N","2015-10-12","201510120PHI"
"CAR",0,0,1,0,0,1,0,1,0,3,0,4,"H","N","2015-10-13","201510130CAR"
"FLA",0,1,0,3,0,4,0,0,1,0,0,1,"A","N","2015-10-13","201510130CAR"
"CGY",0,2,0,1,0,3,0,1,3,0,0,4,"H","N","2015-10-13","201510130CGY"
"STL",0,1,3,0,0,4,0,2,0,1,0,3,"A","N","2015-10-13","201510130CGY"
"DAL",0,1,1,2,0,4,0,0,2,0,0,2,"H","N","2015-10-13","201510130DAL"
"EDM",0,0,2,0,0,2,0,1,1,2,0,4,"A","N","2015-10-13","201510130DAL"
"DET",0,0,1,2,0,3,0,0,0,1,0,1,"H","N","2015-10-13","201510130DET"
"TBL",0,0,0,1,0,1,0,0,1,2,0,3,"A","N","2015-10-13","201510130DET"
"LAK",0,0,0,0,0,0,0,0,2,1,0,3,"H","N","2015-10-13","201510130LAK"
"VAN",0,0,2,1,0,3,0,0,0,0,0,0,"A","N","2015-10-13","201510130LAK"
"NJD",0,0,0,1,0,1,0,1,0,2,0,3,"H","N","2015-10-13","201510130NJD"
"NSH",0,1,0,2,0,3,0,0,0,1,0,1,"A","N","2015-10-13","201510130NJD"
"NYR",0,1,0,0,0,1,0,1,1,2,0,4,"H","N","2015-10-13","201510130NYR"
"WPG",0,1,1,2,0,4,0,1,0,0,0,1,"A","N","2015-10-13","201510130NYR"
"MTL",0,1,1,1,0,3,0,0,2,0,0,2,"A","N","2015-10-13","201510130PIT"
"PIT",0,0,2,0,0,2,0,1,1,1,0,3,"H","N","2015-10-13","201510130PIT"
"SJS",0,1,2,2,0,5,0,0,0,0,0,0,"A","N","2015-10-13","201510130WSH"
"WSH",0,0,0,0,0,0,0,1,2,2,0,5,"H","N","2015-10-13","201510130WSH"
"ANA",0,0,0,0,0,0,0,3,1,0,0,4,"H","N","2015-10-14","201510140ANA"
"ARI",0,3,1,0,0,4,0,0,0,0,0,0,"A","N","2015-10-14","201510140ANA"
"CBJ",0,2,1,0,0,3,0,1,3,3,0,7,"H","N","2015-10-14","201510140CBJ"
"OTT",0,1,3,3,0,7,0,2,1,0,0,3,"A","N","2015-10-14","201510140CBJ"
"BOS",0,2,3,1,0,6,0,0,1,1,0,2,"A","N","2015-10-14","201510140COL"
"COL",0,0,1,1,0,2,0,2,3,1,0,6,"H","N","2015-10-14","201510140COL"
"CHI",0,0,0,0,0,0,0,0,2,1,0,3,"A","N","2015-10-14","201510140PHI"
"PHI",0,0,2,1,0,3,0,0,0,0,0,0,"H","N","2015-10-14","201510140PHI"
"ARI",0,0,2,1,0,3,0,2,2,0,0,4,"H","N","2015-10-15","201510150ARI"
"MIN",0,2,2,0,0,4,0,0,2,1,0,3,"A","N","2015-10-15","201510150ARI"
"EDM",0,1,0,1,0,2,0,1,1,2,0,4,"H","N","2015-10-15","201510150EDM"
"STL",0,1,1,2,0,4,0,1,0,1,0,2,"A","N","2015-10-15","201510150EDM"
"BUF",0,0,1,1,0,2,0,2,0,1,0,3,"A","N","2015-10-15","201510150FLA"
"FLA",0,2,0,1,0,3,0,0,1,1,0,2,"H","N","2015-10-15","201510150FLA"
"MTL",0,0,1,2,0,3,0,0,0,0,0,0,"H","N","2015-10-15","201510150MTL"
"NYR",0,0,0,0,0,0,0,0,1,2,0,3,"A","N","2015-10-15","201510150MTL"
"NSH",0,1,1,1,0,3,0,0,2,2,0,4,"A","N","2015-10-15","201510150NYI"
"NYI",0,0,2,2,0,4,0,1,1,1,0,3,"H","N","2015-10-15","201510150NYI"
"OTT",0,0,0,0,0,0,0,0,2,0,0,2,"A","N","2015-10-15","201510150PIT"
"PIT",0,0,2,0,0,2,0,0,0,0,0,0,"H","N","2015-10-15","201510150PIT"
"DAL",0,2,2,1,0,5,0,1,0,2,0,3,"A","N","2015-10-15","201510150TBL"
"TBL",0,1,0,2,0,3,0,2,2,1,0,5,"H","N","2015-10-15","201510150TBL"
"CHI",0,0,0,1,0,1,0,1,1,2,0,4,"A","N","2015-10-15","201510150WSH"
"WSH",0,1,1,2,0,4,0,0,0,1,0,1,"H","N","2015-10-15","201510150WSH"
"ANA",0,0,0,0,0,0,0,1,1,1,0,3,"H","N","2015-10-16","201510160ANA"
"COL",0,1,1,1,0,3,0,0,0,0,0,0,"A","N","2015-10-16","201510160ANA"
"CBJ",0,1,1,1,0,3,0,0,3,3,0,6,"H","N","2015-10-16","201510160CBJ"
"TOR",0,0,3,3,0,6,0,1,1,1,0,3,"A","N","2015-10-16","201510160CBJ"
"CAR",0,1,2,2,0,5,0,0,2,1,0,3,"A","N","2015-10-16","201510160DET"
"DET",0,0,2,1,0,3,0,1,2,2,0,5,"H","N","2015-10-16","201510160DET"
"LAK",1,0,1,0,0,2,0,0,0,1,0,1,"H","N","2015-10-16","201510160LAK"
"MIN",0,0,0,1,0,1,1,0,1,0,0,2,"A","N","2015-10-16","201510160LAK"
"NJD",0,0,0,1,0,1,0,1,0,0,1,2,"H","Y","2015-10-16","201510160NJD"
"SJS",0,1,0,0,1,2,0,0,0,1,0,1,"A","Y","2015-10-16","201510160NJD"
"STL",0,1,2,1,0,4,0,0,1,2,0,3,"A","N","2015-10-16","201510160VAN"
"VAN",0,0,1,2,0,3,0,1,2,1,0,4,"H","N","2015-10-16","201510160VAN"
"CGY",0,1,0,0,0,1,0,0,1,2,0,3,"A","N","2015-10-16","201510160WPG"
"WPG",0,0,1,2,0,3,0,1,0,0,0,1,"H","N","2015-10-16","201510160WPG"
"ARI",0,1,0,2,0,3,0,0,2,3,0,5,"H","N","2015-10-17","201510170ARI"
"BOS",0,0,2,3,0,5,0,1,0,2,0,3,"A","N","2015-10-17","201510170ARI"
"CGY",0,0,1,1,0,2,0,1,1,3,0,5,"H","N","2015-10-17","201510170CGY"
"EDM",0,1,1,3,0,5,0,0,1,1,0,2,"A","N","2015-10-17","201510170CGY"
"CBJ",0,0,0,1,0,1,0,0,2,2,0,4,"A","N","2015-10-17","201510170CHI"
"CHI",0,0,2,2,0,4,0,0,0,1,0,1,"H","N","2015-10-17","201510170CHI"
"DAL",0,0,1,3,0,4,0,0,2,0,0,2,"A","N","2015-10-17","201510170FLA"
"FLA",0,0,2,0,0,2,0,0,1,3,0,4,"H","N","2015-10-17","201510170FLA"
"DET",0,0,1,0,0,1,0,0,1,3,0,4,"A","N","2015-10-17","201510170MTL"
"MTL",0,0,1,3,0,4,0,0,1,0,0,1,"H","N","2015-10-17","201510170MTL"
"NYI",0,0,3,3,0,6,0,1,2,0,0,3,"H","N","2015-10-17","201510170NYI"
"SJS",0,1,2,0,0,3,0,0,3,3,0,6,"A","N","2015-10-17","201510170NYI"
"NSH",0,1,1,1,1,4,0,0,2,1,0,3,"A","Y","2015-10-17","201510170OTT"
"OTT",0,0,2,1,0,3,0,1,1,1,1,4,"H","Y","2015-10-17","201510170OTT"
"PIT",0,2,0,0,0,2,0,1,0,0,0,1,"H","N","2015-10-17","201510170PIT"
"TOR",0,1,0,0,0,1,0,2,0,0,0,2,"A","N","2015-10-17","201510170PIT"
"BUF",0,1,0,0,0,1,0,0,1,1,0,2,"A","N","2015-10-17","201510170TBL"
"TBL",0,0,1,1,0,2,0,1,0,0,0,1,"H","N","2015-10-17","201510170TBL"
"CAR",0,0,0,1,0,1,0,1,0,3,0,4,"A","N","2015-10-17","201510170WSH"
"WSH",0,1,0,3,0,4,0,0,0,1,0,1,"H","N","2015-10-17","201510170WSH"
"ANA",0,2,0,2,0,4,0,1,0,0,0,1,"H","N","2015-10-18","201510180ANA"
"MIN",0,1,0,0,0,1,0,2,0,2,0,4,"A","N","2015-10-18","201510180ANA"
"COL",0,0,1,0,0,1,0,1,1,0,0,2,"A","N","2015-10-18","201510180LAK"
"LAK",0,1,1,0,0,2,0,0,1,0,0,1,"H","N","2015-10-18","201510180LAK"
"NJD",1,0,1,0,0,2,0,1,0,0,0,1,"A","N","2015-10-18","201510180NYR"
"NYR",0,1,0,0,0,1,1,0,1,0,0,2,"H","N","2015-10-18","201510180NYR"
"EDM",1,1,0,0,0,2,0,1,0,0,0,1,"A","N","2015-10-18","201510180VAN"
"VAN",0,1,0,0,0,1,1,1,0,0,0,2,"H","N","2015-10-18","201510180VAN"
"STL",0,0,2,2,0,4,0,0,2,0,0,2,"A","N","2015-10-18","201510180WPG"
"WPG",0,0,2,0,0,2,0,0,2,2,0,4,"H","N","2015-10-18","201510180WPG"
"NYR",0,1,1,2,0,4,0,0,0,0,0,0,"H","N","2015-10-19","201510190NYR"
"SJS",0,0,0,0,0,0,0,1,1,2,0,4,"A","N","2015-10-19","201510190NYR"
"CBJ",0,0,0,0,0,0,0,1,0,3,0,4,"H","N","2015-10-20","201510200CBJ"
"NYI",0,1,0,3,0,4,0,0,0,0,0,0,"A","N","2015-10-20","201510200CBJ"
"CGY",0,1,0,1,0,2,0,1,3,2,0,6,"H","N","2015-10-20","201510200CGY"
"WSH",0,1,3,2,0,6,0,1,0,1,0,2,"A","N","2015-10-20","201510200CGY"
"MTL",0,1,1,1,0,3,0,0,0,0,0,0,"H","N","2015-10-20","201510200MTL"
"STL",0,0,0,0,0,0,0,1,1,1,0,3,"A","N","2015-10-20","201510200MTL"
"ARI",0,0,0,2,0,2,1,0,1,1,0,3,"A","N","2015-10-20","201510200NJD"
"NJD",1,0,1,1,0,3,0,0,0,2,0,2,"H","N","2015-10-20","201510200NJD"
"NSH",0,1,2,1,1,5,0,0,3,1,0,4,"H","Y","2015-10-20","201510200NSH"
"TBL",0,0,3,1,0,4,0,1,2,1,1,5,"A","Y","2015-10-20","201510200NSH"
"DAL",0,1,1,0,0,2,0,0,0,1,0,1,"A","N","2015-10-20","201510200PHI"
"PHI",0,0,0,1,0,1,0,1,1,0,0,2,"H","N","2015-10-20","201510200PHI"
"FLA",0,0,0,2,0,2,1,1,0,1,0,3,"A","N","2015-10-20","201510200PIT"
"PIT",1,1,0,1,0,3,0,0,0,2,0,2,"H","N","2015-10-20","201510200PIT"
"BOS",0,2,2,0,0,4,1,2,0,2,0,5,"H","N","2015-10-21","201510210BOS"
"PHI",1,2,0,2,0,5,0,2,2,0,0,4,"A","N","2015-10-21","201510210BOS"
"BUF",0,0,0,1,1,2,0,1,0,0,0,1,"H","Y","2015-10-21","201510210BUF"
"TOR",0,1,0,0,0,1,0,0,0,1,1,2,"A","Y","2015-10-21","201510210BUF"
"CAR",1,0,0,0,0,1,0,0,0,0,0,0,"A","N","2015-10-21","201510210COL"
"COL",0,0,0,0,0,0,1,0,0,0,0,1,"H","N","2015-10-21","201510210COL"
"DET",0,0,0,1,0,1,0,1,2,0,0,3,"A","N","2015-10-21","201510210EDM"
"EDM",0,1,2,0,0,3,0,0,0,1,0,1,"H","N","2015-10-21","201510210EDM"
"CHI",0,1,1,1,0,3,0,1,0,1,0,2,"H","N","2015-10-22","201510220CHI"
"FLA",0,1,0,1,0,2,0,1,1,1,0,3,"A","N","2015-10-22","201510220CHI"
"CBJ",0,2,0,0,0,2,0,1,2,0,0,3,"A","N","2015-10-22","201510220MIN"
"MIN",0,1,2,0,0,3,0,2,0,0,0,2,"H","N","2015-10-22","201510220MIN"
"ANA",0,0,0,1,0,1,0,0,3,2,0,5,"A","N","2015-10-22","201510220NSH"
"NSH",0,0,3,2,0,5,0,0,0,1,0,1,"H","N","2015-10-22","201510220NSH"
"ARI",0,1,0,0,0,1,0,0,1,3,0,4,"A","N","2015-10-22","201510220NYR"
"NYR",0,0,1,3,0,4,0,1,0,0,0,1,"H","N","2015-10-22","201510220NYR"
"NJD",0,2,0,2,1,5,0,1,1,2,0,4,"A","Y","2015-10-22","201510220OTT"
"OTT",0,1,1,2,0,4,0,2,0,2,1,5,"H","Y","2015-10-22","201510220OTT"
"DAL",0,2,2,0,0,4,0,0,1,0,0,1,"A","N","2015-10-22","201510220PIT"
"PIT",0,0,1,0,0,1,0,2,2,0,0,4,"H","N","2015-10-22","201510220PIT"
"LAK",0,2,1,1,0,4,0,0,1,0,0,1,"A","N","2015-10-22","201510220SJS"
"SJS",0,0,1,0,0,1,0,2,1,1,0,4,"H","N","2015-10-22","201510220SJS"
"VAN",0,0,2,0,0,2,0,1,0,2,0,3,"H","N","2015-10-22","201510220VAN"
"WSH",0,1,0,2,0,3,0,0,2,0,0,2,"A","N","2015-10-22","201510220VAN"
"BUF",0,0,2,0,0,2,0,1,3,3,0,7,"H","N","2015-10-23","201510230BUF"
"MTL",0,1,3,3,0,7,0,0,2,0,0,2,"A","N","2015-10-23","201510230BUF"
"CGY",1,1,0,1,0,3,0,2,0,0,0,2,"H","N","2015-10-23","201510230CGY"
"DET",0,2,0,0,0,2,1,1,0,1,0,3,"A","N","2015-10-23","201510230CGY"
"EDM",0,2,2,0,0,4,0,3,3,1,0,7,"H","N","2015-10-23","201510230EDM"
"WSH",0,3,3,1,0,7,0,2,2,0,0,4,"A","N","2015-10-23","201510230EDM"
"CAR",0,0,0,0,0,0,0,1,0,2,0,3,"A","N","2015-10-23","201510230LAK"
"LAK",0,1,0,2,0,3,0,0,0,0,0,0,"H","N","2015-10-23","201510230LAK"
"BOS",0,1,2,2,0,5,0,2,0,1,0,3,"A","N","2015-10-23","201510230NYI"
"NYI",0,2,0,1,0,3,0,1,2,2,0,5,"H","N","2015-10-23","201510230NYI"
"TBL",1,1,2,0,0,4,0,1,1,1,0,3,"A","N","2015-10-23","201510230WPG"
"WPG",0,1,1,1,0,3,1,1,2,0,0,4,"H","N","2015-10-23","201510230WPG"
"BUF",0,1,1,1,0,3,0,1,2,1,0,4,"H","N","2015-10-24","201510240BUF"
"NJD",0,1,2,1,0,4,0,1,1,1,0,3,"A","N","2015-10-24","201510240BUF"
"CHI",1,0,0,0,0,1,0,0,0,0,0,0,"H","N","2015-10-24","201510240CHI"
"TBL",0,0,0,0,0,0,1,0,0,0,0,1,"A","N","2015-10-24","201510240CHI"
"CBJ",0,2,0,2,0,4,0,1,2,0,0,3,"A","N","2015-10-24","201510240COL"
"COL",0,1,2,0,0,3,0,2,0,2,0,4,"H","N","2015-10-24","201510240COL"
"DAL",0,1,0,1,0,2,0,2,2,2,0,6,"H","N","2015-10-24","201510240DAL"
"FLA",0,2,2,2,0,6,0,1,0,1,0,2,"A","N","2015-10-24","201510240DAL"
"ANA",0,0,0,0,0,0,0,1,2,0,0,3,"A","N","2015-10-24","201510240MIN"
"MIN",0,1,2,0,0,3,0,0,0,0,0,0,"H","N","2015-10-24","201510240MIN"
"MTL",0,1,4,0,0,5,0,0,2,1,0,3,"H","N","2015-10-24","201510240MTL"
"TOR",0,0,2,1,0,3,0,1,4,0,0,5,"A","N","2015-10-24","201510240MTL"
"NSH",0,0,0,1,0,1,1,0,1,0,0,2,"H","N","2015-10-24","201510240NSH"
"PIT",1,0,1,0,0,2,0,0,0,1,0,1,"A","N","2015-10-24","201510240NSH"
"ARI",0,1,0,3,0,4,0,0,1,0,0,1,"A","N","2015-10-24","201510240OTT"
"OTT",0,0,1,0,0,1,0,1,0,3,0,4,"H","N","2015-10-24","201510240OTT"
"NYR",0,1,1,0,0,2,0,1,1,0,1,3,"A","Y","2015-10-24","201510240PHI"
"PHI",0,1,1,0,1,3,0,1,1,0,0,2,"H","Y","2015-10-24","201510240PHI"
"CAR",0,0,2,0,0,2,0,2,2,1,0,5,"A","N","2015-10-24","201510240SJS"
"SJS",0,2,2,1,0,5,0,0,2,0,0,2,"H","N","2015-10-24","201510240SJS"
"NYI",1,1,1,0,0,3,0,0,0,2,0,2,"A","N","2015-10-24","201510240STL"
"STL",0,0,0,2,0,2,1,1,1,0,0,3,"H","N","2015-10-24","201510240STL"
"DET",1,0,0,2,0,3,0,1,1,0,0,2,"A","N","2015-10-24","201510240VAN"
"VAN",0,1,1,0,0,2,1,0,0,2,0,3,"H","N","2015-10-24","201510240VAN"
"EDM",0,1,0,1,0,2,0,1,1,1,0,3,"H","N","2015-10-25","201510250EDM"
"LAK",0,1,1,1,0,3,0,1,0,1,0,2,"A","N","2015-10-25","201510250EDM"
"CGY",0,1,0,0,0,1,0,0,2,2,0,4,"A","N","2015-10-25","201510250NYR"
"NYR",0,0,2,2,0,4,0,1,0,0,0,1,"H","N","2015-10-25","201510250NYR"
"MIN",0,1,2,1,0,4,0,3,2,0,0,5,"A","N","2015-10-25","201510250WPG"
"WPG",0,3,2,0,0,5,0,1,2,1,0,4,"H","N","2015-10-25","201510250WPG"
"ANA",0,0,0,0,0,0,1,0,0,0,0,1,"A","N","2015-10-26","201510260CHI"
"CHI",1,0,0,0,0,1,0,0,0,0,0,0,"H","N","2015-10-26","201510260CHI"
"CGY",0,0,0,0,0,0,0,0,1,3,0,4,"A","N","2015-10-26","201510260NYI"
"NYI",0,0,1,3,0,4,0,0,0,0,0,0,"H","N","2015-10-26","201510260NYI"
"ARI",0,2,1,1,0,4,0,1,0,2,0,3,"A","N","2015-10-26","201510260TOR"
"TOR",0,1,0,2,0,3,0,2,1,1,0,4,"H","N","2015-10-26","201510260TOR"
"ARI",0,0,0,0,0,0,0,1,2,3,0,6,"A","N","2015-10-27","201510270BOS"
"BOS",0,1,2,3,0,6,0,0,0,0,0,0,"H","N","2015-10-27","201510270BOS"
"ANA",0,3,0,0,0,3,0,0,3,1,0,4,"A","N","2015-10-27","201510270DAL"
"DAL",0,0,3,1,0,4,0,3,0,0,0,3,"H","N","2015-10-27","201510270DAL"
"CAR",0,0,1,2,0,3,0,0,1,0,0,1,"A","N","2015-10-27","201510270DET"
"DET",0,0,1,0,0,1,0,0,1,2,0,3,"H","N","2015-10-27","201510270DET"
"COL",0,0,0,1,0,1,0,1,0,3,0,4,"A","N","2015-10-27","201510270FLA"
"FLA",0,1,0,3,0,4,0,0,0,1,0,1,"H","N","2015-10-27","201510270FLA"
"EDM",0,1,1,1,0,3,0,2,0,2,0,4,"A","N","2015-10-27","201510270MIN"
"MIN",0,2,0,2,0,4,0,1,1,1,0,3,"H","N","2015-10-27","201510270MIN"
"CBJ",0,0,0,3,0,3,0,0,0,1,0,1,"A","N","2015-10-27","201510270NJD"
"NJD",0,0,0,1,0,1,0,0,0,3,0,3,"H","N","2015-10-27","201510270NJD"
"BUF",1,2,0,1,0,4,0,1,0,2,0,3,"A","N","2015-10-27","201510270PHI"
"PHI",0,1,0,2,0,3,1,2,0,1,0,4,"H","N","2015-10-27","201510270PHI"
"STL",0,1,0,1,0,2,0,0,0,0,0,0,"H","N","2015-10-27","201510270STL"
"TBL",0,0,0,0,0,0,0,1,0,1,0,2,"A","N","2015-10-27","201510270STL"
"MTL",0,0,0,1,0,1,0,3,0,2,0,5,"A","N","2015-10-27","201510270VAN"
"VAN",0,3,0,2,0,5,0,0,0,1,0,1,"H","N","2015-10-27","201510270VAN"
"LAK",0,0,1,3,0,4,0,0,1,0,0,1,"A","N","2015-10-27","201510270WPG"
"WPG",0,0,1,0,0,1,0,0,1,3,0,4,"H","N","2015-10-27","201510270WPG"
"CGY",0,0,1,3,0,4,0,0,2,2,1,5,"A","Y","2015-10-28","201510280OTT"
"OTT",0,0,2,2,1,5,0,0,1,3,0,4,"H","Y","2015-10-28","201510280OTT"
"NSH",0,1,0,1,0,2,0,0,0,1,0,1,"A","N","2015-10-28","201510280SJS"
"SJS",0,0,0,1,0,1,0,1,0,1,0,2,"H","N","2015-10-28","201510280SJS"
"PIT",0,0,0,3,0,3,0,0,0,1,0,1,"A","N","2015-10-28","201510280WSH"
"WSH",0,0,0,1,0,1,0,0,0,3,0,3,"H","N","2015-10-28","201510280WSH"
"DAL",1,1,0,2,0,4,0,1,1,1,0,3,"H","N","2015-10-29","201510290DAL"
"VAN",0,1,1,1,0,3,1,1,0,2,0,4,"A","N","2015-10-29","201510290DAL"
"EDM",0,0,1,3,0,4,0,3,0,0,0,3,"H","N","2015-10-29","201510290EDM"
"MTL",0,3,0,0,0,3,0,0,1,3,0,4,"A","N","2015-10-29","201510290EDM"
"CAR",1,1,0,1,0,3,0,1,1,0,0,2,"A","N","2015-10-29","201510290NYI"
"NYI",0,1,1,0,0,2,1,1,0,1,0,3,"H","N","2015-10-29","201510290NYI"
"NJD",0,0,1,3,0,4,0,0,1,0,0,1,"A","N","2015-10-29","201510290PHI"
"PHI",0,0,1,0,0,1,0,0,1,3,0,4,"H","N","2015-10-29","201510290PHI"
"BUF",0,2,0,1,0,3,0,2,2,0,0,4,"A","N","2015-10-29","201510290PIT"
"PIT",0,2,2,0,0,4,0,2,0,1,0,3,"H","N","2015-10-29","201510290PIT"
"ANA",0,0,1,0,0,1,0,0,1,1,0,2,"A","N","2015-10-29","201510290STL"
"STL",0,0,1,1,0,2,0,0,1,0,0,1,"H","N","2015-10-29","201510290STL"
"COL",0,1,1,0,0,2,0,0,1,0,0,1,"A","N","2015-10-29","201510290TBL"
"TBL",0,0,1,0,0,1,0,1,1,0,0,2,"H","N","2015-10-29","201510290TBL"
"CHI",0,1,0,0,0,1,0,1,1,1,0,3,"A","N","2015-10-29","201510290WPG"
"WPG",0,1,1,1,0,3,0,1,0,0,0,1,"H","N","2015-10-29","201510290WPG"
"ARI",0,0,2,1,0,3,0,3,1,0,0,4,"H","N","2015-10-30","201510300ARI"
"VAN",0,3,1,0,0,4,0,0,2,1,0,3,"A","N","2015-10-30","201510300ARI"
"BUF",0,1,1,1,0,3,0,0,0,1,0,1,"H","N","2015-10-30","201510300BUF"
"PHI",0,0,0,1,0,1,0,1,1,1,0,3,"A","N","2015-10-30","201510300BUF"
"CAR",0,0,2,1,0,3,0,0,1,1,0,2,"H","N","2015-10-30","201510300CAR"
"COL",0,0,1,1,0,2,0,0,2,1,0,3,"A","N","2015-10-30","201510300CAR"
"CGY",0,0,2,0,0,2,0,1,3,2,0,6,"H","N","2015-10-30","201510300CGY"
"MTL",0,1,3,2,0,6,0,0,2,0,0,2,"A","N","2015-10-30","201510300CGY"
"DET",0,0,1,0,0,1,0,1,1,1,0,3,"H","N","2015-10-30","201510300DET"
"OTT",0,1,1,1,0,3,0,0,1,0,0,1,"A","N","2015-10-30","201510300DET"
"BOS",0,1,2,0,0,3,0,0,1,0,0,1,"A","N","2015-10-30","201510300FLA"
"FLA",0,0,1,0,0,1,0,1,2,0,0,3,"H","N","2015-10-30","201510300FLA"
"CHI",0,2,2,0,0,4,0,3,1,1,0,5,"A","N","2015-10-30","201510300MIN"
"MIN",0,3,1,1,0,5,0,2,2,0,0,4,"H","N","2015-10-30","201510300MIN"
"NYR",0,1,0,2,0,3,0,0,0,1,0,1,"H","N","2015-10-30","201510300NYR"
"TOR",0,0,0,1,0,1,0,1,0,2,0,3,"A","N","2015-10-30","201510300NYR"
"CBJ",0,0,0,1,0,1,0,0,1,1,0,2,"A","N","2015-10-30","201510300WSH"
"WSH",0,0,1,1,0,2,0,0,0,1,0,1,"H","N","2015-10-30","201510300WSH"
"CBJ",0,1,0,1,0,2,0,3,0,0,0,3,"H","N","2015-10-31","201510310CBJ"
"WPG",0,3,0,0,0,3,0,1,0,1,0,2,"A","N","2015-10-31","201510310CBJ"
"DAL",0,1,2,2,0,5,0,0,3,0,0,3,"H","N","2015-10-31","201510310DAL"
"SJS",0,0,3,0,0,3,0,1,2,2,0,5,"A","N","2015-10-31","201510310DAL"
"CGY",0,3,1,1,0,5,0,1,1,2,0,4,"A","N","2015-10-31","201510310EDM"
"EDM",0,1,1,2,0,4,0,3,1,1,0,5,"H","N","2015-10-31","201510310EDM"
"FLA",0,0,1,0,0,1,1,0,0,1,0,2,"H","N","2015-10-31","201510310FLA"
"WSH",1,0,0,1,0,2,0,0,1,0,0,1,"A","N","2015-10-31","201510310FLA"
"LAK",1,0,1,2,0,4,0,0,2,1,0,3,"H","N","2015-10-31","201510310LAK"
"NSH",0,0,2,1,0,3,1,0,1,2,0,4,"A","N","2015-10-31","201510310LAK"
"NJD",0,2,0,0,1,3,0,0,2,0,0,2,"H","Y","2015-10-31","201510310NJD"
"NYI",0,0,2,0,0,2,0,2,0,0,1,3,"A","Y","2015-10-31","201510310NJD"
"DET",0,1,2,2,0,5,0,0,1,2,0,3,"A","N","2015-10-31","201510310OTT"
"OTT",0,0,1,2,0,3,0,1,2,2,0,5,"H","N","2015-10-31","201510310OTT"
"MIN",0,2,0,0,0,2,1,2,0,0,0,3,"A","N","2015-10-31","201510310STL"
"STL",1,2,0,0,0,3,0,2,0,0,0,2,"H","N","2015-10-31","201510310STL"
"BOS",0,1,0,2,0,3,0,1,0,0,0,1,"A","N","2015-10-31","201510310TBL"
"TBL",0,1,0,0,0,1,0,1,0,2,0,3,"H","N","2015-10-31","201510310TBL"
"PIT",0,1,2,1,0,4,0,0,0,0,0,0,"A","N","2015-10-31","201510310TOR"
"TOR",0,0,0,0,0,0,0,1,2,1,0,4,"H","N","2015-10-31","201510310TOR"
"ANA",0,3,1,0,0,4,0,0,2,0,0,2,"H","N","2015-11-01","201511010ANA"
"NSH",0,0,2,0,0,2,0,3,1,0,0,4,"A","N","2015-11-01","201511010ANA"
"CAR",0,1,0,2,0,3,0,0,2,2,0,4,"H","N","2015-11-01","201511010CAR"
"TBL",0,0,2,2,0,4,0,1,0,2,0,3,"A","N","2015-11-01","201511010CAR"
"COL",0,1,1,1,0,3,0,1,1,2,0,4,"H","N","2015-11-01","201511010COL"
"SJS",0,1,1,2,0,4,0,1,1,1,0,3,"A","N","2015-11-01","201511010COL"
"MTL",0,2,3,0,0,5,0,0,0,1,0,1,"H","N","2015-11-01","201511010MTL"
"WPG",0,0,0,1,0,1,0,2,3,0,0,5,"A","N","2015-11-01","201511010MTL"
"BUF",0,0,0,2,0,2,0,0,1,0,0,1,"A","N","2015-11-01","201511010NYI"
"NYI",0,0,1,0,0,1,0,0,0,2,0,2,"H","N","2015-11-01","201511010NYI"
"CHI",0,1,0,3,0,4,0,2,0,0,0,2,"H","N","2015-11-02","201511020CHI"
"LAK",0,2,0,0,0,2,0,1,0,3,0,4,"A","N","2015-11-02","201511020CHI"
"DAL",0,1,0,0,0,1,0,1,2,1,0,4,"A","N","2015-11-02","201511020TOR"
"TOR",0,1,2,1,0,4,0,1,0,0,0,1,"H","N","2015-11-02","201511020TOR"
"PHI",0,0,1,0,0,1,0,1,1,2,0,4,"A","N","2015-11-02","201511020VAN"
"VAN",0,1,1,2,0,4,0,0,1,0,0,1,"H","N","2015-11-02","201511020VAN"
"BOS",0,2,0,1,0,3,0,1,2,2,0,5,"H","N","2015-11-03","201511030BOS"
"DAL",0,1,2,2,0,5,0,2,0,1,0,3,"A","N","2015-11-03","201511030BOS"
"CGY",0,0,2,1,0,3,0,1,2,3,0,6,"A","N","2015-11-03","201511030COL"
"COL",0,1,2,3,0,6,0,0,2,1,0,3,"H","N","2015-11-03","201511030COL"
"DET",0,0,1,1,0,2,0,0,1,0,0,1,"H","N","2015-11-03","201511030DET"
"TBL",0,0,1,0,0,1,0,0,1,1,0,2,"A","N","2015-11-03","201511030DET"
"EDM",0,1,0,3,0,4,0,0,2,0,0,2,"H","N","2015-11-03","201511030EDM"
"PHI",0,0,2,0,0,2,0,1,0,3,0,4,"A","N","2015-11-03","201511030EDM"
"MTL",0,0,1,0,0,1,1,0,1,0,0,2,"H","N","2015-11-03","201511030MTL"
"OTT",1,0,1,0,0,2,0,0,1,0,0,1,"A","N","2015-11-03","201511030MTL"
"NJD",0,0,0,1,0,1,0,1,0,1,0,2,"A","N","2015-11-03","201511030NYI"
"NYI",0,1,0,1,0,2,0,0,0,1,0,1,"H","N","2015-11-03","201511030NYI"
"NYR",0,2,2,1,0,5,0,1,1,0,0,2,"H","N","2015-11-03","201511030NYR"
"WSH",0,1,1,0,0,2,0,2,2,1,0,5,"A","N","2015-11-03","201511030NYR"
"CBJ",0,1,3,1,0,5,0,1,1,0,0,2,"A","N","2015-11-03","201511030SJS"
"SJS",0,1,1,0,0,2,0,1,3,1,0,5,"H","N","2015-11-03","201511030SJS"
"LAK",0,0,1,2,0,3,0,0,0,0,0,0,"A","N","2015-11-03","201511030STL"
"STL",0,0,0,0,0,0,0,0,1,2,0,3,"H","N","2015-11-03","201511030STL"
"ANA",0,0,1,1,1,3,0,0,2,0,0,2,"H","Y","2015-11-04","201511040ANA"
"FLA",0,0,2,0,0,2,0,0,1,1,1,3,"A","Y","2015-11-04","201511040ANA"
"CHI",0,5,0,0,0,5,1,2,3,0,0,6,"H","N","2015-11-04","201511040CHI"
"STL",1,2,3,0,0,6,0,5,0,0,0,5,"A","N","2015-11-04","201511040CHI"
"TOR",0,1,1,0,0,2,0,2,0,2,0,4,"H","N","2015-11-04","201511040TOR"
"WPG",0,2,0,2,0,4,0,1,1,0,0,2,"A","N","2015-11-04","201511040TOR"
"PIT",0,1,0,2,0,3,0,0,0,2,0,2,"A","N","2015-11-04","201511040VAN"
"VAN",0,0,0,2,0,2,0,1,0,2,0,3,"H","N","2015-11-04","201511040VAN"
"ARI",0,1,2,1,0,4,0,0,1,1,0,2,"H","N","2015-11-05","201511050ARI"
"COL",0,0,1,1,0,2,0,1,2,1,0,4,"A","N","2015-11-05","201511050ARI"
"BUF",0,0,1,0,0,1,0,3,0,1,0,4,"H","N","2015-11-05","201511050BUF"
"TBL",0,3,0,1,0,4,0,0,1,0,0,1,"A","N","2015-11-05","201511050BUF"
"CGY",1,1,0,0,0,2,0,0,1,0,0,1,"H","N","2015-11-05","201511050CGY"
"PHI",0,0,1,0,0,1,1,1,0,0,0,2,"A","N","2015-11-05","201511050CGY"
"CBJ",0,2,0,1,0,3,0,1,0,1,0,2,"A","N","2015-11-05","201511050LAK"
"LAK",0,1,0,1,0,2,0,2,0,1,0,3,"H","N","2015-11-05","201511050LAK"
"MIN",0,0,1,1,0,2,0,0,1,2,0,3,"H","N","2015-11-05","201511050MIN"
"NSH",0,0,1,2,0,3,0,0,1,1,0,2,"A","N","2015-11-05","201511050MIN"
"MTL",0,1,0,3,0,4,0,0,1,0,0,1,"H","N","2015-11-05","201511050MTL"
"NYI",0,0,1,0,0,1,0,1,0,3,0,4,"A","N","2015-11-05","201511050MTL"
"OTT",0,1,1,0,1,3,0,0,1,1,0,2,"H","Y","2015-11-05","201511050OTT"
"WPG",0,0,1,1,0,2,0,1,1,0,1,3,"A","Y","2015-11-05","201511050OTT"
"FLA",0,1,1,0,0,2,0,2,2,1,0,5,"A","N","2015-11-05","201511050SJS"
"SJS",0,2,2,1,0,5,0,1,1,0,0,2,"H","N","2015-11-05","201511050SJS"
"BOS",0,1,0,0,0,1,0,1,2,1,0,4,"A","N","2015-11-05","201511050WSH"
"WSH",0,1,2,1,0,4,0,1,0,0,0,1,"H","N","2015-11-05","201511050WSH"
"ANA",0,1,1,2,0,4,0,0,1,1,0,2,"H","N","2015-11-06","201511060ANA"
"CBJ",0,0,1,1,0,2,0,1,1,2,0,4,"A","N","2015-11-06","201511060ANA"
"CAR",0,0,1,0,0,1,0,0,1,3,0,4,"H","N","2015-11-06","201511060CAR"
"DAL",0,0,1,3,0,4,0,0,1,0,0,1,"A","N","2015-11-06","201511060CAR"
"COL",0,1,0,0,0,1,0,0,2,0,0,2,"H","N","2015-11-06","201511060COL"
"NYR",0,0,2,0,0,2,0,1,0,0,0,1,"A","N","2015-11-06","201511060COL"
"EDM",0,0,1,0,0,1,0,0,1,1,0,2,"H","N","2015-11-06","201511060EDM"
"PIT",0,0,1,1,0,2,0,0,1,0,0,1,"A","N","2015-11-06","201511060EDM"
"CHI",0,0,1,1,0,2,0,3,1,0,0,4,"A","N","2015-11-06","201511060NJD"
"NJD",0,3,1,0,0,4,0,0,1,1,0,2,"H","N","2015-11-06","201511060NJD"
"DET",1,1,0,0,0,2,0,0,0,1,0,1,"A","N","2015-11-06","201511060TOR"
"TOR",0,0,0,1,0,1,1,1,0,0,0,2,"H","N","2015-11-06","201511060TOR"
"ARI",0,0,0,1,0,1,0,1,3,0,0,4,"H","N","2015-11-07","201511070ARI"
"NYR",0,1,3,0,0,4,0,0,0,1,0,1,"A","N","2015-11-07","201511070ARI"
"BUF",0,0,2,1,0,3,0,0,1,1,0,2,"H","N","2015-11-07","201511070BUF"
"VAN",0,0,1,1,0,2,0,0,2,1,0,3,"A","N","2015-11-07","201511070BUF"
"CAR",1,0,1,1,0,3,0,0,2,0,0,2,"H","N","2015-11-07","201511070CAR"
"OTT",0,0,2,0,0,2,1,0,1,1,0,3,"A","N","2015-11-07","201511070CAR"
"CGY",0,3,1,1,0,5,0,1,1,0,0,2,"H","N","2015-11-07","201511070CGY"
"PIT",0,1,1,0,0,2,0,3,1,1,0,5,"A","N","2015-11-07","201511070CGY"
"FLA",0,1,0,0,0,1,0,0,3,1,0,4,"A","N","2015-11-07","201511070LAK"
"LAK",0,0,3,1,0,4,0,1,0,0,0,1,"H","N","2015-11-07","201511070LAK"
"MIN",0,0,1,0,0,1,0,0,0,0,0,0,"H","N","2015-11-07","201511070MIN"
"TBL",0,0,0,0,0,0,0,0,1,0,0,1,"A","N","2015-11-07","201511070MIN"
"BOS",0,1,1,0,0,2,0,0,1,3,0,4,"A","N","2015-11-07","201511070MTL"
"MTL",0,0,1,3,0,4,0,1,1,0,0,2,"H","N","2015-11-07","201511070MTL"
"NSH",0,0,0,0,0,0,0,1,0,3,0,4,"H","N","2015-11-07","201511070NSH"
"STL",0,1,0,3,0,4,0,0,0,0,0,0,"A","N","2015-11-07","201511070NSH"
"ANA",0,1,0,0,0,1,0,0,0,0,0,0,"A","N","2015-11-07","201511070SJS"
"SJS",0,0,0,0,0,0,0,1,0,0,0,1,"H","N","2015-11-07","201511070SJS"
"PHI",0,1,0,2,0,3,0,0,0,0,0,0,"A","N","2015-11-07","201511070WPG"
"WPG",0,0,0,0,0,0,0,1,0,2,0,3,"H","N","2015-11-07","201511070WPG"
"TOR",0,1,0,1,0,2,0,0,1,1,1,3,"A","Y","2015-11-07","201511070WSH"
"WSH",0,0,1,1,1,3,0,1,0,1,0,2,"H","Y","2015-11-07","201511070WSH"
"CHI",0,2,0,2,0,4,0,0,0,2,0,2,"H","N","2015-11-08","201511080CHI"
"EDM",0,0,0,2,0,2,0,2,0,2,0,4,"A","N","2015-11-08","201511080CHI"
"DAL",0,2,0,2,0,4,0,1,0,0,0,1,"A","N","2015-11-08","201511080DET"
"DET",0,1,0,0,0,1,0,2,0,2,0,4,"H","N","2015-11-08","201511080DET"
"NJD",1,2,1,0,0,4,0,1,2,0,0,3,"H","N","2015-11-08","201511080NJD"
"VAN",0,1,2,0,0,3,1,2,1,0,0,4,"A","N","2015-11-08","201511080NJD"
"BOS",0,1,1,0,0,2,0,0,0,1,0,1,"A","N","2015-11-08","201511080NYI"
"NYI",0,0,0,1,0,1,0,1,1,0,0,2,"H","N","2015-11-08","201511080NYI"
"ANA",0,2,0,1,0,3,1,0,3,0,0,4,"H","N","2015-11-09","201511090ANA"
"ARI",1,0,3,0,0,4,0,2,0,1,0,3,"A","N","2015-11-09","201511090ANA"
"CBJ",0,2,0,1,0,3,0,2,0,3,0,5,"H","N","2015-11-10","201511100CBJ"
"VAN",0,2,0,3,0,5,0,2,0,1,0,3,"A","N","2015-11-10","201511100CBJ"
"DAL",0,0,1,1,0,2,0,1,0,2,0,3,"H","N","2015-11-10","201511100DAL"
"TOR",0,1,0,2,0,3,0,0,1,1,0,2,"A","N","2015-11-10","201511100DAL"
"DET",0,0,0,1,0,1,0,0,0,0,0,0,"H","N","2015-11-10","201511100DET"
"WSH",0,0,0,0,0,0,0,0,0,1,0,1,"A","N","2015-11-10","201511100DET"
"CGY",0,1,2,0,0,3,0,2,1,1,0,4,"A","N","2015-11-10","201511100FLA"
"FLA",0,2,1,1,0,4,0,1,2,0,0,3,"H","N","2015-11-10","201511100FLA"
"ARI",0,1,1,1,0,3,0,1,1,0,0,2,"A","N","2015-11-10","201511100LAK"
"LAK",0,1,1,0,0,2,0,1,1,1,0,3,"H","N","2015-11-10","201511100LAK"
"MIN",0,1,4,0,0,5,0,1,0,2,0,3,"H","N","2015-11-10","201511100MIN"
"WPG",0,1,0,2,0,3,0,1,4,0,0,5,"A","N","2015-11-10","201511100MIN"
"NJD",0,0,0,0,0,0,0,0,1,1,0,2,"H","N","2015-11-10","201511100NJD"
"STL",0,0,1,1,0,2,0,0,0,0,0,0,"A","N","2015-11-10","201511100NJD"
"NSH",0,1,3,3,0,7,0,3,2,0,0,5,"H","N","2015-11-10","201511100NSH"
"OTT",0,3,2,0,0,5,0,1,3,3,0,7,"A","N","2015-11-10","201511100NSH"
"CAR",0,0,0,0,0,0,0,2,0,1,0,3,"A","N","2015-11-10","201511100NYR"
"NYR",0,2,0,1,0,3,0,0,0,0,0,0,"H","N","2015-11-10","201511100NYR"
"COL",0,1,2,1,0,4,0,0,0,0,0,0,"A","N","2015-11-10","201511100PHI"
"PHI",0,0,0,0,0,0,0,1,2,1,0,4,"H","N","2015-11-10","201511100PHI"
"NYI",0,2,0,2,0,4,0,0,1,1,0,2,"A","N","2015-11-10","201511100SJS"
"SJS",0,0,1,1,0,2,0,2,0,2,0,4,"H","N","2015-11-10","201511100SJS"
"BUF",0,1,1,2,0,4,0,0,1,0,0,1,"A","N","2015-11-10","201511100TBL"
"TBL",0,0,1,0,0,1,0,1,1,2,0,4,"H","N","2015-11-10","201511100TBL"
"ANA",0,1,0,2,0,3,1,0,1,2,0,4,"H","N","2015-11-11","201511110ANA"
"EDM",1,0,1,2,0,4,0,1,0,2,0,3,"A","N","2015-11-11","201511110ANA"
"MTL",0,1,2,0,0,3,0,2,0,1,1,4,"A","Y","2015-11-11","201511110PIT"
"PIT",0,2,0,1,1,4,0,1,2,0,0,3,"H","Y","2015-11-11","201511110PIT"
"ARI",0,1,2,1,0,4,0,1,0,0,0,1,"H","N","2015-11-12","201511120ARI"
"EDM",0,1,0,0,0,1,0,1,2,1,0,4,"A","N","2015-11-12","201511120ARI"
"BOS",0,2,0,0,0,2,0,2,0,1,0,3,"H","N","2015-11-12","201511120BOS"
"COL",0,2,0,1,0,3,0,2,0,0,0,2,"A","N","2015-11-12","201511120BOS"
"CAR",0,2,0,0,0,2,1,1,1,0,0,3,"H","N","2015-11-12","201511120CAR"
"MIN",1,1,1,0,0,3,0,2,0,0,0,2,"A","N","2015-11-12","201511120CAR"
"CHI",0,1,0,1,0,2,0,0,2,1,0,3,"H","N","2015-11-12","201511120CHI"
"NJD",0,0,2,1,0,3,0,1,0,1,0,2,"A","N","2015-11-12","201511120CHI"
"DAL",0,2,1,3,0,6,0,2,0,1,0,3,"H","N","2015-11-12","201511120DAL"
"WPG",0,2,0,1,0,3,0,2,1,3,0,6,"A","N","2015-11-12","201511120DAL"
"BUF",0,1,1,1,0,3,0,0,1,1,0,2,"A","N","2015-11-12","201511120FLA"
"FLA",0,0,1,1,0,2,0,1,1,1,0,3,"H","N","2015-11-12","201511120FLA"
"LAK",0,1,1,0,0,2,0,1,0,0,0,1,"H","N","2015-11-12","201511120LAK"
"NYI",0,1,0,0,0,1,0,1,1,0,0,2,"A","N","2015-11-12","201511120LAK"
"NSH",0,0,0,1,0,1,0,0,0,1,1,2,"H","Y","2015-11-12","201511120NSH"
"TOR",0,0,0,1,1,2,0,0,0,1,0,1,"A","Y","2015-11-12","201511120NSH"
"NYR",0,3,1,2,0,6,0,1,2,0,0,3,"H","N","2015-11-12","201511120NYR"
"STL",0,1,2,0,0,3,0,3,1,2,0,6,"A","N","2015-11-12","201511120NYR"
"OTT",0,1,1,1,0,3,0,1,0,1,0,2,"H","N","2015-11-12","201511120OTT"
"VAN",0,1,0,1,0,2,0,1,1,1,0,3,"A","N","2015-11-12","201511120OTT"
"PHI",0,1,1,0,0,2,0,1,3,1,0,5,"H","N","2015-11-12","201511120PHI"
"WSH",0,1,3,1,0,5,0,1,1,0,0,2,"A","N","2015-11-12","201511120PHI"
"CGY",0,0,1,0,0,1,0,0,1,2,0,3,"A","N","2015-11-12","201511120TBL"
"TBL",0,0,1,2,0,3,0,0,1,0,0,1,"H","N","2015-11-12","201511120TBL"
"ANA",0,0,1,0,0,1,0,1,1,2,0,4,"H","N","2015-11-13","201511130ANA"
"NYI",0,1,1,2,0,4,0,0,1,0,0,1,"A","N","2015-11-13","201511130ANA"
"DET",0,1,0,1,0,2,0,2,1,0,0,3,"H","N","2015-11-13","201511130DET"
"SJS",0,2,1,0,0,3,0,1,0,1,0,2,"A","N","2015-11-13","201511130DET"
"CBJ",0,0,2,0,0,2,0,0,0,1,0,1,"A","N","2015-11-13","201511130PIT"
"PIT",0,0,0,1,0,1,0,0,2,0,0,2,"H","N","2015-11-13","201511130PIT"
"CGY",1,0,1,1,0,3,0,0,0,2,0,2,"A","N","2015-11-13","201511130WSH"
"WSH",0,0,0,2,0,2,1,0,1,1,0,3,"H","N","2015-11-13","201511130WSH"
"BOS",0,0,3,0,0,3,0,0,0,1,0,1,"H","N","2015-11-14","201511140BOS"
"DET",0,0,0,1,0,1,0,0,3,0,0,3,"A","N","2015-11-14","201511140BOS"
"BUF",0,0,0,1,0,1,1,1,0,0,0,2,"H","N","2015-11-14","201511140BUF"
"SJS",1,1,0,0,0,2,0,0,0,1,0,1,"A","N","2015-11-14","201511140BUF"
"CAR",0,1,1,0,0,2,1,0,1,1,0,3,"H","N","2015-11-14","201511140CAR"
"PHI",1,0,1,1,0,3,0,1,1,0,0,2,"A","N","2015-11-14","201511140CAR"
"ARI",0,1,1,0,0,2,0,2,1,2,0,5,"A","N","2015-11-14","201511140CBJ"
"CBJ",0,2,1,2,0,5,0,1,1,0,0,2,"H","N","2015-11-14","201511140CBJ"
"DAL",1,1,0,1,0,3,0,0,1,1,0,2,"H","N","2015-11-14","201511140DAL"
"MIN",0,0,1,1,0,2,1,1,0,1,0,3,"A","N","2015-11-14","201511140DAL"
"EDM",0,0,2,1,0,3,0,2,1,1,0,4,"A","N","2015-11-14","201511140LAK"
"LAK",0,2,1,1,0,4,0,0,2,1,0,3,"H","N","2015-11-14","201511140LAK"
"COL",0,3,1,2,0,6,0,0,1,0,0,1,"A","N","2015-11-14","201511140MTL"
"MTL",0,0,1,0,0,1,0,3,1,2,0,6,"H","N","2015-11-14","201511140MTL"
"NJD",0,1,1,2,0,4,0,0,0,0,0,0,"H","N","2015-11-14","201511140NJD"
"PIT",0,0,0,0,0,0,0,1,1,2,0,4,"A","N","2015-11-14","201511140NJD"
"NSH",0,4,1,2,0,7,0,0,0,0,0,0,"H","N","2015-11-14","201511140NSH"
"WPG",0,0,0,0,0,0,0,4,1,2,0,7,"A","N","2015-11-14","201511140NSH"
"NYR",0,1,0,0,1,2,0,1,0,0,0,1,"A","Y","2015-11-14","201511140OTT"
"OTT",0,1,0,0,0,1,0,1,0,0,1,2,"H","Y","2015-11-14","201511140OTT"
"CHI",0,1,2,1,0,4,0,0,2,0,0,2,"A","N","2015-11-14","201511140STL"
"STL",0,0,2,0,0,2,0,1,2,1,0,4,"H","N","2015-11-14","201511140STL"
"FLA",0,1,2,1,1,5,0,1,2,1,0,4,"A","Y","2015-11-14","201511140TBL"
"TBL",0,1,2,1,0,4,0,1,2,1,1,5,"H","Y","2015-11-14","201511140TBL"
"TOR",0,1,1,2,0,4,0,0,1,1,0,2,"H","N","2015-11-14","201511140TOR"
"VAN",0,0,1,1,0,2,0,1,1,2,0,4,"A","N","2015-11-14","201511140TOR"
"CGY",0,0,1,0,0,1,0,0,3,1,0,4,"A","N","2015-11-15","201511150CHI"
"CHI",0,0,3,1,0,4,0,0,1,0,0,1,"H","N","2015-11-15","201511150CHI"
"NYR",0,0,2,2,0,4,0,1,1,1,0,3,"H","N","2015-11-15","201511150NYR"
"TOR",0,1,1,1,0,3,0,0,2,2,0,4,"A","N","2015-11-15","201511150NYR"
"ANA",0,1,1,2,0,4,0,0,1,0,0,1,"A","N","2015-11-16","201511160CAR"
"CAR",0,0,1,0,0,1,0,1,1,2,0,4,"H","N","2015-11-16","201511160CAR"
"FLA",0,0,0,1,0,1,0,0,0,0,0,0,"H","N","2015-11-16","201511160FLA"
"TBL",0,0,0,0,0,0,0,0,0,1,0,1,"A","N","2015-11-16","201511160FLA"
"MTL",1,0,2,1,0,4,0,2,1,0,0,3,"H","N","2015-11-16","201511160MTL"
"VAN",0,2,1,0,0,3,1,0,2,1,0,4,"A","N","2015-11-16","201511160MTL"
"ARI",0,0,0,2,0,2,0,1,0,4,0,5,"A","N","2015-11-16","201511160NYI"
"NYI",0,1,0,4,0,5,0,0,0,2,0,2,"H","N","2015-11-16","201511160NYI"
"DET",1,2,1,0,0,4,0,1,0,2,0,3,"A","N","2015-11-16","201511160OTT"
"OTT",0,1,0,2,0,3,1,2,1,0,0,4,"H","N","2015-11-16","201511160OTT"
"STL",0,2,1,0,0,3,0,0,2,0,0,2,"H","N","2015-11-16","201511160STL"
"WPG",0,0,2,0,0,2,0,2,1,0,0,3,"A","N","2015-11-16","201511160STL"
"BOS",0,2,1,1,0,4,0,2,3,0,0,5,"H","N","2015-11-17","201511170BOS"
"SJS",0,2,3,0,0,5,0,2,1,1,0,4,"A","N","2015-11-17","201511170BOS"
"BUF",0,0,0,1,0,1,0,1,0,2,0,3,"H","N","2015-11-17","201511170BUF"
"DAL",0,1,0,2,0,3,0,0,0,1,0,1,"A","N","2015-11-17","201511170BUF"
"CBJ",0,1,1,1,0,3,0,1,0,0,0,1,"H","N","2015-11-17","201511170CBJ"
"STL",0,1,0,0,0,1,0,1,1,1,0,3,"A","N","2015-11-17","201511170CBJ"
"CGY",0,2,1,0,0,3,0,0,2,0,0,2,"H","N","2015-11-17","201511170CGY"
"NJD",0,0,2,0,0,2,0,2,1,0,0,3,"A","N","2015-11-17","201511170CGY"
"ANA",0,1,0,1,0,2,0,2,1,0,0,3,"A","N","2015-11-17","201511170NSH"
"NSH",0,2,1,0,0,3,0,1,0,1,0,2,"H","N","2015-11-17","201511170NSH"
"LAK",0,1,0,1,1,3,0,1,0,1,0,2,"A","Y","2015-11-17","201511170PHI"
"PHI",0,1,0,1,0,2,0,1,0,1,1,3,"H","Y","2015-11-17","201511170PHI"
"MIN",0,1,1,1,0,3,0,2,2,0,0,4,"A","N","2015-11-17","201511170PIT"
"PIT",0,2,2,0,0,4,0,1,1,1,0,3,"H","N","2015-11-17","201511170PIT"
"COL",0,0,1,0,0,1,0,2,1,2,0,5,"A","N","2015-11-17","201511170TOR"
"TOR",0,2,1,2,0,5,0,0,1,0,0,1,"H","N","2015-11-17","201511170TOR"
"DET",0,1,0,0,0,1,1,1,0,0,0,2,"H","N","2015-11-18","201511180DET"
"WSH",1,1,0,0,0,2,0,1,0,0,0,1,"A","N","2015-11-18","201511180DET"
"CHI",1,0,2,1,0,4,0,0,1,2,0,3,"A","N","2015-11-18","201511180EDM"
"EDM",0,0,1,2,0,3,1,0,2,1,0,4,"H","N","2015-11-18","201511180EDM"
"VAN",0,0,1,0,0,1,0,1,1,2,0,4,"A","N","2015-11-18","201511180WPG"
"WPG",0,1,1,2,0,4,0,0,1,0,0,1,"H","N","2015-11-18","201511180WPG"
"BOS",0,1,2,1,0,4,0,0,2,0,0,2,"H","N","2015-11-19","201511190BOS"
"MIN",0,0,2,0,0,2,0,1,2,1,0,4,"A","N","2015-11-19","201511190BOS"
"ANA",0,0,1,2,0,3,0,0,0,1,0,1,"A","N","2015-11-19","201511190FLA"
"FLA",0,0,0,1,0,1,0,0,1,2,0,3,"H","N","2015-11-19","201511190FLA"
"ARI",0,2,1,0,0,3,0,0,1,1,0,2,"A","N","2015-11-19","201511190MTL"
"MTL",0,0,1,1,0,2,0,2,1,0,0,3,"H","N","2015-11-19","201511190MTL"
"CBJ",0,0,0,0,0,0,0,0,2,1,0,3,"A","N","2015-11-19","201511190OTT"
"OTT",0,0,2,1,0,3,0,0,0,0,0,0,"H","N","2015-11-19","201511190OTT"
"PHI",0,0,0,0,0,0,1,0,0,0,0,1,"H","N","2015-11-19","201511190PHI"
"SJS",1,0,0,0,0,1,0,0,0,0,0,0,"A","N","2015-11-19","201511190PHI"
"COL",0,1,0,2,0,3,0,0,3,1,0,4,"A","N","2015-11-19","201511190PIT"
"PIT",0,0,3,1,0,4,0,1,0,2,0,3,"H","N","2015-11-19","201511190PIT"
"BUF",0,0,2,0,0,2,0,1,1,0,1,3,"A","Y","2015-11-19","201511190STL"
"STL",0,1,1,0,1,3,0,0,2,0,0,2,"H","Y","2015-11-19","201511190STL"
"NYR",0,0,0,1,0,1,0,1,0,1,0,2,"A","N","2015-11-19","201511190TBL"
"TBL",0,1,0,1,0,2,0,0,0,1,0,1,"H","N","2015-11-19","201511190TBL"
"DAL",0,1,0,2,0,3,0,1,0,1,0,2,"A","N","2015-11-19","201511190WSH"
"WSH",0,1,0,1,0,2,0,1,0,2,0,3,"H","N","2015-11-19","201511190WSH"
"CAR",0,0,0,1,0,1,0,0,0,1,1,2,"H","Y","2015-11-20","201511200CAR"
"TOR",0,0,0,1,1,2,0,0,0,1,0,1,"A","Y","2015-11-20","201511200CAR"
"CBJ",0,2,1,1,0,4,0,0,0,0,0,0,"H","N","2015-11-20","201511200CBJ"
"NSH",0,0,0,0,0,0,0,2,1,1,0,4,"A","N","2015-11-20","201511200CBJ"
"CGY",1,1,0,0,0,2,0,1,0,0,0,1,"H","N","2015-11-20","201511200CGY"
"CHI",0,1,0,0,0,1,1,1,0,0,0,2,"A","N","2015-11-20","201511200CGY"
"DET",0,1,2,0,0,3,0,1,1,0,0,2,"H","N","2015-11-20","201511200DET"
"LAK",0,1,1,0,0,2,0,1,2,0,0,3,"A","N","2015-11-20","201511200DET"
"EDM",0,1,1,3,0,5,0,0,1,0,0,1,"H","N","2015-11-20","201511200EDM"
"NJD",0,0,1,0,0,1,0,1,1,3,0,5,"A","N","2015-11-20","201511200EDM"
"MTL",0,3,1,1,0,5,0,1,1,1,0,3,"A","N","2015-11-20","201511200NYI"
"NYI",0,1,1,1,0,3,0,3,1,1,0,5,"H","N","2015-11-20","201511200NYI"
"BOS",0,0,0,2,0,2,0,0,0,0,0,0,"H","N","2015-11-21","201511210BOS"
"TOR",0,0,0,0,0,0,0,0,0,2,0,2,"A","N","2015-11-21","201511210BOS"
"BUF",0,0,0,0,0,0,0,1,0,2,0,3,"A","N","2015-11-21","201511210DAL"
"DAL",0,1,0,2,0,3,0,0,0,0,0,0,"H","N","2015-11-21","201511210DAL"
"FLA",0,0,2,2,0,4,1,1,1,2,0,5,"H","N","2015-11-21","201511210FLA"
"NYR",1,1,1,2,0,5,0,0,2,2,0,4,"A","N","2015-11-21","201511210FLA"
"MIN",0,1,2,1,0,4,0,0,0,0,0,0,"H","N","2015-11-21","201511210MIN"
"NSH",0,0,0,0,0,0,0,1,2,1,0,4,"A","N","2015-11-21","201511210MIN"
"OTT",0,1,2,1,0,4,0,0,0,0,0,0,"H","N","2015-11-21","201511210OTT"
"PHI",0,0,0,0,0,0,0,1,2,1,0,4,"A","N","2015-11-21","201511210OTT"
"PIT",0,0,1,0,0,1,0,1,1,1,0,3,"H","N","2015-11-21","201511210PIT"
"SJS",0,1,1,1,0,3,0,0,1,0,0,1,"A","N","2015-11-21","201511210PIT"
"DET",1,2,1,0,0,4,0,2,0,1,0,3,"A","N","2015-11-21","201511210STL"
"STL",0,2,0,1,0,3,1,2,1,0,0,4,"H","N","2015-11-21","201511210STL"
"ANA",0,0,0,0,0,0,0,0,3,2,0,5,"A","N","2015-11-21","201511210TBL"
"TBL",0,0,3,2,0,5,0,0,0,0,0,0,"H","N","2015-11-21","201511210TBL"
"CHI",0,2,0,1,0,3,0,2,1,3,0,6,"A","N","2015-11-21","201511210VAN"
"VAN",0,2,1,3,0,6,0,2,0,1,0,3,"H","N","2015-11-21","201511210VAN"
"ARI",0,2,0,0,0,2,0,1,1,1,0,3,"A","N","2015-11-21","201511210WPG"
"WPG",0,1,1,1,0,3,0,2,0,0,0,2,"H","N","2015-11-21","201511210WPG"
"COL",0,0,2,1,0,3,0,4,0,3,0,7,"A","N","2015-11-21","201511210WSH"
"WSH",0,4,0,3,0,7,0,0,2,1,0,3,"H","N","2015-11-21","201511210WSH"
"CAR",0,1,3,0,0,4,0,0,2,1,0,3,"H","N","2015-11-22","201511220CAR"
"LAK",0,0,2,1,0,3,0,1,3,0,0,4,"A","N","2015-11-22","201511220CAR"
"CBJ",0,0,2,1,0,3,0,1,0,4,0,5,"H","N","2015-11-22","201511220CBJ"
"SJS",0,1,0,4,0,5,0,0,2,1,0,3,"A","N","2015-11-22","201511220CBJ"
"MTL",0,0,2,2,0,4,0,1,0,1,0,2,"H","N","2015-11-22","201511220MTL"
"NYI",0,1,0,1,0,2,0,0,2,2,0,4,"A","N","2015-11-22","201511220MTL"
"NJD",0,0,1,2,0,3,0,0,0,2,0,2,"A","N","2015-11-22","201511220VAN"
"VAN",0,0,0,2,0,2,0,0,1,2,0,3,"H","N","2015-11-22","201511220VAN"
"BUF",0,0,1,0,0,1,0,0,0,2,0,2,"H","N","2015-11-23","201511230BUF"
"STL",0,0,0,2,0,2,0,0,1,0,0,1,"A","N","2015-11-23","201511230BUF"
"FLA",0,0,1,0,0,1,0,1,1,1,0,3,"H","N","2015-11-23","201511230FLA"
"LAK",0,1,1,1,0,3,0,0,1,0,0,1,"A","N","2015-11-23","201511230FLA"
"NSH",0,0,0,0,0,0,0,0,1,2,0,3,"A","N","2015-11-23","201511230NYR"
"NYR",0,0,1,2,0,3,0,0,0,0,0,0,"H","N","2015-11-23","201511230NYR"
"CAR",0,0,0,2,0,2,1,0,2,0,0,3,"A","N","2015-11-23","201511230PHI"
"PHI",1,0,2,0,0,3,0,0,0,2,0,2,"H","N","2015-11-23","201511230PHI"
"BOS",0,2,1,0,1,4,0,0,3,0,0,3,"A","Y","2015-11-23","201511230TOR"
"TOR",0,0,3,0,0,3,0,2,1,0,1,4,"H","Y","2015-11-23","201511230TOR"
"COL",0,0,1,3,0,4,0,1,0,0,0,1,"A","N","2015-11-23","201511230WPG"
"WPG",0,1,0,0,0,1,0,0,1,3,0,4,"H","N","2015-11-23","201511230WPG"
"EDM",0,0,0,0,0,0,0,0,0,1,0,1,"A","N","2015-11-23","201511230WSH"
"WSH",0,0,0,1,0,1,0,0,0,0,0,0,"H","N","2015-11-23","201511230WSH"
"ANA",0,2,0,3,0,5,0,2,1,0,0,3,"H","N","2015-11-24","201511240ANA"
"CGY",0,2,1,0,0,3,0,2,0,3,0,5,"A","N","2015-11-24","201511240ANA"
"DAL",0,0,1,3,0,4,0,2,2,3,0,7,"H","N","2015-11-24","201511240DAL"
"OTT",0,2,2,3,0,7,0,0,1,3,0,4,"A","N","2015-11-24","201511240DAL"
"ANA",0,0,0,2,0,2,0,1,1,2,0,4,"A","N","2015-11-25","201511250ARI"
"ARI",0,1,1,2,0,4,0,0,0,2,0,2,"H","N","2015-11-25","201511250ARI"
"BUF",0,0,1,1,0,2,0,1,2,0,0,3,"H","N","2015-11-25","201511250BUF"
"NSH",0,1,2,0,0,3,0,0,1,1,0,2,"A","N","2015-11-25","201511250BUF"
"CAR",0,1,2,1,0,4,0,1,0,0,0,1,"H","N","2015-11-25","201511250CAR"
"EDM",0,1,0,0,0,1,0,1,2,1,0,4,"A","N","2015-11-25","201511250CAR"
"COL",0,1,0,2,0,3,0,2,2,1,0,5,"H","N","2015-11-25","201511250COL"
"OTT",0,2,2,1,0,5,0,1,0,2,0,3,"A","N","2015-11-25","201511250COL"
"BOS",1,1,0,1,0,3,0,0,2,0,0,2,"A","N","2015-11-25","201511250DET"
"DET",0,0,2,0,0,2,1,1,0,1,0,3,"H","N","2015-11-25","201511250DET"
"MIN",0,1,0,1,0,2,0,1,1,1,0,3,"H","N","2015-11-25","201511250MIN"
"VAN",0,1,1,1,0,3,0,1,0,1,0,2,"A","N","2015-11-25","201511250MIN"
"CBJ",0,1,1,0,0,2,0,0,1,0,0,1,"A","N","2015-11-25","201511250NJD"
"NJD",0,0,1,0,0,1,0,1,1,0,0,2,"H","N","2015-11-25","201511250NJD"
"NYI",0,1,1,1,0,3,0,1,0,0,0,1,"H","N","2015-11-25","201511250NYI"
"PHI",0,1,0,0,0,1,0,1,1,1,0,3,"A","N","2015-11-25","201511250NYI"
"MTL",0,1,1,3,0,5,0,0,1,0,0,1,"A","N","2015-11-25","201511250NYR"
"NYR",0,0,1,0,0,1,0,1,1,3,0,5,"H","N","2015-11-25","201511250NYR"
"PIT",1,1,1,1,0,4,0,1,0,2,0,3,"H","N","2015-11-25","201511250PIT"
"STL",0,1,0,2,0,3,1,1,1,1,0,4,"A","N","2015-11-25","201511250PIT"
"CHI",0,2,1,2,0,5,0,1,0,1,0,2,"A","N","2015-11-25","201511250SJS"
"SJS",0,1,0,1,0,2,0,2,1,2,0,5,"H","N","2015-11-25","201511250SJS"
"LAK",0,0,0,1,0,1,0,0,0,1,1,2,"A","Y","2015-11-25","201511250TBL"
"TBL",0,0,0,1,1,2,0,0,0,1,0,1,"H","Y","2015-11-25","201511250TBL"
"WPG",0,2,1,0,0,3,0,2,2,1,0,5,"A","N","2015-11-25","201511250WSH"
"WSH",0,2,2,1,0,5,0,2,1,0,0,3,"H","N","2015-11-25","201511250WSH"
"ANA",0,1,1,0,0,2,1,0,0,2,0,3,"H","N","2015-11-27","201511270ANA"
"CHI",1,0,0,2,0,3,0,1,1,0,0,2,"A","N","2015-11-27","201511270ANA"
"ARI",1,0,1,0,0,2,0,0,1,0,0,1,"H","N","2015-11-27","201511270ARI"
"CGY",0,0,1,0,0,1,1,0,1,0,0,2,"A","N","2015-11-27","201511270ARI"
"BOS",0,1,1,2,0,4,0,0,2,1,0,3,"H","N","2015-11-27","201511270BOS"
"NYR",0,0,2,1,0,3,0,1,1,2,0,4,"A","N","2015-11-27","201511270BOS"
"BUF",0,1,2,1,0,4,0,0,1,0,0,1,"H","N","2015-11-27","201511270BUF"
"CAR",0,0,1,0,0,1,0,1,2,1,0,4,"A","N","2015-11-27","201511270BUF"
"CBJ",1,0,0,1,0,2,0,0,0,1,0,1,"H","N","2015-11-27","201511270CBJ"
"PIT",0,0,0,1,0,1,1,0,0,1,0,2,"A","N","2015-11-27","201511270CBJ"
"DAL",0,1,1,0,1,3,0,0,1,1,0,2,"H","Y","2015-11-27","201511270DAL"
"VAN",0,0,1,1,0,2,0,1,1,0,1,3,"A","Y","2015-11-27","201511270DAL"
"DET",1,0,3,0,0,4,0,0,2,1,0,3,"H","N","2015-11-27","201511270DET"
"EDM",0,0,2,1,0,3,1,0,3,0,0,4,"A","N","2015-11-27","201511270DET"
"FLA",0,1,1,0,1,3,0,0,0,2,0,2,"H","Y","2015-11-27","201511270FLA"
"NYI",0,0,0,2,0,2,0,1,1,0,1,3,"A","Y","2015-11-27","201511270FLA"
"MIN",0,0,0,1,0,1,0,0,1,2,0,3,"H","N","2015-11-27","201511270MIN"
"WPG",0,0,1,2,0,3,0,0,0,1,0,1,"A","N","2015-11-27","201511270MIN"
"MTL",0,0,1,1,1,3,0,0,2,0,0,2,"A","Y","2015-11-27","201511270NJD"
"NJD",0,0,2,0,0,2,0,0,1,1,1,3,"H","Y","2015-11-27","201511270NJD"
"NSH",0,1,0,1,0,2,1,1,0,1,0,3,"A","N","2015-11-27","201511270PHI"
"PHI",1,1,0,1,0,3,0,1,0,1,0,2,"H","N","2015-11-27","201511270PHI"
"TBL",0,0,0,2,0,2,0,1,2,1,0,4,"A","N","2015-11-27","201511270WSH"
"WSH",0,1,2,1,0,4,0,0,0,2,0,2,"H","N","2015-11-27","201511270WSH"
"ARI",0,1,2,1,0,4,0,1,1,1,0,3,"H","N","2015-11-28","201511280ARI"
"OTT",0,1,1,1,0,3,0,1,2,1,0,4,"A","N","2015-11-28","201511280ARI"
"COL",0,2,1,2,0,5,0,0,2,1,0,3,"H","N","2015-11-28","201511280COL"
"WPG",0,0,2,1,0,3,0,2,1,2,0,5,"A","N","2015-11-28","201511280COL"
"CHI",0,1,1,0,0,2,1,0,0,2,0,3,"A","N","2015-11-28","201511280LAK"
"LAK",1,0,0,2,0,3,0,1,1,0,0,2,"H","N","2015-11-28","201511280LAK"
"DAL",1,0,0,3,0,4,0,2,1,0,0,3,"A","N","2015-11-28","201511280MIN"
"MIN",0,2,1,0,0,3,1,0,0,3,0,4,"H","N","2015-11-28","201511280MIN"
"MTL",0,0,1,1,0,2,1,0,0,2,0,3,"H","N","2015-11-28","201511280MTL"
"NJD",1,0,0,2,0,3,0,0,1,1,0,2,"A","N","2015-11-28","201511280MTL"
"BUF",0,0,2,2,0,4,0,1,0,0,0,1,"A","N","2015-11-28","201511280NSH"
"NSH",0,1,0,0,0,1,0,0,2,2,0,4,"H","N","2015-11-28","201511280NSH"
"NYR",0,0,0,0,0,0,0,0,1,2,0,3,"H","N","2015-11-28","201511280NYR"
"PHI",0,0,1,2,0,3,0,0,0,0,0,0,"A","N","2015-11-28","201511280NYR"
"EDM",0,2,0,0,1,3,0,0,2,0,0,2,"A","Y","2015-11-28","201511280PIT"
"PIT",0,0,2,0,0,2,0,2,0,0,1,3,"H","Y","2015-11-28","201511280PIT"
"CGY",0,0,0,2,0,2,0,2,2,1,0,5,"A","N","2015-11-28","201511280SJS"
"SJS",0,2,2,1,0,5,0,0,0,2,0,2,"H","N","2015-11-28","201511280SJS"
"CBJ",0,1,0,0,0,1,0,0,1,2,0,3,"A","N","2015-11-28","201511280STL"
"STL",0,0,1,2,0,3,0,1,0,0,0,1,"H","N","2015-11-28","201511280STL"
"NYI",0,0,2,1,0,3,0,1,1,0,0,2,"A","N","2015-11-28","201511280TBL"
"TBL",0,1,1,0,0,2,0,0,2,1,0,3,"H","N","2015-11-28","201511280TBL"
"TOR",0,1,1,0,0,2,0,1,3,0,0,4,"H","N","2015-11-28","201511280TOR"
"WSH",0,1,3,0,0,4,0,1,1,0,0,2,"A","N","2015-11-28","201511280TOR"
"DET",0,0,1,0,0,1,1,0,0,1,0,2,"H","N","2015-11-29","201511290DET"
"FLA",1,0,0,1,0,2,0,0,1,0,0,1,"A","N","2015-11-29","201511290DET"
"ANA",0,2,0,2,0,4,0,0,0,0,0,0,"H","N","2015-11-30","201511300ANA"
"VAN",0,0,0,0,0,0,0,2,0,2,0,4,"A","N","2015-11-30","201511300ANA"
"COL",0,1,1,1,0,3,0,1,1,3,0,5,"A","N","2015-11-30","201511300NYI"
"NYI",0,1,1,3,0,5,0,1,1,1,0,3,"H","N","2015-11-30","201511300NYI"
"CAR",0,0,2,1,0,3,0,2,2,0,0,4,"A","N","2015-11-30","201511300NYR"
"NYR",0,2,2,0,0,4,0,0,2,1,0,3,"H","N","2015-11-30","201511300NYR"
"EDM",0,0,0,0,0,0,0,1,0,2,0,3,"A","N","2015-11-30","201511300TOR"
"TOR",0,1,0,2,0,3,0,0,0,0,0,0,"H","N","2015-11-30","201511300TOR"
"CGY",0,0,0,3,1,4,0,2,1,0,0,3,"H","Y","2015-12-01","201512010CGY"
"DAL",0,2,1,0,0,3,0,0,0,3,1,4,"A","Y","2015-12-01","201512010CGY"
"CHI",0,0,1,0,0,1,0,1,0,1,0,2,"H","N","2015-12-01","201512010CHI"
"MIN",0,1,0,1,0,2,0,0,1,0,0,1,"A","N","2015-12-01","201512010CHI"
"BUF",0,1,1,2,0,4,0,2,1,1,1,5,"A","Y","2015-12-01","201512010DET"
"DET",0,2,1,1,1,5,0,1,1,2,0,4,"H","Y","2015-12-01","201512010DET"
"LAK",1,0,0,1,0,2,0,1,0,0,0,1,"H","N","2015-12-01","201512010LAK"
"VAN",0,1,0,0,0,1,1,0,0,1,0,2,"A","N","2015-12-01","201512010LAK"
"CBJ",0,1,0,0,0,1,0,1,0,1,0,2,"A","N","2015-12-01","201512010MTL"
"MTL",0,1,0,1,0,2,0,1,0,0,0,1,"H","N","2015-12-01","201512010MTL"
"COL",0,0,2,0,0,2,0,0,0,1,0,1,"A","N","2015-12-01","201512010NJD"
"NJD",0,0,0,1,0,1,0,0,2,0,0,2,"H","N","2015-12-01","201512010NJD"
"ARI",0,1,1,0,0,2,0,0,1,4,0,5,"A","N","2015-12-01","201512010NSH"
"NSH",0,0,1,4,0,5,0,1,1,0,0,2,"H","N","2015-12-01","201512010NSH"
"OTT",0,1,1,0,0,2,0,1,2,1,0,4,"H","N","2015-12-01","201512010OTT"
"PHI",0,1,2,1,0,4,0,1,1,0,0,2,"A","N","2015-12-01","201512010OTT"
"PIT",0,1,2,2,0,5,0,0,1,0,0,1,"A","N","2015-12-01","201512010SJS"
"SJS",0,0,1,0,0,1,0,1,2,2,0,5,"H","N","2015-12-01","201512010SJS"
"FLA",0,0,3,0,0,3,0,0,1,0,0,1,"A","N","2015-12-01","201512010STL"
"STL",0,0,1,0,0,1,0,0,3,0,0,3,"H","N","2015-12-01","201512010STL"
"ANA",0,0,1,0,0,1,0,0,2,0,0,2,"H","N","2015-12-02","201512020ANA"
"TBL",0,0,2,0,0,2,0,0,1,0,0,1,"A","N","2015-12-02","201512020ANA"
"BOS",0,0,1,1,0,2,0,0,1,1,1,3,"A","Y","2015-12-02","201512020EDM"
"EDM",0,0,1,1,1,3,0,0,1,1,0,2,"H","Y","2015-12-02","201512020EDM"
"NYI",0,0,1,0,1,2,0,0,1,0,0,1,"H","Y","2015-12-02","201512020NYI"
"NYR",0,0,1,0,0,1,0,0,1,0,1,2,"A","Y","2015-12-02","201512020NYI"
"TOR",0,1,0,0,0,1,0,2,0,4,0,6,"A","N","2015-12-02","201512020WPG"
"WPG",0,2,0,4,0,6,0,1,0,0,0,1,"H","N","2015-12-02","201512020WPG"
"CAR",0,0,1,0,0,1,0,1,3,1,0,5,"H","N","2015-12-03","201512030CAR"
"NJD",0,1,3,1,0,5,0,0,1,0,0,1,"A","N","2015-12-03","201512030CAR"
"ARI",0,0,1,0,0,1,0,3,1,1,0,5,"A","N","2015-12-03","201512030DET"
"DET",0,3,1,1,0,5,0,0,1,0,0,1,"H","N","2015-12-03","201512030DET"
"MIN",0,0,1,0,0,1,0,0,0,0,0,0,"H","N","2015-12-03","201512030MIN"
"TOR",0,0,0,0,0,0,0,0,1,0,0,1,"A","N","2015-12-03","201512030MIN"
"MTL",0,0,1,1,0,2,0,1,1,1,0,3,"H","N","2015-12-03","201512030MTL"
"WSH",0,1,1,1,0,3,0,0,1,1,0,2,"A","N","2015-12-03","201512030MTL"
"FLA",0,1,1,0,0,2,0,0,1,0,0,1,"A","N","2015-12-03","201512030NSH"
"NSH",0,0,1,0,0,1,0,1,1,0,0,2,"H","N","2015-12-03","201512030NSH"
"COL",0,0,2,0,0,2,0,0,0,1,0,1,"A","N","2015-12-03","201512030NYR"
"NYR",0,0,0,1,0,1,0,0,2,0,0,2,"H","N","2015-12-03","201512030NYR"
"CHI",0,0,2,1,0,3,1,2,0,1,0,4,"A","N","2015-12-03","201512030OTT"
"OTT",1,2,0,1,0,4,0,0,2,1,0,3,"H","N","2015-12-03","201512030OTT"
"DAL",0,1,1,2,0,4,0,1,0,1,0,2,"A","N","2015-12-03","201512030VAN"
"VAN",0,1,0,1,0,2,0,1,1,2,0,4,"H","N","2015-12-03","201512030VAN"
"ANA",0,0,0,1,0,1,0,0,0,0,0,0,"H","N","2015-12-04","201512040ANA"
"SJS",0,0,0,0,0,0,0,0,0,1,0,1,"A","N","2015-12-04","201512040ANA"
"ARI",0,1,0,1,0,2,0,0,2,3,0,5,"A","N","2015-12-04","201512040BUF"
"BUF",0,0,2,3,0,5,0,1,0,1,0,2,"H","N","2015-12-04","201512040BUF"
"CBJ",0,0,1,0,0,1,0,0,1,0,1,2,"H","Y","2015-12-04","201512040CBJ"
"FLA",0,0,1,0,1,2,0,0,1,0,0,1,"A","Y","2015-12-04","201512040CBJ"
"BOS",0,1,2,1,0,4,1,2,1,1,0,5,"A","N","2015-12-04","201512040CGY"
"CGY",1,2,1,1,0,5,0,1,2,1,0,4,"H","N","2015-12-04","201512040CGY"
"DAL",0,0,1,0,0,1,1,1,0,0,0,2,"A","N","2015-12-04","201512040EDM"
"EDM",1,1,0,0,0,2,0,0,1,0,0,1,"H","N","2015-12-04","201512040EDM"
"NJD",0,1,0,2,0,3,1,1,1,1,0,4,"H","N","2015-12-04","201512040NJD"
"PHI",1,1,1,1,0,4,0,1,0,2,0,3,"A","N","2015-12-04","201512040NJD"
"NYI",0,0,0,1,1,2,0,1,0,0,0,1,"H","Y","2015-12-04","201512040NYI"
"STL",0,1,0,0,0,1,0,0,0,1,1,2,"A","Y","2015-12-04","201512040NYI"
"CAR",0,1,1,1,0,3,0,1,1,0,0,2,"H","N","2015-12-05","201512050CAR"
"MTL",0,1,1,0,0,2,0,1,1,1,0,3,"A","N","2015-12-05","201512050CAR"
"DET",1,1,1,2,0,5,0,0,3,1,0,4,"H","N","2015-12-05","201512050DET"
"NSH",0,0,3,1,0,4,1,1,1,2,0,5,"A","N","2015-12-05","201512050DET"
"LAK",0,0,4,1,0,5,0,0,2,1,0,3,"H","N","2015-12-05","201512050LAK"
"PIT",0,0,2,1,0,3,0,0,4,1,0,5,"A","N","2015-12-05","201512050LAK"
"COL",0,0,0,0,0,0,0,0,1,2,0,3,"A","N","2015-12-05","201512050MIN"
"MIN",0,0,1,2,0,3,0,0,0,0,0,0,"H","N","2015-12-05","201512050MIN"
"NYI",0,1,0,1,0,2,1,0,0,2,0,3,"A","N","2015-12-05","201512050OTT"
"OTT",1,0,0,2,0,3,0,1,0,1,0,2,"H","N","2015-12-05","201512050OTT"
"CBJ",0,2,2,0,0,4,0,0,1,0,0,1,"A","N","2015-12-05","201512050PHI"
"PHI",0,0,1,0,0,1,0,2,2,0,0,4,"H","N","2015-12-05","201512050PHI"
"SJS",0,0,1,2,0,3,0,2,1,1,0,4,"H","N","2015-12-05","201512050SJS"
"TBL",0,2,1,1,0,4,0,0,1,2,0,3,"A","N","2015-12-05","201512050SJS"
"STL",0,1,0,0,0,1,0,1,2,1,0,4,"H","N","2015-12-05","201512050STL"
"TOR",0,1,2,1,0,4,0,1,0,0,0,1,"A","N","2015-12-05","201512050STL"
"BOS",0,2,1,1,0,4,0,0,0,0,0,0,"A","N","2015-12-05","201512050VAN"
"VAN",0,0,0,0,0,0,0,2,1,1,0,4,"H","N","2015-12-05","201512050VAN"
"WPG",1,1,0,0,0,2,0,0,1,0,0,1,"H","N","2015-12-05","201512050WPG"
"WSH",0,0,1,0,0,1,1,1,0,0,0,2,"A","N","2015-12-05","201512050WPG"
"ANA",0,0,2,0,0,2,0,1,0,0,0,1,"H","N","2015-12-06","201512060ANA"
"PIT",0,1,0,0,0,1,0,0,2,0,0,2,"A","N","2015-12-06","201512060ANA"
"ARI",0,2,0,2,0,4,0,2,1,2,0,5,"A","N","2015-12-06","201512060CAR"
"CAR",0,2,1,2,0,5,0,2,0,2,0,4,"H","N","2015-12-06","201512060CAR"
"CHI",0,1,0,2,0,3,0,0,1,0,0,1,"H","N","2015-12-06","201512060CHI"
"WPG",0,0,1,0,0,1,0,1,0,2,0,3,"A","N","2015-12-06","201512060CHI"
"BUF",0,1,1,0,0,2,0,3,1,0,0,4,"A","N","2015-12-06","201512060EDM"
"EDM",0,3,1,0,0,4,0,1,1,0,0,2,"H","N","2015-12-06","201512060EDM"
"LAK",0,1,2,0,0,3,0,0,1,0,0,1,"H","N","2015-12-06","201512060LAK"
"TBL",0,0,1,0,0,1,0,1,2,0,0,3,"A","N","2015-12-06","201512060LAK"
"FLA",0,0,2,0,0,2,0,2,1,1,0,4,"A","N","2015-12-06","201512060NJD"
"NJD",0,2,1,1,0,4,0,0,2,0,0,2,"H","N","2015-12-06","201512060NJD"
"NYR",0,2,0,2,0,4,0,0,1,0,0,1,"H","N","2015-12-06","201512060NYR"
"OTT",0,0,1,0,0,1,0,2,0,2,0,4,"A","N","2015-12-06","201512060NYR"
"BOS",0,1,1,0,0,2,0,1,1,1,0,3,"H","N","2015-12-07","201512070BOS"
"NSH",0,1,1,1,0,3,0,1,1,0,0,2,"A","N","2015-12-07","201512070BOS"
"COL",1,0,1,0,0,2,0,0,0,1,0,1,"H","N","2015-12-07","201512070COL"
"MIN",0,0,0,1,0,1,1,0,1,0,0,2,"A","N","2015-12-07","201512070COL"
"BUF",0,1,0,1,0,2,0,2,2,1,0,5,"A","N","2015-12-07","201512070VAN"
"VAN",0,2,2,1,0,5,0,1,0,1,0,2,"H","N","2015-12-07","201512070VAN"
"CBJ",0,0,2,0,0,2,1,0,1,1,0,3,"H","N","2015-12-08","201512080CBJ"
"LAK",1,0,1,1,0,3,0,0,2,0,0,2,"A","N","2015-12-08","201512080CBJ"
"CGY",0,2,2,0,0,4,0,2,0,0,0,2,"H","N","2015-12-08","201512080CGY"
"SJS",0,2,0,0,0,2,0,2,2,0,0,4,"A","N","2015-12-08","201512080CGY"
"CHI",0,1,1,2,0,4,0,0,1,0,0,1,"H","N","2015-12-08","201512080CHI"
"NSH",0,0,1,0,0,1,0,1,1,2,0,4,"A","N","2015-12-08","201512080CHI"
"CAR",0,0,1,4,0,5,0,4,1,1,0,6,"A","N","2015-12-08","201512080DAL"
"DAL",0,4,1,1,0,6,0,0,1,4,0,5,"H","N","2015-12-08","201512080DAL"
"FLA",0,1,1,0,0,2,0,0,1,3,0,4,"H","N","2015-12-08","201512080FLA"
"OTT",0,0,1,3,0,4,0,1,1,0,0,2,"A","N","2015-12-08","201512080FLA"
"NYI",0,2,1,0,1,4,0,1,1,1,0,3,"A","Y","2015-12-08","201512080PHI"
"PHI",0,1,1,1,0,3,0,2,1,0,1,4,"H","Y","2015-12-08","201512080PHI"
"ARI",0,1,0,0,0,1,0,0,2,2,0,4,"A","N","2015-12-08","201512080STL"
"STL",0,0,2,2,0,4,0,1,0,0,0,1,"H","N","2015-12-08","201512080STL"
"NJD",0,1,1,0,0,2,0,1,1,0,1,3,"A","Y","2015-12-08","201512080TOR"
"TOR",0,1,1,0,1,3,0,1,1,0,0,2,"H","Y","2015-12-08","201512080TOR"
"DET",0,1,1,0,0,2,0,1,0,1,1,3,"A","Y","2015-12-08","201512080WSH"
"WSH",0,1,0,1,1,3,0,1,1,0,0,2,"H","Y","2015-12-08","201512080WSH"
"COL",0,2,0,0,0,2,0,1,0,3,0,4,"H","N","2015-12-09","201512090COL"
"PIT",0,1,0,3,0,4,0,2,0,0,0,2,"A","N","2015-12-09","201512090COL"
"EDM",1,0,1,2,0,4,0,0,0,3,0,3,"H","N","2015-12-09","201512090EDM"
"SJS",0,0,0,3,0,3,1,0,1,2,0,4,"A","N","2015-12-09","201512090EDM"
"BOS",0,0,0,3,0,3,0,1,0,0,0,1,"A","N","2015-12-09","201512090MTL"
"MTL",0,1,0,0,0,1,0,0,0,3,0,3,"H","N","2015-12-09","201512090MTL"
"NYR",0,0,0,1,0,1,0,0,0,2,0,2,"A","N","2015-12-09","201512090VAN"
"VAN",0,0,0,2,0,2,0,0,0,1,0,1,"H","N","2015-12-09","201512090VAN"
"BUF",0,0,0,3,0,3,0,0,2,2,0,4,"A","N","2015-12-10","201512100CGY"
"CGY",0,0,2,2,0,4,0,0,0,3,0,3,"H","N","2015-12-10","201512100CGY"
"DET",0,0,1,2,0,3,0,0,1,1,0,2,"H","N","2015-12-10","201512100DET"
"MTL",0,0,1,1,0,2,0,0,1,2,0,3,"A","N","2015-12-10","201512100DET"
"FLA",0,1,1,2,0,4,0,0,0,1,0,1,"H","N","2015-12-10","201512100FLA"
"WSH",0,0,0,1,0,1,0,1,1,2,0,4,"A","N","2015-12-10","201512100FLA"
"CHI",0,0,0,1,0,1,0,3,0,2,0,5,"A","N","2015-12-10","201512100NSH"
"NSH",0,3,0,2,0,5,0,0,0,1,0,1,"H","N","2015-12-10","201512100NSH"
"PHI",0,0,3,1,0,4,0,0,1,1,0,2,"A","N","2015-12-10","201512100STL"
"STL",0,0,1,1,0,2,0,0,3,1,0,4,"H","N","2015-12-10","201512100STL"
"OTT",0,0,0,1,0,1,0,1,0,3,0,4,"A","N","2015-12-10","201512100TBL"
"TBL",0,1,0,3,0,4,0,0,0,1,0,1,"H","N","2015-12-10","201512100TBL"
"CBJ",0,1,1,2,0,4,0,3,0,3,0,6,"A","N","2015-12-10","201512100WPG"
"WPG",0,3,0,3,0,6,0,1,1,2,0,4,"H","N","2015-12-10","201512100WPG"
"ANA",0,0,0,1,0,1,0,1,2,2,0,5,"H","N","2015-12-11","201512110ANA"
"CAR",0,1,2,2,0,5,0,0,0,1,0,1,"A","N","2015-12-11","201512110ANA"
"ARI",1,0,1,0,0,2,0,0,1,0,0,1,"H","N","2015-12-11","201512110ARI"
"MIN",0,0,1,0,0,1,1,0,1,0,0,2,"A","N","2015-12-11","201512110ARI"
"CHI",0,1,1,0,0,2,0,0,0,0,0,0,"H","N","2015-12-11","201512110CHI"
"WPG",0,0,0,0,0,0,0,1,1,0,0,2,"A","N","2015-12-11","201512110CHI"
"DAL",0,0,2,1,0,3,0,0,1,0,0,1,"H","N","2015-12-11","201512110DAL"
"PHI",0,0,1,0,0,1,0,0,2,1,0,3,"A","N","2015-12-11","201512110DAL"
"EDM",0,3,0,4,0,7,0,1,2,2,0,5,"H","N","2015-12-11","201512110EDM"
"NYR",0,1,2,2,0,5,0,3,0,4,0,7,"A","N","2015-12-11","201512110EDM"
"DET",0,0,2,0,0,2,1,0,0,2,0,3,"A","N","2015-12-11","201512110NJD"
"NJD",1,0,0,2,0,3,0,0,2,0,0,2,"H","N","2015-12-11","201512110NJD"
"LAK",0,1,0,1,1,3,0,0,1,1,0,2,"A","Y","2015-12-11","201512110PIT"
"PIT",0,0,1,1,0,2,0,1,0,1,1,3,"H","Y","2015-12-11","201512110PIT"
"ARI",0,0,1,3,0,4,1,2,1,1,0,5,"H","N","2015-12-12","201512120ARI"
"CAR",1,2,1,1,0,5,0,0,1,3,0,4,"A","N","2015-12-12","201512120ARI"
"BOS",0,1,1,1,0,3,0,0,0,1,0,1,"H","N","2015-12-12","201512120BOS"
"FLA",0,0,0,1,0,1,0,1,1,1,0,3,"A","N","2015-12-12","201512120BOS"
"BUF",1,1,0,0,0,2,0,1,0,0,0,1,"H","N","2015-12-12","201512120BUF"
"LAK",0,1,0,0,0,1,1,1,0,0,0,2,"A","N","2015-12-12","201512120BUF"
"CBJ",0,0,1,1,0,2,1,1,1,0,0,3,"H","N","2015-12-12","201512120CBJ"
"NYI",1,1,1,0,0,3,0,0,1,1,0,2,"A","N","2015-12-12","201512120CBJ"
"CGY",1,0,2,2,0,5,0,1,0,3,0,4,"H","N","2015-12-12","201512120CGY"
"NYR",0,1,0,3,0,4,1,0,2,2,0,5,"A","N","2015-12-12","201512120CGY"
"MTL",0,2,1,0,0,3,0,0,1,0,0,1,"H","N","2015-12-12","201512120MTL"
"OTT",0,0,1,0,0,1,0,2,1,0,0,3,"A","N","2015-12-12","201512120MTL"
"COL",0,2,0,1,0,3,0,1,0,1,0,2,"A","N","2015-12-12","201512120NSH"
"NSH",0,1,0,1,0,2,0,2,0,1,0,3,"H","N","2015-12-12","201512120NSH"
"MIN",0,0,0,2,0,2,0,0,0,0,0,0,"A","N","2015-12-12","201512120SJS"
"SJS",0,0,0,0,0,0,0,0,0,2,0,2,"H","N","2015-12-12","201512120SJS"
"DAL",0,0,0,0,0,0,0,1,0,2,0,3,"A","N","2015-12-12","201512120STL"
"STL",0,1,0,2,0,3,0,0,0,0,0,0,"H","N","2015-12-12","201512120STL"
"TBL",0,0,0,1,0,1,0,1,1,0,0,2,"H","N","2015-12-12","201512120TBL"
"WSH",0,1,1,0,0,2,0,0,0,1,0,1,"A","N","2015-12-12","201512120TBL"
"CHI",0,1,0,3,0,4,0,0,0,0,0,0,"H","N","2015-12-13","201512130CHI"
"VAN",0,0,0,0,0,0,0,1,0,3,0,4,"A","N","2015-12-13","201512130CHI"
"NJD",0,0,0,0,0,0,0,2,2,0,0,4,"A","N","2015-12-13","201512130NYI"
"NYI",0,2,2,0,0,4,0,0,0,0,0,0,"H","N","2015-12-13","201512130NYI"
"COL",0,2,0,1,0,3,0,0,0,1,0,1,"A","N","2015-12-13","201512130STL"
"STL",0,0,0,1,0,1,0,2,0,1,0,3,"H","N","2015-12-13","201512130STL"
"BOS",0,0,1,1,0,2,1,2,0,0,0,3,"H","N","2015-12-14","201512140BOS"
"EDM",1,2,0,0,0,3,0,0,1,1,0,2,"A","N","2015-12-14","201512140BOS"
"CBJ",0,0,1,0,0,1,0,0,1,1,0,2,"H","N","2015-12-14","201512140CBJ"
"TBL",0,0,1,1,0,2,0,0,1,0,0,1,"A","N","2015-12-14","201512140CBJ"
"BUF",0,0,0,2,0,2,0,0,1,0,0,1,"A","N","2015-12-14","201512140DET"
"DET",0,0,1,0,0,1,0,0,0,2,0,2,"H","N","2015-12-14","201512140DET"
"LAK",0,1,1,1,0,3,0,0,4,1,0,5,"A","N","2015-12-14","201512140OTT"
"OTT",0,0,4,1,0,5,0,1,1,1,0,3,"H","N","2015-12-14","201512140OTT"
"PIT",0,1,0,0,0,1,0,2,0,2,0,4,"H","N","2015-12-14","201512140PIT"
"WSH",0,2,0,2,0,4,0,1,0,0,0,1,"A","N","2015-12-14","201512140PIT"
"BUF",0,0,0,0,0,0,0,0,1,1,0,2,"H","N","2015-12-15","201512150BUF"
"NJD",0,0,1,1,0,2,0,0,0,0,0,0,"A","N","2015-12-15","201512150BUF"
"CHI",0,0,0,0,0,0,0,1,1,1,0,3,"H","N","2015-12-15","201512150CHI"
"COL",0,1,1,1,0,3,0,0,0,0,0,0,"A","N","2015-12-15","201512150CHI"
"CBJ",0,0,1,0,0,1,0,1,3,1,0,5,"A","N","2015-12-15","201512150DAL"
"DAL",0,1,3,1,0,5,0,0,1,0,0,1,"H","N","2015-12-15","201512150DAL"
"MIN",0,2,4,0,0,6,0,0,1,1,0,2,"H","N","2015-12-15","201512150MIN"
"VAN",0,0,1,1,0,2,0,2,4,0,0,6,"A","N","2015-12-15","201512150MIN"
"MTL",0,0,1,0,0,1,0,1,2,0,0,3,"H","N","2015-12-15","201512150MTL"
"SJS",0,1,2,0,0,3,0,0,1,0,0,1,"A","N","2015-12-15","201512150MTL"
"CGY",1,0,1,0,0,2,0,1,0,0,0,1,"A","N","2015-12-15","201512150NSH"
"NSH",0,1,0,0,0,1,1,0,1,0,0,2,"H","N","2015-12-15","201512150NSH"
"FLA",0,0,3,2,0,5,0,0,1,0,0,1,"A","N","2015-12-15","201512150NYI"
"NYI",0,0,1,0,0,1,0,0,3,2,0,5,"H","N","2015-12-15","201512150NYI"
"EDM",0,0,2,0,0,2,0,1,2,1,0,4,"A","N","2015-12-15","201512150NYR"
"NYR",0,1,2,1,0,4,0,0,2,0,0,2,"H","N","2015-12-15","201512150NYR"
"CAR",0,1,1,1,0,3,1,0,3,0,0,4,"A","N","2015-12-15","201512150PHI"
"PHI",1,0,3,0,0,4,0,1,1,1,0,3,"H","N","2015-12-15","201512150PHI"
"TBL",1,1,1,2,0,5,0,2,1,1,0,4,"A","N","2015-12-15","201512150TOR"
"TOR",0,2,1,1,0,4,1,1,1,2,0,5,"H","N","2015-12-15","201512150TOR"
"STL",0,0,2,2,0,4,0,1,2,0,0,3,"A","N","2015-12-15","201512150WPG"
"WPG",0,1,2,0,0,3,0,0,2,2,0,4,"H","N","2015-12-15","201512150WPG"
"BOS",0,1,1,1,0,3,0,0,0,0,0,0,"H","N","2015-12-16","201512160BOS"
"PIT",0,0,0,0,0,0,0,1,1,1,0,3,"A","N","2015-12-16","201512160BOS"
"OTT",0,0,0,1,0,1,0,1,1,0,0,2,"A","N","2015-12-16","201512160WSH"
"WSH",0,1,1,0,0,2,0,0,0,1,0,1,"H","N","2015-12-16","201512160WSH"
"ARI",0,1,3,1,0,5,0,2,3,2,0,7,"H","N","2015-12-17","201512170ARI"
"CBJ",0,2,3,2,0,7,0,1,3,1,0,5,"A","N","2015-12-17","201512170ARI"
"ANA",0,0,0,0,0,0,0,0,2,1,0,3,"A","N","2015-12-17","201512170BUF"
"BUF",0,0,2,1,0,3,0,0,0,0,0,0,"H","N","2015-12-17","201512170BUF"
"CHI",0,1,1,2,0,4,0,0,0,0,0,0,"H","N","2015-12-17","201512170CHI"
"EDM",0,0,0,0,0,0,0,1,1,2,0,4,"A","N","2015-12-17","201512170CHI"
"COL",0,1,0,1,0,2,0,0,1,0,0,1,"H","N","2015-12-17","201512170COL"
"NYI",0,0,1,0,0,1,0,1,0,1,0,2,"A","N","2015-12-17","201512170COL"
"CGY",0,2,1,0,0,3,0,1,0,0,0,1,"A","N","2015-12-17","201512170DAL"
"DAL",0,1,0,0,0,1,0,2,1,0,0,3,"H","N","2015-12-17","201512170DAL"
"MIN",0,1,1,3,0,5,0,0,1,1,0,2,"H","N","2015-12-17","201512170MIN"
"NYR",0,0,1,1,0,2,0,1,1,3,0,5,"A","N","2015-12-17","201512170MIN"
"LAK",0,0,2,1,0,3,0,0,0,0,0,0,"A","N","2015-12-17","201512170MTL"
"MTL",0,0,0,0,0,0,0,0,2,1,0,3,"H","N","2015-12-17","201512170MTL"
"FLA",0,2,1,2,0,5,0,0,0,1,0,1,"A","N","2015-12-17","201512170NJD"
"NJD",0,0,0,1,0,1,0,2,1,2,0,5,"H","N","2015-12-17","201512170NJD"
"PHI",0,1,0,1,0,2,0,0,0,0,0,0,"H","N","2015-12-17","201512170PHI"
"VAN",0,0,0,0,0,0,0,1,0,1,0,2,"A","N","2015-12-17","201512170PHI"
"NSH",0,1,0,0,0,1,0,0,0,2,0,2,"A","N","2015-12-17","201512170STL"
"STL",0,0,0,2,0,2,0,1,0,0,0,1,"H","N","2015-12-17","201512170STL"
"SJS",1,2,0,2,0,5,0,1,2,1,0,4,"A","N","2015-12-17","201512170TOR"
"TOR",0,1,2,1,0,4,1,2,0,2,0,5,"H","N","2015-12-17","201512170TOR"
"CAR",0,0,0,0,0,0,0,0,0,2,0,2,"H","N","2015-12-18","201512180CAR"
"FLA",0,0,0,2,0,2,0,0,0,0,0,0,"A","N","2015-12-18","201512180CAR"
"DET",0,0,1,2,0,3,0,1,1,1,1,4,"H","Y","2015-12-18","201512180DET"
"VAN",0,1,1,1,1,4,0,0,1,2,0,3,"A","Y","2015-12-18","201512180DET"
"OTT",0,0,1,3,0,4,0,0,1,1,0,2,"H","N","2015-12-18","201512180OTT"
"SJS",0,0,1,1,0,2,0,0,1,3,0,4,"A","N","2015-12-18","201512180OTT"
"BOS",0,1,2,3,0,6,0,1,1,0,0,2,"A","N","2015-12-18","201512180PIT"
"PIT",0,1,1,0,0,2,0,1,2,3,0,6,"H","N","2015-12-18","201512180PIT"
"NYR",0,1,1,0,0,2,0,3,1,1,0,5,"A","N","2015-12-18","201512180WPG"
"WPG",0,3,1,1,0,5,0,1,1,0,0,2,"H","N","2015-12-18","201512180WPG"
"TBL",0,1,2,0,0,3,0,0,1,4,0,5,"A","N","2015-12-18","201512180WSH"
"WSH",0,0,1,4,0,5,0,1,2,0,0,3,"H","N","2015-12-18","201512180WSH"
"ARI",0,1,0,0,0,1,0,0,0,0,0,0,"H","N","2015-12-19","201512190ARI"
"NYI",0,0,0,0,0,0,0,1,0,0,0,1,"A","N","2015-12-19","201512190ARI"
"BUF",0,0,1,1,0,2,0,1,0,1,1,3,"H","Y","2015-12-19","201512190BUF"
"CHI",0,1,0,1,1,3,0,0,1,1,0,2,"A","Y","2015-12-19","201512190BUF"
"CBJ",0,1,1,0,1,3,0,0,0,2,0,2,"H","Y","2015-12-19","201512190CBJ"
"PHI",0,0,0,2,0,2,0,1,1,0,1,3,"A","Y","2015-12-19","201512190CBJ"
"COL",0,2,1,2,0,5,0,0,0,1,0,1,"H","N","2015-12-19","201512190COL"
"EDM",0,0,0,1,0,1,0,2,1,2,0,5,"A","N","2015-12-19","201512190COL"
"DAL",0,1,3,2,0,6,0,0,1,1,0,2,"H","N","2015-12-19","201512190DAL"
"MTL",0,0,1,1,0,2,0,1,3,2,0,6,"A","N","2015-12-19","201512190DAL"
"ANA",0,2,0,0,0,2,0,0,0,1,0,1,"A","N","2015-12-19","201512190NJD"
"NJD",0,0,0,1,0,1,0,2,0,0,0,2,"H","N","2015-12-19","201512190NJD"
"MIN",0,0,1,1,0,2,0,2,1,0,0,3,"A","N","2015-12-19","201512190NSH"
"NSH",0,2,1,0,0,3,0,0,1,1,0,2,"H","N","2015-12-19","201512190NSH"
"CAR",0,2,0,0,0,2,0,0,1,0,0,1,"A","N","2015-12-19","201512190PIT"
"PIT",0,0,1,0,0,1,0,2,0,0,0,2,"H","N","2015-12-19","201512190PIT"
"CGY",0,0,0,2,0,2,0,2,1,0,0,3,"A","N","2015-12-19","201512190STL"
"STL",0,2,1,0,0,3,0,0,0,2,0,2,"H","N","2015-12-19","201512190STL"
"LAK",0,0,0,0,0,0,0,1,0,4,0,5,"A","N","2015-12-19","201512190TOR"
"TOR",0,1,0,4,0,5,0,0,0,0,0,0,"H","N","2015-12-19","201512190TOR"
"BOS",0,1,0,0,1,2,0,0,1,0,0,1,"H","Y","2015-12-20","201512200BOS"
"NJD",0,0,1,0,0,1,0,1,0,0,1,2,"A","Y","2015-12-20","201512200BOS"
"CHI",1,2,0,1,0,4,0,2,1,0,0,3,"H","N","2015-12-20","201512200CHI"
"SJS",0,2,1,0,0,3,1,2,0,1,0,4,"A","N","2015-12-20","201512200CHI"
"CGY",0,0,1,1,0,2,0,0,3,1,0,4,"A","N","2015-12-20","201512200DET"
"DET",0,0,3,1,0,4,0,0,1,1,0,2,"H","N","2015-12-20","201512200DET"
"FLA",0,2,2,0,1,5,0,2,2,0,0,4,"H","Y","2015-12-20","201512200FLA"
"VAN",0,2,2,0,0,4,0,2,2,0,1,5,"A","Y","2015-12-20","201512200FLA"
"NYR",0,3,0,0,0,3,0,1,4,2,0,7,"H","N","2015-12-20","201512200NYR"
"WSH",0,1,4,2,0,7,0,3,0,0,0,3,"A","N","2015-12-20","201512200NYR"
"OTT",0,1,1,0,0,2,0,2,1,2,0,5,"A","N","2015-12-20","201512200TBL"
"TBL",0,2,1,2,0,5,0,1,1,0,0,2,"H","N","2015-12-20","201512200TBL"
"CAR",0,0,0,1,0,1,0,1,1,0,0,2,"H","N","2015-12-21","201512210CAR"
"WSH",0,1,1,0,0,2,0,0,0,1,0,1,"A","N","2015-12-21","201512210CAR"
"COL",0,1,2,1,0,4,0,2,1,4,0,7,"H","N","2015-12-21","201512210COL"
"TOR",0,2,1,4,0,7,0,1,2,1,0,4,"A","N","2015-12-21","201512210COL"
"EDM",0,2,1,0,0,3,0,0,1,0,0,1,"H","N","2015-12-21","201512210EDM"
"WPG",0,0,1,0,0,1,0,2,1,0,0,3,"A","N","2015-12-21","201512210EDM"
"DAL",0,0,3,3,0,6,0,2,0,1,0,3,"A","N","2015-12-21","201512210MIN"
"MIN",0,2,0,1,0,3,0,0,3,3,0,6,"H","N","2015-12-21","201512210MIN"
"MTL",0,0,0,1,0,1,0,1,1,3,0,5,"A","N","2015-12-21","201512210NSH"
"NSH",0,1,1,3,0,5,0,0,0,1,0,1,"H","N","2015-12-21","201512210NSH"
"ANA",0,1,0,1,0,2,0,3,0,2,0,5,"A","N","2015-12-21","201512210NYI"
"NYI",0,3,0,2,0,5,0,1,0,1,0,2,"H","N","2015-12-21","201512210NYI"
"PHI",0,0,2,2,0,4,0,2,1,0,0,3,"H","N","2015-12-21","201512210PHI"
"STL",0,2,1,0,0,3,0,0,2,2,0,4,"A","N","2015-12-21","201512210PHI"
"CBJ",0,1,0,1,0,2,0,0,4,1,0,5,"A","N","2015-12-21","201512210PIT"
"PIT",0,0,4,1,0,5,0,1,0,1,0,2,"H","N","2015-12-21","201512210PIT"
"ARI",0,2,0,1,0,3,0,1,1,0,0,2,"H","N","2015-12-22","201512220ARI"
"TOR",0,1,1,0,0,2,0,2,0,1,0,3,"A","N","2015-12-22","201512220ARI"
"BOS",0,0,0,0,0,0,0,0,0,2,0,2,"H","N","2015-12-22","201512220BOS"
"STL",0,0,0,2,0,2,0,0,0,0,0,0,"A","N","2015-12-22","201512220BOS"
"CGY",0,2,0,2,0,4,0,1,0,0,0,1,"H","N","2015-12-22","201512220CGY"
"WPG",0,1,0,0,0,1,0,2,0,2,0,4,"A","N","2015-12-22","201512220CGY"
"CHI",0,0,0,0,0,0,0,0,1,3,0,4,"A","N","2015-12-22","201512220DAL"
"DAL",0,0,1,3,0,4,0,0,0,0,0,0,"H","N","2015-12-22","201512220DAL"
"DET",0,1,1,1,0,3,0,3,0,1,0,4,"H","N","2015-12-22","201512220DET"
"NJD",0,3,0,1,0,4,0,1,1,1,0,3,"A","N","2015-12-22","201512220DET"
"FLA",0,0,1,0,1,2,0,0,0,1,0,1,"H","Y","2015-12-22","201512220FLA"
"OTT",0,0,0,1,0,1,0,0,1,0,1,2,"A","Y","2015-12-22","201512220FLA"
"LAK",0,2,1,0,0,3,0,1,1,3,0,5,"H","N","2015-12-22","201512220LAK"
"SJS",0,1,1,3,0,5,0,2,1,0,0,3,"A","N","2015-12-22","201512220LAK"
"MIN",0,1,0,1,0,2,0,0,0,1,0,1,"H","N","2015-12-22","201512220MIN"
"MTL",0,0,0,1,0,1,0,1,0,1,0,2,"A","N","2015-12-22","201512220MIN"
"ANA",0,1,0,1,0,2,1,1,0,1,0,3,"A","N","2015-12-22","201512220NYR"
"NYR",1,1,0,1,0,3,0,1,0,1,0,2,"H","N","2015-12-22","201512220NYR"
"TBL",0,0,1,0,0,1,0,1,0,1,0,2,"H","N","2015-12-22","201512220TBL"
"VAN",0,1,0,1,0,2,0,0,1,0,0,1,"A","N","2015-12-22","201512220TBL"
"ARI",0,1,0,2,0,3,1,0,0,3,0,4,"H","N","2015-12-26","201512260ARI"
"LAK",1,0,0,3,0,4,0,1,0,2,0,3,"A","N","2015-12-26","201512260ARI"
"BOS",0,0,2,1,0,3,0,0,1,5,0,6,"H","N","2015-12-26","201512260BOS"
"BUF",0,0,1,5,0,6,0,0,2,1,0,3,"A","N","2015-12-26","201512260BOS"
"CAR",0,0,1,2,0,3,0,0,0,1,0,1,"H","N","2015-12-26","201512260CAR"
"NJD",0,0,0,1,0,1,0,0,1,2,0,3,"A","N","2015-12-26","201512260CAR"
"MIN",0,0,1,0,0,1,0,0,3,0,0,3,"H","N","2015-12-26","201512260MIN"
"PIT",0,0,3,0,0,3,0,0,1,0,0,1,"A","N","2015-12-26","201512260MIN"
"DET",0,1,1,1,0,3,0,1,1,0,0,2,"A","N","2015-12-26","201512260NSH"
"NSH",0,1,1,0,0,2,0,1,1,1,0,3,"H","N","2015-12-26","201512260NSH"
"DAL",0,0,2,0,0,2,0,0,1,1,1,3,"A","Y","2015-12-26","201512260STL"
"STL",0,0,1,1,1,3,0,0,2,0,0,2,"H","Y","2015-12-26","201512260STL"
"CBJ",0,1,1,0,0,2,0,1,3,1,0,5,"A","N","2015-12-26","201512260TBL"
"TBL",0,1,3,1,0,5,0,1,1,0,0,2,"H","N","2015-12-26","201512260TBL"
"EDM",0,1,0,0,0,1,1,0,1,0,0,2,"A","N","2015-12-26","201512260VAN"
"VAN",1,0,1,0,0,2,0,1,0,0,0,1,"H","N","2015-12-26","201512260VAN"
"MTL",0,0,1,0,0,1,0,1,1,1,0,3,"A","N","2015-12-26","201512260WSH"
"WSH",0,1,1,1,0,3,0,0,1,0,0,1,"H","N","2015-12-26","201512260WSH"
"ANA",0,1,1,2,0,4,0,1,1,0,0,2,"H","N","2015-12-27","201512270ANA"
"PHI",0,1,1,0,0,2,0,1,1,2,0,4,"A","N","2015-12-27","201512270ANA"
"CGY",0,0,4,1,0,5,0,2,1,0,0,3,"H","N","2015-12-27","201512270CGY"
"EDM",0,2,1,0,0,3,0,0,4,1,0,5,"A","N","2015-12-27","201512270CGY"
"CAR",0,0,1,1,0,2,0,0,0,1,0,1,"A","N","2015-12-27","201512270CHI"
"CHI",0,0,0,1,0,1,0,0,1,1,0,2,"H","N","2015-12-27","201512270CHI"
"ARI",1,0,0,1,0,2,0,1,0,0,0,1,"A","N","2015-12-27","201512270COL"
"COL",0,1,0,0,0,1,1,0,0,1,0,2,"H","N","2015-12-27","201512270COL"
"DAL",0,1,0,2,0,3,0,0,0,0,0,0,"H","N","2015-12-27","201512270DAL"
"STL",0,0,0,0,0,0,0,1,0,2,0,3,"A","N","2015-12-27","201512270DAL"
"CBJ",0,0,1,1,0,2,0,2,0,1,0,3,"A","N","2015-12-27","201512270FLA"
"FLA",0,2,0,1,0,3,0,0,1,1,0,2,"H","N","2015-12-27","201512270FLA"
"NYI",0,0,0,1,0,1,0,0,2,1,0,3,"H","N","2015-12-27","201512270NYI"
"TOR",0,0,2,1,0,3,0,0,0,1,0,1,"A","N","2015-12-27","201512270NYI"
"BOS",0,0,1,0,0,1,0,1,1,1,0,3,"A","N","2015-12-27","201512270OTT"
"OTT",0,1,1,1,0,3,0,0,1,0,0,1,"H","N","2015-12-27","201512270OTT"
"PIT",0,0,0,0,0,0,0,1,0,0,0,1,"A","N","2015-12-27","201512270WPG"
"WPG",0,1,0,0,0,1,0,0,0,0,0,0,"H","N","2015-12-27","201512270WPG"
"BUF",0,0,0,0,0,0,0,0,2,0,0,2,"H","N","2015-12-28","201512280BUF"
"WSH",0,0,2,0,0,2,0,0,0,0,0,0,"A","N","2015-12-28","201512280BUF"
"DET",0,0,0,1,0,1,0,1,0,2,0,3,"A","N","2015-12-28","201512280MIN"
"MIN",0,1,0,2,0,3,0,0,0,1,0,1,"H","N","2015-12-28","201512280MIN"
"NSH",0,1,1,3,0,5,0,0,1,2,0,3,"H","N","2015-12-28","201512280NSH"
"NYR",0,0,1,2,0,3,0,1,1,3,0,5,"A","N","2015-12-28","201512280NSH"
"COL",0,2,1,3,0,6,0,1,1,1,0,3,"A","N","2015-12-28","201512280SJS"
"SJS",0,1,1,1,0,3,0,2,1,3,0,6,"H","N","2015-12-28","201512280SJS"
"MTL",0,1,1,1,1,4,0,0,1,2,0,3,"A","Y","2015-12-28","201512280TBL"
"TBL",0,0,1,2,0,3,0,1,1,1,1,4,"H","Y","2015-12-28","201512280TBL"
"LAK",0,1,2,2,0,5,0,0,0,0,0,0,"A","N","2015-12-28","201512280VAN"
"VAN",0,0,0,0,0,0,0,1,2,2,0,5,"H","N","2015-12-28","201512280VAN"
"ARI",0,2,0,3,0,5,0,3,2,2,0,7,"H","N","2015-12-29","201512290ARI"
"CHI",0,3,2,2,0,7,0,2,0,3,0,5,"A","N","2015-12-29","201512290ARI"
"BOS",0,2,1,4,0,7,0,1,1,1,0,3,"H","N","2015-12-29","201512290BOS"
"OTT",0,1,1,1,0,3,0,2,1,4,0,7,"A","N","2015-12-29","201512290BOS"
"CBJ",0,3,1,2,0,6,0,1,1,1,0,3,"H","N","2015-12-29","201512290CBJ"
"DAL",0,1,1,1,0,3,0,3,1,2,0,6,"A","N","2015-12-29","201512290CBJ"
"ANA",0,0,1,0,0,1,0,0,0,0,0,0,"A","N","2015-12-29","201512290CGY"
"CGY",0,0,0,0,0,0,0,0,1,0,0,1,"H","N","2015-12-29","201512290CGY"
"EDM",0,0,1,1,0,2,0,0,4,1,0,5,"H","N","2015-12-29","201512290EDM"
"LAK",0,0,4,1,0,5,0,0,1,1,0,2,"A","N","2015-12-29","201512290EDM"
"FLA",0,1,1,1,0,3,0,1,0,0,0,1,"H","N","2015-12-29","201512290FLA"
"MTL",0,1,0,0,0,1,0,1,1,1,0,3,"A","N","2015-12-29","201512290FLA"
"CAR",0,0,2,0,0,2,0,0,1,2,0,3,"A","N","2015-12-29","201512290NJD"
"NJD",0,0,1,2,0,3,0,0,2,0,0,2,"H","N","2015-12-29","201512290NJD"
"NSH",0,1,0,2,0,3,1,1,1,1,0,4,"A","N","2015-12-29","201512290STL"
"STL",1,1,1,1,0,4,0,1,0,2,0,3,"H","N","2015-12-29","201512290STL"
"NYI",0,3,3,0,0,6,0,1,1,1,0,3,"A","N","2015-12-29","201512290TOR"
"TOR",0,1,1,1,0,3,0,3,3,0,0,6,"H","N","2015-12-29","201512290TOR"
"DET",0,0,0,1,0,1,0,2,2,0,0,4,"A","N","2015-12-29","201512290WPG"
"WPG",0,2,2,0,0,4,0,0,0,1,0,1,"H","N","2015-12-29","201512290WPG"
"NJD",0,2,0,1,0,3,0,0,0,0,0,0,"A","N","2015-12-30","201512300OTT"
"OTT",0,0,0,0,0,0,0,2,0,1,0,3,"H","N","2015-12-30","201512300OTT"
"PIT",0,1,1,0,0,2,0,1,1,0,1,3,"H","Y","2015-12-30","201512300PIT"
"TOR",0,1,1,0,1,3,0,1,1,0,0,2,"A","Y","2015-12-30","201512300PIT"
"PHI",0,0,1,1,0,2,0,0,1,3,0,4,"A","N","2015-12-30","201512300SJS"
"SJS",0,0,1,3,0,4,0,0,1,1,0,2,"H","N","2015-12-30","201512300SJS"
"NYR",0,1,1,3,0,5,0,1,1,0,0,2,"A","N","2015-12-30","201512300TBL"
"TBL",0,1,1,0,0,2,0,1,1,3,0,5,"H","N","2015-12-30","201512300TBL"
"BUF",0,1,1,0,0,2,0,0,1,4,0,5,"A","N","2015-12-30","201512300WSH"
"WSH",0,0,1,4,0,5,0,1,1,0,0,2,"H","N","2015-12-30","201512300WSH"
"ARI",0,1,0,3,0,4,0,1,0,1,0,2,"H","N","2015-12-31","201512310ARI"
"WPG",0,1,0,1,0,2,0,1,0,3,0,4,"A","N","2015-12-31","201512310ARI"
"BUF",0,0,0,1,0,1,0,0,1,1,0,2,"H","N","2015-12-31","201512310BUF"
"NYI",0,0,1,1,0,2,0,0,0,1,0,1,"A","N","2015-12-31","201512310BUF"
"CAR",0,0,1,3,0,4,0,0,1,1,0,2,"H","N","2015-12-31","201512310CAR"
"WSH",0,0,1,1,0,2,0,0,1,3,0,4,"A","N","2015-12-31","201512310CAR"
"CGY",0,0,0,1,0,1,0,1,2,1,0,4,"H","N","2015-12-31","201512310CGY"
"LAK",0,1,2,1,0,4,0,0,0,1,0,1,"A","N","2015-12-31","201512310CGY"
"CHI",1,1,2,0,0,4,0,1,1,1,0,3,"A","N","2015-12-31","201512310COL"
"COL",0,1,1,1,0,3,1,1,2,0,0,4,"H","N","2015-12-31","201512310COL"
"DAL",0,0,2,3,0,5,0,0,1,0,0,1,"H","N","2015-12-31","201512310DAL"
"NSH",0,0,1,0,0,1,0,0,2,3,0,5,"A","N","2015-12-31","201512310DAL"
"DET",0,2,0,0,0,2,0,0,2,3,0,5,"H","N","2015-12-31","201512310DET"
"PIT",0,0,2,3,0,5,0,2,0,0,0,2,"A","N","2015-12-31","201512310DET"
"ANA",0,1,0,0,0,1,0,0,0,0,0,0,"A","N","2015-12-31","201512310EDM"
"EDM",0,0,0,0,0,0,0,1,0,0,0,1,"H","N","2015-12-31","201512310EDM"
"MIN",0,0,1,2,0,3,0,0,1,0,0,1,"A","N","2015-12-31","201512310STL"
"STL",0,0,1,0,0,1,0,0,1,2,0,3,"H","N","2015-12-31","201512310STL"
"BOS",0,0,0,1,0,1,0,1,2,2,0,5,"H","N","2016-01-01","201601010BOS"
"MTL",0,1,2,2,0,5,0,0,0,1,0,1,"A","N","2016-01-01","201601010BOS"
"ANA",0,0,1,0,0,1,0,0,0,1,1,2,"A","Y","2016-01-01","201601010VAN"
"VAN",0,0,0,1,1,2,0,0,1,0,0,1,"H","Y","2016-01-01","201601010VAN"
"BUF",0,0,2,1,0,3,0,1,1,2,0,4,"H","N","2016-01-02","201601020BUF"
"DET",0,1,1,2,0,4,0,0,2,1,0,3,"A","N","2016-01-02","201601020BUF"
"CAR",0,1,0,0,0,1,1,0,1,0,0,2,"H","N","2016-01-02","201601020CAR"
"NSH",1,0,1,0,0,2,0,1,0,0,0,1,"A","N","2016-01-02","201601020CAR"
"CBJ",0,2,0,2,1,5,0,2,1,1,0,4,"H","Y","2016-01-02","201601020CBJ"
"WSH",0,2,1,1,0,4,0,2,0,2,1,5,"A","Y","2016-01-02","201601020CBJ"
"CGY",0,1,3,0,0,4,0,0,0,0,0,0,"A","N","2016-01-02","201601020COL"
"COL",0,0,0,0,0,0,0,1,3,0,0,4,"H","N","2016-01-02","201601020COL"
"ARI",0,1,1,1,0,3,0,2,0,1,1,4,"A","Y","2016-01-02","201601020EDM"
"EDM",0,2,0,1,1,4,0,1,1,1,0,3,"H","Y","2016-01-02","201601020EDM"
"FLA",0,1,2,0,0,3,0,0,0,0,0,0,"H","N","2016-01-02","201601020FLA"
"NYR",0,0,0,0,0,0,0,1,2,0,0,3,"A","N","2016-01-02","201601020FLA"
"LAK",0,2,0,0,0,2,0,0,0,1,0,1,"H","N","2016-01-02","201601020LAK"
"PHI",0,0,0,1,0,1,0,2,0,0,0,2,"A","N","2016-01-02","201601020LAK"
"DAL",0,0,0,2,0,2,1,0,2,0,0,3,"A","N","2016-01-02","201601020NJD"
"NJD",1,0,2,0,0,3,0,0,0,2,0,2,"H","N","2016-01-02","201601020NJD"
"NYI",0,0,1,1,0,2,0,2,3,0,0,5,"A","N","2016-01-02","201601020PIT"
"PIT",0,2,3,0,0,5,0,0,1,1,0,2,"H","N","2016-01-02","201601020PIT"
"SJS",0,0,1,0,0,1,0,1,2,1,0,4,"H","N","2016-01-02","201601020SJS"
"WPG",0,1,2,1,0,4,0,0,1,0,0,1,"A","N","2016-01-02","201601020SJS"
"MIN",0,1,0,1,0,2,0,1,1,0,1,3,"A","Y","2016-01-02","201601020TBL"
"TBL",0,1,1,0,1,3,0,1,0,1,0,2,"H","Y","2016-01-02","201601020TBL"
"STL",0,0,1,0,0,1,0,0,1,3,0,4,"A","N","2016-01-02","201601020TOR"
"TOR",0,0,1,3,0,4,0,0,1,0,0,1,"H","N","2016-01-02","201601020TOR"
"ANA",0,2,2,0,0,4,0,0,1,0,0,1,"H","N","2016-01-03","201601030ANA"
"WPG",0,0,1,0,0,1,0,2,2,0,0,4,"A","N","2016-01-03","201601030ANA"
"CHI",0,0,1,2,0,3,0,0,0,0,0,0,"H","N","2016-01-03","201601030CHI"
"OTT",0,0,0,0,0,0,0,0,1,2,0,3,"A","N","2016-01-03","201601030CHI"
"FLA",0,1,0,1,0,2,0,0,1,0,0,1,"H","N","2016-01-03","201601030FLA"
"MIN",0,0,1,0,0,1,0,1,0,1,0,2,"A","N","2016-01-03","201601030FLA"
"DAL",0,2,0,3,0,5,0,2,3,1,0,6,"A","N","2016-01-03","201601030NYI"
"NYI",0,2,3,1,0,6,0,2,0,3,0,5,"H","N","2016-01-03","201601030NYI"
"COL",0,0,2,2,0,4,0,0,1,0,0,1,"H","N","2016-01-04","201601040COL"
"LAK",0,0,1,0,0,1,0,0,2,2,0,4,"A","N","2016-01-04","201601040COL"
"CAR",0,0,0,0,0,0,1,0,0,0,0,1,"A","N","2016-01-04","201601040EDM"
"EDM",1,0,0,0,0,1,0,0,0,0,0,0,"H","N","2016-01-04","201601040EDM"
"DET",0,1,0,0,0,1,0,0,0,0,0,0,"A","N","2016-01-04","201601040NJD"
"NJD",0,0,0,0,0,0,0,1,0,0,0,1,"H","N","2016-01-04","201601040NJD"
"OTT",1,0,1,1,0,3,0,1,1,0,0,2,"A","N","2016-01-04","201601040STL"
"STL",0,1,1,0,0,2,1,0,1,1,0,3,"H","N","2016-01-04","201601040STL"
"ARI",0,0,2,1,0,3,0,0,1,1,0,2,"A","N","2016-01-04","201601040VAN"
"VAN",0,0,1,1,0,2,0,0,2,1,0,3,"H","N","2016-01-04","201601040VAN"
"BOS",0,0,1,1,0,2,0,1,1,1,0,3,"H","N","2016-01-05","201601050BOS"
"WSH",0,1,1,1,0,3,0,0,1,1,0,2,"A","N","2016-01-05","201601050BOS"
"BUF",0,0,1,0,0,1,0,1,1,3,0,5,"H","N","2016-01-05","201601050BUF"
"FLA",0,1,1,3,0,5,0,0,1,0,0,1,"A","N","2016-01-05","201601050BUF"
"CBJ",0,0,1,1,0,2,0,1,1,2,0,4,"H","N","2016-01-05","201601050CBJ"
"MIN",0,1,1,2,0,4,0,0,1,1,0,2,"A","N","2016-01-05","201601050CBJ"
"CGY",0,1,1,1,0,3,0,0,0,1,0,1,"H","N","2016-01-05","201601050CGY"
"TBL",0,0,0,1,0,1,0,1,1,1,0,3,"A","N","2016-01-05","201601050CGY"
"NSH",0,0,0,1,0,1,0,1,1,2,0,4,"H","N","2016-01-05","201601050NSH"
"WPG",0,1,1,2,0,4,0,0,0,1,0,1,"A","N","2016-01-05","201601050NSH"
"DAL",0,1,0,1,0,2,0,2,1,3,0,6,"A","N","2016-01-05","201601050NYR"
"NYR",0,2,1,3,0,6,0,1,0,1,0,2,"H","N","2016-01-05","201601050NYR"
"MTL",0,1,1,1,0,3,0,1,2,1,0,4,"A","N","2016-01-05","201601050PHI"
"PHI",0,1,2,1,0,4,0,1,1,1,0,3,"H","N","2016-01-05","201601050PHI"
"CHI",1,0,2,0,0,3,0,0,0,2,0,2,"A","N","2016-01-05","201601050PIT"
"PIT",0,0,0,2,0,2,1,0,2,0,0,3,"H","N","2016-01-05","201601050PIT"
"ANA",0,0,0,0,0,0,0,1,2,1,0,4,"H","N","2016-01-06","201601060ANA"
"TOR",0,1,2,1,0,4,0,0,0,0,0,0,"A","N","2016-01-06","201601060ANA"
"CHI",0,1,0,2,0,3,0,0,1,0,0,1,"H","N","2016-01-06","201601060CHI"
"PIT",0,0,1,0,0,1,0,1,0,2,0,3,"A","N","2016-01-06","201601060CHI"
"COL",1,1,1,1,0,4,0,2,1,0,0,3,"H","N","2016-01-06","201601060COL"
"STL",0,2,1,0,0,3,1,1,1,1,0,4,"A","N","2016-01-06","201601060COL"
"MTL",0,1,1,0,0,2,0,0,0,1,0,1,"H","N","2016-01-06","201601060MTL"
"NJD",0,0,0,1,0,1,0,1,1,0,0,2,"A","N","2016-01-06","201601060MTL"
"CAR",0,0,1,1,0,2,0,0,1,2,0,3,"A","N","2016-01-06","201601060VAN"
"VAN",0,0,1,2,0,3,0,0,1,1,0,2,"H","N","2016-01-06","201601060VAN"
"ARI",0,1,0,1,0,2,0,1,0,0,0,1,"A","N","2016-01-07","201601070CGY"
"CGY",0,1,0,0,0,1,0,1,0,1,0,2,"H","N","2016-01-07","201601070CGY"
"DAL",0,1,0,0,1,2,0,0,1,0,0,1,"H","Y","2016-01-07","201601070DAL"
"WPG",0,0,1,0,0,1,0,1,0,0,1,2,"A","Y","2016-01-07","201601070DAL"
"LAK",0,0,0,2,0,2,0,0,0,1,0,1,"H","N","2016-01-07","201601070LAK"
"TOR",0,0,0,1,0,1,0,0,0,2,0,2,"A","N","2016-01-07","201601070LAK"
"MIN",0,1,1,1,0,3,1,1,2,0,0,4,"H","N","2016-01-07","201601070MIN"
"PHI",1,1,2,0,0,4,0,1,1,1,0,3,"A","N","2016-01-07","201601070MIN"
"NYI",0,0,1,0,0,1,0,2,1,1,0,4,"H","N","2016-01-07","201601070NYI"
"WSH",0,2,1,1,0,4,0,0,1,0,0,1,"A","N","2016-01-07","201601070NYI"
"FLA",0,2,0,1,0,3,0,0,1,1,0,2,"A","N","2016-01-07","201601070OTT"
"OTT",0,0,1,1,0,2,0,2,0,1,0,3,"H","N","2016-01-07","201601070OTT"
"DET",0,1,0,1,0,2,0,1,0,0,0,1,"A","N","2016-01-07","201601070SJS"
"SJS",0,1,0,0,0,1,0,1,0,1,0,2,"H","N","2016-01-07","201601070SJS"
"ANA",0,1,1,1,1,4,0,0,3,0,0,3,"H","Y","2016-01-08","201601080ANA"
"STL",0,0,3,0,0,3,0,1,1,1,1,4,"A","Y","2016-01-08","201601080ANA"
"CAR",0,1,1,2,0,4,0,0,1,0,0,1,"H","N","2016-01-08","201601080CAR"
"CBJ",0,0,1,0,0,1,0,1,1,2,0,4,"A","N","2016-01-08","201601080CAR"
"BUF",0,0,0,1,0,1,0,1,0,2,0,3,"A","N","2016-01-08","201601080CHI"
"CHI",0,1,0,2,0,3,0,0,0,1,0,1,"H","N","2016-01-08","201601080CHI"
"COL",0,2,1,2,0,5,0,1,2,0,0,3,"H","N","2016-01-08","201601080COL"
"NSH",0,1,2,0,0,3,0,2,1,2,0,5,"A","N","2016-01-08","201601080COL"
"EDM",0,1,1,0,0,2,0,0,0,3,0,3,"H","N","2016-01-08","201601080EDM"
"TBL",0,0,0,3,0,3,0,1,1,0,0,2,"A","N","2016-01-08","201601080EDM"
"BOS",0,1,2,1,0,4,0,0,1,0,0,1,"A","N","2016-01-08","201601080NJD"
"NJD",0,0,1,0,0,1,0,1,2,1,0,4,"H","N","2016-01-08","201601080NJD"
"ARI",0,0,1,3,0,4,0,0,0,0,0,0,"H","N","2016-01-09","201601090ARI"
"NSH",0,0,0,0,0,0,0,0,1,3,0,4,"A","N","2016-01-09","201601090ARI"
"CAR",1,1,2,0,0,4,0,0,1,2,0,3,"A","N","2016-01-09","201601090CBJ"
"CBJ",0,0,1,2,0,3,1,1,2,0,0,4,"H","N","2016-01-09","201601090CBJ"
"DAL",0,0,0,1,0,1,0,0,2,0,0,2,"H","N","2016-01-09","201601090DAL"
"MIN",0,0,2,0,0,2,0,0,0,1,0,1,"A","N","2016-01-09","201601090DAL"
"LAK",0,0,1,0,0,1,0,0,1,0,1,2,"H","Y","2016-01-09","201601090LAK"
"STL",0,0,1,0,1,2,0,0,1,0,0,1,"A","Y","2016-01-09","201601090LAK"
"MTL",0,0,1,0,0,1,0,0,2,1,0,3,"H","N","2016-01-09","201601090MTL"
"PIT",0,0,2,1,0,3,0,0,1,0,0,1,"A","N","2016-01-09","201601090MTL"
"NYR",0,0,0,3,0,3,1,1,1,1,0,4,"H","N","2016-01-09","201601090NYR"
"WSH",1,1,1,1,0,4,0,0,0,3,0,3,"A","N","2016-01-09","201601090NYR"
"BOS",0,0,1,0,0,1,1,1,0,0,0,2,"A","N","2016-01-09","201601090OTT"
"OTT",1,1,0,0,0,2,0,0,1,0,0,1,"H","N","2016-01-09","201601090OTT"
"NYI",0,0,0,0,0,0,0,0,2,2,0,4,"A","N","2016-01-09","201601090PHI"
"PHI",0,0,2,2,0,4,0,0,0,0,0,0,"H","N","2016-01-09","201601090PHI"
"SJS",0,0,4,3,0,7,0,0,0,0,0,0,"H","N","2016-01-09","201601090SJS"
"TOR",0,0,0,0,0,0,0,0,4,3,0,7,"A","N","2016-01-09","201601090SJS"
"TBL",1,1,0,1,0,3,0,1,0,1,0,2,"A","N","2016-01-09","201601090VAN"
"VAN",0,1,0,1,0,2,1,1,0,1,0,3,"H","N","2016-01-09","201601090VAN"
"ANA",0,1,0,0,0,1,0,1,0,1,0,2,"H","N","2016-01-10","201601100ANA"
"DET",0,1,0,1,0,2,0,1,0,0,0,1,"A","N","2016-01-10","201601100ANA"
"CHI",0,2,4,0,0,6,0,0,2,1,0,3,"H","N","2016-01-10","201601100CHI"
"COL",0,0,2,1,0,3,0,2,4,0,0,6,"A","N","2016-01-10","201601100CHI"
"EDM",0,1,0,0,0,1,0,2,0,0,0,2,"H","N","2016-01-10","201601100EDM"
"FLA",0,2,0,0,0,2,0,1,0,0,0,1,"A","N","2016-01-10","201601100EDM"
"MIN",0,0,0,1,0,1,0,0,0,2,0,2,"H","N","2016-01-10","201601100MIN"
"NJD",0,0,0,2,0,2,0,0,0,1,0,1,"A","N","2016-01-10","201601100MIN"
"BUF",0,2,0,2,0,4,0,1,1,0,0,2,"A","N","2016-01-10","201601100WPG"
"WPG",0,1,1,0,0,2,0,2,0,2,0,4,"H","N","2016-01-10","201601100WPG"
"OTT",0,0,1,0,0,1,0,2,3,2,0,7,"A","N","2016-01-10","201601100WSH"
"WSH",0,2,3,2,0,7,0,0,1,0,0,1,"H","N","2016-01-10","201601100WSH"
"CGY",0,1,2,1,0,4,0,2,1,2,0,5,"H","N","2016-01-11","201601110CGY"
"SJS",0,2,1,2,0,5,0,1,2,1,0,4,"A","N","2016-01-11","201601110CGY"
"DET",0,2,0,0,0,2,0,1,1,2,0,4,"A","N","2016-01-11","201601110LAK"
"LAK",0,1,1,2,0,4,0,2,0,0,0,2,"H","N","2016-01-11","201601110LAK"
"BOS",0,0,1,0,0,1,0,0,0,2,0,2,"A","N","2016-01-11","201601110NYR"
"NYR",0,0,0,2,0,2,0,0,1,0,0,1,"H","N","2016-01-11","201601110NYR"
"FLA",0,2,0,0,0,2,1,0,1,1,0,3,"A","N","2016-01-11","201601110VAN"
"VAN",1,0,1,1,0,3,0,2,0,0,0,2,"H","N","2016-01-11","201601110VAN"
"ARI",1,0,1,2,0,4,0,1,1,1,0,3,"H","N","2016-01-12","201601120ARI"
"EDM",0,1,1,1,0,3,1,0,1,2,0,4,"A","N","2016-01-12","201601120ARI"
"CAR",1,0,2,0,0,3,0,0,1,1,0,2,"H","N","2016-01-12","201601120CAR"
"PIT",0,0,1,1,0,2,1,0,2,0,0,3,"A","N","2016-01-12","201601120CAR"
"CHI",0,1,2,0,0,3,0,0,1,1,0,2,"H","N","2016-01-12","201601120CHI"
"NSH",0,0,1,1,0,2,0,1,2,0,0,3,"A","N","2016-01-12","201601120CHI"
"COL",0,0,0,0,0,0,0,1,2,1,0,4,"H","N","2016-01-12","201601120COL"
"TBL",0,1,2,1,0,4,0,0,0,0,0,0,"A","N","2016-01-12","201601120COL"
"BUF",0,3,0,0,0,3,0,0,1,1,0,2,"A","N","2016-01-12","201601120MIN"
"MIN",0,0,1,1,0,2,0,3,0,0,0,3,"H","N","2016-01-12","201601120MIN"
"CBJ",0,1,1,0,0,2,0,2,1,2,0,5,"A","N","2016-01-12","201601120NYI"
"NYI",0,2,1,2,0,5,0,1,1,0,0,2,"H","N","2016-01-12","201601120NYI"
"NJD",0,2,0,0,0,2,0,1,2,2,0,5,"A","N","2016-01-12","201601120STL"
"STL",0,1,2,2,0,5,0,2,0,0,0,2,"H","N","2016-01-12","201601120STL"
"SJS",0,2,0,2,0,4,0,1,0,0,0,1,"A","N","2016-01-12","201601120WPG"
"WPG",0,1,0,0,0,1,0,2,0,2,0,4,"H","N","2016-01-12","201601120WPG"
"ANA",0,0,1,3,0,4,0,0,1,0,0,1,"H","N","2016-01-13","201601130ANA"
"OTT",0,0,1,0,0,1,0,0,1,3,0,4,"A","N","2016-01-13","201601130ANA"
"CGY",0,4,1,1,0,6,0,0,0,0,0,0,"H","N","2016-01-13","201601130CGY"
"FLA",0,0,0,0,0,0,0,4,1,1,0,6,"A","N","2016-01-13","201601130CGY"
"BOS",0,0,2,0,0,2,0,1,0,2,0,3,"A","N","2016-01-13","201601130PHI"
"PHI",0,1,0,2,0,3,0,0,2,0,0,2,"H","N","2016-01-13","201601130PHI"
"CBJ",0,1,1,1,0,3,0,0,0,1,0,1,"A","N","2016-01-13","201601130TOR"
"TOR",0,0,0,1,0,1,0,1,1,1,0,3,"H","N","2016-01-13","201601130TOR"
"ARI",0,0,2,0,0,2,1,0,0,2,0,3,"H","N","2016-01-14","201601140ARI"
"DET",1,0,0,2,0,3,0,0,2,0,0,2,"A","N","2016-01-14","201601140ARI"
"COL",0,1,1,1,0,3,0,0,0,0,0,0,"H","N","2016-01-14","201601140COL"
"NJD",0,0,0,0,0,0,0,1,1,1,0,3,"A","N","2016-01-14","201601140COL"
"CHI",0,2,0,0,0,2,0,1,0,0,0,1,"A","N","2016-01-14","201601140MTL"
"MTL",0,1,0,0,0,1,0,2,0,0,0,2,"H","N","2016-01-14","201601140MTL"
"NYI",0,0,0,3,0,3,0,0,1,0,0,1,"H","N","2016-01-14","201601140NYI"
"NYR",0,0,1,0,0,1,0,0,0,3,0,3,"A","N","2016-01-14","201601140NYI"
"EDM",0,0,1,0,0,1,0,1,0,0,1,2,"A","Y","2016-01-14","201601140SJS"
"SJS",0,1,0,0,1,2,0,0,1,0,0,1,"H","Y","2016-01-14","201601140SJS"
"CAR",0,0,1,3,0,4,0,0,0,1,0,1,"A","N","2016-01-14","201601140STL"
"STL",0,0,0,1,0,1,0,0,1,3,0,4,"H","N","2016-01-14","201601140STL"
"NSH",0,1,0,3,0,4,1,0,3,1,0,5,"A","N","2016-01-14","201601140WPG"
"WPG",1,0,3,1,0,5,0,1,0,3,0,4,"H","N","2016-01-14","201601140WPG"
"VAN",0,0,0,1,0,1,0,0,2,2,0,4,"A","N","2016-01-14","201601140WSH"
"WSH",0,0,2,2,0,4,0,0,0,1,0,1,"H","N","2016-01-14","201601140WSH"
"ANA",0,4,0,0,0,4,0,0,1,1,0,2,"H","N","2016-01-15","201601150ANA"
"DAL",0,0,1,1,0,2,0,4,0,0,0,4,"A","N","2016-01-15","201601150ANA"
"BOS",0,0,1,3,0,4,0,1,0,0,0,1,"A","N","2016-01-15","201601150BUF"
"BUF",0,1,0,0,0,1,0,0,1,3,0,4,"H","N","2016-01-15","201601150BUF"
"CAR",0,1,0,1,0,2,1,1,1,0,0,3,"H","N","2016-01-15","201601150CAR"
"VAN",1,1,1,0,0,3,0,1,0,1,0,2,"A","N","2016-01-15","201601150CAR"
"MIN",0,0,0,0,0,0,0,1,0,0,0,1,"H","N","2016-01-15","201601150MIN"
"WPG",0,1,0,0,0,1,0,0,0,0,0,0,"A","N","2016-01-15","201601150MIN"
"PIT",0,1,1,2,0,4,1,1,2,1,0,5,"A","N","2016-01-15","201601150TBL"
"TBL",1,1,2,1,0,5,0,1,1,2,0,4,"H","N","2016-01-15","201601150TBL"
"CHI",0,0,2,2,0,4,0,0,0,1,0,1,"A","N","2016-01-15","201601150TOR"
"TOR",0,0,0,1,0,1,0,0,2,2,0,4,"H","N","2016-01-15","201601150TOR"
"ARI",0,0,0,0,0,0,0,1,0,1,0,2,"H","N","2016-01-16","201601160ARI"
"NJD",0,1,0,1,0,2,0,0,0,0,0,0,"A","N","2016-01-16","201601160ARI"
"BOS",0,1,1,1,0,3,0,1,1,0,0,2,"H","N","2016-01-16","201601160BOS"
"TOR",0,1,1,0,0,2,0,1,1,1,0,3,"A","N","2016-01-16","201601160BOS"
"BUF",0,2,2,0,0,4,0,0,0,1,0,1,"H","N","2016-01-16","201601160BUF"
"WSH",0,0,0,1,0,1,0,2,2,0,0,4,"A","N","2016-01-16","201601160BUF"
"CBJ",0,1,0,1,0,2,0,0,1,0,0,1,"H","N","2016-01-16","201601160CBJ"
"COL",0,0,1,0,0,1,0,1,0,1,0,2,"A","N","2016-01-16","201601160CBJ"
"CGY",0,1,0,0,0,1,0,0,0,1,1,2,"A","Y","2016-01-16","201601160EDM"
"EDM",0,0,0,1,1,2,0,1,0,0,0,1,"H","Y","2016-01-16","201601160EDM"
"LAK",0,1,1,1,0,3,0,0,1,4,0,5,"H","N","2016-01-16","201601160LAK"
"OTT",0,0,1,4,0,5,0,1,1,1,0,3,"A","N","2016-01-16","201601160LAK"
"MIN",0,0,0,0,0,0,0,1,0,2,0,3,"A","N","2016-01-16","201601160NSH"
"NSH",0,1,0,2,0,3,0,0,0,0,0,0,"H","N","2016-01-16","201601160NSH"
"NYR",0,1,1,0,1,3,0,1,0,1,0,2,"A","Y","2016-01-16","201601160PHI"
"PHI",0,1,0,1,0,2,0,1,1,0,1,3,"H","Y","2016-01-16","201601160PHI"
"DAL",0,1,0,2,0,3,1,0,2,1,0,4,"A","N","2016-01-16","201601160SJS"
"SJS",1,0,2,1,0,4,0,1,0,2,0,3,"H","N","2016-01-16","201601160SJS"
"MTL",0,0,2,1,0,3,1,1,1,1,0,4,"A","N","2016-01-16","201601160STL"
"STL",1,1,1,1,0,4,0,0,2,1,0,3,"H","N","2016-01-16","201601160STL"
"ANA",0,0,1,1,0,2,0,0,3,0,0,3,"H","N","2016-01-17","201601170ANA"
"LAK",0,0,3,0,0,3,0,0,1,1,0,2,"A","N","2016-01-17","201601170ANA"
"CHI",0,1,2,2,0,5,0,1,0,1,0,2,"H","N","2016-01-17","201601170CHI"
"MTL",0,1,0,1,0,2,0,1,2,2,0,5,"A","N","2016-01-17","201601170CHI"
"DET",0,0,1,0,0,1,0,0,0,1,1,2,"H","Y","2016-01-17","201601170DET"
"PHI",0,0,0,1,1,2,0,0,1,0,0,1,"A","Y","2016-01-17","201601170DET"
"NYI",0,0,0,1,0,1,0,0,1,0,1,2,"H","Y","2016-01-17","201601170NYI"
"VAN",0,0,1,0,1,2,0,0,0,1,0,1,"A","Y","2016-01-17","201601170NYI"
"CAR",0,0,0,0,0,0,0,2,1,2,0,5,"A","N","2016-01-17","201601170PIT"
"PIT",0,2,1,2,0,5,0,0,0,0,0,0,"H","N","2016-01-17","201601170PIT"
"FLA",0,0,0,1,0,1,0,0,2,1,0,3,"A","N","2016-01-17","201601170TBL"
"TBL",0,0,2,1,0,3,0,0,0,1,0,1,"H","N","2016-01-17","201601170TBL"
"NYR",0,1,1,0,0,2,0,1,2,2,0,5,"A","N","2016-01-17","201601170WSH"
"WSH",0,1,2,2,0,5,0,1,1,0,0,2,"H","N","2016-01-17","201601170WSH"
"ARI",0,0,0,1,0,1,0,0,2,0,0,2,"H","N","2016-01-18","201601180ARI"
"BUF",0,0,2,0,0,2,0,0,0,1,0,1,"A","N","2016-01-18","201601180ARI"
"EDM",0,2,1,1,0,4,0,0,0,2,0,2,"A","N","2016-01-18","201601180FLA"
"FLA",0,0,0,2,0,2,0,2,1,1,0,4,"H","N","2016-01-18","201601180FLA"
"OTT",0,1,1,1,1,4,0,0,1,2,0,3,"A","Y","2016-01-18","201601180SJS"
"SJS",0,0,1,2,0,3,0,1,1,1,1,4,"H","Y","2016-01-18","201601180SJS"
"PIT",0,1,1,0,0,2,0,1,1,3,0,5,"A","N","2016-01-18","201601180STL"
"STL",0,1,1,3,0,5,0,1,1,0,0,2,"H","N","2016-01-18","201601180STL"
"COL",0,0,2,0,0,2,0,0,0,1,0,1,"A","N","2016-01-18","201601180WPG"
"WPG",0,0,0,1,0,1,0,0,2,0,0,2,"H","N","2016-01-18","201601180WPG"
"CBJ",0,1,1,1,0,3,0,2,3,1,0,6,"H","N","2016-01-19","201601190CBJ"
"WSH",0,2,3,1,0,6,0,1,1,1,0,3,"A","N","2016-01-19","201601190CBJ"
"DAL",0,2,0,0,0,2,0,2,0,1,0,3,"A","N","2016-01-19","201601190LAK"
"LAK",0,2,0,1,0,3,0,2,0,0,0,2,"H","N","2016-01-19","201601190LAK"
"BOS",0,1,1,2,0,4,0,0,1,0,0,1,"A","N","2016-01-19","201601190MTL"
"MTL",0,0,1,0,0,1,0,1,1,2,0,4,"H","N","2016-01-19","201601190MTL"
"CGY",0,1,1,0,0,2,0,1,2,1,0,4,"A","N","2016-01-19","201601190NJD"
"NJD",0,1,2,1,0,4,0,1,1,0,0,2,"H","N","2016-01-19","201601190NJD"
"CHI",0,1,2,1,0,4,0,0,1,0,0,1,"A","N","2016-01-19","201601190NSH"
"NSH",0,0,1,0,0,1,0,1,2,1,0,4,"H","N","2016-01-19","201601190NSH"
"NYR",1,0,1,1,0,3,0,1,1,0,0,2,"H","N","2016-01-19","201601190NYR"
"VAN",0,1,1,0,0,2,1,0,1,1,0,3,"A","N","2016-01-19","201601190NYR"
"PHI",0,1,0,1,0,2,0,1,1,1,0,3,"H","N","2016-01-19","201601190PHI"
"TOR",0,1,1,1,0,3,0,1,0,1,0,2,"A","N","2016-01-19","201601190PHI"
"EDM",0,2,0,2,0,4,0,2,2,2,0,6,"A","N","2016-01-19","201601190TBL"
"TBL",0,2,2,2,0,6,0,2,0,2,0,4,"H","N","2016-01-19","201601190TBL"
"ANA",0,1,0,2,0,3,0,1,0,0,0,1,"H","N","2016-01-20","201601200ANA"
"MIN",0,1,0,0,0,1,0,1,0,2,0,3,"A","N","2016-01-20","201601200ANA"
"BUF",0,0,1,0,0,1,0,0,0,2,0,2,"A","N","2016-01-20","201601200COL"
"COL",0,0,0,2,0,2,0,0,1,0,0,1,"H","N","2016-01-20","201601200COL"
"DET",0,0,0,1,0,1,0,1,0,1,0,2,"H","N","2016-01-20","201601200DET"
"STL",0,1,0,1,0,2,0,0,0,1,0,1,"A","N","2016-01-20","201601200DET"
"ARI",0,0,0,1,0,1,0,2,0,1,0,3,"H","N","2016-01-21","201601210ARI"
"SJS",0,2,0,1,0,3,0,0,0,1,0,1,"A","N","2016-01-21","201601210ARI"
"BOS",0,0,1,1,0,2,0,1,0,3,0,4,"H","N","2016-01-21","201601210BOS"
"VAN",0,1,0,3,0,4,0,0,1,1,0,2,"A","N","2016-01-21","201601210BOS"
"CBJ",0,0,2,0,0,2,0,1,1,2,0,4,"H","N","2016-01-21","201601210CBJ"
"CGY",0,1,1,2,0,4,0,0,2,0,0,2,"A","N","2016-01-21","201601210CBJ"
"DAL",0,1,2,0,0,3,0,0,1,1,0,2,"H","N","2016-01-21","201601210DAL"
"EDM",0,0,1,1,0,2,0,1,2,0,0,3,"A","N","2016-01-21","201601210DAL"
"LAK",0,0,0,0,0,0,0,0,2,1,0,3,"H","N","2016-01-21","201601210LAK"
"MIN",0,0,2,1,0,3,0,0,0,0,0,0,"A","N","2016-01-21","201601210LAK"
"NJD",0,5,0,1,0,6,0,0,1,2,0,3,"H","N","2016-01-21","201601210NJD"
"OTT",0,0,1,2,0,3,0,5,0,1,0,6,"A","N","2016-01-21","201601210NJD"
"PHI",0,2,0,1,0,3,0,0,3,1,0,4,"A","N","2016-01-21","201601210PIT"
"PIT",0,0,3,1,0,4,0,2,0,1,0,3,"H","N","2016-01-21","201601210PIT"
"CHI",0,1,0,0,0,1,0,1,1,0,0,2,"A","N","2016-01-21","201601210TBL"
"TBL",0,1,1,0,0,2,0,1,0,0,0,1,"H","N","2016-01-21","201601210TBL"
"CAR",1,0,0,0,0,1,0,0,0,0,0,0,"A","N","2016-01-21","201601210TOR"
"TOR",0,0,0,0,0,0,1,0,0,0,0,1,"H","N","2016-01-21","201601210TOR"
"NSH",0,1,1,2,0,4,0,1,0,0,0,1,"A","N","2016-01-21","201601210WPG"
"WPG",0,1,0,0,0,1,0,1,1,2,0,4,"H","N","2016-01-21","201601210WPG"
"BUF",0,0,0,0,0,0,0,0,0,3,0,3,"H","N","2016-01-22","201601220BUF"
"DET",0,0,0,3,0,3,0,0,0,0,0,0,"A","N","2016-01-22","201601220BUF"
"CAR",0,0,1,0,0,1,0,2,2,0,0,4,"H","N","2016-01-22","201601220CAR"
"NYR",0,2,2,0,0,4,0,0,1,0,0,1,"A","N","2016-01-22","201601220CAR"
"COL",0,0,0,1,1,2,0,0,1,0,0,1,"H","Y","2016-01-22","201601220COL"
"STL",0,0,1,0,0,1,0,0,0,1,1,2,"A","Y","2016-01-22","201601220COL"
"CHI",0,0,0,0,0,0,0,3,1,0,0,4,"A","N","2016-01-22","201601220FLA"
"FLA",0,3,1,0,0,4,0,0,0,0,0,0,"H","N","2016-01-22","201601220FLA"
"NYI",0,1,1,3,0,5,0,0,2,0,0,2,"A","N","2016-01-22","201601220OTT"
"OTT",0,0,2,0,0,2,0,1,1,3,0,5,"H","N","2016-01-22","201601220OTT"
"ARI",0,1,1,1,0,3,0,0,2,0,0,2,"H","N","2016-01-23","201601230ARI"
"LAK",0,0,2,0,0,2,0,1,1,1,0,3,"A","N","2016-01-23","201601230ARI"
"BOS",0,0,2,0,1,3,0,0,2,0,0,2,"H","Y","2016-01-23","201601230BOS"
"CBJ",0,0,2,0,0,2,0,0,2,0,1,3,"A","Y","2016-01-23","201601230BOS"
"COL",0,1,1,1,0,3,0,0,1,0,0,1,"A","N","2016-01-23","201601230DAL"
"DAL",0,0,1,0,0,1,0,1,1,1,0,3,"H","N","2016-01-23","201601230DAL"
"ANA",0,2,0,2,0,4,0,1,1,1,0,3,"A","N","2016-01-23","201601230DET"
"DET",0,1,1,1,0,3,0,2,0,2,0,4,"H","N","2016-01-23","201601230DET"
"EDM",0,1,0,0,0,1,0,1,1,2,0,4,"H","N","2016-01-23","201601230EDM"
"NSH",0,1,1,2,0,4,0,1,0,0,0,1,"A","N","2016-01-23","201601230EDM"
"FLA",0,0,4,1,0,5,0,0,0,2,0,2,"H","N","2016-01-23","201601230FLA"
"TBL",0,0,0,2,0,2,0,0,4,1,0,5,"A","N","2016-01-23","201601230FLA"
"PIT",0,0,1,4,0,5,0,2,0,2,0,4,"H","N","2016-01-23","201601230PIT"
"VAN",0,2,0,2,0,4,0,0,1,4,0,5,"A","N","2016-01-23","201601230PIT"
"MIN",0,2,0,1,0,3,0,1,2,1,0,4,"A","N","2016-01-23","201601230SJS"
"SJS",0,1,2,1,0,4,0,2,0,1,0,3,"H","N","2016-01-23","201601230SJS"
"MTL",0,2,0,0,1,3,0,0,1,1,0,2,"A","Y","2016-01-23","201601230TOR"
"TOR",0,0,1,1,0,2,0,2,0,0,1,3,"H","Y","2016-01-23","201601230TOR"
"NJD",0,1,1,1,0,3,0,0,0,1,0,1,"A","N","2016-01-23","201601230WPG"
"WPG",0,0,0,1,0,1,0,1,1,1,0,3,"H","N","2016-01-23","201601230WPG"
"CAR",0,2,1,2,0,5,0,0,1,1,0,2,"H","N","2016-01-24","201601240CAR"
"CGY",0,0,1,1,0,2,0,2,1,2,0,5,"A","N","2016-01-24","201601240CAR"
"CHI",0,0,1,1,0,2,0,0,0,0,0,0,"H","N","2016-01-24","201601240CHI"
"STL",0,0,0,0,0,0,0,0,1,1,0,2,"A","N","2016-01-24","201601240CHI"
"NYR",0,0,0,0,0,0,0,0,1,2,0,3,"A","N","2016-01-24","201601240OTT"
"OTT",0,0,1,2,0,3,0,0,0,0,0,0,"H","N","2016-01-24","201601240OTT"
"LAK",1,0,0,2,0,3,0,0,1,1,0,2,"A","N","2016-01-24","201601240SJS"
"SJS",0,0,1,1,0,2,1,0,0,2,0,3,"H","N","2016-01-24","201601240SJS"
"CBJ",0,1,1,3,0,5,0,1,1,0,0,2,"H","N","2016-01-25","201601250CBJ"
"MTL",0,1,1,0,0,2,0,1,1,3,0,5,"A","N","2016-01-25","201601250CBJ"
"CGY",0,0,0,1,0,1,0,0,2,0,0,2,"A","N","2016-01-25","201601250DAL"
"DAL",0,0,2,0,0,2,0,0,0,1,0,1,"H","N","2016-01-25","201601250DAL"
"ARI",0,0,0,1,1,2,0,0,0,1,0,1,"A","Y","2016-01-25","201601250MIN"
"MIN",0,0,0,1,0,1,0,0,0,1,1,2,"H","Y","2016-01-25","201601250MIN"
"DET",0,1,2,1,0,4,0,1,0,1,0,2,"A","N","2016-01-25","201601250NYI"
"NYI",0,1,0,1,0,2,0,1,2,1,0,4,"H","N","2016-01-25","201601250NYI"
"BUF",0,1,0,2,0,3,0,1,1,4,0,6,"A","N","2016-01-25","201601250NYR"
"NYR",0,1,1,4,0,6,0,1,0,2,0,3,"H","N","2016-01-25","201601250NYR"
"BOS",0,2,0,1,0,3,0,0,1,1,0,2,"A","N","2016-01-25","201601250PHI"
"PHI",0,0,1,1,0,2,0,2,0,1,0,3,"H","N","2016-01-25","201601250PHI"
"ANA",0,2,2,2,0,6,0,1,0,1,0,2,"A","N","2016-01-26","201601260BOS"
"BOS",0,1,0,1,0,2,0,2,2,2,0,6,"H","N","2016-01-26","201601260BOS"
"CAR",0,3,2,0,0,5,0,0,0,0,0,0,"H","N","2016-01-26","201601260CAR"
"CHI",0,0,0,0,0,0,0,3,2,0,0,5,"A","N","2016-01-26","201601260CAR"
"FLA",0,0,3,2,0,5,0,1,0,0,0,1,"H","N","2016-01-26","201601260FLA"
"TOR",0,1,0,0,0,1,0,0,3,2,0,5,"A","N","2016-01-26","201601260FLA"
"CBJ",0,2,1,2,0,5,0,0,1,1,0,2,"A","N","2016-01-26","201601260MTL"
"MTL",0,0,1,1,0,2,0,2,1,2,0,5,"H","N","2016-01-26","201601260MTL"
"BUF",0,1,1,1,0,3,0,1,1,0,0,2,"A","N","2016-01-26","201601260OTT"
"OTT",0,1,1,0,0,2,0,1,1,1,0,3,"H","N","2016-01-26","201601260OTT"
"NJD",0,0,0,0,0,0,0,1,1,0,0,2,"A","N","2016-01-26","201601260PIT"
"PIT",0,1,1,0,0,2,0,0,0,0,0,0,"H","N","2016-01-26","201601260PIT"
"COL",0,0,0,1,0,1,0,2,2,2,0,6,"A","N","2016-01-26","201601260SJS"
"SJS",0,2,2,2,0,6,0,0,0,1,0,1,"H","N","2016-01-26","201601260SJS"
"NSH",0,1,0,1,0,2,0,1,0,0,0,1,"A","N","2016-01-26","201601260VAN"
"VAN",0,1,0,0,0,1,0,1,0,1,0,2,"H","N","2016-01-26","201601260VAN"
"ARI",0,0,1,1,0,2,0,2,3,0,0,5,"A","N","2016-01-26","201601260WPG"
"WPG",0,2,3,0,0,5,0,0,1,1,0,2,"H","N","2016-01-26","201601260WPG"
"CGY",0,0,0,1,0,1,0,1,1,0,0,2,"H","N","2016-01-27","201601270CGY"
"NSH",0,1,1,0,0,2,0,0,0,1,0,1,"A","N","2016-01-27","201601270CGY"
"COL",0,0,2,2,0,4,0,2,1,0,0,3,"A","N","2016-01-27","201601270LAK"
"LAK",0,2,1,0,0,3,0,0,2,2,0,4,"H","N","2016-01-27","201601270LAK"
"TBL",0,1,0,0,0,1,0,0,0,0,0,0,"H","N","2016-01-27","201601270TBL"
"TOR",0,0,0,0,0,0,0,1,0,0,0,1,"A","N","2016-01-27","201601270TBL"
"PHI",1,2,1,0,0,4,0,0,2,1,0,3,"A","N","2016-01-27","201601270WSH"
"WSH",0,0,2,1,0,3,1,2,1,0,0,4,"H","N","2016-01-27","201601270WSH"
"ANA",0,1,2,0,0,3,0,0,2,0,0,2,"H","N","2016-02-02","201602020ANA"
"SJS",0,0,2,0,0,2,0,1,2,0,0,3,"A","N","2016-02-02","201602020ANA"
"ARI",0,1,1,0,0,2,0,0,4,2,0,6,"H","N","2016-02-02","201602020ARI"
"LAK",0,0,4,2,0,6,0,1,1,0,0,2,"A","N","2016-02-02","201602020ARI"
"BOS",0,1,0,2,0,3,1,0,1,2,0,4,"H","N","2016-02-02","201602020BOS"
"TOR",1,0,1,2,0,4,0,1,0,2,0,3,"A","N","2016-02-02","201602020BOS"
"CHI",0,2,0,0,0,2,0,1,0,0,0,1,"A","N","2016-02-02","201602020COL"
"COL",0,1,0,0,0,1,0,2,0,0,0,2,"H","N","2016-02-02","201602020COL"
"CBJ",0,1,0,0,0,1,0,0,4,1,0,5,"A","N","2016-02-02","201602020EDM"
"EDM",0,0,4,1,0,5,0,1,0,0,0,1,"H","N","2016-02-02","201602020EDM"
"NJD",0,0,1,2,0,3,0,1,0,1,0,2,"H","N","2016-02-02","201602020NJD"
"NYR",0,1,0,1,0,2,0,0,1,2,0,3,"A","N","2016-02-02","201602020NJD"
"NSH",0,0,0,0,0,0,0,0,0,1,0,1,"H","N","2016-02-02","201602020NSH"
"STL",0,0,0,1,0,1,0,0,0,0,0,0,"A","N","2016-02-02","201602020NSH"
"MIN",0,1,1,1,0,3,0,0,3,2,0,5,"A","N","2016-02-02","201602020NYI"
"NYI",0,0,3,2,0,5,0,1,1,1,0,3,"H","N","2016-02-02","201602020NYI"
"MTL",0,1,1,0,0,2,0,2,0,2,0,4,"A","N","2016-02-02","201602020PHI"
"PHI",0,2,0,2,0,4,0,1,1,0,0,2,"H","N","2016-02-02","201602020PHI"
"OTT",0,2,2,1,0,5,0,3,2,1,0,6,"A","N","2016-02-02","201602020PIT"
"PIT",0,3,2,1,0,6,0,2,2,1,0,5,"H","N","2016-02-02","201602020PIT"
"DAL",0,0,3,2,0,5,0,1,1,1,0,3,"A","N","2016-02-02","201602020WPG"
"WPG",0,1,1,1,0,3,0,0,3,2,0,5,"H","N","2016-02-02","201602020WPG"
"FLA",0,2,2,1,0,5,0,0,0,2,0,2,"A","N","2016-02-02","201602020WSH"
"WSH",0,0,0,2,0,2,0,2,2,1,0,5,"H","N","2016-02-02","201602020WSH"
"CAR",0,1,0,0,0,1,0,1,2,1,0,4,"A","N","2016-02-03","201602030CGY"
"CGY",0,1,2,1,0,4,0,1,0,0,0,1,"H","N","2016-02-03","201602030CGY"
"BUF",0,1,0,3,0,4,0,0,2,0,0,2,"A","N","2016-02-03","201602030MTL"
"MTL",0,0,2,0,0,2,0,1,0,3,0,4,"H","N","2016-02-03","201602030MTL"
"DET",0,0,1,0,0,1,0,0,2,1,0,3,"A","N","2016-02-03","201602030TBL"
"TBL",0,0,2,1,0,3,0,0,1,0,0,1,"H","N","2016-02-03","201602030TBL"
"ARI",0,1,2,1,0,4,1,0,3,1,0,5,"H","N","2016-02-04","201602040ARI"
"CHI",1,0,3,1,0,5,0,1,2,1,0,4,"A","N","2016-02-04","201602040ARI"
"BOS",0,0,1,1,1,3,0,1,1,0,0,2,"A","Y","2016-02-04","201602040BUF"
"BUF",0,1,1,0,0,2,0,0,1,1,1,3,"H","Y","2016-02-04","201602040BUF"
"COL",0,2,1,0,0,3,1,1,1,1,0,4,"H","N","2016-02-04","201602040COL"
"DAL",1,1,1,1,0,4,0,2,1,0,0,3,"A","N","2016-02-04","201602040COL"
"DET",0,1,1,1,0,3,0,3,1,2,0,6,"A","N","2016-02-04","201602040FLA"
"FLA",0,3,1,2,0,6,0,1,1,1,0,3,"H","N","2016-02-04","201602040FLA"
"ANA",0,2,2,0,0,4,0,0,1,1,0,2,"A","N","2016-02-04","201602040LAK"
"LAK",0,0,1,1,0,2,0,2,2,0,0,4,"H","N","2016-02-04","201602040LAK"
"NSH",0,0,2,1,0,3,0,2,2,2,0,6,"H","N","2016-02-04","201602040NSH"
"PHI",0,2,2,2,0,6,0,0,2,1,0,3,"A","N","2016-02-04","201602040NSH"
"MIN",0,2,0,0,0,2,0,0,2,2,0,4,"A","N","2016-02-04","201602040NYR"
"NYR",0,0,2,2,0,4,0,2,0,0,0,2,"H","N","2016-02-04","201602040NYR"
"EDM",0,3,1,3,0,7,0,1,1,0,0,2,"A","N","2016-02-04","201602040OTT"
"OTT",0,1,1,0,0,2,0,3,1,3,0,7,"H","N","2016-02-04","201602040OTT"
"SJS",0,0,2,1,0,3,0,0,1,0,0,1,"A","N","2016-02-04","201602040STL"
"STL",0,0,1,0,0,1,0,0,2,1,0,3,"H","N","2016-02-04","201602040STL"
"NJD",0,1,0,1,0,2,0,1,0,1,1,3,"A","Y","2016-02-04","201602040TOR"
"TOR",0,1,0,1,1,3,0,1,0,1,0,2,"H","Y","2016-02-04","201602040TOR"
"CBJ",0,0,0,1,1,2,0,1,0,0,0,1,"A","Y","2016-02-04","201602040VAN"
"VAN",0,1,0,0,0,1,0,0,0,1,1,2,"H","Y","2016-02-04","201602040VAN"
"NYI",0,1,0,1,0,2,0,1,1,1,0,3,"A","N","2016-02-04","201602040WSH"
"WSH",0,1,1,1,0,3,0,1,0,1,0,2,"H","N","2016-02-04","201602040WSH"
"ANA",0,0,2,3,0,5,0,1,1,0,0,2,"H","N","2016-02-05","201602050ANA"
"ARI",0,1,1,0,0,2,0,0,2,3,0,5,"A","N","2016-02-05","201602050ANA"
"CBJ",0,0,1,1,0,2,0,1,0,0,0,1,"A","N","2016-02-05","201602050CGY"
"CGY",0,1,0,0,0,1,0,0,1,1,0,2,"H","N","2016-02-05","201602050CGY"
"PIT",0,1,1,1,0,3,0,2,2,2,0,6,"A","N","2016-02-05","201602050TBL"
"TBL",0,2,2,2,0,6,0,1,1,1,0,3,"H","N","2016-02-05","201602050TBL"
"CAR",0,4,0,1,0,5,0,0,1,2,0,3,"A","N","2016-02-05","201602050WPG"
"WPG",0,0,1,2,0,3,0,4,0,1,0,5,"H","N","2016-02-05","201602050WPG"
"BOS",1,1,0,0,0,2,0,0,1,0,0,1,"H","N","2016-02-06","201602060BOS"
"BUF",0,0,1,0,0,1,1,1,0,0,0,2,"A","N","2016-02-06","201602060BOS"
"COL",0,1,1,0,0,2,0,1,2,1,0,4,"H","N","2016-02-06","201602060COL"
"WPG",0,1,2,1,0,4,0,1,1,0,0,2,"A","N","2016-02-06","201602060COL"
"CHI",0,3,2,0,0,5,0,1,0,0,0,1,"A","N","2016-02-06","201602060DAL"
"DAL",0,1,0,0,0,1,0,3,2,0,0,5,"H","N","2016-02-06","201602060DAL"
"DET",0,2,2,1,0,5,0,0,0,1,0,1,"H","N","2016-02-06","201602060DET"
"NYI",0,0,0,1,0,1,0,2,2,1,0,5,"A","N","2016-02-06","201602060DET"
"FLA",0,0,1,1,0,2,1,0,0,2,0,3,"H","N","2016-02-06","201602060FLA"
"PIT",1,0,0,2,0,3,0,0,1,1,0,2,"A","N","2016-02-06","201602060FLA"
"EDM",0,0,0,1,0,1,0,2,2,1,0,5,"A","N","2016-02-06","201602060MTL"
"MTL",0,2,2,1,0,5,0,0,0,1,0,1,"H","N","2016-02-06","201602060MTL"
"NJD",0,0,0,2,0,2,0,0,1,1,1,3,"H","Y","2016-02-06","201602060NJD"
"WSH",0,0,1,1,1,3,0,0,0,2,0,2,"A","Y","2016-02-06","201602060NJD"
"NSH",0,1,2,3,0,6,0,0,1,1,0,2,"H","N","2016-02-06","201602060NSH"
"SJS",0,0,1,1,0,2,0,1,2,3,0,6,"A","N","2016-02-06","201602060NSH"
"OTT",0,3,1,2,0,6,0,0,0,1,0,1,"H","N","2016-02-06","201602060OTT"
"TOR",0,0,0,1,0,1,0,3,1,2,0,6,"A","N","2016-02-06","201602060OTT"
"NYR",0,0,0,2,1,3,0,0,1,1,0,2,"A","Y","2016-02-06","201602060PHI"
"PHI",0,0,1,1,0,2,0,0,0,2,1,3,"H","Y","2016-02-06","201602060PHI"
"MIN",0,0,1,0,0,1,0,0,3,1,0,4,"A","N","2016-02-06","201602060STL"
"STL",0,0,3,1,0,4,0,0,1,0,0,1,"H","N","2016-02-06","201602060STL"
"CGY",0,0,1,3,0,4,0,0,0,1,0,1,"A","N","2016-02-06","201602060VAN"
"VAN",0,0,0,1,0,1,0,0,1,3,0,4,"H","N","2016-02-06","201602060VAN"
"CAR",0,1,0,0,0,1,0,0,1,0,1,2,"A","Y","2016-02-07","201602070MTL"
"MTL",0,0,1,0,1,2,0,1,0,0,0,1,"H","Y","2016-02-07","201602070MTL"
"EDM",0,0,1,0,0,1,0,3,4,1,0,8,"A","N","2016-02-07","201602070NYI"
"NYI",0,3,4,1,0,8,0,0,1,0,0,1,"H","N","2016-02-07","201602070NYI"
"PHI",0,1,0,1,0,2,0,0,2,1,0,3,"A","N","2016-02-07","201602070WSH"
"WSH",0,0,2,1,0,3,0,1,0,1,0,2,"H","N","2016-02-07","201602070WSH"
"DET",0,0,0,3,0,3,0,0,0,0,0,0,"H","N","2016-02-08","201602080DET"
"FLA",0,0,0,0,0,0,0,0,0,3,0,3,"A","N","2016-02-08","201602080DET"
"NJD",0,0,0,1,0,1,0,0,1,1,0,2,"A","N","2016-02-08","201602080NYR"
"NYR",0,0,1,1,0,2,0,0,0,1,0,1,"H","N","2016-02-08","201602080NYR"
"OTT",0,2,2,1,0,5,0,1,0,0,0,1,"H","N","2016-02-08","201602080OTT"
"TBL",0,1,0,0,0,1,0,2,2,1,0,5,"A","N","2016-02-08","201602080OTT"
"ANA",0,1,1,0,0,2,0,3,1,2,0,6,"A","N","2016-02-08","201602080PIT"
"PIT",0,3,1,2,0,6,0,1,1,0,0,2,"H","N","2016-02-08","201602080PIT"
"BOS",0,1,0,1,0,2,0,2,4,3,0,9,"H","N","2016-02-09","201602090BOS"
"LAK",0,2,4,3,0,9,0,1,0,1,0,2,"A","N","2016-02-09","201602090BOS"
"BUF",0,0,2,2,0,4,0,3,3,1,0,7,"H","N","2016-02-09","201602090BUF"
"FLA",0,3,3,1,0,7,0,0,2,2,0,4,"A","N","2016-02-09","201602090BUF"
"CBJ",0,2,0,0,0,2,0,1,0,1,1,3,"H","Y","2016-02-09","201602090CBJ"
"NYI",0,1,0,1,1,3,0,2,0,0,0,2,"A","Y","2016-02-09","201602090CBJ"
"CGY",0,2,2,0,0,4,0,1,1,1,0,3,"H","N","2016-02-09","201602090CGY"
"TOR",0,1,1,1,0,3,0,2,2,0,0,4,"A","N","2016-02-09","201602090CGY"
"CHI",0,0,0,0,0,0,0,0,1,1,0,2,"H","N","2016-02-09","201602090CHI"
"SJS",0,0,1,1,0,2,0,0,0,0,0,0,"A","N","2016-02-09","201602090CHI"
"COL",0,0,1,0,0,1,0,0,2,1,0,3,"H","N","2016-02-09","201602090COL"
"VAN",0,0,2,1,0,3,0,0,1,0,0,1,"A","N","2016-02-09","201602090COL"
"DAL",1,1,2,0,0,4,0,2,0,1,0,3,"A","N","2016-02-09","201602090MIN"
"MIN",0,2,0,1,0,3,1,1,2,0,0,4,"H","N","2016-02-09","201602090MIN"
"MTL",0,1,2,1,0,4,0,0,1,1,0,2,"H","N","2016-02-09","201602090MTL"
"TBL",0,0,1,1,0,2,0,1,2,1,0,4,"A","N","2016-02-09","201602090MTL"
"EDM",0,1,0,0,0,1,0,1,0,1,0,2,"A","N","2016-02-09","201602090NJD"
"NJD",0,1,0,1,0,2,0,1,0,0,0,1,"H","N","2016-02-09","201602090NJD"
"NSH",0,0,1,2,0,3,0,1,1,3,0,5,"H","N","2016-02-09","201602090NSH"
"WSH",0,1,1,3,0,5,0,0,1,2,0,3,"A","N","2016-02-09","201602090NSH"
"ANA",0,2,1,1,0,4,0,0,0,1,0,1,"A","N","2016-02-09","201602090PHI"
"PHI",0,0,0,1,0,1,0,2,1,1,0,4,"H","N","2016-02-09","201602090PHI"
"STL",0,0,1,0,0,1,0,0,1,0,1,2,"H","Y","2016-02-09","201602090STL"
"WPG",0,0,1,0,1,2,0,0,1,0,0,1,"A","Y","2016-02-09","201602090STL"
"ARI",0,0,1,0,0,1,0,1,1,0,0,2,"H","N","2016-02-10","201602100ARI"
"VAN",0,1,1,0,0,2,0,0,1,0,0,1,"A","N","2016-02-10","201602100ARI"
"DET",0,1,0,2,0,3,0,0,0,1,0,1,"H","N","2016-02-10","201602100DET"
"OTT",0,0,0,1,0,1,0,1,0,2,0,3,"A","N","2016-02-10","201602100DET"
"NYR",0,1,0,2,0,3,0,0,0,0,0,0,"A","N","2016-02-10","201602100PIT"
"PIT",0,0,0,0,0,0,0,1,0,2,0,3,"H","N","2016-02-10","201602100PIT"
"ANA",0,1,1,1,0,3,0,0,1,2,1,4,"A","Y","2016-02-11","201602110CBJ"
"CBJ",0,0,1,2,1,4,0,1,1,1,0,3,"H","Y","2016-02-11","201602110CBJ"
"CHI",0,0,0,2,0,2,0,4,0,0,0,4,"H","N","2016-02-11","201602110CHI"
"DAL",0,4,0,0,0,4,0,0,0,2,0,2,"A","N","2016-02-11","201602110CHI"
"EDM",0,1,2,2,0,5,0,1,1,0,0,2,"H","N","2016-02-11","201602110EDM"
"TOR",0,1,1,0,0,2,0,1,2,2,0,5,"A","N","2016-02-11","201602110EDM"
"MIN",0,0,1,2,0,3,0,0,3,1,0,4,"H","N","2016-02-11","201602110MIN"
"WSH",0,0,3,1,0,4,0,0,1,2,0,3,"A","N","2016-02-11","201602110MIN"
"LAK",0,0,1,1,0,2,0,3,1,1,0,5,"A","N","2016-02-11","201602110NYI"
"NYI",0,3,1,1,0,5,0,0,1,1,0,2,"H","N","2016-02-11","201602110NYI"
"COL",0,1,2,1,0,4,0,0,2,1,0,3,"A","N","2016-02-11","201602110OTT"
"OTT",0,0,2,1,0,3,0,1,2,1,0,4,"H","N","2016-02-11","201602110OTT"
"BUF",0,0,0,1,0,1,0,0,4,1,0,5,"A","N","2016-02-11","201602110PHI"
"PHI",0,0,4,1,0,5,0,0,0,1,0,1,"H","N","2016-02-11","201602110PHI"
"CGY",0,4,0,1,1,6,0,1,2,2,0,5,"A","Y","2016-02-11","201602110SJS"
"SJS",0,1,2,2,0,5,0,4,0,1,1,6,"H","Y","2016-02-11","201602110SJS"
"BOS",0,3,0,3,0,6,0,2,0,0,0,2,"A","N","2016-02-11","201602110WPG"
"WPG",0,2,0,0,0,2,0,3,0,3,0,6,"H","N","2016-02-11","201602110WPG"
"ARI",0,1,2,1,0,4,0,0,0,1,0,1,"H","N","2016-02-12","201602120ARI"
"CGY",0,0,0,1,0,1,0,1,2,1,0,4,"A","N","2016-02-12","201602120ARI"
"BUF",0,2,3,1,0,6,0,1,3,0,0,4,"H","N","2016-02-12","201602120BUF"
"MTL",0,1,3,0,0,4,0,2,3,1,0,6,"A","N","2016-02-12","201602120BUF"
"CAR",0,0,0,1,0,1,0,0,1,0,1,2,"H","Y","2016-02-12","201602120CAR"
"PIT",0,0,1,0,1,2,0,0,0,1,0,1,"A","Y","2016-02-12","201602120CAR"
"COL",0,1,0,1,1,3,0,0,1,1,0,2,"A","Y","2016-02-12","201602120DET"
"DET",0,0,1,1,0,2,0,1,0,1,1,3,"H","Y","2016-02-12","201602120DET"
"FLA",0,1,1,1,0,3,0,3,1,1,0,5,"H","N","2016-02-12","201602120FLA"
"STL",0,3,1,1,0,5,0,1,1,1,0,3,"A","N","2016-02-12","201602120FLA"
"LAK",1,2,1,1,0,5,0,1,2,1,0,4,"A","N","2016-02-12","201602120NYR"
"NYR",0,1,2,1,0,4,1,2,1,1,0,5,"H","N","2016-02-12","201602120NYR"
"NSH",0,1,0,2,0,3,1,0,2,1,0,4,"A","N","2016-02-12","201602120TBL"
"TBL",1,0,2,1,0,4,0,1,0,2,0,3,"H","N","2016-02-12","201602120TBL"
"CAR",0,1,5,0,0,6,0,0,2,1,0,3,"H","N","2016-02-13","201602130CAR"
"NYI",0,0,2,1,0,3,0,1,5,0,0,6,"A","N","2016-02-13","201602130CAR"
"CBJ",0,1,1,2,0,4,0,0,0,2,0,2,"H","N","2016-02-13","201602130CBJ"
"OTT",0,0,0,2,0,2,0,1,1,2,0,4,"A","N","2016-02-13","201602130CBJ"
"ANA",1,0,0,2,0,3,0,0,1,1,0,2,"A","N","2016-02-13","201602130CHI"
"CHI",0,0,1,1,0,2,1,0,0,2,0,3,"H","N","2016-02-13","201602130CHI"
"DAL",0,0,4,0,0,4,0,0,0,3,0,3,"H","N","2016-02-13","201602130DAL"
"WSH",0,0,0,3,0,3,0,0,4,0,0,4,"A","N","2016-02-13","201602130DAL"
"EDM",0,0,0,1,0,1,0,0,1,0,1,2,"H","Y","2016-02-13","201602130EDM"
"WPG",0,0,1,0,1,2,0,0,0,1,0,1,"A","Y","2016-02-13","201602130EDM"
"FLA",0,0,0,0,0,0,0,2,1,2,0,5,"H","N","2016-02-13","201602130FLA"
"NSH",0,2,1,2,0,5,0,0,0,0,0,0,"A","N","2016-02-13","201602130FLA"
"BOS",0,1,1,2,0,4,0,0,1,1,0,2,"A","N","2016-02-13","201602130MIN"
"MIN",0,0,1,1,0,2,0,1,1,2,0,4,"H","N","2016-02-13","201602130MIN"
"NJD",1,1,0,0,0,2,0,0,0,1,0,1,"A","N","2016-02-13","201602130PHI"
"PHI",0,0,0,1,0,1,1,1,0,0,0,2,"H","N","2016-02-13","201602130PHI"
"ARI",0,0,1,0,0,1,0,2,0,2,0,4,"A","N","2016-02-13","201602130SJS"
"SJS",0,2,0,2,0,4,0,0,1,0,0,1,"H","N","2016-02-13","201602130SJS"
"TOR",0,0,2,3,0,5,0,0,1,1,0,2,"A","N","2016-02-13","201602130VAN"
"VAN",0,0,1,1,0,2,0,0,2,3,0,5,"H","N","2016-02-13","201602130VAN"
"BUF",0,3,0,1,0,4,0,0,1,0,0,1,"H","N","2016-02-14","201602140BUF"
"COL",0,0,1,0,0,1,0,3,0,1,0,4,"A","N","2016-02-14","201602140BUF"
"BOS",0,3,1,1,0,5,0,2,3,1,0,6,"A","N","2016-02-14","201602140DET"
"DET",0,2,3,1,0,6,0,3,1,1,0,5,"H","N","2016-02-14","201602140DET"
"LAK",0,0,0,0,0,0,0,1,0,0,0,1,"A","N","2016-02-14","201602140NJD"
"NJD",0,1,0,0,0,1,0,0,0,0,0,0,"H","N","2016-02-14","201602140NJD"
"NYR",0,1,0,2,0,3,0,0,0,1,0,1,"H","N","2016-02-14","201602140NYR"
"PHI",0,0,0,1,0,1,0,1,0,2,0,3,"A","N","2016-02-14","201602140NYR"
"STL",0,0,1,1,0,2,0,0,0,1,0,1,"A","N","2016-02-14","201602140TBL"
"TBL",0,0,0,1,0,1,0,0,1,1,0,2,"H","N","2016-02-14","201602140TBL"
"ARI",0,2,3,1,0,6,0,1,1,0,0,2,"H","N","2016-02-15","201602150ARI"
"MTL",0,1,1,0,0,2,0,2,3,1,0,6,"A","N","2016-02-15","201602150ARI"
"ANA",0,2,3,1,0,6,0,3,1,0,0,4,"A","N","2016-02-15","201602150CGY"
"CGY",0,3,1,0,0,4,0,2,3,1,0,6,"H","N","2016-02-15","201602150CGY"
"CHI",0,2,1,4,0,7,0,0,0,2,0,2,"H","N","2016-02-15","201602150CHI"
"TOR",0,0,0,2,0,2,0,2,1,4,0,7,"A","N","2016-02-15","201602150CHI"
"FLA",0,1,0,0,1,2,0,0,0,1,0,1,"H","Y","2016-02-15","201602150FLA"
"PIT",0,0,0,1,0,1,0,1,0,0,1,2,"A","Y","2016-02-15","201602150FLA"
"DAL",1,0,2,0,0,3,0,1,1,0,0,2,"A","N","2016-02-15","201602150NSH"
"NSH",0,1,1,0,0,2,1,0,2,0,0,3,"H","N","2016-02-15","201602150NSH"
"DET",0,0,0,1,0,1,0,0,3,1,0,4,"A","N","2016-02-15","201602150NYI"
"NYI",0,0,3,1,0,4,0,0,0,1,0,1,"H","N","2016-02-15","201602150NYI"
"MIN",0,2,2,1,0,5,0,1,1,0,0,2,"A","N","2016-02-15","201602150VAN"
"VAN",0,1,1,0,0,2,0,2,2,1,0,5,"H","N","2016-02-15","201602150VAN"
"CAR",0,1,1,0,0,2,0,0,0,1,0,1,"H","N","2016-02-16","201602160CAR"
"WPG",0,0,0,1,0,1,0,1,1,0,0,2,"A","N","2016-02-16","201602160CAR"
"BOS",1,1,0,0,0,2,0,1,0,0,0,1,"A","N","2016-02-16","201602160CBJ"
"CBJ",0,1,0,0,0,1,1,1,0,0,0,2,"H","N","2016-02-16","201602160CBJ"
"ANA",0,1,1,3,0,5,0,0,2,1,0,3,"A","N","2016-02-16","201602160EDM"
"EDM",0,0,2,1,0,3,0,1,1,3,0,5,"H","N","2016-02-16","201602160EDM"
"NJD",0,1,0,2,0,3,0,1,1,4,0,6,"H","N","2016-02-16","201602160NJD"
"PHI",0,1,1,4,0,6,0,1,0,2,0,3,"A","N","2016-02-16","201602160NJD"
"BUF",0,1,0,0,0,1,0,1,0,0,1,2,"A","Y","2016-02-16","201602160OTT"
"OTT",0,1,0,0,1,2,0,1,0,0,0,1,"H","Y","2016-02-16","201602160OTT"
"DAL",0,0,0,1,0,1,1,0,1,0,0,2,"A","N","2016-02-16","201602160STL"
"STL",1,0,1,0,0,2,0,0,0,1,0,1,"H","N","2016-02-16","201602160STL"
"SJS",0,0,2,2,0,4,0,1,1,0,0,2,"A","N","2016-02-16","201602160TBL"
"TBL",0,1,1,0,0,2,0,0,2,2,0,4,"H","N","2016-02-16","201602160TBL"
"LAK",0,1,0,0,0,1,0,0,1,2,0,3,"A","N","2016-02-16","201602160WSH"
"WSH",0,0,1,2,0,3,0,1,0,0,0,1,"H","N","2016-02-16","201602160WSH"
"CGY",0,0,2,1,0,3,0,2,2,1,0,5,"H","N","2016-02-17","201602170CGY"
"MIN",0,2,2,1,0,5,0,0,2,1,0,3,"A","N","2016-02-17","201602170CGY"
"COL",0,0,2,1,0,3,0,1,1,0,0,2,"H","N","2016-02-17","201602170COL"
"MTL",0,1,1,0,0,2,0,0,2,1,0,3,"A","N","2016-02-17","201602170COL"
"CHI",0,1,1,3,0,5,0,0,1,2,0,3,"A","N","2016-02-17","201602170NYR"
"NYR",0,0,1,2,0,3,0,1,1,3,0,5,"H","N","2016-02-17","201602170NYR"
"ARI",0,0,3,3,0,6,0,1,1,1,0,3,"H","N","2016-02-18","201602180ARI"
"DAL",0,1,1,1,0,3,0,0,3,3,0,6,"A","N","2016-02-18","201602180ARI"
"EDM",0,2,0,0,0,2,0,2,2,1,0,5,"H","N","2016-02-18","201602180EDM"
"MIN",0,2,2,1,0,5,0,2,0,0,0,2,"A","N","2016-02-18","201602180EDM"
"FLA",0,0,0,1,0,1,0,0,0,1,1,2,"H","Y","2016-02-18","201602180FLA"
"SJS",0,0,0,1,1,2,0,0,0,1,0,1,"A","Y","2016-02-18","201602180FLA"
"BOS",0,0,0,0,0,0,0,2,0,0,0,2,"A","N","2016-02-18","201602180NSH"
"NSH",0,2,0,0,0,2,0,0,0,0,0,0,"H","N","2016-02-18","201602180NSH"
"NYI",0,1,0,1,0,2,1,0,2,0,0,3,"H","N","2016-02-18","201602180NYI"
"WSH",1,0,2,0,0,3,0,1,0,1,0,2,"A","N","2016-02-18","201602180NYI"
"CAR",0,1,1,0,0,2,0,1,1,2,0,4,"A","N","2016-02-18","201602180OTT"
"OTT",0,1,1,2,0,4,0,1,1,0,0,2,"H","N","2016-02-18","201602180OTT"
"DET",0,1,1,1,0,3,0,2,2,2,0,6,"A","N","2016-02-18","201602180PIT"
"PIT",0,2,2,2,0,6,0,1,1,1,0,3,"H","N","2016-02-18","201602180PIT"
"LAK",0,0,0,1,0,1,1,1,0,0,0,2,"A","N","2016-02-18","201602180STL"
"STL",1,1,0,0,0,2,0,0,0,1,0,1,"H","N","2016-02-18","201602180STL"
"TBL",0,3,0,2,1,6,0,0,1,4,0,5,"H","Y","2016-02-18","201602180TBL"
"WPG",0,0,1,4,0,5,0,3,0,2,1,6,"A","Y","2016-02-18","201602180TBL"
"NYR",0,0,2,2,0,4,0,1,0,1,0,2,"A","N","2016-02-18","201602180TOR"
"TOR",0,1,0,1,0,2,0,0,2,2,0,4,"H","N","2016-02-18","201602180TOR"
"ANA",0,0,2,3,0,5,0,0,0,2,0,2,"A","N","2016-02-18","201602180VAN"
"VAN",0,0,0,2,0,2,0,0,2,3,0,5,"H","N","2016-02-18","201602180VAN"
"CAR",0,1,1,3,0,5,0,1,0,1,0,2,"H","N","2016-02-19","201602190CAR"
"SJS",0,1,0,1,0,2,0,1,1,3,0,5,"A","N","2016-02-19","201602190CAR"
"BUF",0,2,0,2,0,4,0,0,0,0,0,0,"A","N","2016-02-19","201602190CBJ"
"CBJ",0,0,0,0,0,0,0,2,0,2,0,4,"H","N","2016-02-19","201602190CBJ"
"CGY",0,1,3,1,0,5,0,2,0,0,0,2,"H","N","2016-02-19","201602190CGY"
"VAN",0,2,0,0,0,2,0,1,3,1,0,5,"A","N","2016-02-19","201602190CGY"
"MTL",0,1,0,1,1,3,0,1,0,1,0,2,"H","Y","2016-02-19","201602190MTL"
"PHI",0,1,0,1,0,2,0,1,0,1,1,3,"A","Y","2016-02-19","201602190MTL"
"NJD",0,0,0,0,0,0,0,1,0,0,0,1,"H","N","2016-02-19","201602190NJD"
"NYI",0,1,0,0,0,1,0,0,0,0,0,0,"A","N","2016-02-19","201602190NJD"
"ARI",0,1,1,2,0,4,0,4,0,2,0,6,"H","N","2016-02-20","201602200ARI"
"STL",0,4,0,2,0,6,0,1,1,2,0,4,"A","N","2016-02-20","201602200ARI"
"BOS",0,1,3,3,0,7,0,3,0,0,0,3,"A","N","2016-02-20","201602200DAL"
"DAL",0,3,0,0,0,3,0,1,3,3,0,7,"H","N","2016-02-20","201602200DAL"
"COL",0,1,1,1,0,3,0,1,0,1,0,2,"A","N","2016-02-20","201602200EDM"
"EDM",0,1,0,1,0,2,0,1,1,1,0,3,"H","N","2016-02-20","201602200EDM"
"FLA",0,0,1,2,0,3,0,1,0,0,0,1,"H","N","2016-02-20","201602200FLA"
"WPG",0,1,0,0,0,1,0,0,1,2,0,3,"A","N","2016-02-20","201602200FLA"
"LAK",1,1,0,0,0,2,0,1,0,0,0,1,"A","N","2016-02-20","201602200NSH"
"NSH",0,1,0,0,0,1,1,1,0,0,0,2,"H","N","2016-02-20","201602200NSH"
"DET",0,0,2,0,0,2,0,0,1,1,1,3,"A","Y","2016-02-20","201602200OTT"
"OTT",0,0,1,1,1,3,0,0,2,0,0,2,"H","Y","2016-02-20","201602200OTT"
"PIT",0,0,2,0,0,2,0,2,2,0,0,4,"H","N","2016-02-20","201602200PIT"
"TBL",0,2,2,0,0,4,0,0,2,0,0,2,"A","N","2016-02-20","201602200PIT"
"PHI",1,2,1,1,0,5,0,1,1,2,0,4,"A","N","2016-02-20","201602200TOR"
"TOR",0,1,1,2,0,4,1,2,1,1,0,5,"H","N","2016-02-20","201602200TOR"
"NJD",0,2,0,1,0,3,0,1,1,2,0,4,"A","N","2016-02-20","201602200WSH"
"WSH",0,1,1,2,0,4,0,2,0,1,0,3,"H","N","2016-02-20","201602200WSH"
"ANA",0,1,1,3,0,5,0,0,1,1,0,2,"H","N","2016-02-21","201602210ANA"
"CGY",0,0,1,1,0,2,0,1,1,3,0,5,"A","N","2016-02-21","201602210ANA"
"BUF",0,1,0,2,0,3,0,1,2,1,0,4,"H","N","2016-02-21","201602210BUF"
"PIT",0,1,2,1,0,4,0,1,0,2,0,3,"A","N","2016-02-21","201602210BUF"
"CAR",0,1,1,0,0,2,0,0,2,2,0,4,"H","N","2016-02-21","201602210CAR"
"TBL",0,0,2,2,0,4,0,1,1,0,0,2,"A","N","2016-02-21","201602210CAR"
"CHI",0,0,0,1,0,1,0,2,2,2,0,6,"A","N","2016-02-21","201602210MIN"
"MIN",0,2,2,2,0,6,0,0,0,1,0,1,"H","N","2016-02-21","201602210MIN"
"DET",0,0,0,0,0,0,1,0,0,0,0,1,"A","N","2016-02-21","201602210NYR"
"NYR",1,0,0,0,0,1,0,0,0,0,0,0,"H","N","2016-02-21","201602210NYR"
"COL",0,0,0,1,0,1,0,2,1,2,0,5,"A","N","2016-02-21","201602210VAN"
"VAN",0,2,1,2,0,5,0,0,0,1,0,1,"H","N","2016-02-21","201602210VAN"
"BOS",0,1,1,2,0,4,0,1,3,2,0,6,"H","N","2016-02-22","201602220BOS"
"CBJ",0,1,3,2,0,6,0,1,1,2,0,4,"A","N","2016-02-22","201602220BOS"
"MTL",0,1,0,0,0,1,0,1,0,0,1,2,"H","Y","2016-02-22","201602220MTL"
"NSH",0,1,0,0,1,2,0,1,0,0,0,1,"A","Y","2016-02-22","201602220MTL"
"SJS",0,3,1,2,0,6,0,1,1,1,0,3,"A","N","2016-02-22","201602220STL"
"STL",0,1,1,1,0,3,0,3,1,2,0,6,"H","N","2016-02-22","201602220STL"
"ARI",0,0,1,1,0,2,0,0,1,2,0,3,"A","N","2016-02-22","201602220WSH"
"WSH",0,0,1,2,0,3,0,0,1,1,0,2,"H","N","2016-02-22","201602220WSH"
"CAR",0,0,2,1,0,3,0,1,0,0,0,1,"H","N","2016-02-23","201602230CAR"
"PHI",0,1,0,0,0,1,0,0,2,1,0,3,"A","N","2016-02-23","201602230CAR"
"CBJ",0,1,0,0,0,1,0,0,1,0,1,2,"A","Y","2016-02-23","201602230DET"
"DET",0,0,1,0,1,2,0,1,0,0,0,1,"H","Y","2016-02-23","201602230DET"
"EDM",0,0,1,0,0,1,0,1,1,2,0,4,"H","N","2016-02-23","201602230EDM"
"OTT",0,1,1,2,0,4,0,0,1,0,0,1,"A","N","2016-02-23","201602230EDM"
"CGY",0,0,1,0,0,1,0,0,2,0,0,2,"A","N","2016-02-23","201602230LAK"
"LAK",0,0,2,0,0,2,0,0,1,0,0,1,"H","N","2016-02-23","201602230LAK"
"MIN",0,0,1,0,0,1,0,2,0,2,0,4,"H","N","2016-02-23","201602230MIN"
"NYI",0,2,0,2,0,4,0,0,1,0,0,1,"A","N","2016-02-23","201602230MIN"
"NJD",0,1,2,2,0,5,0,2,0,0,0,2,"H","N","2016-02-23","201602230NJD"
"NYR",0,2,0,0,0,2,0,1,2,2,0,5,"A","N","2016-02-23","201602230NJD"
"ARI",0,0,0,1,0,1,0,1,1,0,0,2,"A","N","2016-02-23","201602230TBL"
"TBL",0,1,1,0,0,2,0,0,0,1,0,1,"H","N","2016-02-23","201602230TBL"
"NSH",0,1,2,0,0,3,0,0,0,2,0,2,"A","N","2016-02-23","201602230TOR"
"TOR",0,0,0,2,0,2,0,1,2,0,0,3,"H","N","2016-02-23","201602230TOR"
"DAL",0,1,1,3,0,5,0,0,2,1,0,3,"A","N","2016-02-23","201602230WPG"
"WPG",0,0,2,1,0,3,0,1,1,3,0,5,"H","N","2016-02-23","201602230WPG"
"ANA",0,0,1,0,0,1,0,0,0,0,0,0,"H","N","2016-02-24","201602240ANA"
"BUF",0,0,0,0,0,0,0,0,1,0,0,1,"A","N","2016-02-24","201602240ANA"
"BOS",0,1,1,3,0,5,0,0,1,0,0,1,"H","N","2016-02-24","201602240BOS"
"PIT",0,0,1,0,0,1,0,1,1,3,0,5,"A","N","2016-02-24","201602240BOS"
"COL",0,1,0,2,1,4,0,1,0,2,0,3,"H","Y","2016-02-24","201602240COL"
"SJS",0,1,0,2,0,3,0,1,0,2,1,4,"A","Y","2016-02-24","201602240COL"
"MTL",0,2,2,0,0,4,0,0,1,2,0,3,"A","N","2016-02-24","201602240WSH"
"WSH",0,0,1,2,0,3,0,2,2,0,0,4,"H","N","2016-02-24","201602240WSH"
"CBJ",0,3,2,1,0,6,0,0,1,0,0,1,"H","N","2016-02-25","201602250CBJ"
"NJD",0,0,1,0,0,1,0,3,2,1,0,6,"A","N","2016-02-25","201602250CBJ"
"CGY",0,1,0,0,0,1,1,0,0,1,0,2,"H","N","2016-02-25","201602250CGY"
"NYI",1,0,0,1,0,2,0,1,0,0,0,1,"A","N","2016-02-25","201602250CGY"
"CHI",0,0,1,0,0,1,0,0,1,2,0,3,"H","N","2016-02-25","201602250CHI"
"NSH",0,0,1,2,0,3,0,0,1,0,0,1,"A","N","2016-02-25","201602250CHI"
"DAL",0,0,2,1,0,3,0,3,0,3,0,6,"H","N","2016-02-25","201602250DAL"
"WPG",0,3,0,3,0,6,0,0,2,1,0,3,"A","N","2016-02-25","201602250DAL"
"ARI",0,1,0,1,0,2,0,1,1,1,0,3,"A","N","2016-02-25","201602250FLA"
"FLA",0,1,1,1,0,3,0,1,0,1,0,2,"H","N","2016-02-25","201602250FLA"
"EDM",0,0,1,0,0,1,0,0,0,2,0,2,"A","N","2016-02-25","201602250LAK"
"LAK",0,0,0,2,0,2,0,0,1,0,0,1,"H","N","2016-02-25","201602250LAK"
"MIN",0,0,2,0,0,2,0,1,1,1,0,3,"A","N","2016-02-25","201602250PHI"
"PHI",0,1,1,1,0,3,0,0,2,0,0,2,"H","N","2016-02-25","201602250PHI"
"NYR",0,1,0,1,0,2,0,0,1,0,0,1,"A","N","2016-02-25","201602250STL"
"STL",0,0,1,0,0,1,0,1,0,1,0,2,"H","N","2016-02-25","201602250STL"
"CAR",0,1,0,0,0,1,0,1,1,1,0,3,"A","N","2016-02-25","201602250TOR"
"TOR",0,1,1,1,0,3,0,1,0,0,0,1,"H","N","2016-02-25","201602250TOR"
"OTT",0,1,2,0,0,3,0,1,1,3,0,5,"A","N","2016-02-25","201602250VAN"
"VAN",0,1,1,3,0,5,0,1,2,0,0,3,"H","N","2016-02-25","201602250VAN"
"ANA",1,0,0,1,0,2,0,0,0,1,0,1,"H","N","2016-02-26","201602260ANA"
"EDM",0,0,0,1,0,1,1,0,0,1,0,2,"A","N","2016-02-26","201602260ANA"
"BOS",0,2,0,2,0,4,0,0,0,1,0,1,"A","N","2016-02-26","201602260CAR"
"CAR",0,0,0,1,0,1,0,2,0,2,0,4,"H","N","2016-02-26","201602260CAR"
"NJD",0,0,0,0,0,0,0,1,2,1,0,4,"H","N","2016-02-26","201602260NJD"
"TBL",0,1,2,1,0,4,0,0,0,0,0,0,"A","N","2016-02-26","201602260NJD"
"BUF",0,0,1,2,0,3,0,1,0,0,0,1,"A","N","2016-02-26","201602260SJS"
"SJS",0,1,0,0,0,1,0,0,1,2,0,3,"H","N","2016-02-26","201602260SJS"
"MIN",0,1,1,0,0,2,0,0,1,2,0,3,"A","N","2016-02-26","201602260WSH"
"WSH",0,0,1,2,0,3,0,1,1,0,0,2,"H","N","2016-02-26","201602260WSH"
"CBJ",0,0,1,2,1,4,0,1,1,1,0,3,"H","Y","2016-02-27","201602270CBJ"
"FLA",0,1,1,1,0,3,0,0,1,2,1,4,"A","Y","2016-02-27","201602270CBJ"
"CGY",0,2,2,0,0,4,0,1,1,4,0,6,"H","N","2016-02-27","201602270CGY"
"OTT",0,1,1,4,0,6,0,2,2,0,0,4,"A","N","2016-02-27","201602270CGY"
"COL",0,2,0,1,0,3,0,1,0,4,0,5,"H","N","2016-02-27","201602270COL"
"DET",0,1,0,4,0,5,0,2,0,1,0,3,"A","N","2016-02-27","201602270COL"
"DAL",0,0,1,1,0,2,0,0,1,2,0,3,"H","N","2016-02-27","201602270DAL"
"NYR",0,0,1,2,0,3,0,0,1,1,0,2,"A","N","2016-02-27","201602270DAL"
"BUF",0,0,0,0,0,0,0,0,1,1,0,2,"A","N","2016-02-27","201602270LAK"
"LAK",0,0,1,1,0,2,0,0,0,0,0,0,"H","N","2016-02-27","201602270LAK"
"MTL",0,1,1,2,0,4,0,1,0,0,0,1,"H","N","2016-02-27","201602270MTL"
"TOR",0,1,0,0,0,1,0,1,1,2,0,4,"A","N","2016-02-27","201602270MTL"
"NSH",0,1,3,1,0,5,0,0,0,0,0,0,"H","N","2016-02-27","201602270NSH"
"STL",0,0,0,0,0,0,0,1,3,1,0,5,"A","N","2016-02-27","201602270NSH"
"ARI",0,1,0,1,0,2,0,3,0,1,0,4,"A","N","2016-02-27","201602270PHI"
"PHI",0,3,0,1,0,4,0,1,0,1,0,2,"H","N","2016-02-27","201602270PHI"
"PIT",0,0,2,2,0,4,0,0,1,0,0,1,"H","N","2016-02-27","201602270PIT"
"WPG",0,0,1,0,0,1,0,0,2,2,0,4,"A","N","2016-02-27","201602270PIT"
"ANA",0,1,1,2,0,4,0,1,1,0,0,2,"H","N","2016-02-28","201602280ANA"
"LAK",0,1,1,0,0,2,0,1,1,2,0,4,"A","N","2016-02-28","201602280ANA"
"BOS",0,1,0,0,0,1,0,2,2,0,0,4,"H","N","2016-02-28","201602280BOS"
"TBL",0,2,2,0,0,4,0,1,0,0,0,1,"A","N","2016-02-28","201602280BOS"
"CAR",0,2,0,0,0,2,0,1,2,2,0,5,"H","N","2016-02-28","201602280CAR"
"STL",0,1,2,2,0,5,0,2,0,0,0,2,"A","N","2016-02-28","201602280CAR"
"CHI",0,1,1,1,0,3,0,1,0,1,0,2,"H","N","2016-02-28","201602280CHI"
"WSH",0,1,0,1,0,2,0,1,1,1,0,3,"A","N","2016-02-28","201602280CHI"
"EDM",0,0,0,3,0,3,0,0,1,0,0,1,"H","N","2016-02-28","201602280EDM"
"NYI",0,0,1,0,0,1,0,0,0,3,0,3,"A","N","2016-02-28","201602280EDM"
"FLA",0,0,1,0,0,1,0,1,0,2,0,3,"A","N","2016-02-28","201602280MIN"
"MIN",0,1,0,2,0,3,0,0,1,0,0,1,"H","N","2016-02-28","201602280MIN"
"SJS",0,0,0,4,0,4,0,0,1,0,0,1,"A","N","2016-02-28","201602280VAN"
"VAN",0,0,1,0,0,1,0,0,0,4,0,4,"H","N","2016-02-28","201602280VAN"
"DAL",0,0,1,1,0,2,1,0,1,1,0,3,"H","N","2016-02-29","201602290DAL"
"DET",1,0,1,1,0,3,0,0,1,1,0,2,"A","N","2016-02-29","201602290DAL"
"CBJ",0,0,0,1,0,1,0,1,0,1,0,2,"A","N","2016-02-29","201602290NYR"
"NYR",0,1,0,1,0,2,0,0,0,1,0,1,"H","N","2016-02-29","201602290NYR"
"CGY",0,1,0,2,0,3,0,1,3,1,0,5,"A","N","2016-02-29","201602290PHI"
"PHI",0,1,3,1,0,5,0,1,0,2,0,3,"H","N","2016-02-29","201602290PHI"
"ARI",0,0,0,0,0,0,0,2,2,2,0,6,"A","N","2016-02-29","201602290PIT"
"PIT",0,2,2,2,0,6,0,0,0,0,0,0,"H","N","2016-02-29","201602290PIT"
"MTL",0,1,1,0,0,2,0,2,1,3,0,6,"A","N","2016-02-29","201602290SJS"
"SJS",0,2,1,3,0,6,0,1,1,0,0,2,"H","N","2016-02-29","201602290SJS"
"TBL",0,0,2,0,0,2,0,0,0,1,0,1,"A","N","2016-02-29","201602290TOR"
"TOR",0,0,0,1,0,1,0,0,2,0,0,2,"H","N","2016-02-29","201602290TOR"
"BOS",0,1,0,1,0,2,0,0,0,1,0,1,"H","N","2016-03-01","201603010BOS"
"CGY",0,0,0,1,0,1,0,1,0,1,0,2,"A","N","2016-03-01","201603010BOS"
"BUF",0,0,0,1,0,1,1,1,0,0,0,2,"H","N","2016-03-01","201603010BUF"
"EDM",1,1,0,0,0,2,0,0,0,1,0,1,"A","N","2016-03-01","201603010BUF"
"COL",0,1,2,0,0,3,0,3,0,3,0,6,"A","N","2016-03-01","201603010MIN"
"MIN",0,3,0,3,0,6,0,1,2,0,0,3,"H","N","2016-03-01","201603010MIN"
"CAR",0,0,1,2,0,3,0,1,0,0,0,1,"A","N","2016-03-01","201603010NJD"
"NJD",0,1,0,0,0,1,0,0,1,2,0,3,"H","N","2016-03-01","201603010NJD"
"DAL",0,1,1,1,0,3,0,1,3,1,0,5,"A","N","2016-03-01","201603010NSH"
"NSH",0,1,3,1,0,5,0,1,1,1,0,3,"H","N","2016-03-01","201603010NSH"
"OTT",0,0,1,2,0,3,0,2,1,0,1,4,"H","Y","2016-03-01","201603010OTT"
"STL",0,2,1,0,1,4,0,0,1,2,0,3,"A","Y","2016-03-01","201603010OTT"
"NYI",0,1,1,1,0,3,0,1,0,1,0,2,"A","N","2016-03-01","201603010VAN"
"VAN",0,1,0,1,0,2,0,1,1,1,0,3,"H","N","2016-03-01","201603010VAN"
"FLA",0,1,0,2,0,3,0,0,2,0,0,2,"A","N","2016-03-01","201603010WPG"
"WPG",0,0,2,0,0,2,0,1,0,2,0,3,"H","N","2016-03-01","201603010WPG"
"PIT",0,1,1,0,0,2,0,0,2,1,0,3,"A","N","2016-03-01","201603010WSH"
"WSH",0,0,2,1,0,3,0,1,1,0,0,2,"H","N","2016-03-01","201603010WSH"
"ANA",0,0,1,1,1,3,0,0,1,1,0,2,"H","Y","2016-03-02","201603020ANA"
"MTL",0,0,1,1,0,2,0,0,1,1,1,3,"A","Y","2016-03-02","201603020ANA"
"CHI",0,1,2,2,0,5,0,0,0,2,0,2,"A","N","2016-03-02","201603020DET"
"DET",0,0,0,2,0,2,0,1,2,2,0,5,"H","N","2016-03-02","201603020DET"
"TOR",0,0,1,1,0,2,0,2,0,1,0,3,"A","N","2016-03-02","201603020WSH"
"WSH",0,2,0,1,0,3,0,0,1,1,0,2,"H","N","2016-03-02","201603020WSH"
"ANA",0,2,3,0,0,5,0,0,1,0,0,1,"A","N","2016-03-03","201603030ARI"
"ARI",0,0,1,0,0,1,0,2,3,0,0,5,"H","N","2016-03-03","201603030ARI"
"BOS",0,2,2,0,0,4,0,1,1,0,0,2,"H","N","2016-03-03","201603030BOS"
"CHI",0,1,1,0,0,2,0,2,2,0,0,4,"A","N","2016-03-03","201603030BOS"
"BUF",0,0,3,3,0,6,0,0,2,1,0,3,"H","N","2016-03-03","201603030BUF"
"CGY",0,0,2,1,0,3,0,0,3,3,0,6,"A","N","2016-03-03","201603030BUF"
"COL",0,2,1,0,0,3,0,1,1,0,0,2,"H","N","2016-03-03","201603030COL"
"FLA",0,1,1,0,0,2,0,2,1,0,0,3,"A","N","2016-03-03","201603030COL"
"LAK",0,2,0,1,0,3,0,1,0,1,0,2,"H","N","2016-03-03","201603030LAK"
"MTL",0,1,0,1,0,2,0,2,0,1,0,3,"A","N","2016-03-03","201603030LAK"
"NJD",1,1,1,2,0,5,0,2,1,1,0,4,"A","N","2016-03-03","201603030NSH"
"NSH",0,2,1,1,0,4,1,1,1,2,0,5,"H","N","2016-03-03","201603030NSH"
"OTT",0,0,0,1,0,1,0,0,2,2,0,4,"H","N","2016-03-03","201603030OTT"
"TBL",0,0,2,2,0,4,0,0,0,1,0,1,"A","N","2016-03-03","201603030OTT"
"EDM",0,1,2,1,0,4,0,0,0,0,0,0,"A","N","2016-03-03","201603030PHI"
"PHI",0,0,0,0,0,0,0,1,2,1,0,4,"H","N","2016-03-03","201603030PHI"
"NYR",0,0,1,0,0,1,0,0,3,1,0,4,"A","N","2016-03-03","201603030PIT"
"PIT",0,0,3,1,0,4,0,0,1,0,0,1,"H","N","2016-03-03","201603030PIT"
"MIN",0,0,1,1,0,2,0,0,1,0,0,1,"A","N","2016-03-03","201603030TOR"
"TOR",0,0,1,0,0,1,0,0,1,1,0,2,"H","N","2016-03-03","201603030TOR"
"SJS",0,0,1,2,0,3,0,2,0,0,0,2,"A","N","2016-03-03","201603030VAN"
"VAN",0,2,0,0,0,2,0,0,1,2,0,3,"H","N","2016-03-03","201603030VAN"
"NYI",1,0,1,2,0,4,0,1,0,2,0,3,"A","N","2016-03-03","201603030WPG"
"WPG",0,1,0,2,0,3,1,0,1,2,0,4,"H","N","2016-03-03","201603030WPG"
"CBJ",0,2,3,1,0,6,0,0,2,1,0,3,"H","N","2016-03-04","201603040CBJ"
"EDM",0,0,2,1,0,3,0,2,3,1,0,6,"A","N","2016-03-04","201603040CBJ"
"DAL",0,1,2,1,0,4,0,0,1,1,0,2,"H","N","2016-03-04","201603040DAL"
"NJD",0,0,1,1,0,2,0,1,2,1,0,4,"A","N","2016-03-04","201603040DAL"
"NYR",0,2,0,1,0,3,0,0,2,0,0,2,"A","N","2016-03-04","201603040WSH"
"WSH",0,0,2,0,0,2,0,2,0,1,0,3,"H","N","2016-03-04","201603040WSH"
"ARI",0,0,2,3,0,5,0,0,1,0,0,1,"H","N","2016-03-05","201603050ARI"
"FLA",0,0,1,0,0,1,0,0,2,3,0,5,"A","N","2016-03-05","201603050ARI"
"BOS",0,1,0,0,0,1,1,0,1,0,0,2,"H","N","2016-03-05","201603050BOS"
"WSH",1,0,1,0,0,2,0,1,0,0,0,1,"A","N","2016-03-05","201603050BOS"
"BUF",0,0,2,0,0,2,0,1,0,1,1,3,"H","Y","2016-03-05","201603050BUF"
"MIN",0,1,0,1,1,3,0,0,2,0,0,2,"A","Y","2016-03-05","201603050BUF"
"COL",0,1,1,0,0,2,0,0,1,4,0,5,"H","N","2016-03-05","201603050COL"
"NSH",0,0,1,4,0,5,0,1,1,0,0,2,"A","N","2016-03-05","201603050COL"
"ANA",0,0,2,1,0,3,0,0,1,1,0,2,"A","N","2016-03-05","201603050LAK"
"LAK",0,0,1,1,0,2,0,0,2,1,0,3,"H","N","2016-03-05","201603050LAK"
"CBJ",0,0,0,0,0,0,0,2,2,2,0,6,"A","N","2016-03-05","201603050PHI"
"PHI",0,2,2,2,0,6,0,0,0,0,0,0,"H","N","2016-03-05","201603050PHI"
"CGY",0,1,2,1,0,4,0,1,1,0,0,2,"A","N","2016-03-05","201603050PIT"
"PIT",0,1,1,0,0,2,0,1,2,1,0,4,"H","N","2016-03-05","201603050PIT"
"SJS",0,1,0,1,0,2,0,1,1,2,0,4,"H","N","2016-03-05","201603050SJS"
"VAN",0,1,1,2,0,4,0,1,0,1,0,2,"A","N","2016-03-05","201603050SJS"
"CAR",0,0,1,2,0,3,1,1,1,1,0,4,"A","N","2016-03-05","201603050TBL"
"TBL",1,1,1,1,0,4,0,0,1,2,0,3,"H","N","2016-03-05","201603050TBL"
"OTT",0,1,0,2,0,3,0,1,1,0,0,2,"A","N","2016-03-05","201603050TOR"
"TOR",0,1,1,0,0,2,0,1,0,2,0,3,"H","N","2016-03-05","201603050TOR"
"MTL",0,0,1,1,0,2,0,0,1,3,0,4,"A","N","2016-03-05","201603050WPG"
"WPG",0,0,1,3,0,4,0,0,1,1,0,2,"H","N","2016-03-05","201603050WPG"
"CHI",0,2,0,2,0,4,0,1,0,0,0,1,"H","N","2016-03-06","201603060CHI"
"DET",0,1,0,0,0,1,0,2,0,2,0,4,"A","N","2016-03-06","201603060CHI"
"MIN",0,0,0,2,0,2,0,2,1,1,0,4,"H","N","2016-03-06","201603060MIN"
"STL",0,2,1,1,0,4,0,0,0,2,0,2,"A","N","2016-03-06","201603060MIN"
"NJD",0,0,1,0,0,1,0,2,2,2,0,6,"H","N","2016-03-06","201603060NJD"
"PIT",0,2,2,2,0,6,0,0,1,0,0,1,"A","N","2016-03-06","201603060NJD"
"NYI",0,4,0,2,0,6,0,3,0,1,0,4,"A","N","2016-03-06","201603060NYR"
"NYR",0,3,0,1,0,4,0,4,0,2,0,6,"H","N","2016-03-06","201603060NYR"
"DAL",0,0,1,1,0,2,0,0,1,0,0,1,"A","N","2016-03-06","201603060OTT"
"OTT",0,0,1,0,0,1,0,0,1,1,0,2,"H","N","2016-03-06","201603060OTT"
"EDM",0,0,2,0,0,2,0,0,1,0,0,1,"A","N","2016-03-06","201603060WPG"
"WPG",0,0,1,0,0,1,0,0,2,0,0,2,"H","N","2016-03-06","201603060WPG"
"ANA",0,1,0,0,0,1,0,0,0,1,1,2,"H","Y","2016-03-07","201603070ANA"
"WSH",0,0,0,1,1,2,0,1,0,0,0,1,"A","Y","2016-03-07","201603070ANA"
"CGY",0,0,0,1,0,1,1,1,0,0,0,2,"H","N","2016-03-07","201603070CGY"
"SJS",1,1,0,0,0,2,0,0,0,1,0,1,"A","N","2016-03-07","201603070CGY"
"ARI",0,0,0,1,0,1,0,1,1,1,0,3,"A","N","2016-03-07","201603070COL"
"COL",0,1,1,1,0,3,0,0,0,1,0,1,"H","N","2016-03-07","201603070COL"
"BOS",1,4,0,0,0,5,0,1,2,1,0,4,"A","N","2016-03-07","201603070FLA"
"FLA",0,1,2,1,0,4,1,4,0,0,0,5,"H","N","2016-03-07","201603070FLA"
"LAK",0,0,2,3,0,5,0,0,1,0,0,1,"H","N","2016-03-07","201603070LAK"
"VAN",0,0,1,0,0,1,0,0,2,3,0,5,"A","N","2016-03-07","201603070LAK"
"PHI",0,0,1,3,0,4,0,1,0,1,0,2,"H","N","2016-03-07","201603070PHI"
"TBL",0,1,0,1,0,2,0,0,1,3,0,4,"A","N","2016-03-07","201603070PHI"
"BUF",0,0,1,2,1,4,0,2,1,0,0,3,"A","Y","2016-03-07","201603070TOR"
"TOR",0,2,1,0,0,3,0,0,1,2,1,4,"H","Y","2016-03-07","201603070TOR"
"BUF",0,0,2,0,0,2,0,1,2,1,0,4,"H","N","2016-03-08","201603080BUF"
"NYR",0,1,2,1,0,4,0,0,2,0,0,2,"A","N","2016-03-08","201603080BUF"
"CAR",0,0,2,1,1,4,0,2,1,0,0,3,"H","Y","2016-03-08","201603080CAR"
"OTT",0,2,1,0,0,3,0,0,2,1,1,4,"A","Y","2016-03-08","201603080CAR"
"CBJ",0,0,2,3,0,5,0,0,1,2,0,3,"H","N","2016-03-08","201603080CBJ"
"DET",0,0,1,2,0,3,0,0,2,3,0,5,"A","N","2016-03-08","201603080CBJ"
"EDM",0,0,0,0,0,0,0,2,1,0,0,3,"H","N","2016-03-08","201603080EDM"
"SJS",0,2,1,0,0,3,0,0,0,0,0,0,"A","N","2016-03-08","201603080EDM"
"DAL",0,1,2,0,0,3,1,1,2,0,0,4,"A","N","2016-03-08","201603080MTL"
"MTL",1,1,2,0,0,4,0,1,2,0,0,3,"H","N","2016-03-08","201603080MTL"
"NYI",0,1,0,1,0,2,0,1,0,0,0,1,"H","N","2016-03-08","201603080NYI"
"PIT",0,1,0,0,0,1,0,1,0,1,0,2,"A","N","2016-03-08","201603080NYI"
"BOS",1,0,0,0,0,1,0,0,0,0,0,0,"A","N","2016-03-08","201603080TBL"
"TBL",0,0,0,0,0,0,1,0,0,0,0,1,"H","N","2016-03-08","201603080TBL"
"NSH",0,2,0,2,0,4,0,1,0,1,0,2,"A","N","2016-03-08","201603080WPG"
"WPG",0,1,0,1,0,2,0,2,0,2,0,4,"H","N","2016-03-08","201603080WPG"
"CGY",1,2,0,0,0,3,0,0,0,2,0,2,"H","N","2016-03-09","201603090CGY"
"NSH",0,0,0,2,0,2,1,2,0,0,0,3,"A","N","2016-03-09","201603090CGY"
"ANA",0,0,0,0,0,0,0,1,2,0,0,3,"A","N","2016-03-09","201603090COL"
"COL",0,1,2,0,0,3,0,0,0,0,0,0,"H","N","2016-03-09","201603090COL"
"LAK",1,3,0,0,0,4,0,0,0,3,0,3,"H","N","2016-03-09","201603090LAK"
"WSH",0,0,0,3,0,3,1,3,0,0,0,4,"A","N","2016-03-09","201603090LAK"
"CHI",0,0,1,1,0,2,0,0,0,2,1,3,"A","Y","2016-03-09","201603090STL"
"STL",0,0,0,2,1,3,0,0,1,1,0,2,"H","Y","2016-03-09","201603090STL"
"NYI",0,1,1,1,0,3,0,1,1,1,1,4,"A","Y","2016-03-09","201603090TOR"
"TOR",0,1,1,1,1,4,0,1,1,1,0,3,"H","Y","2016-03-09","201603090TOR"
"ARI",0,0,2,0,0,2,1,0,2,0,0,3,"A","N","2016-03-09","201603090VAN"
"VAN",1,0,2,0,0,3,0,0,2,0,0,2,"H","N","2016-03-09","201603090VAN"
"BOS",0,0,1,1,0,2,1,1,1,0,0,3,"H","N","2016-03-10","201603100BOS"
"CAR",1,1,1,0,0,3,0,0,1,1,0,2,"A","N","2016-03-10","201603100BOS"
"DET",0,0,2,1,0,3,0,2,0,0,0,2,"H","N","2016-03-10","201603100DET"
"WPG",0,2,0,0,0,2,0,0,2,1,0,3,"A","N","2016-03-10","201603100DET"
"FLA",0,1,3,2,0,6,0,1,1,0,0,2,"H","N","2016-03-10","201603100FLA"
"OTT",0,1,1,0,0,2,0,1,3,2,0,6,"A","N","2016-03-10","201603100FLA"
"EDM",0,1,0,1,0,2,0,0,1,0,0,1,"A","N","2016-03-10","201603100MIN"
"MIN",0,0,1,0,0,1,0,1,0,1,0,2,"H","N","2016-03-10","201603100MIN"
"BUF",0,0,1,1,0,2,0,0,2,1,0,3,"A","N","2016-03-10","201603100MTL"
"MTL",0,0,2,1,0,3,0,0,1,1,0,2,"H","N","2016-03-10","201603100MTL"
"NJD",0,0,1,2,0,3,0,0,0,0,0,0,"A","N","2016-03-10","201603100SJS"
"SJS",0,0,0,0,0,0,0,0,1,2,0,3,"H","N","2016-03-10","201603100SJS"
"CBJ",0,1,1,0,0,2,0,1,2,0,0,3,"H","N","2016-03-11","201603110CBJ"
"PIT",0,1,2,0,0,3,0,1,1,0,0,2,"A","N","2016-03-11","201603110CBJ"
"ARI",0,0,1,3,0,4,0,0,1,0,0,1,"A","N","2016-03-11","201603110CGY"
"CGY",0,0,1,0,0,1,0,0,1,3,0,4,"H","N","2016-03-11","201603110CGY"
"CHI",0,0,1,1,0,2,0,1,3,1,0,5,"A","N","2016-03-11","201603110DAL"
"DAL",0,1,3,1,0,5,0,0,1,1,0,2,"H","N","2016-03-11","201603110DAL"
"ANA",0,0,1,1,0,2,0,0,1,4,0,5,"A","N","2016-03-11","201603110STL"
"STL",0,0,1,4,0,5,0,0,1,1,0,2,"H","N","2016-03-11","201603110STL"
"PHI",0,1,2,0,0,3,0,0,0,1,0,1,"A","N","2016-03-11","201603110TBL"
"TBL",0,0,0,1,0,1,0,1,2,0,0,3,"H","N","2016-03-11","201603110TBL"
"BOS",0,1,1,1,0,3,0,0,1,0,0,1,"H","N","2016-03-12","201603120BOS"
"NYI",0,0,1,0,0,1,0,1,1,1,0,3,"A","N","2016-03-12","201603120BOS"
"BUF",1,0,1,1,0,3,0,0,1,1,0,2,"H","N","2016-03-12","201603120BUF"
"CAR",0,0,1,1,0,2,1,0,1,1,0,3,"A","N","2016-03-12","201603120BUF"
"DAL",0,1,1,2,0,4,1,1,3,0,0,5,"H","N","2016-03-12","201603120DAL"
"STL",1,1,3,0,0,5,0,1,1,2,0,4,"A","N","2016-03-12","201603120DAL"
"DET",1,0,0,2,0,3,0,1,0,1,0,2,"H","N","2016-03-12","201603120DET"
"NYR",0,1,0,1,0,2,1,0,0,2,0,3,"A","N","2016-03-12","201603120DET"
"ARI",0,1,2,1,0,4,0,0,0,0,0,0,"A","N","2016-03-12","201603120EDM"
"EDM",0,0,0,0,0,0,0,1,2,1,0,4,"H","N","2016-03-12","201603120EDM"
"FLA",0,1,1,2,1,5,0,1,1,2,0,4,"H","Y","2016-03-12","201603120FLA"
"PHI",0,1,1,2,0,4,0,1,1,2,1,5,"A","Y","2016-03-12","201603120FLA"
"LAK",0,0,1,0,0,1,1,1,0,0,0,2,"H","N","2016-03-12","201603120LAK"
"NJD",1,1,0,0,0,2,0,0,1,0,0,1,"A","N","2016-03-12","201603120LAK"
"MIN",0,2,1,1,0,4,0,1,0,0,0,1,"A","N","2016-03-12","201603120MTL"
"MTL",0,1,0,0,0,1,0,2,1,1,0,4,"H","N","2016-03-12","201603120MTL"
"OTT",0,1,1,2,0,4,0,0,0,0,0,0,"H","N","2016-03-12","201603120OTT"
"TOR",0,0,0,0,0,0,0,1,1,2,0,4,"A","N","2016-03-12","201603120OTT"
"SJS",0,1,1,3,0,5,0,0,2,0,0,2,"H","N","2016-03-12","201603120SJS"
"WSH",0,0,2,0,0,2,0,1,1,3,0,5,"A","N","2016-03-12","201603120SJS"
"NSH",0,0,2,0,0,2,0,2,1,1,0,4,"A","N","2016-03-12","201603120VAN"
"VAN",0,2,1,1,0,4,0,0,2,0,0,2,"H","N","2016-03-12","201603120VAN"
"COL",0,0,2,0,0,2,0,0,1,2,0,3,"A","N","2016-03-12","201603120WPG"
"WPG",0,0,1,2,0,3,0,0,2,0,0,2,"H","N","2016-03-12","201603120WPG"
"CBJ",0,0,0,0,0,0,0,0,1,3,0,4,"H","N","2016-03-13","201603130CBJ"
"TBL",0,0,1,3,0,4,0,0,0,0,0,0,"A","N","2016-03-13","201603130CBJ"
"DET",0,0,0,0,0,0,0,0,1,0,0,1,"H","N","2016-03-13","201603130DET"
"TOR",0,0,1,0,0,1,0,0,0,0,0,0,"A","N","2016-03-13","201603130DET"
"NYR",0,1,1,1,0,3,0,1,2,2,0,5,"H","N","2016-03-13","201603130NYR"
"PIT",0,1,2,2,0,5,0,1,1,1,0,3,"A","N","2016-03-13","201603130NYR"
"ANA",0,0,4,3,0,7,0,0,1,0,0,1,"H","N","2016-03-14","201603140ANA"
"NJD",0,0,1,0,0,1,0,0,4,3,0,7,"A","N","2016-03-14","201603140ANA"
"CGY",0,2,3,2,0,7,0,2,0,2,0,4,"H","N","2016-03-14","201603140CGY"
"STL",0,2,0,2,0,4,0,2,3,2,0,7,"A","N","2016-03-14","201603140CGY"
"CHI",0,0,0,0,0,0,0,2,1,2,0,5,"H","N","2016-03-14","201603140CHI"
"LAK",0,2,1,2,0,5,0,0,0,0,0,0,"A","N","2016-03-14","201603140CHI"
"EDM",0,1,1,0,0,2,0,1,1,1,0,3,"H","N","2016-03-14","201603140EDM"
"NSH",0,1,1,1,0,3,0,1,1,0,0,2,"A","N","2016-03-14","201603140EDM"
"FLA",0,1,1,0,0,2,0,0,0,3,0,3,"A","N","2016-03-14","201603140NYI"
"NYI",0,0,0,3,0,3,0,1,1,0,0,2,"H","N","2016-03-14","201603140NYI"
"VAN",0,0,0,2,0,2,0,2,1,2,0,5,"H","N","2016-03-14","201603140VAN"
"WPG",0,2,1,2,0,5,0,0,0,2,0,2,"A","N","2016-03-14","201603140VAN"
"DAL",0,1,1,0,0,2,0,3,2,0,0,5,"H","N","2016-03-15","201603150DAL"
"LAK",0,3,2,0,0,5,0,1,1,0,0,2,"A","N","2016-03-15","201603150DAL"
"FLA",0,1,2,1,0,4,0,0,1,0,0,1,"A","N","2016-03-15","201603150MTL"
"MTL",0,0,1,0,0,1,0,1,2,1,0,4,"H","N","2016-03-15","201603150MTL"
"MIN",0,1,0,1,0,2,1,0,1,1,0,3,"A","N","2016-03-15","201603150OTT"
"OTT",1,0,1,1,0,3,0,1,0,1,0,2,"H","N","2016-03-15","201603150OTT"
"DET",0,0,2,1,0,3,0,2,2,0,0,4,"A","N","2016-03-15","201603150PHI"
"PHI",0,2,2,0,0,4,0,0,2,1,0,3,"H","N","2016-03-15","201603150PHI"
"NYI",0,0,0,1,0,1,0,1,0,0,1,2,"A","Y","2016-03-15","201603150PIT"
"PIT",0,1,0,0,1,2,0,0,0,1,0,1,"H","Y","2016-03-15","201603150PIT"
"BOS",0,2,0,0,0,2,0,1,1,1,0,3,"A","N","2016-03-15","201603150SJS"
"SJS",0,1,1,1,0,3,0,2,0,0,0,2,"H","N","2016-03-15","201603150SJS"
"TBL",0,0,0,1,0,1,0,0,1,3,0,4,"A","N","2016-03-15","201603150TOR"
"TOR",0,0,1,3,0,4,0,0,0,1,0,1,"H","N","2016-03-15","201603150TOR"
"CAR",0,0,1,0,0,1,1,0,1,0,0,2,"A","N","2016-03-15","201603150WSH"
"WSH",1,0,1,0,0,2,0,0,1,0,0,1,"H","N","2016-03-15","201603150WSH"
"ANA",0,1,0,0,0,1,0,0,1,1,0,2,"H","N","2016-03-16","201603160ANA"
"NYR",0,0,1,1,0,2,0,1,0,0,0,1,"A","N","2016-03-16","201603160ANA"
"BUF",0,1,0,1,0,2,1,0,2,0,0,3,"H","N","2016-03-16","201603160BUF"
"MTL",1,0,2,0,0,3,0,1,0,1,0,2,"A","N","2016-03-16","201603160BUF"
"CGY",0,3,0,1,0,4,0,0,1,0,0,1,"H","N","2016-03-16","201603160CGY"
"WPG",0,0,1,0,0,1,0,3,0,1,0,4,"A","N","2016-03-16","201603160CGY"
"CHI",0,1,1,0,0,2,0,1,1,1,0,3,"H","N","2016-03-16","201603160CHI"
"PHI",0,1,1,1,0,3,0,1,1,0,0,2,"A","N","2016-03-16","201603160CHI"
"EDM",0,2,3,1,0,6,0,1,1,2,0,4,"H","N","2016-03-16","201603160EDM"
"STL",0,1,1,2,0,4,0,2,3,1,0,6,"A","N","2016-03-16","201603160EDM"
"COL",0,1,0,2,0,3,0,1,0,0,0,1,"A","N","2016-03-16","201603160VAN"
"VAN",0,1,0,0,0,1,0,1,0,2,0,3,"H","N","2016-03-16","201603160VAN"
"ARI",0,1,0,2,0,3,0,0,1,0,0,1,"H","N","2016-03-17","201603170ARI"
"SJS",0,0,1,0,0,1,0,1,0,2,0,3,"A","N","2016-03-17","201603170ARI"
"CBJ",0,0,0,1,0,1,0,1,0,2,0,3,"H","N","2016-03-17","201603170CBJ"
"DET",0,1,0,2,0,3,0,0,0,1,0,1,"A","N","2016-03-17","201603170CBJ"
"DAL",0,1,1,2,0,4,0,1,2,0,0,3,"H","N","2016-03-17","201603170DAL"
"TBL",0,1,2,0,0,3,0,1,1,2,0,4,"A","N","2016-03-17","201603170DAL"
"LAK",1,1,0,2,0,4,0,1,1,1,0,3,"H","N","2016-03-17","201603170LAK"
"NYR",0,1,1,1,0,3,1,1,0,2,0,4,"A","N","2016-03-17","201603170LAK"
"MIN",0,1,1,2,0,4,0,3,3,1,0,7,"A","N","2016-03-17","201603170NJD"
"NJD",0,3,3,1,0,7,0,1,1,2,0,4,"H","N","2016-03-17","201603170NJD"
"NSH",0,1,2,1,0,4,0,0,1,1,0,2,"H","N","2016-03-17","201603170NSH"
"NYI",0,0,1,1,0,2,0,1,2,1,0,4,"A","N","2016-03-17","201603170NSH"
"CAR",0,2,0,0,0,2,0,1,2,1,0,4,"A","N","2016-03-17","201603170PIT"
"PIT",0,1,2,1,0,4,0,2,0,0,0,2,"H","N","2016-03-17","201603170PIT"
"FLA",0,0,2,2,0,4,0,0,1,0,0,1,"A","N","2016-03-17","201603170TOR"
"TOR",0,0,1,0,0,1,0,0,2,2,0,4,"H","N","2016-03-17","201603170TOR"
"ANA",0,2,0,2,0,4,0,0,0,0,0,0,"H","N","2016-03-18","201603180ANA"
"BOS",0,0,0,0,0,0,0,2,0,2,0,4,"A","N","2016-03-18","201603180ANA"
"BUF",0,2,1,0,0,3,0,1,0,0,0,1,"H","N","2016-03-18","201603180BUF"
"OTT",0,1,0,0,0,1,0,2,1,0,0,3,"A","N","2016-03-18","201603180BUF"
"CGY",0,1,2,0,0,3,0,1,1,1,1,4,"H","Y","2016-03-18","201603180CGY"
"COL",0,1,1,1,1,4,0,1,2,0,0,3,"A","Y","2016-03-18","201603180CGY"
"EDM",0,0,1,1,0,2,0,0,0,0,0,0,"H","N","2016-03-18","201603180EDM"
"VAN",0,0,0,0,0,0,0,0,1,1,0,2,"A","N","2016-03-18","201603180EDM"
"CHI",0,0,2,2,0,4,0,0,0,0,0,0,"A","N","2016-03-18","201603180WPG"
"WPG",0,0,0,0,0,0,0,0,2,2,0,4,"H","N","2016-03-18","201603180WPG"
"NSH",0,0,1,0,0,1,0,0,3,1,0,4,"A","N","2016-03-18","201603180WSH"
"WSH",0,0,3,1,0,4,0,0,1,0,0,1,"H","N","2016-03-18","201603180WSH"
"ARI",0,0,0,0,0,0,0,1,0,1,0,2,"H","N","2016-03-19","201603190ARI"
"TBL",0,1,0,1,0,2,0,0,0,0,0,0,"A","N","2016-03-19","201603190ARI"
"CBJ",0,2,1,3,0,6,0,0,2,1,0,3,"H","N","2016-03-19","201603190CBJ"
"NJD",0,0,2,1,0,3,0,2,1,3,0,6,"A","N","2016-03-19","201603190CBJ"
"DAL",0,0,1,2,0,3,0,0,0,0,0,0,"H","N","2016-03-19","201603190DAL"
"NYI",0,0,0,0,0,0,0,0,1,2,0,3,"A","N","2016-03-19","201603190DAL"
"DET",0,1,1,3,0,5,0,1,2,0,0,3,"A","N","2016-03-19","201603190FLA"
"FLA",0,1,2,0,0,3,0,1,1,3,0,5,"H","N","2016-03-19","201603190FLA"
"BOS",0,0,1,0,0,1,0,1,1,0,0,2,"A","N","2016-03-19","201603190LAK"
"LAK",0,1,1,0,0,2,0,0,1,0,0,1,"H","N","2016-03-19","201603190LAK"
"CAR",0,0,1,1,0,2,0,0,1,1,1,3,"A","Y","2016-03-19","201603190MIN"
"MIN",0,0,1,1,1,3,0,0,1,1,0,2,"H","Y","2016-03-19","201603190MIN"
"MTL",0,0,0,0,0,0,0,1,1,3,0,5,"A","N","2016-03-19","201603190OTT"
"OTT",0,1,1,3,0,5,0,0,0,0,0,0,"H","N","2016-03-19","201603190OTT"
"PHI",0,0,1,0,0,1,0,0,3,1,0,4,"H","N","2016-03-19","201603190PHI"
"PIT",0,0,3,1,0,4,0,0,1,0,0,1,"A","N","2016-03-19","201603190PHI"
"NYR",0,0,1,0,0,1,0,0,1,3,0,4,"A","N","2016-03-19","201603190SJS"
"SJS",0,0,1,3,0,4,0,0,1,0,0,1,"H","N","2016-03-19","201603190SJS"
"BUF",0,1,0,0,0,1,0,0,1,3,0,4,"A","N","2016-03-19","201603190TOR"
"TOR",0,0,1,3,0,4,0,1,0,0,0,1,"H","N","2016-03-19","201603190TOR"
"STL",0,0,1,2,0,3,0,0,0,0,0,0,"A","N","2016-03-19","201603190VAN"
"VAN",0,0,0,0,0,0,0,0,1,2,0,3,"H","N","2016-03-19","201603190VAN"
"CHI",0,0,2,0,0,2,0,0,2,0,1,3,"H","Y","2016-03-20","201603200CHI"
"MIN",0,0,2,0,1,3,0,0,2,0,0,2,"A","Y","2016-03-20","201603200CHI"
"COL",0,0,2,1,0,3,0,0,0,2,0,2,"A","N","2016-03-20","201603200EDM"
"EDM",0,0,0,2,0,2,0,0,2,1,0,3,"H","N","2016-03-20","201603200EDM"
"CGY",0,0,2,2,0,4,0,0,0,1,0,1,"A","N","2016-03-20","201603200MTL"
"MTL",0,0,0,1,0,1,0,0,2,2,0,4,"H","N","2016-03-20","201603200MTL"
"CBJ",0,0,1,0,0,1,0,1,0,1,0,2,"A","N","2016-03-20","201603200NJD"
"NJD",0,1,0,1,0,2,0,0,1,0,0,1,"H","N","2016-03-20","201603200NJD"
"PIT",0,2,1,3,0,6,0,0,2,0,0,2,"H","N","2016-03-20","201603200PIT"
"WSH",0,0,2,0,0,2,0,2,1,3,0,6,"A","N","2016-03-20","201603200PIT"
"ARI",0,0,0,0,0,0,0,1,1,1,0,3,"A","N","2016-03-20","201603200SJS"
"SJS",0,1,1,1,0,3,0,0,0,0,0,0,"H","N","2016-03-20","201603200SJS"
"ANA",1,1,1,0,0,3,0,1,1,0,0,2,"A","N","2016-03-20","201603200WPG"
"WPG",0,1,1,0,0,2,1,1,1,0,0,3,"H","N","2016-03-20","201603200WPG"
"LAK",0,0,0,2,0,2,0,0,3,2,0,5,"A","N","2016-03-21","201603210NSH"
"NSH",0,0,3,2,0,5,0,0,0,2,0,2,"H","N","2016-03-21","201603210NSH"
"NYI",0,0,1,0,0,1,0,0,2,2,0,4,"H","N","2016-03-21","201603210NYI"
"PHI",0,0,2,2,0,4,0,0,1,0,0,1,"A","N","2016-03-21","201603210NYI"
"FLA",0,0,0,2,0,2,0,1,1,2,0,4,"A","N","2016-03-21","201603210NYR"
"NYR",0,1,1,2,0,4,0,0,0,2,0,2,"H","N","2016-03-21","201603210NYR"
"CGY",0,0,2,0,0,2,0,1,1,3,0,5,"A","N","2016-03-21","201603210TOR"
"TOR",0,1,1,3,0,5,0,0,2,0,0,2,"H","N","2016-03-21","201603210TOR"
"ARI",0,1,2,1,0,4,0,1,1,0,0,2,"H","N","2016-03-22","201603220ARI"
"EDM",0,1,1,0,0,2,0,1,2,1,0,4,"A","N","2016-03-22","201603220ARI"
"BUF",0,1,0,2,0,3,0,0,1,1,0,2,"A","N","2016-03-22","201603220CAR"
"CAR",0,0,1,1,0,2,0,1,0,2,0,3,"H","N","2016-03-22","201603220CAR"
"CBJ",0,0,0,2,1,3,0,1,0,1,0,2,"H","Y","2016-03-22","201603220CBJ"
"PHI",0,1,0,1,0,2,0,0,0,2,1,3,"A","Y","2016-03-22","201603220CBJ"
"CHI",0,0,1,1,0,2,0,4,1,1,0,6,"H","N","2016-03-22","201603220CHI"
"DAL",0,4,1,1,0,6,0,0,1,1,0,2,"A","N","2016-03-22","201603220CHI"
"LAK",0,0,1,0,0,1,0,1,1,0,0,2,"A","N","2016-03-22","201603220MIN"
"MIN",0,1,1,0,0,2,0,0,1,0,0,1,"H","N","2016-03-22","201603220MIN"
"ANA",0,1,2,0,0,3,0,1,2,1,0,4,"A","N","2016-03-22","201603220MTL"
"MTL",0,1,2,1,0,4,0,1,2,0,0,3,"H","N","2016-03-22","201603220MTL"
"OTT",0,0,1,1,0,2,0,3,0,1,0,4,"H","N","2016-03-22","201603220OTT"
"WSH",0,3,0,1,0,4,0,0,1,1,0,2,"A","N","2016-03-22","201603220OTT"
"SJS",0,0,0,0,0,0,0,0,0,1,0,1,"H","N","2016-03-22","201603220SJS"
"STL",0,0,0,1,0,1,0,0,0,0,0,0,"A","N","2016-03-22","201603220SJS"
"DET",0,0,2,0,0,2,0,2,2,2,0,6,"A","N","2016-03-22","201603220TBL"
"TBL",0,2,2,2,0,6,0,0,2,0,0,2,"H","N","2016-03-22","201603220TBL"
"VAN",0,0,0,0,0,0,0,0,0,2,0,2,"A","N","2016-03-22","201603220WPG"
"WPG",0,0,0,2,0,2,0,0,0,0,0,0,"H","N","2016-03-22","201603220WPG"
"NYI",0,0,3,0,0,3,0,0,0,1,0,1,"H","N","2016-03-23","201603230NYI"
"OTT",0,0,0,1,0,1,0,0,3,0,0,3,"A","N","2016-03-23","201603230NYI"
"BOS",0,0,1,1,0,2,0,2,1,2,0,5,"A","N","2016-03-23","201603230NYR"
"NYR",0,2,1,2,0,5,0,0,1,1,0,2,"H","N","2016-03-23","201603230NYR"
"ARI",0,1,1,1,0,3,0,1,0,0,0,1,"H","N","2016-03-24","201603240ARI"
"DAL",0,1,0,0,0,1,0,1,1,1,0,3,"A","N","2016-03-24","201603240ARI"
"BOS",0,0,1,0,0,1,0,0,2,2,0,4,"H","N","2016-03-24","201603240BOS"
"FLA",0,0,2,2,0,4,0,0,1,0,0,1,"A","N","2016-03-24","201603240BOS"
"CAR",0,0,0,3,0,3,0,0,1,1,0,2,"A","N","2016-03-24","201603240CBJ"
"CBJ",0,0,1,1,0,2,0,0,0,3,0,3,"H","N","2016-03-24","201603240CBJ"
"COL",0,0,1,1,0,2,0,0,1,3,0,4,"H","N","2016-03-24","201603240COL"
"PHI",0,0,1,3,0,4,0,0,1,1,0,2,"A","N","2016-03-24","201603240COL"
"DET",0,1,3,0,0,4,0,0,0,3,0,3,"H","N","2016-03-24","201603240DET"
"MTL",0,0,0,3,0,3,0,1,3,0,0,4,"A","N","2016-03-24","201603240DET"
"CGY",0,1,1,0,0,2,0,3,1,2,0,6,"A","N","2016-03-24","201603240MIN"
"MIN",0,3,1,2,0,6,0,1,1,0,0,2,"H","N","2016-03-24","201603240MIN"
"NSH",0,0,0,2,1,3,0,2,0,0,0,2,"H","Y","2016-03-24","201603240NSH"
"VAN",0,2,0,0,0,2,0,0,0,2,1,3,"A","Y","2016-03-24","201603240NSH"
"NJD",0,2,0,1,0,3,0,0,0,0,0,0,"A","N","2016-03-24","201603240PIT"
"PIT",0,0,0,0,0,0,0,2,0,1,0,3,"H","N","2016-03-24","201603240PIT"
"EDM",0,0,4,2,0,6,0,2,1,0,0,3,"A","N","2016-03-24","201603240SJS"
"SJS",0,2,1,0,0,3,0,0,4,2,0,6,"H","N","2016-03-24","201603240SJS"
"ANA",0,1,2,2,0,5,1,2,2,1,0,6,"A","N","2016-03-24","201603240TOR"
"TOR",1,2,2,1,0,6,0,1,2,2,0,5,"H","N","2016-03-24","201603240TOR"
"LAK",0,0,1,0,0,1,0,0,1,3,0,4,"A","N","2016-03-24","201603240WPG"
"WPG",0,0,1,3,0,4,0,0,1,0,0,1,"H","N","2016-03-24","201603240WPG"
"NJD",0,0,0,0,0,0,1,0,0,0,0,1,"H","N","2016-03-25","201603250NJD"
"WSH",1,0,0,0,0,1,0,0,0,0,0,0,"A","N","2016-03-25","201603250NJD"
"STL",0,2,1,1,0,4,0,0,0,0,0,0,"H","N","2016-03-25","201603250STL"
"VAN",0,0,0,0,0,0,0,2,1,1,0,4,"A","N","2016-03-25","201603250STL"
"NYI",0,1,2,1,0,4,0,2,1,4,0,7,"A","N","2016-03-25","201603250TBL"
"TBL",0,2,1,4,0,7,0,1,2,1,0,4,"H","N","2016-03-25","201603250TBL"
"ARI",0,0,2,0,0,2,0,0,0,1,0,1,"H","N","2016-03-26","201603260ARI"
"PHI",0,0,0,1,0,1,0,0,2,0,0,2,"A","N","2016-03-26","201603260ARI"
"BUF",0,1,0,2,0,3,0,2,0,0,0,2,"H","N","2016-03-26","201603260BUF"
"WPG",0,2,0,0,0,2,0,1,0,2,0,3,"A","N","2016-03-26","201603260BUF"
"CAR",0,0,3,0,0,3,1,2,0,1,0,4,"H","N","2016-03-26","201603260CAR"
"NYI",1,2,0,1,0,4,0,0,3,0,0,3,"A","N","2016-03-26","201603260CAR"
"CGY",0,0,1,0,0,1,0,0,2,2,0,4,"H","N","2016-03-26","201603260CGY"
"CHI",0,0,2,2,0,4,0,0,1,0,0,1,"A","N","2016-03-26","201603260CGY"
"COL",0,0,0,0,0,0,0,0,2,2,0,4,"H","N","2016-03-26","201603260COL"
"MIN",0,0,2,2,0,4,0,0,0,0,0,0,"A","N","2016-03-26","201603260COL"
"DET",0,1,0,1,0,2,0,0,4,3,0,7,"H","N","2016-03-26","201603260DET"
"PIT",0,0,4,3,0,7,0,1,0,1,0,2,"A","N","2016-03-26","201603260DET"
"EDM",0,2,0,2,0,4,0,2,3,1,0,6,"A","N","2016-03-26","201603260LAK"
"LAK",0,2,3,1,0,6,0,2,0,2,0,4,"H","N","2016-03-26","201603260LAK"
"MTL",0,1,1,0,0,2,0,1,4,0,0,5,"H","N","2016-03-26","201603260MTL"
"NYR",0,1,4,0,0,5,0,1,1,0,0,2,"A","N","2016-03-26","201603260MTL"
"CBJ",0,1,0,0,0,1,0,2,2,1,0,5,"A","N","2016-03-26","201603260NSH"
"NSH",0,2,2,1,0,5,0,1,0,0,0,1,"H","N","2016-03-26","201603260NSH"
"ANA",1,0,0,3,0,4,0,1,2,0,0,3,"A","N","2016-03-26","201603260OTT"
"OTT",0,1,2,0,0,3,1,0,0,3,0,4,"H","N","2016-03-26","201603260OTT"
"DAL",0,1,2,1,0,4,0,0,0,2,0,2,"A","N","2016-03-26","201603260SJS"
"SJS",0,0,0,2,0,2,0,1,2,1,0,4,"H","N","2016-03-26","201603260SJS"
"FLA",0,2,1,2,0,5,0,1,0,1,0,2,"A","N","2016-03-26","201603260TBL"
"TBL",0,1,0,1,0,2,0,2,1,2,0,5,"H","N","2016-03-26","201603260TBL"
"BOS",0,0,2,1,0,3,0,1,0,0,0,1,"A","N","2016-03-26","201603260TOR"
"TOR",0,1,0,0,0,1,0,0,2,1,0,3,"H","N","2016-03-26","201603260TOR"
"STL",0,0,3,1,0,4,0,0,0,0,0,0,"A","N","2016-03-26","201603260WSH"
"WSH",0,0,0,0,0,0,0,0,3,1,0,4,"H","N","2016-03-26","201603260WSH"
"CAR",0,2,1,0,0,3,0,0,2,0,0,2,"H","N","2016-03-27","201603270CAR"
"NJD",0,0,2,0,0,2,0,2,1,0,0,3,"A","N","2016-03-27","201603270CAR"
"NYR",0,1,1,0,0,2,1,1,1,0,0,3,"H","N","2016-03-27","201603270NYR"
"PIT",1,1,1,0,0,3,0,1,1,0,0,2,"A","N","2016-03-27","201603270NYR"
"CHI",0,1,0,2,0,3,0,0,1,1,0,2,"A","N","2016-03-27","201603270VAN"
"VAN",0,0,1,1,0,2,0,1,0,2,0,3,"H","N","2016-03-27","201603270VAN"
"ARI",0,0,2,0,0,2,0,1,2,2,0,5,"H","N","2016-03-28","201603280ARI"
"CGY",0,1,2,2,0,5,0,0,2,0,0,2,"A","N","2016-03-28","201603280ARI"
"BUF",0,0,0,2,0,2,0,1,1,1,0,3,"A","N","2016-03-28","201603280DET"
"DET",0,1,1,1,0,3,0,0,0,2,0,2,"H","N","2016-03-28","201603280DET"
"ANA",0,1,1,0,0,2,0,0,0,1,0,1,"A","N","2016-03-28","201603280EDM"
"EDM",0,0,0,1,0,1,0,1,1,0,0,2,"H","N","2016-03-28","201603280EDM"
"COL",0,3,0,1,0,4,0,1,0,2,0,3,"A","N","2016-03-28","201603280NSH"
"NSH",0,1,0,2,0,3,0,3,0,1,0,4,"H","N","2016-03-28","201603280NSH"
"PHI",1,0,2,0,0,3,0,0,1,1,0,2,"H","N","2016-03-28","201603280PHI"
"WPG",0,0,1,1,0,2,1,0,2,0,0,3,"A","N","2016-03-28","201603280PHI"
"LAK",0,1,1,0,0,2,0,1,1,3,0,5,"A","N","2016-03-28","201603280SJS"
"SJS",0,1,1,3,0,5,0,1,1,0,0,2,"H","N","2016-03-28","201603280SJS"
"TBL",0,2,1,0,0,3,0,0,0,0,0,0,"H","N","2016-03-28","201603280TBL"
"TOR",0,0,0,0,0,0,0,2,1,0,0,3,"A","N","2016-03-28","201603280TBL"
"CBJ",0,1,0,0,0,1,0,1,0,3,0,4,"A","N","2016-03-28","201603280WSH"
"WSH",0,1,0,3,0,4,0,1,0,0,0,1,"H","N","2016-03-28","201603280WSH"
"DAL",0,1,2,2,0,5,0,1,1,0,0,2,"H","N","2016-03-29","201603290DAL"
"NSH",0,1,1,0,0,2,0,1,2,2,0,5,"A","N","2016-03-29","201603290DAL"
"FLA",0,0,1,1,0,2,0,1,2,2,0,5,"H","N","2016-03-29","201603290FLA"
"TOR",0,1,2,2,0,5,0,0,1,1,0,2,"A","N","2016-03-29","201603290FLA"
"CHI",0,1,0,0,0,1,0,1,0,3,0,4,"A","N","2016-03-29","201603290MIN"
"MIN",0,1,0,3,0,4,0,1,0,0,0,1,"H","N","2016-03-29","201603290MIN"
"DET",0,0,3,0,0,3,0,2,0,2,0,4,"A","N","2016-03-29","201603290MTL"
"MTL",0,2,0,2,0,4,0,0,3,0,0,3,"H","N","2016-03-29","201603290MTL"
"BOS",0,0,1,0,0,1,0,1,0,1,0,2,"A","N","2016-03-29","201603290NJD"
"NJD",0,1,0,1,0,2,0,0,1,0,0,1,"H","N","2016-03-29","201603290NJD"
"CAR",0,0,1,0,0,1,0,0,0,1,1,2,"A","Y","2016-03-29","201603290NYI"
"NYI",0,0,0,1,1,2,0,0,1,0,0,1,"H","Y","2016-03-29","201603290NYI"
"BUF",0,3,0,1,0,4,0,0,4,0,1,5,"A","Y","2016-03-29","201603290PIT"
"PIT",0,0,4,0,1,5,0,3,0,1,0,4,"H","Y","2016-03-29","201603290PIT"
"COL",0,1,0,0,0,1,0,1,2,0,0,3,"A","N","2016-03-29","201603290STL"
"STL",0,1,2,0,0,3,0,1,0,0,0,1,"H","N","2016-03-29","201603290STL"
"SJS",0,0,2,2,0,4,0,0,1,0,0,1,"A","N","2016-03-29","201603290VAN"
"VAN",0,0,1,0,0,1,0,0,2,2,0,4,"H","N","2016-03-29","201603290VAN"
"ANA",0,3,4,1,0,8,0,0,3,0,0,3,"H","N","2016-03-30","201603300ANA"
"CGY",0,0,3,0,0,3,0,3,4,1,0,8,"A","N","2016-03-30","201603300ANA"
"PHI",0,0,0,1,1,2,0,0,0,1,0,1,"H","Y","2016-03-30","201603300PHI"
"WSH",0,0,0,1,0,1,0,0,0,1,1,2,"A","Y","2016-03-30","201603300PHI"
"OTT",0,1,0,1,0,2,0,0,0,1,0,1,"A","N","2016-03-30","201603300WPG"
"WPG",0,0,0,1,0,1,0,1,0,1,0,2,"H","N","2016-03-30","201603300WPG"
"BUF",0,2,1,1,0,4,0,0,1,0,0,1,"H","N","2016-03-31","201603310BUF"
"TOR",0,0,1,0,0,1,0,2,1,1,0,4,"A","N","2016-03-31","201603310BUF"
"CAR",0,1,1,2,0,4,0,0,3,0,0,3,"H","N","2016-03-31","201603310CAR"
"NYR",0,0,3,0,0,3,0,1,1,2,0,4,"A","N","2016-03-31","201603310CAR"
"ARI",0,1,0,0,0,1,0,1,2,1,0,4,"A","N","2016-03-31","201603310DAL"
"DAL",0,1,2,1,0,4,0,1,0,0,0,1,"H","N","2016-03-31","201603310DAL"
"FLA",0,0,1,2,0,3,0,1,0,1,0,2,"H","N","2016-03-31","201603310FLA"
"NJD",0,1,0,1,0,2,0,0,1,2,0,3,"A","N","2016-03-31","201603310FLA"
"CGY",0,0,0,0,0,0,0,0,2,1,0,3,"A","N","2016-03-31","201603310LAK"
"LAK",0,0,2,1,0,3,0,0,0,0,0,0,"H","N","2016-03-31","201603310LAK"
"MIN",0,0,1,1,0,2,0,0,2,1,0,3,"H","N","2016-03-31","201603310MIN"
"OTT",0,0,2,1,0,3,0,0,1,1,0,2,"A","N","2016-03-31","201603310MIN"
"CBJ",0,1,1,1,0,3,0,3,0,1,0,4,"A","N","2016-03-31","201603310NYI"
"NYI",0,3,0,1,0,4,0,1,1,1,0,3,"H","N","2016-03-31","201603310NYI"
"NSH",0,1,1,0,0,2,0,1,3,1,0,5,"A","N","2016-03-31","201603310PIT"
"PIT",0,1,3,1,0,5,0,1,1,0,0,2,"H","N","2016-03-31","201603310PIT"
"SJS",0,0,1,1,0,2,0,2,0,2,0,4,"H","N","2016-03-31","201603310SJS"
"VAN",0,2,0,2,0,4,0,0,1,1,0,2,"A","N","2016-03-31","201603310SJS"
"MTL",0,1,1,1,0,3,0,0,0,0,0,0,"A","N","2016-03-31","201603310TBL"
"TBL",0,0,0,0,0,0,0,1,1,1,0,3,"H","N","2016-03-31","201603310TBL"
"ANA",0,1,0,1,0,2,0,0,1,2,0,3,"H","N","2016-04-01","201604010ANA"
"VAN",0,0,1,2,0,3,0,1,0,1,0,2,"A","N","2016-04-01","201604010ANA"
"COL",0,0,1,1,0,2,0,0,3,1,0,4,"H","N","2016-04-01","201604010COL"
"WSH",0,0,3,1,0,4,0,0,1,1,0,2,"A","N","2016-04-01","201604010COL"
"DET",0,1,1,1,0,3,0,0,1,1,0,2,"H","N","2016-04-01","201604010DET"
"MIN",0,0,1,1,0,2,0,1,1,1,0,3,"A","N","2016-04-01","201604010DET"
"BOS",0,2,3,1,0,6,0,1,1,3,0,5,"A","N","2016-04-01","201604010STL"
"STL",0,1,1,3,0,5,0,2,3,1,0,6,"H","N","2016-04-01","201604010STL"
"CHI",1,2,1,1,0,5,0,1,1,2,0,4,"A","N","2016-04-01","201604010WPG"
"WPG",0,1,1,2,0,4,1,2,1,1,0,5,"H","N","2016-04-01","201604010WPG"
"ARI",0,0,0,3,0,3,0,0,0,0,0,0,"H","N","2016-04-02","201604020ARI"
"WSH",0,0,0,0,0,0,0,0,0,3,0,3,"A","N","2016-04-02","201604020ARI"
"CAR",0,1,0,0,0,1,0,1,3,1,0,5,"H","N","2016-04-02","201604020CAR"
"CBJ",0,1,3,1,0,5,0,1,0,0,0,1,"A","N","2016-04-02","201604020CAR"
"CGY",0,1,1,3,0,5,0,0,0,0,0,0,"A","N","2016-04-02","201604020EDM"
"EDM",0,0,0,0,0,0,0,1,1,3,0,5,"H","N","2016-04-02","201604020EDM"
"FLA",0,0,2,2,0,4,0,1,2,0,0,3,"H","N","2016-04-02","201604020FLA"
"MTL",0,1,2,0,0,3,0,0,2,2,0,4,"A","N","2016-04-02","201604020FLA"
"DAL",0,1,0,2,0,3,0,1,1,0,0,2,"A","N","2016-04-02","201604020LAK"
"LAK",0,1,1,0,0,2,0,1,0,2,0,3,"H","N","2016-04-02","201604020LAK"
"NSH",0,1,1,0,0,2,0,0,0,2,1,3,"H","Y","2016-04-02","201604020NSH"
"SJS",0,0,0,2,1,3,0,1,1,0,0,2,"A","Y","2016-04-02","201604020NSH"
"NYI",0,0,0,0,0,0,0,1,2,2,0,5,"H","N","2016-04-02","201604020NYI"
"PIT",0,1,2,2,0,5,0,0,0,0,0,0,"A","N","2016-04-02","201604020NYI"
"BUF",0,2,2,0,0,4,0,0,2,1,0,3,"A","N","2016-04-02","201604020NYR"
"NYR",0,0,2,1,0,3,0,2,2,0,0,4,"H","N","2016-04-02","201604020NYR"
"OTT",0,0,1,1,0,2,0,0,2,1,0,3,"A","N","2016-04-02","201604020PHI"
"PHI",0,0,2,1,0,3,0,0,1,1,0,2,"H","N","2016-04-02","201604020PHI"
"NJD",0,0,1,0,0,1,0,0,1,2,0,3,"A","N","2016-04-02","201604020TBL"
"TBL",0,0,1,2,0,3,0,0,1,0,0,1,"H","N","2016-04-02","201604020TBL"
"DET",0,2,0,1,0,3,0,0,1,1,0,2,"A","N","2016-04-02","201604020TOR"
"TOR",0,0,1,1,0,2,0,2,0,1,0,3,"H","N","2016-04-02","201604020TOR"
"ANA",0,0,1,2,0,3,0,0,0,1,0,1,"H","N","2016-04-03","201604030ANA"
"DAL",0,0,0,1,0,1,0,0,1,2,0,3,"A","N","2016-04-03","201604030ANA"
"BOS",0,0,2,2,0,4,0,2,4,0,0,6,"A","N","2016-04-03","201604030CHI"
"CHI",0,2,4,0,0,6,0,0,2,2,0,4,"H","N","2016-04-03","201604030CHI"
"COL",0,0,0,1,0,1,0,3,1,1,0,5,"H","N","2016-04-03","201604030COL"
"STL",0,3,1,1,0,5,0,0,0,1,0,1,"A","N","2016-04-03","201604030COL"
"PHI",0,0,1,1,0,2,0,2,1,3,0,6,"A","N","2016-04-03","201604030PIT"
"PIT",0,2,1,3,0,6,0,0,1,1,0,2,"H","N","2016-04-03","201604030PIT"
"MIN",0,0,0,1,0,1,0,1,1,3,0,5,"A","N","2016-04-03","201604030WPG"
"WPG",0,1,1,3,0,5,0,0,0,1,0,1,"H","N","2016-04-03","201604030WPG"
"CBJ",0,0,1,1,0,2,0,1,2,1,0,4,"H","N","2016-04-04","201604040CBJ"
"NYR",0,1,2,1,0,4,0,0,1,1,0,2,"A","N","2016-04-04","201604040CBJ"
"NYI",0,1,3,1,0,5,0,0,2,0,0,2,"H","N","2016-04-04","201604040NYI"
"TBL",0,0,2,0,0,2,0,1,3,1,0,5,"A","N","2016-04-04","201604040NYI"
"ARI",0,2,0,0,0,2,0,0,1,4,0,5,"A","N","2016-04-04","201604040STL"
"STL",0,0,1,4,0,5,0,2,0,0,0,2,"H","N","2016-04-04","201604040STL"
"FLA",0,0,3,1,0,4,0,0,0,3,0,3,"A","N","2016-04-04","201604040TOR"
"TOR",0,0,0,3,0,3,0,0,3,1,0,4,"H","N","2016-04-04","201604040TOR"
"LAK",0,1,1,0,0,2,0,1,2,0,0,3,"A","N","2016-04-04","201604040VAN"
"VAN",0,1,2,0,0,3,0,1,1,0,0,2,"H","N","2016-04-04","201604040VAN"
"ANA",0,1,0,0,0,1,1,0,0,1,0,2,"H","N","2016-04-05","201604050ANA"
"WPG",1,0,0,1,0,2,0,1,0,0,0,1,"A","N","2016-04-05","201604050ANA"
"BOS",0,0,0,1,0,1,0,1,0,0,1,2,"H","Y","2016-04-05","201604050BOS"
"CAR",0,1,0,0,1,2,0,0,0,1,0,1,"A","Y","2016-04-05","201604050BOS"
"CGY",0,1,1,2,0,4,1,1,1,2,0,5,"H","N","2016-04-05","201604050CGY"
"LAK",1,1,1,2,0,5,0,1,1,2,0,4,"A","N","2016-04-05","201604050CGY"
"ARI",0,0,0,2,0,2,0,2,3,1,0,6,"A","N","2016-04-05","201604050CHI"
"CHI",0,2,3,1,0,6,0,0,0,2,0,2,"H","N","2016-04-05","201604050CHI"
"MIN",0,0,0,0,0,0,0,1,1,1,0,3,"H","N","2016-04-05","201604050MIN"
"SJS",0,1,1,1,0,3,0,0,0,0,0,0,"A","N","2016-04-05","201604050MIN"
"FLA",0,1,1,2,0,4,0,0,1,0,0,1,"A","N","2016-04-05","201604050MTL"
"MTL",0,0,1,0,0,1,0,1,1,2,0,4,"H","N","2016-04-05","201604050MTL"
"BUF",0,0,1,2,0,3,0,0,0,1,0,1,"A","N","2016-04-05","201604050NJD"
"NJD",0,0,0,1,0,1,0,0,1,2,0,3,"H","N","2016-04-05","201604050NJD"
"COL",0,1,1,1,0,3,0,2,0,2,0,4,"A","N","2016-04-05","201604050NSH"
"NSH",0,2,0,2,0,4,0,1,1,1,0,3,"H","N","2016-04-05","201604050NSH"
"NYR",0,0,1,2,0,3,0,2,0,0,0,2,"H","N","2016-04-05","201604050NYR"
"TBL",0,2,0,0,0,2,0,0,1,2,0,3,"A","N","2016-04-05","201604050NYR"
"OTT",0,1,2,0,0,3,0,0,2,3,0,5,"H","N","2016-04-05","201604050OTT"
"PIT",0,0,2,3,0,5,0,1,2,0,0,3,"A","N","2016-04-05","201604050OTT"
"NYI",1,0,1,2,0,4,0,1,0,2,0,3,"A","N","2016-04-05","201604050WSH"
"WSH",0,1,0,2,0,3,1,0,1,2,0,4,"H","N","2016-04-05","201604050WSH"
"DET",0,1,1,1,0,3,0,0,0,0,0,0,"H","N","2016-04-06","201604060DET"
"PHI",0,0,0,0,0,0,0,1,1,1,0,3,"A","N","2016-04-06","201604060DET"
"EDM",0,0,3,3,0,6,0,0,0,2,0,2,"H","N","2016-04-06","201604060EDM"
"VAN",0,0,0,2,0,2,0,0,3,3,0,6,"A","N","2016-04-06","201604060EDM"
"CBJ",0,0,2,3,0,5,0,0,1,0,0,1,"A","N","2016-04-06","201604060TOR"
"TOR",0,0,1,0,0,1,0,0,2,3,0,5,"H","N","2016-04-06","201604060TOR"
"BOS",0,2,1,2,0,5,0,0,1,1,0,2,"H","N","2016-04-07","201604070BOS"
"DET",0,0,1,1,0,2,0,2,1,2,0,5,"A","N","2016-04-07","201604070BOS"
"CAR",0,1,1,0,0,2,0,1,2,1,0,4,"H","N","2016-04-07","201604070CAR"
"MTL",0,1,2,1,0,4,0,1,1,0,0,2,"A","N","2016-04-07","201604070CAR"
"CGY",0,2,3,2,0,7,0,2,1,0,0,3,"H","N","2016-04-07","201604070CGY"
"VAN",0,2,1,0,0,3,0,2,3,2,0,7,"A","N","2016-04-07","201604070CGY"
"CHI",0,0,1,0,0,1,1,0,0,1,0,2,"H","N","2016-04-07","201604070CHI"
"STL",1,0,0,1,0,2,0,0,1,0,0,1,"A","N","2016-04-07","201604070CHI"
"COL",0,0,0,2,0,2,0,1,2,1,0,4,"A","N","2016-04-07","201604070DAL"
"DAL",0,1,2,1,0,4,0,0,0,2,0,2,"H","N","2016-04-07","201604070DAL"
"ANA",0,1,0,0,0,1,0,0,2,0,0,2,"A","N","2016-04-07","201604070LAK"
"LAK",0,0,2,0,0,2,0,1,0,0,0,1,"H","N","2016-04-07","201604070LAK"
"NJD",0,0,1,1,0,2,0,1,1,2,0,4,"H","N","2016-04-07","201604070NJD"
"TBL",0,1,1,2,0,4,0,0,1,1,0,2,"A","N","2016-04-07","201604070NJD"
"ARI",0,1,1,0,0,2,1,0,0,2,0,3,"A","N","2016-04-07","201604070NSH"
"NSH",1,0,0,2,0,3,0,1,1,0,0,2,"H","N","2016-04-07","201604070NSH"
"NYI",0,0,3,1,0,4,0,0,0,1,0,1,"A","N","2016-04-07","201604070NYR"
"NYR",0,0,0,1,0,1,0,0,3,1,0,4,"H","N","2016-04-07","201604070NYR"
"FLA",0,0,0,1,0,1,0,1,1,1,0,3,"A","N","2016-04-07","201604070OTT"
"OTT",0,1,1,1,0,3,0,0,0,1,0,1,"H","N","2016-04-07","201604070OTT"
"PHI",0,0,1,2,0,3,1,2,1,0,0,4,"H","N","2016-04-07","201604070PHI"
"TOR",1,2,1,0,0,4,0,0,1,2,0,3,"A","N","2016-04-07","201604070PHI"
"SJS",0,1,2,1,0,4,0,0,3,2,0,5,"H","N","2016-04-07","201604070SJS"
"WPG",0,0,3,2,0,5,0,1,2,1,0,4,"A","N","2016-04-07","201604070SJS"
"PIT",1,1,2,0,0,4,0,0,1,2,0,3,"A","N","2016-04-07","201604070WSH"
"WSH",0,0,1,2,0,3,1,1,2,0,0,4,"H","N","2016-04-07","201604070WSH"
"BUF",0,0,1,0,0,1,0,1,2,1,0,4,"H","N","2016-04-08","201604080BUF"
"CBJ",0,1,2,1,0,4,0,0,1,0,0,1,"A","N","2016-04-08","201604080BUF"
"BOS",0,1,0,0,0,1,0,0,4,2,0,6,"H","N","2016-04-09","201604090BOS"
"OTT",0,0,4,2,0,6,0,1,0,0,0,1,"A","N","2016-04-09","201604090BOS"
"CBJ",1,0,3,1,0,5,0,3,0,1,0,4,"H","N","2016-04-09","201604090CBJ"
"CHI",0,3,0,1,0,4,1,0,3,1,0,5,"A","N","2016-04-09","201604090CBJ"
"ANA",0,2,1,2,0,5,0,0,2,1,0,3,"A","N","2016-04-09","201604090COL"
"COL",0,0,2,1,0,3,0,2,1,2,0,5,"H","N","2016-04-09","201604090COL"
"DAL",0,0,2,1,0,3,0,1,1,0,0,2,"H","N","2016-04-09","201604090DAL"
"NSH",0,1,1,0,0,2,0,0,2,1,0,3,"A","N","2016-04-09","201604090DAL"
"CAR",0,0,1,1,0,2,0,3,1,1,0,5,"A","N","2016-04-09","201604090FLA"
"FLA",0,3,1,1,0,5,0,0,1,1,0,2,"H","N","2016-04-09","201604090FLA"
"LAK",0,2,1,0,0,3,0,0,2,1,1,4,"H","Y","2016-04-09","201604090LAK"
"WPG",0,0,2,1,1,4,0,2,1,0,0,3,"A","Y","2016-04-09","201604090LAK"
"CGY",0,0,0,2,0,2,0,0,1,0,0,1,"A","N","2016-04-09","201604090MIN"
"MIN",0,0,1,0,0,1,0,0,0,2,0,2,"H","N","2016-04-09","201604090MIN"
"MTL",0,2,2,1,0,5,0,0,0,2,0,2,"H","N","2016-04-09","201604090MTL"
"TBL",0,0,0,2,0,2,0,2,2,1,0,5,"A","N","2016-04-09","201604090MTL"
"NJD",0,1,2,2,0,5,0,1,0,0,0,1,"H","N","2016-04-09","201604090NJD"
"TOR",0,1,0,0,0,1,0,1,2,2,0,5,"A","N","2016-04-09","201604090NJD"
"BUF",1,0,2,1,0,4,0,0,1,2,0,3,"A","N","2016-04-09","201604090NYI"
"NYI",0,0,1,2,0,3,1,0,2,1,0,4,"H","N","2016-04-09","201604090NYI"
"DET",0,0,1,1,0,2,0,1,0,2,0,3,"A","N","2016-04-09","201604090NYR"
"NYR",0,1,0,2,0,3,0,0,1,1,0,2,"H","N","2016-04-09","201604090NYR"
"PHI",0,1,1,1,0,3,0,1,0,0,0,1,"H","N","2016-04-09","201604090PHI"
"PIT",0,1,0,0,0,1,0,1,1,1,0,3,"A","N","2016-04-09","201604090PHI"
"ARI",0,0,0,0,0,0,0,0,0,1,0,1,"A","N","2016-04-09","201604090SJS"
"SJS",0,0,0,1,0,1,0,0,0,0,0,0,"H","N","2016-04-09","201604090SJS"
"STL",0,1,0,0,0,1,0,2,2,1,0,5,"H","N","2016-04-09","201604090STL"
"WSH",0,2,2,1,0,5,0,1,0,0,0,1,"A","N","2016-04-09","201604090STL"
"EDM",0,0,1,2,0,3,0,1,0,2,1,4,"A","Y","2016-04-09","201604090VAN"
"VAN",0,1,0,2,1,4,0,0,1,2,0,3,"H","Y","2016-04-09","201604090VAN"
"NYI",0,2,0,0,0,2,0,2,1,2,0,5,"H","N","2016-04-10","201604100NYI"
"PHI",0,2,1,2,0,5,0,2,0,0,0,2,"A","N","2016-04-10","201604100NYI"
"ANA",0,0,2,0,0,2,0,0,0,0,0,0,"A","N","2016-04-10","201604100WSH"
"WSH",0,0,0,0,0,0,0,0,2,0,0,2,"H","N","2016-04-10","201604100WSH"
"NYR",0,0,0,2,0,2,0,1,1,3,0,5,"A","N","2016-04-13","201604130PIT"
"PIT",0,1,1,3,0,5,0,0,0,2,0,2,"H","N","2016-04-13","201604130PIT"
"CHI",0,0,0,0,0,0,1,0,0,0,0,1,"A","N","2016-04-13","201604130STL"
"STL",1,0,0,0,0,1,0,0,0,0,0,0,"H","N","2016-04-13","201604130STL"
"DET",0,0,2,0,0,2,0,1,1,1,0,3,"A","N","2016-04-13","201604130TBL"
"TBL",0,1,1,1,0,3,0,0,2,0,0,2,"H","N","2016-04-13","201604130TBL"
"DAL",0,0,2,2,0,4,0,0,0,0,0,0,"H","N","2016-04-14","201604140DAL"
"MIN",0,0,0,0,0,0,0,0,2,2,0,4,"A","N","2016-04-14","201604140DAL"
"FLA",0,2,1,1,0,4,0,2,1,2,0,5,"H","N","2016-04-14","201604140FLA"
"NYI",0,2,1,2,0,5,0,2,1,1,0,4,"A","N","2016-04-14","201604140FLA"
"LAK",0,1,2,0,0,3,0,1,2,1,0,4,"H","N","2016-04-14","201604140LAK"
"SJS",0,1,2,1,0,4,0,1,2,0,0,3,"A","N","2016-04-14","201604140LAK"
"PHI",0,0,0,0,0,0,0,0,1,1,0,2,"A","N","2016-04-14","201604140WSH"
"WSH",0,0,1,1,0,2,0,0,0,0,0,0,"H","N","2016-04-14","201604140WSH"
"ANA",0,1,1,0,0,2,0,1,1,1,0,3,"H","N","2016-04-15","201604150ANA"
"NSH",0,1,1,1,0,3,0,1,1,0,0,2,"A","N","2016-04-15","201604150ANA"
"FLA",0,1,1,1,0,3,0,0,0,1,0,1,"H","N","2016-04-15","201604150FLA"
"NYI",0,0,0,1,0,1,0,1,1,1,0,3,"A","N","2016-04-15","201604150FLA"
"CHI",0,0,1,2,0,3,0,0,1,1,0,2,"A","N","2016-04-15","201604150STL"
"STL",0,0,1,1,0,2,0,0,1,2,0,3,"H","N","2016-04-15","201604150STL"
"DET",0,0,1,1,0,2,0,1,1,3,0,5,"A","N","2016-04-15","201604150TBL"
"TBL",0,1,1,3,0,5,0,0,1,1,0,2,"H","N","2016-04-15","201604150TBL"
"DAL",0,0,1,1,0,2,0,0,0,1,0,1,"H","N","2016-04-16","201604160DAL"
"MIN",0,0,0,1,0,1,0,0,1,1,0,2,"A","N","2016-04-16","201604160DAL"
"LAK",0,0,0,1,0,1,0,1,1,0,0,2,"H","N","2016-04-16","201604160LAK"
"SJS",0,1,1,0,0,2,0,0,0,1,0,1,"A","N","2016-04-16","201604160LAK"
"NYR",0,0,3,1,0,4,0,0,1,1,0,2,"A","N","2016-04-16","201604160PIT"
"PIT",0,0,1,1,0,2,0,0,3,1,0,4,"H","N","2016-04-16","201604160PIT"
"PHI",0,0,1,0,0,1,0,1,2,1,0,4,"A","N","2016-04-16","201604160WSH"
"WSH",0,1,2,1,0,4,0,0,1,0,0,1,"H","N","2016-04-16","201604160WSH"
"ANA",0,1,0,1,0,2,0,1,2,0,0,3,"H","N","2016-04-17","201604170ANA"
"NSH",0,1,2,0,0,3,0,1,0,1,0,2,"A","N","2016-04-17","201604170ANA"
"CHI",0,1,1,0,0,2,0,1,0,2,0,3,"H","N","2016-04-17","201604170CHI"
"STL",0,1,0,2,0,3,0,1,1,0,0,2,"A","N","2016-04-17","201604170CHI"
"DET",0,0,2,0,0,2,0,0,0,0,0,0,"H","N","2016-04-17","201604170DET"
"TBL",0,0,0,0,0,0,0,0,2,0,0,2,"A","N","2016-04-17","201604170DET"
"FLA",0,1,2,0,0,3,1,0,3,0,0,4,"A","N","2016-04-17","201604170NYI"
"NYI",1,0,3,0,0,4,0,1,2,0,0,3,"H","N","2016-04-17","201604170NYI"
"DAL",0,2,0,1,0,3,0,1,2,2,0,5,"A","N","2016-04-18","201604180MIN"
"MIN",0,1,2,2,0,5,0,2,0,1,0,3,"H","N","2016-04-18","201604180MIN"
"PHI",0,1,0,0,0,1,0,1,1,4,0,6,"H","N","2016-04-18","201604180PHI"
"WSH",0,1,1,4,0,6,0,1,0,0,0,1,"A","N","2016-04-18","201604180PHI"
"LAK",1,1,0,0,0,2,0,1,0,0,0,1,"A","N","2016-04-18","201604180SJS"
"SJS",0,1,0,0,0,1,1,1,0,0,0,2,"H","N","2016-04-18","201604180SJS"
"CHI",0,0,2,1,0,3,0,1,1,2,0,4,"H","N","2016-04-19","201604190CHI"
"STL",0,1,1,2,0,4,0,0,2,1,0,3,"A","N","2016-04-19","201604190CHI"
"DET",0,0,2,0,0,2,0,1,1,1,0,3,"H","N","2016-04-19","201604190DET"
"TBL",0,1,1,1,0,3,0,0,2,0,0,2,"A","N","2016-04-19","201604190DET"
"ANA",0,1,2,0,0,3,0,0,0,0,0,0,"A","N","2016-04-19","201604190NSH"
"NSH",0,0,0,0,0,0,0,1,2,0,0,3,"H","N","2016-04-19","201604190NSH"
"NYR",0,0,1,0,0,1,0,0,1,2,0,3,"H","N","2016-04-19","201604190NYR"
"PIT",0,0,1,2,0,3,0,0,1,0,0,1,"A","N","2016-04-19","201604190NYR"
"DAL",0,0,3,0,0,3,0,0,2,0,0,2,"A","N","2016-04-20","201604200MIN"
"MIN",0,0,2,0,0,2,0,0,3,0,0,3,"H","N","2016-04-20","201604200MIN"
"FLA",0,0,1,1,0,2,0,0,1,0,0,1,"A","N","2016-04-20","201604200NYI"
"NYI",0,0,1,0,0,1,0,0,1,1,0,2,"H","N","2016-04-20","201604200NYI"
"PHI",0,1,1,0,0,2,0,0,0,1,0,1,"H","N","2016-04-20","201604200PHI"
"WSH",0,0,0,1,0,1,0,1,1,0,0,2,"A","N","2016-04-20","201604200PHI"
"LAK",0,0,0,2,0,2,0,0,2,1,0,3,"A","N","2016-04-20","201604200SJS"
"SJS",0,0,2,1,0,3,0,0,0,2,0,2,"H","N","2016-04-20","201604200SJS"
"ANA",0,1,2,1,0,4,0,0,1,0,0,1,"A","N","2016-04-21","201604210NSH"
"NSH",0,0,1,0,0,1,0,1,2,1,0,4,"H","N","2016-04-21","201604210NSH"
"NYR",0,0,0,0,0,0,0,3,1,1,0,5,"H","N","2016-04-21","201604210NYR"
"PIT",0,3,1,1,0,5,0,0,0,0,0,0,"A","N","2016-04-21","201604210NYR"
"CHI",1,0,3,0,0,4,0,0,1,2,0,3,"A","N","2016-04-21","201604210STL"
"STL",0,0,1,2,0,3,1,0,3,0,0,4,"H","N","2016-04-21","201604210STL"
"DET",0,0,0,0,0,0,0,0,0,1,0,1,"A","N","2016-04-21","201604210TBL"
"TBL",0,0,0,1,0,1,0,0,0,0,0,0,"H","N","2016-04-21","201604210TBL"
"DAL",0,1,0,3,0,4,1,2,0,2,0,5,"H","N","2016-04-22","201604220DAL"
"MIN",1,2,0,2,0,5,0,1,0,3,0,4,"A","N","2016-04-22","201604220DAL"
"FLA",0,0,0,1,0,1,1,1,0,0,0,2,"H","N","2016-04-22","201604220FLA"
"NYI",1,1,0,0,0,2,0,0,0,1,0,1,"A","N","2016-04-22","201604220FLA"
"LAK",0,0,3,0,0,3,0,2,1,3,0,6,"H","N","2016-04-22","201604220LAK"
"SJS",0,2,1,3,0,6,0,0,3,0,0,3,"A","N","2016-04-22","201604220LAK"
"PHI",0,0,1,1,0,2,0,0,0,0,0,0,"A","N","2016-04-22","201604220WSH"
"WSH",0,0,0,0,0,0,0,0,1,1,0,2,"H","N","2016-04-22","201604220WSH"
"ANA",0,0,2,3,0,5,0,0,1,1,0,2,"H","N","2016-04-23","201604230ANA"
"NSH",0,0,1,1,0,2,0,0,2,3,0,5,"A","N","2016-04-23","201604230ANA"
"CHI",0,1,3,2,0,6,0,3,0,0,0,3,"H","N","2016-04-23","201604230CHI"
"STL",0,3,0,0,0,3,0,1,3,2,0,6,"A","N","2016-04-23","201604230CHI"
"NYR",0,2,0,1,0,3,0,2,4,0,0,6,"A","N","2016-04-23","201604230PIT"
"PIT",0,2,4,0,0,6,0,2,0,1,0,3,"H","N","2016-04-23","201604230PIT"
"DAL",0,3,1,1,0,5,0,0,0,4,0,4,"A","N","2016-04-24","201604240MIN"
"MIN",0,0,0,4,0,4,0,3,1,1,0,5,"H","N","2016-04-24","201604240MIN"
"FLA",0,1,0,0,0,1,1,0,0,1,0,2,"A","N","2016-04-24","201604240NYI"
"NYI",1,0,0,1,0,2,0,1,0,0,0,1,"H","N","2016-04-24","201604240NYI"
"PHI",0,0,0,0,0,0,0,0,1,0,0,1,"H","N","2016-04-24","201604240PHI"
"WSH",0,0,1,0,0,1,0,0,0,0,0,0,"A","N","2016-04-24","201604240PHI"
"ANA",0,0,1,0,0,1,0,0,2,1,0,3,"A","N","2016-04-25","201604250NSH"
"NSH",0,0,2,1,0,3,0,0,1,0,0,1,"H","N","2016-04-25","201604250NSH"
"CHI",0,1,1,0,0,2,0,2,0,1,0,3,"A","N","2016-04-25","201604250STL"
"STL",0,2,0,1,0,3,0,1,1,0,0,2,"H","N","2016-04-25","201604250STL"
"ANA",0,0,0,1,0,1,0,2,0,0,0,2,"H","N","2016-04-27","201604270ANA"
"NSH",0,2,0,0,0,2,0,0,0,1,0,1,"A","N","2016-04-27","201604270ANA"
"NYI",0,3,1,1,0,5,0,1,0,2,0,3,"A","N","2016-04-27","201604270TBL"
"TBL",0,1,0,2,0,3,0,3,1,1,0,5,"H","N","2016-04-27","201604270TBL"
"PIT",0,0,2,1,0,3,1,1,1,1,0,4,"A","N","2016-04-28","201604280WSH"
"WSH",1,1,1,1,0,4,0,0,2,1,0,3,"H","N","2016-04-28","201604280WSH"
"DAL",0,0,1,1,0,2,0,0,0,1,0,1,"H","N","2016-04-29","201604290DAL"
"STL",0,0,0,1,0,1,0,0,1,1,0,2,"A","N","2016-04-29","201604290DAL"
"NSH",0,0,1,1,0,2,0,0,0,5,0,5,"A","N","2016-04-29","201604290SJS"
"SJS",0,0,0,5,0,5,0,0,1,1,0,2,"H","N","2016-04-29","201604290SJS"
"NYI",0,1,0,0,0,1,0,2,1,1,0,4,"A","N","2016-04-30","201604300TBL"
"TBL",0,2,1,1,0,4,0,1,0,0,0,1,"H","N","2016-04-30","201604300TBL"
"PIT",0,0,1,1,0,2,0,0,0,1,0,1,"A","N","2016-04-30","201604300WSH"
"WSH",0,0,0,1,0,1,0,0,1,1,0,2,"H","N","2016-04-30","201604300WSH"
"DAL",0,1,0,2,0,3,1,3,0,0,0,4,"H","N","2016-05-01","201605010DAL"
"STL",1,3,0,0,0,4,0,1,0,2,0,3,"A","N","2016-05-01","201605010DAL"
"NSH",0,0,0,2,0,2,0,0,1,2,0,3,"A","N","2016-05-01","201605010SJS"
"SJS",0,0,1,2,0,3,0,0,0,2,0,2,"H","N","2016-05-01","201605010SJS"
"PIT",0,2,1,0,0,3,0,0,0,2,0,2,"H","N","2016-05-02","201605020PIT"
"WSH",0,0,0,2,0,2,0,2,1,0,0,3,"A","N","2016-05-02","201605020PIT"
"NSH",0,0,2,2,0,4,0,1,0,0,0,1,"H","N","2016-05-03","201605030NSH"
"SJS",0,1,0,0,0,1,0,0,2,2,0,4,"A","N","2016-05-03","201605030NSH"
"NYI",0,1,1,2,0,4,1,1,1,2,0,5,"H","N","2016-05-03","201605030NYI"
"TBL",1,1,1,2,0,5,0,1,1,2,0,4,"A","N","2016-05-03","201605030NYI"
"DAL",0,1,0,0,0,1,0,2,3,1,0,6,"A","N","2016-05-03","201605030STL"
"STL",0,2,3,1,0,6,0,1,0,0,0,1,"H","N","2016-05-03","201605030STL"
"PIT",1,1,1,0,0,3,0,1,1,0,0,2,"H","N","2016-05-04","201605040PIT"
"WSH",0,1,1,0,0,2,1,1,1,0,0,3,"A","N","2016-05-04","201605040PIT"
"NSH",1,2,0,1,0,4,0,1,1,1,0,3,"H","N","2016-05-05","201605050NSH"
"SJS",0,1,1,1,0,3,1,2,0,1,0,4,"A","N","2016-05-05","201605050NSH"
"DAL",1,0,2,0,0,3,0,1,1,0,0,2,"A","N","2016-05-05","201605050STL"
"STL",0,1,1,0,0,2,1,0,2,0,0,3,"H","N","2016-05-05","201605050STL"
"NYI",0,1,0,0,0,1,1,0,0,1,0,2,"H","N","2016-05-06","201605060NYI"
"TBL",1,0,0,1,0,2,0,1,0,0,0,1,"A","N","2016-05-06","201605060NYI"
"DAL",0,1,0,0,0,1,0,1,2,1,0,4,"H","N","2016-05-07","201605070DAL"
"STL",0,1,2,1,0,4,0,1,0,0,0,1,"A","N","2016-05-07","201605070DAL"
"NSH",0,1,0,0,0,1,0,2,2,1,0,5,"A","N","2016-05-07","201605070SJS"
"SJS",0,2,2,1,0,5,0,1,0,0,0,1,"H","N","2016-05-07","201605070SJS"
"PIT",0,1,0,0,0,1,0,1,2,0,0,3,"A","N","2016-05-07","201605070WSH"
"WSH",0,1,2,0,0,3,0,1,0,0,0,1,"H","N","2016-05-07","201605070WSH"
"NYI",0,0,0,0,0,0,0,2,1,1,0,4,"A","N","2016-05-08","201605080TBL"
"TBL",0,2,1,1,0,4,0,0,0,0,0,0,"H","N","2016-05-08","201605080TBL"
"NSH",1,1,1,1,0,4,0,2,0,1,0,3,"H","N","2016-05-09","201605090NSH"
"SJS",0,2,0,1,0,3,1,1,1,1,0,4,"A","N","2016-05-09","201605090NSH"
"DAL",0,3,0,0,0,3,0,0,1,1,0,2,"A","N","2016-05-09","201605090STL"
"STL",0,0,1,1,0,2,0,3,0,0,0,3,"H","N","2016-05-09","201605090STL"
"PIT",1,1,2,0,0,4,0,0,1,2,0,3,"H","N","2016-05-10","201605100PIT"
"WSH",0,0,1,2,0,3,1,1,2,0,0,4,"A","N","2016-05-10","201605100PIT"
"DAL",0,0,0,1,0,1,0,3,2,1,0,6,"H","N","2016-05-11","201605110DAL"
"STL",0,3,2,1,0,6,0,0,0,1,0,1,"A","N","2016-05-11","201605110DAL"
"NSH",0,0,0,0,0,0,0,2,1,2,0,5,"A","N","2016-05-12","201605120SJS"
"SJS",0,2,1,2,0,5,0,0,0,0,0,0,"H","N","2016-05-12","201605120SJS"
"PIT",0,0,1,0,0,1,0,1,2,0,0,3,"H","N","2016-05-13","201605130PIT"
"TBL",0,1,2,0,0,3,0,0,1,0,0,1,"A","N","2016-05-13","201605130PIT"
"SJS",0,1,0,0,0,1,0,1,1,0,0,2,"A","N","2016-05-15","201605150STL"
"STL",0,1,1,0,0,2,0,1,0,0,0,1,"H","N","2016-05-15","201605150STL"
"PIT",1,2,0,0,0,3,0,2,0,0,0,2,"H","N","2016-05-16","201605160PIT"
"TBL",0,2,0,0,0,2,1,2,0,0,0,3,"A","N","2016-05-16","201605160PIT"
"SJS",0,1,1,2,0,4,0,0,0,0,0,0,"A","N","2016-05-17","201605170STL"
"STL",0,0,0,0,0,0,0,1,1,2,0,4,"H","N","2016-05-17","201605170STL"
"PIT",0,0,1,3,0,4,0,0,0,2,0,2,"A","N","2016-05-18","201605180TBL"
"TBL",0,0,0,2,0,2,0,0,1,3,0,4,"H","N","2016-05-18","201605180TBL"
"SJS",0,1,1,1,0,3,0,0,0,0,0,0,"H","N","2016-05-19","201605190SJS"
"STL",0,0,0,0,0,0,0,1,1,1,0,3,"A","N","2016-05-19","201605190SJS"
"PIT",0,0,0,3,0,3,0,2,2,0,0,4,"A","N","2016-05-20","201605200TBL"
"TBL",0,2,2,0,0,4,0,0,0,3,0,3,"H","N","2016-05-20","201605200TBL"
"SJS",0,0,0,3,0,3,0,2,2,2,0,6,"H","N","2016-05-21","201605210SJS"
"STL",0,2,2,2,0,6,0,0,0,3,0,3,"A","N","2016-05-21","201605210SJS"
"PIT",0,1,2,0,0,3,1,0,2,1,0,4,"H","N","2016-05-22","201605220PIT"
"TBL",1,0,2,1,0,4,0,1,2,0,0,3,"A","N","2016-05-22","201605220PIT"
"SJS",0,1,2,3,0,6,0,2,1,0,0,3,"A","N","2016-05-23","201605230STL"
"STL",0,2,1,0,0,3,0,1,2,3,0,6,"H","N","2016-05-23","201605230STL"
"PIT",0,1,2,2,0,5,0,0,0,2,0,2,"A","N","2016-05-24","201605240TBL"
"TBL",0,0,0,2,0,2,0,1,2,2,0,5,"H","N","2016-05-24","201605240TBL"
"SJS",0,1,1,3,0,5,0,0,0,2,0,2,"H","N","2016-05-25","201605250SJS"
"STL",0,0,0,2,0,2,0,1,1,3,0,5,"A","N","2016-05-25","201605250SJS"
"PIT",0,0,2,0,0,2,0,0,1,0,0,1,"H","N","2016-05-26","201605260PIT"
"TBL",0,0,1,0,0,1,0,0,2,0,0,2,"A","N","2016-05-26","201605260PIT"
"PIT",0,2,0,1,0,3,0,0,2,0,0,2,"H","N","2016-05-30","201605300PIT"
"SJS",0,0,2,0,0,2,0,2,0,1,0,3,"A","N","2016-05-30","201605300PIT"
"PIT",1,0,1,0,0,2,0,0,0,1,0,1,"H","N","2016-06-01","201606010PIT"
"SJS",0,0,0,1,0,1,1,0,1,0,0,2,"A","N","2016-06-01","201606010PIT"
"PIT",0,1,1,0,0,2,1,1,0,1,0,3,"A","N","2016-06-04","201606040SJS"
"SJS",1,1,0,1,0,3,0,1,1,0,0,2,"H","N","2016-06-04","201606040SJS"
"PIT",0,1,1,1,0,3,0,0,0,1,0,1,"A","N","2016-06-06","201606060SJS"
"SJS",0,0,0,1,0,1,0,1,1,1,0,3,"H","N","2016-06-06","201606060SJS"
"PIT",0,2,0,0,0,2,0,3,0,1,0,4,"H","N","2016-06-09","201606090PIT"
"SJS",0,3,0,1,0,4,0,2,0,0,0,2,"A","N","2016-06-09","201606090PIT"
"PIT",0,1,1,1,0,3,0,0,1,0,0,1,"A","N","2016-06-12","201606120SJS"
"SJS",0,0,1,0,0,1,0,1,1,1,0,3,"H","N","2016-06-12","201606120SJS"
"CHI",0,1,1,0,0,2,0,0,2,3,0,5,"H","N","2016-10-12","201610120CHI"
"STL",0,0,2,3,0,5,0,1,1,0,0,2,"A","N","2016-10-12","201610120CHI"
"CGY",0,1,2,1,0,4,0,3,2,2,0,7,"A","N","2016-10-12","201610120EDM"
"EDM",0,3,2,2,0,7,0,1,2,1,0,4,"H","N","2016-10-12","201610120EDM"
"OTT",1,2,1,1,0,5,0,2,2,0,0,4,"H","N","2016-10-12","201610120OTT"
"TOR",0,2,2,0,0,4,1,2,1,1,0,5,"A","N","2016-10-12","201610120OTT"
"LAK",0,1,0,0,0,1,0,1,0,1,0,2,"A","N","2016-10-12","201610120SJS"
"SJS",0,1,0,1,0,2,0,1,0,0,0,1,"H","N","2016-10-12","201610120SJS"
"BUF",0,0,0,1,0,1,0,1,1,2,0,4,"H","N","2016-10-13","201610130BUF"
"MTL",0,1,1,2,0,4,0,0,0,1,0,1,"A","N","2016-10-13","201610130BUF"
"BOS",0,0,3,3,0,6,0,2,1,0,0,3,"A","N","2016-10-13","201610130CBJ"
"CBJ",0,2,1,0,0,3,0,0,3,3,0,6,"H","N","2016-10-13","201610130CBJ"
"ANA",0,1,0,1,0,2,0,1,1,2,0,4,"A","N","2016-10-13","201610130DAL"
"DAL",0,1,1,2,0,4,0,1,0,1,0,2,"H","N","2016-10-13","201610130DAL"
"FLA",1,1,0,0,0,2,0,1,0,0,0,1,"H","N","2016-10-13","201610130FLA"
"NJD",0,1,0,0,0,1,1,1,0,0,0,2,"A","N","2016-10-13","201610130FLA"
"NYI",0,0,0,3,0,3,0,1,1,3,0,5,"A","N","2016-10-13","201610130NYR"
"NYR",0,1,1,3,0,5,0,0,0,3,0,3,"H","N","2016-10-13","201610130NYR"
"PIT",0,0,2,0,1,3,0,1,0,1,0,2,"H","Y","2016-10-13","201610130PIT"
"WSH",0,1,0,1,0,2,0,0,2,0,1,3,"A","Y","2016-10-13","201610130PIT"
"MIN",0,0,1,1,0,2,0,1,1,1,0,3,"A","N","2016-10-13","201610130STL"
"STL",0,1,1,1,0,3,0,0,1,1,0,2,"H","N","2016-10-13","201610130STL"
"DET",0,2,1,1,0,4,0,0,2,4,0,6,"A","N","2016-10-13","201610130TBL"
"TBL",0,0,2,4,0,6,0,2,1,1,0,4,"H","N","2016-10-13","201610130TBL"
"CAR",0,1,2,1,0,4,1,1,0,3,0,5,"A","N","2016-10-13","201610130WPG"
"WPG",1,1,0,3,0,5,0,1,2,1,0,4,"H","N","2016-10-13","201610130WPG"
"CGY",0,2,0,1,0,3,0,1,1,3,0,5,"H","N","2016-10-14","201610140CGY"
"EDM",0,1,1,3,0,5,0,2,0,1,0,3,"A","N","2016-10-14","201610140CGY"
"LAK",0,0,1,1,0,2,0,0,4,0,0,4,"H","N","2016-10-14","201610140LAK"
"PHI",0,0,4,0,0,4,0,0,1,1,0,2,"A","N","2016-10-14","201610140LAK"
"CHI",0,2,0,0,0,2,0,2,1,0,0,3,"A","N","2016-10-14","201610140NSH"
"NSH",0,2,1,0,0,3,0,2,0,0,0,2,"H","N","2016-10-14","201610140NSH"
"ARI",1,2,1,0,0,4,0,1,1,1,0,3,"H","N","2016-10-15","201610150ARI"
"PHI",0,1,1,1,0,3,1,2,1,0,0,4,"A","N","2016-10-15","201610150ARI"
"CBJ",0,0,0,2,0,2,0,2,0,1,0,3,"H","N","2016-10-15","201610150CBJ"
"SJS",0,2,0,1,0,3,0,0,0,2,0,2,"A","N","2016-10-15","201610150CBJ"
"CHI",0,3,0,2,0,5,0,1,1,1,0,3,"H","N","2016-10-15","201610150CHI"
"NSH",0,1,1,1,0,3,0,3,0,2,0,5,"A","N","2016-10-15","201610150CHI"
"COL",0,2,3,1,0,6,0,2,2,1,0,5,"H","N","2016-10-15","201610150COL"
"DAL",0,2,2,1,0,5,0,2,3,1,0,6,"A","N","2016-10-15","201610150COL"
"DET",0,1,0,0,0,1,0,2,0,2,0,4,"A","N","2016-10-15","201610150FLA"
"FLA",0,2,0,2,0,4,0,1,0,0,0,1,"H","N","2016-10-15","201610150FLA"
"MIN",0,0,3,1,0,4,0,2,0,1,0,3,"H","N","2016-10-15","201610150MIN"
"WPG",0,2,0,1,0,3,0,0,3,1,0,4,"A","N","2016-10-15","201610150MIN"
"MTL",0,0,1,2,0,3,0,2,0,1,1,4,"A","Y","2016-10-15","201610150OTT"
"OTT",0,2,0,1,1,4,0,0,1,2,0,3,"H","Y","2016-10-15","201610150OTT"
"ANA",0,1,1,0,0,2,0,1,2,0,0,3,"A","N","2016-10-15","201610150PIT"
"PIT",0,1,2,0,0,3,0,1,1,0,0,2,"H","N","2016-10-15","201610150PIT"
"NYR",0,1,1,0,0,2,0,2,1,0,0,3,"A","N","2016-10-15","201610150STL"
"STL",0,2,1,0,0,3,0,1,1,0,0,2,"H","N","2016-10-15","201610150STL"
"NJD",0,2,0,0,0,2,0,0,2,1,0,3,"A","N","2016-10-15","201610150TBL"
"TBL",0,0,2,1,0,3,0,2,0,0,0,2,"H","N","2016-10-15","201610150TBL"
"BOS",0,1,0,0,0,1,0,3,0,1,0,4,"A","N","2016-10-15","201610150TOR"
"TOR",0,3,0,1,0,4,0,1,0,0,0,1,"H","N","2016-10-15","201610150TOR"
"CGY",0,1,0,0,0,1,0,0,0,1,1,2,"A","Y","2016-10-15","201610150VAN"
"VAN",0,0,0,1,1,2,0,1,0,0,0,1,"H","Y","2016-10-15","201610150VAN"
"NYI",0,1,0,0,0,1,0,1,1,0,0,2,"A","N","2016-10-15","201610150WSH"
"WSH",0,1,1,0,0,2,0,1,0,0,0,1,"H","N","2016-10-15","201610150WSH"
"BUF",0,2,2,2,0,6,0,2,0,0,0,2,"A","N","2016-10-16","201610160EDM"
"EDM",0,2,0,0,0,2,0,2,2,2,0,6,"H","N","2016-10-16","201610160EDM"
"ANA",0,0,0,2,0,2,1,1,0,1,0,3,"A","N","2016-10-16","201610160NYI"
"NYI",1,1,0,1,0,3,0,0,0,2,0,2,"H","N","2016-10-16","201610160NYI"
"CAR",0,2,1,0,0,3,1,0,1,2,0,4,"A","N","2016-10-16","201610160VAN"
"VAN",1,0,1,2,0,4,0,2,1,0,0,3,"H","N","2016-10-16","201610160VAN"
"DET",0,3,0,2,0,5,0,0,1,0,0,1,"H","N","2016-10-17","201610170DET"
"OTT",0,0,1,0,0,1,0,3,0,2,0,5,"A","N","2016-10-17","201610170DET"
"NYR",0,1,2,4,0,7,0,1,0,3,0,4,"H","N","2016-10-17","201610170NYR"
"SJS",0,1,0,3,0,4,0,1,2,4,0,7,"A","N","2016-10-17","201610170NYR"
"COL",1,2,0,1,0,4,0,2,0,1,0,3,"A","N","2016-10-17","201610170PIT"
"PIT",0,2,0,1,0,3,1,2,0,1,0,4,"H","N","2016-10-17","201610170PIT"
"BOS",0,1,1,2,0,4,0,1,0,0,0,1,"A","N","2016-10-17","201610170WPG"
"WPG",0,1,0,0,0,1,0,1,1,2,0,4,"H","N","2016-10-17","201610170WPG"
"BUF",0,1,1,1,0,3,1,1,0,2,0,4,"A","N","2016-10-18","201610180CGY"
"CGY",1,1,0,2,0,4,0,1,1,1,0,3,"H","N","2016-10-18","201610180CGY"
"CHI",0,3,1,3,0,7,0,0,1,3,0,4,"H","N","2016-10-18","201610180CHI"
"PHI",0,0,1,3,0,4,0,3,1,3,0,7,"A","N","2016-10-18","201610180CHI"
"CAR",0,0,0,2,0,2,0,2,1,0,0,3,"A","N","2016-10-18","201610180EDM"
"EDM",0,2,1,0,0,3,0,0,0,2,0,2,"H","N","2016-10-18","201610180EDM"
"LAK",0,1,0,2,0,3,0,2,3,1,0,6,"A","N","2016-10-18","201610180MIN"
"MIN",0,2,3,1,0,6,0,1,0,2,0,3,"H","N","2016-10-18","201610180MIN"
"MTL",0,1,1,2,0,4,0,0,0,0,0,0,"H","N","2016-10-18","201610180MTL"
"PIT",0,0,0,0,0,0,0,1,1,2,0,4,"A","N","2016-10-18","201610180MTL"
"ANA",0,1,0,0,0,1,0,0,2,0,0,2,"A","N","2016-10-18","201610180NJD"
"NJD",0,0,2,0,0,2,0,1,0,0,0,1,"H","N","2016-10-18","201610180NJD"
"DAL",0,0,1,1,0,2,0,0,1,0,0,1,"A","N","2016-10-18","201610180NSH"
"NSH",0,0,1,0,0,1,0,0,1,1,0,2,"H","N","2016-10-18","201610180NSH"
"NYI",0,0,2,0,0,2,0,1,1,1,0,3,"H","N","2016-10-18","201610180NYI"
"SJS",0,1,1,1,0,3,0,0,2,0,0,2,"A","N","2016-10-18","201610180NYI"
"ARI",0,1,0,3,0,4,0,2,1,4,0,7,"A","N","2016-10-18","201610180OTT"
"OTT",0,2,1,4,0,7,0,1,0,3,0,4,"H","N","2016-10-18","201610180OTT"
"FLA",0,0,1,2,0,3,0,0,2,1,1,4,"A","Y","2016-10-18","201610180TBL"
"TBL",0,0,2,1,1,4,0,0,1,2,0,3,"H","Y","2016-10-18","201610180TBL"
"STL",0,0,1,0,0,1,1,0,0,1,0,2,"A","N","2016-10-18","201610180VAN"
"VAN",1,0,0,1,0,2,0,0,1,0,0,1,"H","N","2016-10-18","201610180VAN"
"COL",0,0,0,0,0,0,0,1,1,1,0,3,"A","N","2016-10-18","201610180WSH"
"WSH",0,1,1,1,0,3,0,0,0,0,0,0,"H","N","2016-10-18","201610180WSH"
"DET",0,0,1,1,0,2,0,1,0,0,0,1,"A","N","2016-10-19","201610190NYR"
"NYR",0,1,0,0,0,1,0,0,1,1,0,2,"H","N","2016-10-19","201610190NYR"
"TOR",0,2,2,0,0,4,1,0,1,3,0,5,"A","N","2016-10-19","201610190WPG"
"WPG",1,0,1,3,0,5,0,2,2,0,0,4,"H","N","2016-10-19","201610190WPG"
"BOS",0,0,0,2,0,2,0,0,0,1,0,1,"H","N","2016-10-20","201610200BOS"
"NJD",0,0,0,1,0,1,0,0,0,2,0,2,"A","N","2016-10-20","201610200BOS"
"CAR",0,2,1,1,0,4,0,0,1,1,0,2,"A","N","2016-10-20","201610200CGY"
"CGY",0,0,1,1,0,2,0,2,1,1,0,4,"H","N","2016-10-20","201610200CGY"
"DAL",0,1,1,1,0,3,1,1,2,0,0,4,"H","N","2016-10-20","201610200DAL"
"LAK",1,1,2,0,0,4,0,1,1,1,0,3,"A","N","2016-10-20","201610200DAL"
"EDM",0,0,1,2,0,3,0,0,1,0,0,1,"H","N","2016-10-20","201610200EDM"
"STL",0,0,1,0,0,1,0,0,1,2,0,3,"A","N","2016-10-20","201610200EDM"
"FLA",0,1,1,0,0,2,0,2,0,2,0,4,"H","N","2016-10-20","201610200FLA"
"WSH",0,2,0,2,0,4,0,1,1,0,0,2,"A","N","2016-10-20","201610200FLA"
"MIN",0,0,1,2,0,3,0,0,2,0,0,2,"H","N","2016-10-20","201610200MIN"
"TOR",0,0,2,0,0,2,0,0,1,2,0,3,"A","N","2016-10-20","201610200MIN"
"ARI",0,0,2,0,0,2,0,1,3,1,0,5,"A","N","2016-10-20","201610200MTL"
"MTL",0,1,3,1,0,5,0,0,2,0,0,2,"H","N","2016-10-20","201610200MTL"
"ANA",0,1,1,1,0,3,0,0,2,0,0,2,"A","N","2016-10-20","201610200PHI"
"PHI",0,0,2,0,0,2,0,1,1,1,0,3,"H","N","2016-10-20","201610200PHI"
"PIT",0,0,0,3,0,3,0,0,2,0,0,2,"H","N","2016-10-20","201610200PIT"
"SJS",0,0,2,0,0,2,0,0,0,3,0,3,"A","N","2016-10-20","201610200PIT"
"COL",0,1,1,2,0,4,0,0,0,0,0,0,"A","N","2016-10-20","201610200TBL"
"TBL",0,0,0,0,0,0,0,1,1,2,0,4,"H","N","2016-10-20","201610200TBL"
"BUF",0,0,0,1,0,1,0,0,1,1,0,2,"A","N","2016-10-20","201610200VAN"
"VAN",0,0,1,1,0,2,0,0,0,1,0,1,"H","N","2016-10-20","201610200VAN"
"CBJ",0,1,2,0,0,3,0,0,1,1,0,2,"H","N","2016-10-21","201610210CBJ"
"CHI",0,0,1,1,0,2,0,1,2,0,0,3,"A","N","2016-10-21","201610210CBJ"
"DET",0,0,2,3,0,5,0,0,2,1,0,3,"H","N","2016-10-21","201610210DET"
"NSH",0,0,2,1,0,3,0,0,2,3,0,5,"A","N","2016-10-21","201610210DET"
"ARI",0,2,0,0,0,2,0,2,0,1,0,3,"A","N","2016-10-21","201610210NYI"
"NYI",0,2,0,1,0,3,0,2,0,0,0,2,"H","N","2016-10-21","201610210NYI"
"BOS",0,0,0,2,0,2,0,0,2,2,0,4,"H","N","2016-10-22","201610220BOS"
"MTL",0,0,2,2,0,4,0,0,0,2,0,2,"A","N","2016-10-22","201610220BOS"
"CGY",0,0,2,2,0,4,0,1,3,2,0,6,"H","N","2016-10-22","201610220CGY"
"STL",0,1,3,2,0,6,0,0,2,2,0,4,"A","N","2016-10-22","201610220CGY"
"CHI",0,1,1,2,1,5,0,1,2,1,0,4,"H","Y","2016-10-22","201610220CHI"
"TOR",0,1,2,1,0,4,0,1,1,2,1,5,"A","Y","2016-10-22","201610220CHI"
"CBJ",0,0,1,2,0,3,0,0,0,0,0,0,"A","N","2016-10-22","201610220DAL"
"DAL",0,0,0,0,0,0,0,0,1,2,0,3,"H","N","2016-10-22","201610220DAL"
"DET",0,0,2,1,0,3,0,0,0,0,0,0,"H","N","2016-10-22","201610220DET"
"SJS",0,0,0,0,0,0,0,0,2,1,0,3,"A","N","2016-10-22","201610220DET"
"COL",0,1,0,1,0,2,0,0,2,3,0,5,"A","N","2016-10-22","201610220FLA"
"FLA",0,0,2,3,0,5,0,1,0,1,0,2,"H","N","2016-10-22","201610220FLA"
"LAK",0,2,1,0,1,4,0,0,2,1,0,3,"H","Y","2016-10-22","201610220LAK"
"VAN",0,0,2,1,0,3,0,2,1,0,1,4,"A","Y","2016-10-22","201610220LAK"
"MIN",0,0,1,0,0,1,1,0,0,1,0,2,"A","N","2016-10-22","201610220NJD"
"NJD",1,0,0,1,0,2,0,0,1,0,0,1,"H","N","2016-10-22","201610220NJD"
"NSH",0,1,4,0,0,5,0,1,0,0,0,1,"H","N","2016-10-22","201610220NSH"
"PIT",0,1,0,0,0,1,0,1,4,0,0,5,"A","N","2016-10-22","201610220NSH"
"OTT",0,0,1,0,0,1,0,0,2,2,0,4,"H","N","2016-10-22","201610220OTT"
"TBL",0,0,2,2,0,4,0,0,1,0,0,1,"A","N","2016-10-22","201610220OTT"
"CAR",0,0,3,0,0,3,0,0,4,2,0,6,"A","N","2016-10-22","201610220PHI"
"PHI",0,0,4,2,0,6,0,0,3,0,0,3,"H","N","2016-10-22","201610220PHI"
"NYR",0,0,3,1,0,4,0,2,0,0,0,2,"A","N","2016-10-22","201610220WSH"
"WSH",0,2,0,0,0,2,0,0,3,1,0,4,"H","N","2016-10-22","201610220WSH"
"ANA",0,1,1,2,0,4,0,1,0,1,0,2,"H","N","2016-10-23","201610230ANA"
"VAN",0,1,0,1,0,2,0,1,1,2,0,4,"A","N","2016-10-23","201610230ANA"
"MIN",0,0,2,1,0,3,0,0,3,3,0,6,"A","N","2016-10-23","201610230NYI"
"NYI",0,0,3,3,0,6,0,0,2,1,0,3,"H","N","2016-10-23","201610230NYI"
"ARI",0,1,1,0,0,2,0,1,1,1,0,3,"A","N","2016-10-23","201610230NYR"
"NYR",0,1,1,1,0,3,0,1,1,0,0,2,"H","N","2016-10-23","201610230NYR"
"EDM",0,0,3,0,0,3,0,0,0,0,0,0,"A","N","2016-10-23","201610230WPG"
"WPG",0,0,0,0,0,0,0,0,3,0,0,3,"H","N","2016-10-23","201610230WPG"
"CGY",0,1,1,0,1,3,0,0,1,1,0,2,"A","Y","2016-10-24","201610240CHI"
"CHI",0,0,1,1,0,2,0,1,1,0,1,3,"H","Y","2016-10-24","201610240CHI"
"MTL",0,0,1,2,0,3,0,0,1,0,0,1,"H","N","2016-10-24","201610240MTL"
"PHI",0,0,1,0,0,1,0,0,1,2,0,3,"A","N","2016-10-24","201610240MTL"
"BOS",0,0,0,0,0,0,0,0,4,1,0,5,"H","N","2016-10-25","201610250BOS"
"MIN",0,0,4,1,0,5,0,0,0,0,0,0,"A","N","2016-10-25","201610250BOS"
"DAL",0,1,1,1,0,3,0,0,1,1,0,2,"H","N","2016-10-25","201610250DAL"
"WPG",0,0,1,1,0,2,0,1,1,1,0,3,"A","N","2016-10-25","201610250DAL"
"CAR",0,0,2,0,0,2,0,3,1,0,0,4,"A","N","2016-10-25","201610250DET"
"DET",0,3,1,0,0,4,0,0,2,0,0,2,"H","N","2016-10-25","201610250DET"
"CBJ",0,0,2,0,0,2,1,0,1,1,0,3,"A","N","2016-10-25","201610250LAK"
"LAK",1,0,1,1,0,3,0,0,2,0,0,2,"H","N","2016-10-25","201610250LAK"
"ARI",0,1,0,2,0,3,0,1,2,2,0,5,"A","N","2016-10-25","201610250NJD"
"NJD",0,1,2,2,0,5,0,1,0,2,0,3,"H","N","2016-10-25","201610250NJD"
"BUF",0,0,3,0,0,3,0,0,0,3,1,4,"A","Y","2016-10-25","201610250PHI"
"PHI",0,0,0,3,1,4,0,0,3,0,0,3,"H","Y","2016-10-25","201610250PHI"
"FLA",0,1,1,0,0,2,0,0,1,2,0,3,"A","N","2016-10-25","201610250PIT"
"PIT",0,0,1,2,0,3,0,1,1,0,0,2,"H","N","2016-10-25","201610250PIT"
"ANA",0,0,1,0,0,1,1,1,0,0,0,2,"A","N","2016-10-25","201610250SJS"
"SJS",1,1,0,0,0,2,0,0,1,0,0,1,"H","N","2016-10-25","201610250SJS"
"CGY",0,2,1,1,0,4,0,0,0,1,0,1,"A","N","2016-10-25","201610250STL"
"STL",0,0,0,1,0,1,0,2,1,1,0,4,"H","N","2016-10-25","201610250STL"
"TBL",0,3,1,3,0,7,0,0,1,2,0,3,"A","N","2016-10-25","201610250TOR"
"TOR",0,0,1,2,0,3,0,3,1,3,0,7,"H","N","2016-10-25","201610250TOR"
"OTT",0,1,0,2,0,3,0,0,0,0,0,0,"A","N","2016-10-25","201610250VAN"
"VAN",0,0,0,0,0,0,0,1,0,2,0,3,"H","N","2016-10-25","201610250VAN"
"ANA",0,1,5,0,0,6,0,0,0,1,0,1,"H","N","2016-10-26","201610260ANA"
"NSH",0,0,0,1,0,1,0,1,5,0,0,6,"A","N","2016-10-26","201610260ANA"
"EDM",0,0,2,2,0,4,0,0,0,1,0,1,"H","N","2016-10-26","201610260EDM"
"WSH",0,0,0,1,0,1,0,0,2,2,0,4,"A","N","2016-10-26","201610260EDM"
"MTL",0,0,1,2,0,3,0,0,1,1,0,2,"A","N","2016-10-26","201610260NYI"
"NYI",0,0,1,1,0,2,0,0,1,2,0,3,"H","N","2016-10-26","201610260NYI"
"BOS",0,2,0,0,0,2,0,0,3,2,0,5,"A","N","2016-10-26","201610260NYR"
"NYR",0,0,3,2,0,5,0,2,0,0,0,2,"H","N","2016-10-26","201610260NYR"
"BUF",0,0,0,0,0,0,0,2,0,2,0,4,"H","N","2016-10-27","201610270BUF"
"MIN",0,2,0,2,0,4,0,0,0,0,0,0,"A","N","2016-10-27","201610270BUF"
"LAK",1,0,1,1,0,3,0,0,1,1,0,2,"H","N","2016-10-27","201610270LAK"
"NSH",0,0,1,1,0,2,1,0,1,1,0,3,"A","N","2016-10-27","201610270LAK"
"MTL",0,0,0,3,0,3,0,0,1,0,0,1,"H","N","2016-10-27","201610270MTL"
"TBL",0,0,1,0,0,1,0,0,0,3,0,3,"A","N","2016-10-27","201610270MTL"
"ARI",0,2,0,3,0,5,0,0,2,2,0,4,"A","N","2016-10-27","201610270PHI"
"PHI",0,0,2,2,0,4,0,2,0,3,0,5,"H","N","2016-10-27","201610270PHI"
"NYI",0,0,1,1,0,2,0,1,0,3,0,4,"A","N","2016-10-27","201610270PIT"
"PIT",0,1,0,3,0,4,0,0,1,1,0,2,"H","N","2016-10-27","201610270PIT"
"CBJ",0,0,0,1,0,1,0,1,0,2,0,3,"A","N","2016-10-27","201610270SJS"
"SJS",0,1,0,2,0,3,0,0,0,1,0,1,"H","N","2016-10-27","201610270SJS"
"DET",0,0,1,0,1,2,0,0,1,0,0,1,"A","Y","2016-10-27","201610270STL"
"STL",0,0,1,0,0,1,0,0,1,0,1,2,"H","Y","2016-10-27","201610270STL"
"FLA",0,1,1,0,0,2,0,1,2,0,0,3,"A","N","2016-10-27","201610270TOR"
"TOR",0,1,2,0,0,3,0,1,1,0,0,2,"H","N","2016-10-27","201610270TOR"
"DAL",0,0,0,1,0,1,0,2,1,1,0,4,"A","N","2016-10-27","201610270WPG"
"WPG",0,2,1,1,0,4,0,0,0,1,0,1,"H","N","2016-10-27","201610270WPG"
"ANA",0,0,0,0,0,0,0,4,0,0,0,4,"H","N","2016-10-28","201610280ANA"
"CBJ",0,4,0,0,0,4,0,0,0,0,0,0,"A","N","2016-10-28","201610280ANA"
"CAR",0,1,2,0,0,3,0,1,1,0,0,2,"H","N","2016-10-28","201610280CAR"
"NYR",0,1,1,0,0,2,0,1,2,0,0,3,"A","N","2016-10-28","201610280CAR"
"CGY",0,1,2,2,0,5,0,2,0,0,0,2,"H","N","2016-10-28","201610280CGY"
"OTT",0,2,0,0,0,2,0,1,2,2,0,5,"A","N","2016-10-28","201610280CGY"
"COL",0,0,0,0,0,0,0,0,1,0,0,1,"H","N","2016-10-28","201610280COL"
"WPG",0,0,1,0,0,1,0,0,0,0,0,0,"A","N","2016-10-28","201610280COL"
"CHI",1,0,1,1,0,3,0,1,0,1,0,2,"A","N","2016-10-28","201610280NJD"
"NJD",0,1,0,1,0,2,1,0,1,1,0,3,"H","N","2016-10-28","201610280NJD"
"EDM",0,0,1,1,0,2,0,0,0,0,0,0,"A","N","2016-10-28","201610280VAN"
"VAN",0,0,0,0,0,0,0,0,1,1,0,2,"H","N","2016-10-28","201610280VAN"
"ARI",0,1,0,1,0,2,0,0,1,2,0,3,"H","N","2016-10-29","201610290ARI"
"COL",0,0,1,2,0,3,0,1,0,1,0,2,"A","N","2016-10-29","201610290ARI"
"BUF",0,1,1,1,0,3,0,0,0,0,0,0,"H","N","2016-10-29","201610290BUF"
"FLA",0,0,0,0,0,0,0,1,1,1,0,3,"A","N","2016-10-29","201610290BUF"
"BOS",0,0,1,0,0,1,0,0,0,0,0,0,"A","N","2016-10-29","201610290DET"
"DET",0,0,0,0,0,0,0,0,1,0,0,1,"H","N","2016-10-29","201610290DET"
"DAL",0,0,0,0,0,0,0,1,0,3,0,4,"A","N","2016-10-29","201610290MIN"
"MIN",0,1,0,3,0,4,0,0,0,0,0,0,"H","N","2016-10-29","201610290MIN"
"MTL",0,0,1,1,0,2,0,0,0,1,0,1,"H","N","2016-10-29","201610290MTL"
"TOR",0,0,0,1,0,1,0,0,1,1,0,2,"A","N","2016-10-29","201610290MTL"
"NJD",0,2,1,0,0,3,0,0,0,1,0,1,"H","N","2016-10-29","201610290NJD"
"TBL",0,0,0,1,0,1,0,2,1,0,0,3,"A","N","2016-10-29","201610290NJD"
"PHI",0,2,2,0,0,4,0,3,1,1,0,5,"H","N","2016-10-29","201610290PHI"
"PIT",0,3,1,1,0,5,0,2,2,0,0,4,"A","N","2016-10-29","201610290PHI"
"NSH",0,0,1,0,0,1,0,1,2,1,0,4,"A","N","2016-10-29","201610290SJS"
"SJS",0,1,2,1,0,4,0,0,1,0,0,1,"H","N","2016-10-29","201610290SJS"
"LAK",0,0,0,0,0,0,0,0,0,1,0,1,"A","N","2016-10-29","201610290STL"
"STL",0,0,0,1,0,1,0,0,0,0,0,0,"H","N","2016-10-29","201610290STL"
"VAN",0,1,1,0,0,2,0,2,1,2,0,5,"H","N","2016-10-29","201610290VAN"
"WSH",0,2,1,2,0,5,0,1,1,0,0,2,"A","N","2016-10-29","201610290VAN"
"CAR",0,0,3,0,0,3,0,1,2,1,0,4,"H","N","2016-10-30","201610300CAR"
"PHI",0,1,2,1,0,4,0,0,3,0,0,3,"A","N","2016-10-30","201610300CAR"
"CGY",0,1,0,0,0,1,0,2,0,1,0,3,"H","N","2016-10-30","201610300CGY"
"WSH",0,2,0,1,0,3,0,1,0,0,0,1,"A","N","2016-10-30","201610300CGY"
"CHI",0,1,1,1,0,3,0,0,0,0,0,0,"H","N","2016-10-30","201610300CHI"
"LAK",0,0,0,0,0,0,0,1,1,1,0,3,"A","N","2016-10-30","201610300CHI"
"DET",0,0,1,1,0,2,0,3,2,0,0,5,"H","N","2016-10-30","201610300DET"
"FLA",0,3,2,0,0,5,0,0,1,1,0,2,"A","N","2016-10-30","201610300DET"
"EDM",0,0,0,0,0,0,0,0,1,1,0,2,"H","N","2016-10-30","201610300EDM"
"OTT",0,0,1,1,0,2,0,0,0,0,0,0,"A","N","2016-10-30","201610300EDM"
"NYI",0,2,0,3,0,5,0,0,0,1,0,1,"H","N","2016-10-30","201610300NYI"
"TOR",0,0,0,1,0,1,0,2,0,3,0,5,"A","N","2016-10-30","201610300NYI"
"NYR",0,0,4,2,0,6,0,0,0,1,0,1,"H","N","2016-10-30","201610300NYR"
"TBL",0,0,0,1,0,1,0,0,4,2,0,6,"A","N","2016-10-30","201610300NYR"
"BUF",0,2,1,0,0,3,0,0,0,1,0,1,"A","N","2016-10-30","201610300WPG"
"WPG",0,0,0,1,0,1,0,2,1,0,0,3,"H","N","2016-10-30","201610300WPG"
"ARI",0,0,3,0,0,3,0,1,0,1,0,2,"H","N","2016-11-01","201611010ARI"
"SJS",0,1,0,1,0,2,0,0,3,0,0,3,"A","N","2016-11-01","201611010ARI"
"CBJ",1,0,1,1,0,3,0,0,1,1,0,2,"H","N","2016-11-01","201611010CBJ"
"DAL",0,0,1,1,0,2,1,0,1,1,0,3,"A","N","2016-11-01","201611010CBJ"
"CGY",0,0,1,0,0,1,0,1,0,4,0,5,"A","N","2016-11-01","201611010CHI"
"CHI",0,1,0,4,0,5,0,0,1,0,0,1,"H","N","2016-11-01","201611010CHI"
"COL",0,1,0,0,0,1,0,2,1,2,0,5,"H","N","2016-11-01","201611010COL"
"NSH",0,2,1,2,0,5,0,1,0,0,0,1,"A","N","2016-11-01","201611010COL"
"BOS",0,1,1,0,0,2,0,0,0,1,0,1,"A","N","2016-11-01","201611010FLA"
"FLA",0,0,0,1,0,1,0,1,1,0,0,2,"H","N","2016-11-01","201611010FLA"
"ANA",0,1,3,0,0,4,0,0,0,0,0,0,"A","N","2016-11-01","201611010LAK"
"LAK",0,0,0,0,0,0,0,1,3,0,0,4,"H","N","2016-11-01","201611010LAK"
"BUF",0,1,0,1,0,2,0,0,1,0,0,1,"A","N","2016-11-01","201611010MIN"
"MIN",0,0,1,0,0,1,0,1,0,1,0,2,"H","N","2016-11-01","201611010MIN"
"NYI",0,0,1,0,0,1,0,3,3,0,0,6,"H","N","2016-11-01","201611010NYI"
"TBL",0,3,3,0,0,6,0,0,1,0,0,1,"A","N","2016-11-01","201611010NYI"
"NYR",0,2,3,0,0,5,0,0,0,0,0,0,"H","N","2016-11-01","201611010NYR"
"STL",0,0,0,0,0,0,0,2,3,0,0,5,"A","N","2016-11-01","201611010NYR"
"CAR",0,1,0,0,0,1,1,1,0,0,0,2,"A","N","2016-11-01","201611010OTT"
"OTT",1,1,0,0,0,2,0,1,0,0,0,1,"H","N","2016-11-01","201611010OTT"
"EDM",0,1,0,1,0,2,1,1,1,0,0,3,"A","N","2016-11-01","201611010TOR"
"TOR",1,1,1,0,0,3,0,1,0,1,0,2,"H","N","2016-11-01","201611010TOR"
"WPG",0,0,0,2,0,2,0,1,1,1,0,3,"H","N","2016-11-01","201611010WPG"
"WSH",0,1,1,1,0,3,0,0,0,2,0,2,"A","N","2016-11-01","201611010WPG"
"ANA",0,1,0,0,0,1,0,2,1,2,0,5,"H","N","2016-11-02","201611020ANA"
"PIT",0,2,1,2,0,5,0,1,0,0,0,1,"A","N","2016-11-02","201611020ANA"
"MTL",0,0,2,1,0,3,0,0,0,0,0,0,"H","N","2016-11-02","201611020MTL"
"VAN",0,0,0,0,0,0,0,0,2,1,0,3,"A","N","2016-11-02","201611020MTL"
"DET",0,2,0,1,0,3,1,0,1,2,0,4,"A","N","2016-11-02","201611020PHI"
"PHI",1,0,1,2,0,4,0,2,0,1,0,3,"H","N","2016-11-02","201611020PHI"
"ARI",0,1,0,1,1,3,0,1,1,0,0,2,"H","Y","2016-11-03","201611030ARI"
"NSH",0,1,1,0,0,2,0,1,0,1,1,3,"A","Y","2016-11-03","201611030ARI"
"BUF",0,0,1,0,0,1,0,1,1,0,0,2,"H","N","2016-11-03","201611030BUF"
"TOR",0,1,1,0,0,2,0,0,1,0,0,1,"A","N","2016-11-03","201611030BUF"
"CHI",0,2,0,2,0,4,0,0,0,0,0,0,"H","N","2016-11-03","201611030CHI"
"COL",0,0,0,0,0,0,0,2,0,2,0,4,"A","N","2016-11-03","201611030CHI"
"DAL",0,0,2,4,0,6,0,0,1,1,0,2,"H","N","2016-11-03","201611030DAL"
"STL",0,0,1,1,0,2,0,0,2,4,0,6,"A","N","2016-11-03","201611030DAL"
"FLA",1,1,1,1,0,4,0,0,1,2,0,3,"H","N","2016-11-03","201611030FLA"
"NJD",0,0,1,2,0,3,1,1,1,1,0,4,"A","N","2016-11-03","201611030FLA"
"LAK",1,0,1,1,0,3,0,1,0,1,0,2,"H","N","2016-11-03","201611030LAK"
"PIT",0,1,0,1,0,2,1,0,1,1,0,3,"A","N","2016-11-03","201611030LAK"
"NYI",0,0,1,1,0,2,0,0,1,1,1,3,"H","Y","2016-11-03","201611030NYI"
"PHI",0,0,1,1,1,3,0,0,1,1,0,2,"A","Y","2016-11-03","201611030NYI"
"EDM",0,1,1,1,0,3,0,1,1,3,0,5,"A","N","2016-11-03","201611030NYR"
"NYR",0,1,1,3,0,5,0,1,1,1,0,3,"H","N","2016-11-03","201611030NYR"
"OTT",0,0,1,0,0,1,0,0,0,0,0,0,"H","N","2016-11-03","201611030OTT"
"VAN",0,0,0,0,0,0,0,0,1,0,0,1,"A","N","2016-11-03","201611030OTT"
"CGY",0,0,2,1,0,3,0,0,0,2,0,2,"A","N","2016-11-03","201611030SJS"
"SJS",0,0,0,2,0,2,0,0,2,1,0,3,"H","N","2016-11-03","201611030SJS"
"BOS",0,2,1,0,1,4,0,1,1,1,0,3,"A","Y","2016-11-03","201611030TBL"
"TBL",0,1,1,1,0,3,0,2,1,0,1,4,"H","Y","2016-11-03","201611030TBL"
"WPG",0,0,0,3,0,3,1,1,2,0,0,4,"A","N","2016-11-03","201611030WSH"
"WSH",1,1,2,0,0,4,0,0,0,3,0,3,"H","N","2016-11-03","201611030WSH"
"ANA",0,3,1,1,0,5,0,0,1,0,0,1,"H","N","2016-11-04","201611040ANA"
"ARI",0,0,1,0,0,1,0,3,1,1,0,5,"A","N","2016-11-04","201611040ANA"
"CBJ",0,3,5,2,0,10,0,0,0,0,0,0,"H","N","2016-11-04","201611040CBJ"
"MTL",0,0,0,0,0,0,0,3,5,2,0,10,"A","N","2016-11-04","201611040CBJ"
"DET",0,1,1,1,0,3,0,1,0,4,0,5,"H","N","2016-11-04","201611040DET"
"WPG",0,1,0,4,0,5,0,1,1,1,0,3,"A","N","2016-11-04","201611040DET"
"BOS",0,1,0,1,0,2,0,2,1,2,0,5,"H","N","2016-11-05","201611050BOS"
"NYR",0,2,1,2,0,5,0,1,0,1,0,2,"A","N","2016-11-05","201611050BOS"
"COL",0,0,0,1,0,1,0,0,0,0,0,0,"H","N","2016-11-05","201611050COL"
"MIN",0,0,0,0,0,0,0,0,0,1,0,1,"A","N","2016-11-05","201611050COL"
"CHI",0,1,2,0,0,3,0,2,0,0,0,2,"A","N","2016-11-05","201611050DAL"
"DAL",0,2,0,0,0,2,0,1,2,0,0,3,"H","N","2016-11-05","201611050DAL"
"CGY",0,0,0,0,0,0,0,2,2,1,0,5,"A","N","2016-11-05","201611050LAK"
"LAK",0,2,2,1,0,5,0,0,0,0,0,0,"H","N","2016-11-05","201611050LAK"
"MTL",0,2,1,2,0,5,0,2,0,2,0,4,"H","N","2016-11-05","201611050MTL"
"PHI",0,2,0,2,0,4,0,2,1,2,0,5,"A","N","2016-11-05","201611050MTL"
"CAR",0,0,1,1,1,3,0,1,1,0,0,2,"A","Y","2016-11-05","201611050NSH"
"NSH",0,1,1,0,0,2,0,0,1,1,1,3,"H","Y","2016-11-05","201611050NSH"
"EDM",0,2,1,0,1,4,0,2,1,0,0,3,"A","Y","2016-11-05","201611050NYI"
"NYI",0,2,1,0,0,3,0,2,1,0,1,4,"H","Y","2016-11-05","201611050NYI"
"BUF",0,0,0,2,0,2,0,0,1,0,0,1,"A","N","2016-11-05","201611050OTT"
"OTT",0,0,1,0,0,1,0,0,0,2,0,2,"H","N","2016-11-05","201611050OTT"
"PIT",0,2,3,0,0,5,0,0,0,0,0,0,"A","N","2016-11-05","201611050SJS"
"SJS",0,0,0,0,0,0,0,2,3,0,0,5,"H","N","2016-11-05","201611050SJS"
"CBJ",0,0,1,0,0,1,1,0,0,1,0,2,"A","N","2016-11-05","201611050STL"
"STL",1,0,0,1,0,2,0,0,1,0,0,1,"H","N","2016-11-05","201611050STL"
"NJD",0,1,0,0,0,1,0,0,2,2,0,4,"A","N","2016-11-05","201611050TBL"
"TBL",0,0,2,2,0,4,0,1,0,0,0,1,"H","N","2016-11-05","201611050TBL"
"TOR",0,2,1,3,0,6,0,1,1,1,0,3,"H","N","2016-11-05","201611050TOR"
"VAN",0,1,1,1,0,3,0,2,1,3,0,6,"A","N","2016-11-05","201611050TOR"
"FLA",0,1,0,1,0,2,0,0,1,3,0,4,"A","N","2016-11-05","201611050WSH"
"WSH",0,0,1,3,0,4,0,1,0,1,0,2,"H","N","2016-11-05","201611050WSH"
"ANA",0,1,2,1,0,4,0,1,0,0,0,1,"H","N","2016-11-06","201611060ANA"
"CGY",0,1,0,0,0,1,0,1,2,1,0,4,"A","N","2016-11-06","201611060ANA"
"CAR",0,0,0,1,0,1,0,0,2,2,0,4,"H","N","2016-11-06","201611060CAR"
"NJD",0,0,2,2,0,4,0,0,0,1,0,1,"A","N","2016-11-06","201611060CAR"
"CHI",1,0,1,2,0,4,0,1,1,1,0,3,"H","N","2016-11-06","201611060CHI"
"DAL",0,1,1,1,0,3,1,0,1,2,0,4,"A","N","2016-11-06","201611060CHI"
"DET",0,1,0,0,0,1,0,1,1,0,0,2,"H","N","2016-11-06","201611060DET"
"EDM",0,1,1,0,0,2,0,1,0,0,0,1,"A","N","2016-11-06","201611060DET"
"NYR",0,1,4,0,0,5,0,1,1,0,0,2,"H","N","2016-11-06","201611060NYR"
"WPG",0,1,1,0,0,2,0,1,4,0,0,5,"A","N","2016-11-06","201611060NYR"
"COL",0,0,1,0,0,1,0,2,3,0,0,5,"A","N","2016-11-06","201611060STL"
"STL",0,2,3,0,0,5,0,0,1,0,0,1,"H","N","2016-11-06","201611060STL"
"BOS",0,0,3,1,0,4,0,0,0,0,0,0,"H","N","2016-11-07","201611070BOS"
"BUF",0,0,0,0,0,0,0,0,3,1,0,4,"A","N","2016-11-07","201611070BOS"
"FLA",0,1,0,2,0,3,0,0,0,1,0,1,"H","N","2016-11-07","201611070FLA"
"TBL",0,0,0,1,0,1,0,1,0,2,0,3,"A","N","2016-11-07","201611070FLA"
"NYI",0,1,1,2,0,4,0,1,1,0,0,2,"H","N","2016-11-07","201611070NYI"
"VAN",0,1,1,0,0,2,0,1,1,2,0,4,"A","N","2016-11-07","201611070NYI"
"ARI",0,1,2,1,0,4,0,0,2,0,0,2,"A","N","2016-11-08","201611080COL"
"COL",0,0,2,0,0,2,0,1,2,1,0,4,"H","N","2016-11-08","201611080COL"
"BOS",0,0,1,1,0,2,0,0,2,1,0,3,"A","N","2016-11-08","201611080MTL"
"MTL",0,0,2,1,0,3,0,0,1,1,0,2,"H","N","2016-11-08","201611080MTL"
"CAR",0,0,2,0,0,2,0,1,0,1,1,3,"A","Y","2016-11-08","201611080NJD"
"NJD",0,1,0,1,1,3,0,0,2,0,0,2,"H","Y","2016-11-08","201611080NJD"
"NSH",0,0,2,1,0,3,0,0,0,1,0,1,"H","N","2016-11-08","201611080NSH"
"OTT",0,0,0,1,0,1,0,0,2,1,0,3,"A","N","2016-11-08","201611080NSH"
"NYR",0,0,1,2,0,3,0,0,1,4,0,5,"H","N","2016-11-08","201611080NYR"
"VAN",0,0,1,4,0,5,0,0,1,2,0,3,"A","N","2016-11-08","201611080NYR"
"DET",0,1,0,1,1,3,0,1,0,1,0,2,"A","Y","2016-11-08","201611080PHI"
"PHI",0,1,0,1,0,2,0,1,0,1,1,3,"H","Y","2016-11-08","201611080PHI"
"EDM",0,2,1,0,0,3,0,1,1,2,0,4,"A","N","2016-11-08","201611080PIT"
"PIT",0,1,1,2,0,4,0,2,1,0,0,3,"H","N","2016-11-08","201611080PIT"
"LAK",0,1,4,2,0,7,0,0,0,0,0,0,"A","N","2016-11-08","201611080TOR"
"TOR",0,0,0,0,0,0,0,1,4,2,0,7,"H","N","2016-11-08","201611080TOR"
"DAL",0,0,1,1,0,2,0,2,4,2,0,8,"A","N","2016-11-08","201611080WPG"
"WPG",0,2,4,2,0,8,0,0,1,1,0,2,"H","N","2016-11-08","201611080WPG"
"SJS",0,0,2,1,0,3,0,0,0,0,0,0,"A","N","2016-11-08","201611080WSH"
"WSH",0,0,0,0,0,0,0,0,2,1,0,3,"H","N","2016-11-08","201611080WSH"
"BUF",0,1,0,0,0,1,0,0,1,0,1,2,"H","Y","2016-11-09","201611090BUF"
"OTT",0,0,1,0,1,2,0,1,0,0,0,1,"A","Y","2016-11-09","201611090BUF"
"ANA",0,0,1,1,0,2,1,2,0,0,0,3,"A","N","2016-11-09","201611090CBJ"
"CBJ",1,2,0,0,0,3,0,0,1,1,0,2,"H","N","2016-11-09","201611090CBJ"
"CHI",1,0,1,0,0,2,0,0,0,1,0,1,"A","N","2016-11-09","201611090STL"
"STL",0,0,0,1,0,1,1,0,1,0,0,2,"H","N","2016-11-09","201611090STL"
"ARI",0,1,0,1,0,2,0,1,1,1,0,3,"H","N","2016-11-10","201611100ARI"
"WPG",0,1,1,1,0,3,0,1,0,1,0,2,"A","N","2016-11-10","201611100ARI"
"BOS",0,4,1,0,0,5,0,1,0,1,0,2,"H","N","2016-11-10","201611100BOS"
"CBJ",0,1,0,1,0,2,0,4,1,0,0,5,"A","N","2016-11-10","201611100BOS"
"ANA",0,0,3,1,0,4,0,0,1,1,0,2,"A","N","2016-11-10","201611100CAR"
"CAR",0,0,1,1,0,2,0,0,3,1,0,4,"H","N","2016-11-10","201611100CAR"
"CGY",0,0,2,0,0,2,0,2,0,2,0,4,"H","N","2016-11-10","201611100CGY"
"DAL",0,2,0,2,0,4,0,0,2,0,0,2,"A","N","2016-11-10","201611100CGY"
"DET",0,2,0,1,0,3,0,0,0,1,0,1,"H","N","2016-11-10","201611100DET"
"VAN",0,0,0,1,0,1,0,2,0,1,0,3,"A","N","2016-11-10","201611100DET"
"FLA",0,2,0,0,0,2,0,1,1,2,0,4,"H","N","2016-11-10","201611100FLA"
"SJS",0,1,1,2,0,4,0,2,0,0,0,2,"A","N","2016-11-10","201611100FLA"
"LAK",0,0,0,1,0,1,0,2,1,1,0,4,"A","N","2016-11-10","201611100MTL"
"MTL",0,2,1,1,0,4,0,0,0,1,0,1,"H","N","2016-11-10","201611100MTL"
"NSH",0,0,1,2,0,3,0,1,0,0,0,1,"H","N","2016-11-10","201611100NSH"
"STL",0,1,0,0,0,1,0,0,1,2,0,3,"A","N","2016-11-10","201611100NSH"
"MIN",0,1,1,2,0,4,0,1,1,0,0,2,"A","N","2016-11-10","201611100PIT"
"PIT",0,1,1,0,0,2,0,1,1,2,0,4,"H","N","2016-11-10","201611100PIT"
"NYI",0,0,1,0,0,1,0,2,1,1,0,4,"A","N","2016-11-10","201611100TBL"
"TBL",0,2,1,1,0,4,0,0,1,0,0,1,"H","N","2016-11-10","201611100TBL"
"BUF",0,1,0,0,0,1,1,0,0,1,0,2,"H","N","2016-11-11","201611110BUF"
"NJD",1,0,0,1,0,2,0,1,0,0,0,1,"A","N","2016-11-11","201611110BUF"
"CHI",0,1,0,1,0,2,1,2,0,0,0,3,"H","N","2016-11-11","201611110CHI"
"WSH",1,2,0,0,0,3,0,1,0,1,0,2,"A","N","2016-11-11","201611110CHI"
"COL",1,0,2,0,0,3,0,0,2,0,0,2,"H","N","2016-11-11","201611110COL"
"WPG",0,0,2,0,0,2,1,0,2,0,0,3,"A","N","2016-11-11","201611110COL"
"DAL",0,2,1,0,0,3,0,2,0,0,0,2,"A","N","2016-11-11","201611110EDM"
"EDM",0,2,0,0,0,2,0,2,1,0,0,3,"H","N","2016-11-11","201611110EDM"
"LAK",0,0,1,0,0,1,0,0,0,2,0,2,"A","N","2016-11-11","201611110OTT"
"OTT",0,0,0,2,0,2,0,0,1,0,0,1,"H","N","2016-11-11","201611110OTT"
"PHI",0,2,1,0,0,3,0,2,0,4,0,6,"A","N","2016-11-11","201611110TOR"
"TOR",0,2,0,4,0,6,0,2,1,0,0,3,"H","N","2016-11-11","201611110TOR"
"ARI",0,0,0,1,0,1,0,0,2,0,0,2,"H","N","2016-11-12","201611120ARI"
"BOS",0,0,2,0,0,2,0,0,0,1,0,1,"A","N","2016-11-12","201611120ARI"
"CAR",0,2,2,1,0,5,0,1,0,0,0,1,"H","N","2016-11-12","201611120CAR"
"WSH",0,1,0,0,0,1,0,2,2,1,0,5,"A","N","2016-11-12","201611120CAR"
"CBJ",0,3,4,1,0,8,0,1,1,2,0,4,"H","N","2016-11-12","201611120CBJ"
"STL",0,1,1,2,0,4,0,3,4,1,0,8,"A","N","2016-11-12","201611120CBJ"
"CGY",0,0,0,1,0,1,0,2,2,0,0,4,"H","N","2016-11-12","201611120CGY"
"NYR",0,2,2,0,0,4,0,0,0,1,0,1,"A","N","2016-11-12","201611120CGY"
"FLA",1,0,0,2,0,3,0,1,1,0,0,2,"H","N","2016-11-12","201611120FLA"
"NYI",0,1,1,0,0,2,1,0,0,2,0,3,"A","N","2016-11-12","201611120FLA"
"DET",0,0,0,0,0,0,0,3,2,0,0,5,"A","N","2016-11-12","201611120MTL"
"MTL",0,3,2,0,0,5,0,0,0,0,0,0,"H","N","2016-11-12","201611120MTL"
"BUF",0,0,1,1,0,2,0,1,2,1,0,4,"A","N","2016-11-12","201611120NJD"
"NJD",0,1,2,1,0,4,0,0,1,1,0,2,"H","N","2016-11-12","201611120NJD"
"ANA",0,0,0,0,0,0,0,1,3,1,0,5,"A","N","2016-11-12","201611120NSH"
"NSH",0,1,3,1,0,5,0,0,0,0,0,0,"H","N","2016-11-12","201611120NSH"
"MIN",0,1,1,0,0,2,0,1,1,1,0,3,"A","N","2016-11-12","201611120PHI"
"PHI",0,1,1,1,0,3,0,1,1,0,0,2,"H","N","2016-11-12","201611120PHI"
"PIT",0,0,2,2,0,4,0,1,0,0,0,1,"H","N","2016-11-12","201611120PIT"
"TOR",0,1,0,0,0,1,0,0,2,2,0,4,"A","N","2016-11-12","201611120PIT"
"SJS",0,2,1,0,0,3,0,0,0,1,0,1,"A","N","2016-11-12","201611120TBL"
"TBL",0,0,0,1,0,1,0,2,1,0,0,3,"H","N","2016-11-12","201611120TBL"
"CHI",0,1,2,0,0,3,0,0,2,0,0,2,"H","N","2016-11-13","201611130CHI"
"MTL",0,0,2,0,0,2,0,1,2,0,0,3,"A","N","2016-11-13","201611130CHI"
"BOS",0,1,0,1,0,2,0,0,0,0,0,0,"A","N","2016-11-13","201611130COL"
"COL",0,0,0,0,0,0,0,1,0,1,0,2,"H","N","2016-11-13","201611130COL"
"EDM",0,1,0,0,0,1,0,2,1,0,0,3,"H","N","2016-11-13","201611130EDM"
"NYR",0,2,1,0,0,3,0,1,0,0,0,1,"A","N","2016-11-13","201611130EDM"
"MIN",1,1,0,0,0,2,0,0,0,1,0,1,"A","N","2016-11-13","201611130OTT"
"OTT",0,0,0,1,0,1,1,1,0,0,0,2,"H","N","2016-11-13","201611130OTT"
"DAL",0,2,1,1,0,4,1,1,0,3,0,5,"A","N","2016-11-13","201611130VAN"
"VAN",1,1,0,3,0,5,0,2,1,1,0,4,"H","N","2016-11-13","201611130VAN"
"LAK",0,1,0,1,0,2,0,2,0,0,1,3,"A","Y","2016-11-13","201611130WPG"
"WPG",0,2,0,0,1,3,0,1,0,1,0,2,"H","Y","2016-11-13","201611130WPG"
"NYI",0,0,0,0,0,0,0,2,2,0,0,4,"H","N","2016-11-14","201611140NYI"
"TBL",0,2,2,0,0,4,0,0,0,0,0,0,"A","N","2016-11-14","201611140NYI"
"ANA",0,1,2,1,0,4,0,0,1,0,0,1,"H","N","2016-11-15","201611150ANA"
"EDM",0,0,1,0,0,1,0,1,2,1,0,4,"A","N","2016-11-15","201611150ANA"
"CAR",0,0,0,1,0,1,0,0,0,0,0,0,"H","N","2016-11-15","201611150CAR"
"SJS",0,0,0,0,0,0,0,0,0,1,0,1,"A","N","2016-11-15","201611150CAR"
"CBJ",1,0,0,1,0,2,0,0,1,0,0,1,"H","N","2016-11-15","201611150CBJ"
"WSH",0,0,1,0,0,1,1,0,0,1,0,2,"A","N","2016-11-15","201611150CBJ"
"COL",0,0,2,2,0,4,0,0,1,0,0,1,"H","N","2016-11-15","201611150COL"
"LAK",0,0,1,0,0,1,0,0,2,2,0,4,"A","N","2016-11-15","201611150COL"
"DAL",0,1,0,0,0,1,1,1,0,0,0,2,"H","N","2016-11-15","201611150DAL"
"NJD",1,1,0,0,0,2,0,1,0,0,0,1,"A","N","2016-11-15","201611150DAL"
"DET",0,1,0,2,0,3,0,2,0,2,0,4,"H","N","2016-11-15","201611150DET"
"TBL",0,2,0,2,0,4,0,1,0,2,0,3,"A","N","2016-11-15","201611150DET"
"CGY",0,1,0,0,0,1,0,0,0,0,0,0,"A","N","2016-11-15","201611150MIN"
"MIN",0,0,0,0,0,0,0,1,0,0,0,1,"H","N","2016-11-15","201611150MIN"
"FLA",1,2,1,0,0,4,0,1,1,1,0,3,"A","N","2016-11-15","201611150MTL"
"MTL",0,1,1,1,0,3,1,2,1,0,0,4,"H","N","2016-11-15","201611150MTL"
"OTT",0,0,1,1,1,3,0,1,1,0,0,2,"A","Y","2016-11-15","201611150PHI"
"PHI",0,1,1,0,0,2,0,0,1,1,1,3,"H","Y","2016-11-15","201611150PHI"
"BUF",0,1,0,0,0,1,0,1,0,3,0,4,"A","N","2016-11-15","201611150STL"
"STL",0,1,0,3,0,4,0,1,0,0,0,1,"H","N","2016-11-15","201611150STL"
"NSH",0,1,1,0,0,2,0,2,1,3,0,6,"A","N","2016-11-15","201611150TOR"
"TOR",0,2,1,3,0,6,0,1,1,0,0,2,"H","N","2016-11-15","201611150TOR"
"NYR",0,1,2,4,0,7,0,0,1,1,0,2,"A","N","2016-11-15","201611150VAN"
"VAN",0,0,1,1,0,2,0,1,2,4,0,7,"H","N","2016-11-15","201611150VAN"
"CHI",0,0,0,0,0,0,0,1,0,3,0,4,"A","N","2016-11-15","201611150WPG"
"WPG",0,1,0,3,0,4,0,0,0,0,0,0,"H","N","2016-11-15","201611150WPG"
"ARI",0,0,1,0,0,1,1,0,0,1,0,2,"A","N","2016-11-16","201611160CGY"
"CGY",1,0,0,1,0,2,0,0,1,0,0,1,"H","N","2016-11-16","201611160CGY"
"PIT",0,0,0,1,0,1,0,3,1,3,0,7,"A","N","2016-11-16","201611160WSH"
"WSH",0,3,1,3,0,7,0,0,0,1,0,1,"H","N","2016-11-16","201611160WSH"
"ANA",0,0,2,1,0,3,0,0,2,0,0,2,"H","N","2016-11-17","201611170ANA"
"NJD",0,0,2,0,0,2,0,0,2,1,0,3,"A","N","2016-11-17","201611170ANA"
"BUF",0,0,1,0,0,1,0,1,2,1,0,4,"H","N","2016-11-17","201611170BUF"
"TBL",0,1,2,1,0,4,0,0,1,0,0,1,"A","N","2016-11-17","201611170BUF"
"COL",0,0,1,1,0,2,0,3,0,0,0,3,"A","N","2016-11-17","201611170DAL"
"DAL",0,3,0,0,0,3,0,0,1,1,0,2,"H","N","2016-11-17","201611170DAL"
"EDM",0,0,2,0,0,2,0,2,1,1,0,4,"A","N","2016-11-17","201611170LAK"
"LAK",0,2,1,1,0,4,0,0,2,0,0,2,"H","N","2016-11-17","201611170LAK"
"BOS",0,0,0,0,0,0,0,0,0,1,0,1,"A","N","2016-11-17","201611170MIN"
"MIN",0,0,0,1,0,1,0,0,0,0,0,0,"H","N","2016-11-17","201611170MIN"
"NSH",0,2,1,2,0,5,0,1,0,0,0,1,"A","N","2016-11-17","201611170OTT"
"OTT",0,1,0,0,0,1,0,2,1,2,0,5,"H","N","2016-11-17","201611170OTT"
"PHI",0,2,1,2,0,5,0,0,2,0,0,2,"H","N","2016-11-17","201611170PHI"
"WPG",0,0,2,0,0,2,0,2,1,2,0,5,"A","N","2016-11-17","201611170PHI"
"SJS",0,1,1,0,0,2,0,1,2,0,0,3,"A","N","2016-11-17","201611170STL"
"STL",0,1,2,0,0,3,0,1,1,0,0,2,"H","N","2016-11-17","201611170STL"
"FLA",0,1,0,0,0,1,0,3,2,1,0,6,"A","N","2016-11-17","201611170TOR"
"TOR",0,3,2,1,0,6,0,1,0,0,0,1,"H","N","2016-11-17","201611170TOR"
"ARI",0,0,2,0,0,2,1,0,2,0,0,3,"A","N","2016-11-17","201611170VAN"
"VAN",1,0,2,0,0,3,0,0,2,0,0,2,"H","N","2016-11-17","201611170VAN"
"CAR",0,0,0,3,0,3,0,0,1,1,0,2,"H","N","2016-11-18","201611180CAR"
"MTL",0,0,1,1,0,2,0,0,0,3,0,3,"A","N","2016-11-18","201611180CAR"
"CBJ",0,1,1,2,0,4,0,0,1,1,0,2,"H","N","2016-11-18","201611180CBJ"
"NYR",0,0,1,1,0,2,0,1,1,2,0,4,"A","N","2016-11-18","201611180CBJ"
"CGY",0,0,2,0,0,2,0,1,1,1,0,3,"H","N","2016-11-18","201611180CGY"
"CHI",0,1,1,1,0,3,0,0,2,0,0,2,"A","N","2016-11-18","201611180CGY"
"NYI",0,0,2,0,0,2,1,1,1,0,0,3,"H","N","2016-11-18","201611180NYI"
"PIT",1,1,1,0,0,3,0,0,2,0,0,2,"A","N","2016-11-18","201611180NYI"
"DET",0,0,0,0,0,0,0,0,0,1,0,1,"A","N","2016-11-18","201611180WSH"
"WSH",0,0,0,1,0,1,0,0,0,0,0,0,"H","N","2016-11-18","201611180WSH"
"ARI",1,1,1,0,0,3,0,0,0,2,0,2,"H","N","2016-11-19","201611190ARI"
"SJS",0,0,0,2,0,2,1,1,1,0,0,3,"A","N","2016-11-19","201611190ARI"
"BOS",0,0,3,1,0,4,0,0,0,1,0,1,"H","N","2016-11-19","201611190BOS"
"WPG",0,0,0,1,0,1,0,0,3,1,0,4,"A","N","2016-11-19","201611190BOS"
"BUF",0,1,0,0,1,2,0,0,0,1,0,1,"H","Y","2016-11-19","201611190BUF"
"PIT",0,0,0,1,0,1,0,1,0,0,1,2,"A","Y","2016-11-19","201611190BUF"
"DAL",0,0,2,0,0,2,0,2,2,1,0,5,"H","N","2016-11-19","201611190DAL"
"EDM",0,2,2,1,0,5,0,0,2,0,0,2,"A","N","2016-11-19","201611190DAL"
"LAK",0,0,2,2,0,4,0,1,0,1,0,2,"H","N","2016-11-19","201611190LAK"
"NJD",0,1,0,1,0,2,0,0,2,2,0,4,"A","N","2016-11-19","201611190LAK"
"COL",0,0,0,3,0,3,0,1,1,0,0,2,"A","N","2016-11-19","201611190MIN"
"MIN",0,1,1,0,0,2,0,0,0,3,0,3,"H","N","2016-11-19","201611190MIN"
"MTL",0,1,1,0,0,2,0,0,1,0,0,1,"H","N","2016-11-19","201611190MTL"
"TOR",0,0,1,0,0,1,0,1,1,0,0,2,"A","N","2016-11-19","201611190MTL"
"FLA",0,2,1,1,0,4,0,0,0,1,0,1,"A","N","2016-11-19","201611190OTT"
"OTT",0,0,0,1,0,1,0,2,1,1,0,4,"H","N","2016-11-19","201611190OTT"
"PHI",0,0,0,0,0,0,0,1,1,1,0,3,"H","N","2016-11-19","201611190PHI"
"TBL",0,1,1,1,0,3,0,0,0,0,0,0,"A","N","2016-11-19","201611190PHI"
"NSH",0,0,1,0,0,1,0,0,1,2,0,3,"A","N","2016-11-19","201611190STL"
"STL",0,0,1,2,0,3,0,0,1,0,0,1,"H","N","2016-11-19","201611190STL"
"CHI",1,0,0,3,0,4,0,1,2,0,0,3,"A","N","2016-11-19","201611190VAN"
"VAN",0,1,2,0,0,3,1,0,0,3,0,4,"H","N","2016-11-19","201611190VAN"
"ANA",0,0,0,2,0,2,0,0,3,0,0,3,"H","N","2016-11-20","201611200ANA"
"LAK",0,0,3,0,0,3,0,0,0,2,0,2,"A","N","2016-11-20","201611200ANA"
"CAR",0,1,0,2,0,3,0,0,0,1,0,1,"H","N","2016-11-20","201611200CAR"
"WPG",0,0,0,1,0,1,0,1,0,2,0,3,"A","N","2016-11-20","201611200CAR"
"CGY",0,0,1,2,0,3,0,1,0,1,0,2,"A","N","2016-11-20","201611200DET"
"DET",0,1,0,1,0,2,0,0,1,2,0,3,"H","N","2016-11-20","201611200DET"
"FLA",0,0,1,1,1,3,0,1,0,1,0,2,"A","Y","2016-11-20","201611200NYR"
"NYR",0,1,0,1,0,2,0,0,1,1,1,3,"H","Y","2016-11-20","201611200NYR"
"CBJ",0,0,1,2,0,3,0,1,1,0,0,2,"A","N","2016-11-20","201611200WSH"
"WSH",0,1,1,0,0,2,0,0,1,2,0,3,"H","N","2016-11-20","201611200WSH"
"BUF",0,0,3,1,0,4,0,1,0,1,0,2,"H","N","2016-11-21","201611210BUF"
"CGY",0,1,0,1,0,2,0,0,3,1,0,4,"A","N","2016-11-21","201611210BUF"
"CBJ",0,1,0,1,0,2,1,0,2,0,0,3,"H","N","2016-11-21","201611210CBJ"
"COL",1,0,2,0,0,3,0,1,0,1,0,2,"A","N","2016-11-21","201611210CBJ"
"DAL",1,0,1,1,0,3,0,0,1,1,0,2,"H","N","2016-11-21","201611210DAL"
"MIN",0,0,1,1,0,2,1,0,1,1,0,3,"A","N","2016-11-21","201611210DAL"
"CHI",0,0,0,0,0,0,0,2,1,2,0,5,"A","N","2016-11-21","201611210EDM"
"EDM",0,2,1,2,0,5,0,0,0,0,0,0,"H","N","2016-11-21","201611210EDM"
"NSH",0,1,2,0,0,3,0,0,0,1,0,1,"H","N","2016-11-21","201611210NSH"
"TBL",0,0,0,1,0,1,0,1,2,0,0,3,"A","N","2016-11-21","201611210NSH"
"NYR",0,0,3,2,0,5,0,2,0,0,0,2,"A","N","2016-11-21","201611210PIT"
"PIT",0,2,0,0,0,2,0,0,3,2,0,5,"H","N","2016-11-21","201611210PIT"
"NJD",0,0,0,0,0,0,0,2,1,1,0,4,"A","N","2016-11-21","201611210SJS"
"SJS",0,2,1,1,0,4,0,0,0,0,0,0,"H","N","2016-11-21","201611210SJS"
"ANA",0,1,0,1,0,2,0,2,0,0,1,3,"H","Y","2016-11-22","201611220ANA"
"NYI",0,2,0,0,1,3,0,1,0,1,0,2,"A","Y","2016-11-22","201611220ANA"
"BOS",0,1,1,0,0,2,0,0,3,1,0,4,"H","N","2016-11-22","201611220BOS"
"STL",0,0,3,1,0,4,0,1,1,0,0,2,"A","N","2016-11-22","201611220BOS"
"FLA",0,0,0,1,0,1,0,1,1,1,0,3,"H","N","2016-11-22","201611220FLA"
"PHI",0,1,1,1,0,3,0,0,0,1,0,1,"A","N","2016-11-22","201611220FLA"
"MTL",0,0,2,1,0,3,0,0,2,2,0,4,"H","N","2016-11-22","201611220MTL"
"OTT",0,0,2,2,0,4,0,0,2,1,0,3,"A","N","2016-11-22","201611220MTL"
"CAR",0,1,1,0,0,2,0,1,0,0,0,1,"A","N","2016-11-22","201611220TOR"
"TOR",0,1,0,0,0,1,0,1,1,0,0,2,"H","N","2016-11-22","201611220TOR"
"ARI",0,0,1,0,0,1,0,1,3,0,0,4,"H","N","2016-11-23","201611230ARI"
"VAN",0,1,3,0,0,4,0,0,1,0,0,1,"A","N","2016-11-23","201611230ARI"
"BUF",0,0,0,1,0,1,0,0,1,0,1,2,"H","Y","2016-11-23","201611230BUF"
"DET",0,0,1,0,1,2,0,0,0,1,0,1,"A","Y","2016-11-23","201611230BUF"
"CBJ",0,0,0,0,0,0,0,0,1,1,0,2,"H","N","2016-11-23","201611230CBJ"
"CGY",0,0,1,1,0,2,0,0,0,0,0,0,"A","N","2016-11-23","201611230CBJ"
"COL",0,2,1,0,0,3,0,2,0,4,0,6,"H","N","2016-11-23","201611230COL"
"EDM",0,2,0,4,0,6,0,2,1,0,0,3,"A","N","2016-11-23","201611230COL"
"LAK",0,1,0,3,0,4,0,0,0,2,0,2,"H","N","2016-11-23","201611230LAK"
"NYI",0,0,0,2,0,2,0,1,0,3,0,4,"A","N","2016-11-23","201611230LAK"
"MIN",0,0,1,2,0,3,0,0,0,1,0,1,"H","N","2016-11-23","201611230MIN"
"WPG",0,0,0,1,0,1,0,0,1,2,0,3,"A","N","2016-11-23","201611230MIN"
"NJD",0,0,3,1,1,5,0,3,1,0,0,4,"H","Y","2016-11-23","201611230NJD"
"TOR",0,3,1,0,0,4,0,0,3,1,1,5,"A","Y","2016-11-23","201611230NJD"
"DAL",0,0,0,2,0,2,0,1,1,3,0,5,"A","N","2016-11-23","201611230NSH"
"NSH",0,1,1,3,0,5,0,0,0,2,0,2,"H","N","2016-11-23","201611230NSH"
"NYR",0,1,0,0,0,1,0,0,5,1,0,6,"H","N","2016-11-23","201611230NYR"
"PIT",0,0,5,1,0,6,0,1,0,0,0,1,"A","N","2016-11-23","201611230NYR"
"CHI",0,0,1,0,0,1,0,2,0,0,0,2,"A","N","2016-11-23","201611230SJS"
"SJS",0,2,0,0,0,2,0,0,1,0,0,1,"H","N","2016-11-23","201611230SJS"
"PHI",0,0,2,0,0,2,0,1,0,3,0,4,"A","N","2016-11-23","201611230TBL"
"TBL",0,1,0,3,0,4,0,0,2,0,0,2,"H","N","2016-11-23","201611230TBL"
"STL",0,0,1,2,0,3,0,1,1,2,0,4,"A","N","2016-11-23","201611230WSH"
"WSH",0,1,1,2,0,4,0,0,1,2,0,3,"H","N","2016-11-23","201611230WSH"
"CAR",0,1,0,0,0,1,0,1,0,1,0,2,"A","N","2016-11-24","201611240MTL"
"MTL",0,1,0,1,0,2,0,1,0,0,0,1,"H","N","2016-11-24","201611240MTL"
"BOS",0,1,0,0,0,1,0,0,1,2,0,3,"A","N","2016-11-24","201611240OTT"
"OTT",0,0,1,2,0,3,0,1,0,0,0,1,"H","N","2016-11-24","201611240OTT"
"ANA",0,0,1,1,0,2,0,1,2,0,0,3,"H","N","2016-11-25","201611250ANA"
"CHI",0,1,2,0,0,3,0,0,1,1,0,2,"A","N","2016-11-25","201611250ANA"
"ARI",0,1,0,1,1,3,0,2,0,0,0,2,"H","Y","2016-11-25","201611250ARI"
"EDM",0,2,0,0,0,2,0,1,0,1,1,3,"A","Y","2016-11-25","201611250ARI"
"BOS",0,0,0,1,0,1,0,1,0,1,0,2,"H","N","2016-11-25","201611250BOS"
"CGY",0,1,0,1,0,2,0,0,0,1,0,1,"A","N","2016-11-25","201611250BOS"
"DAL",0,0,2,0,0,2,0,1,0,0,0,1,"H","N","2016-11-25","201611250DAL"
"VAN",0,1,0,0,0,1,0,0,2,0,0,2,"A","N","2016-11-25","201611250DAL"
"MIN",0,3,2,1,0,6,0,1,0,1,0,2,"H","N","2016-11-25","201611250MIN"
"PIT",0,1,0,1,0,2,0,3,2,1,0,6,"A","N","2016-11-25","201611250MIN"
"DET",1,2,1,1,0,5,0,1,2,1,0,4,"A","N","2016-11-25","201611250NJD"
"NJD",0,1,2,1,0,4,1,2,1,1,0,5,"H","N","2016-11-25","201611250NJD"
"NSH",0,0,3,2,0,5,0,1,0,0,0,1,"H","N","2016-11-25","201611250NSH"
"WPG",0,1,0,0,0,1,0,0,3,2,0,5,"A","N","2016-11-25","201611250NSH"
"NYR",0,2,1,0,0,3,0,0,0,2,0,2,"A","N","2016-11-25","201611250PHI"
"PHI",0,0,0,2,0,2,0,2,1,0,0,3,"H","N","2016-11-25","201611250PHI"
"NYI",0,1,0,1,0,2,0,0,2,1,0,3,"A","N","2016-11-25","201611250SJS"
"SJS",0,0,2,1,0,3,0,1,0,1,0,2,"H","N","2016-11-25","201611250SJS"
"CBJ",0,2,1,2,0,5,0,0,2,1,0,3,"A","N","2016-11-25","201611250TBL"
"TBL",0,0,2,1,0,3,0,2,1,2,0,5,"H","N","2016-11-25","201611250TBL"
"BUF",0,0,0,1,0,1,0,1,1,1,0,3,"A","N","2016-11-25","201611250WSH"
"WSH",0,1,1,1,0,3,0,0,0,1,0,1,"H","N","2016-11-25","201611250WSH"
"COL",0,0,1,1,0,2,0,1,0,1,1,3,"H","Y","2016-11-26","201611260COL"
"VAN",0,1,0,1,1,3,0,0,1,1,0,2,"A","Y","2016-11-26","201611260COL"
"DET",0,0,0,1,0,1,1,0,0,1,0,2,"H","N","2016-11-26","201611260DET"
"MTL",1,0,0,1,0,2,0,0,0,1,0,1,"A","N","2016-11-26","201611260DET"
"CBJ",0,0,0,1,0,1,0,1,0,0,1,2,"A","Y","2016-11-26","201611260FLA"
"FLA",0,1,0,0,1,2,0,0,0,1,0,1,"H","Y","2016-11-26","201611260FLA"
"CHI",0,1,0,0,0,1,1,0,1,0,0,2,"A","N","2016-11-26","201611260LAK"
"LAK",1,0,1,0,0,2,0,1,0,0,0,1,"H","N","2016-11-26","201611260LAK"
"CAR",0,1,0,0,0,1,0,0,1,1,0,2,"A","N","2016-11-26","201611260OTT"
"OTT",0,0,1,1,0,2,0,1,0,0,0,1,"H","N","2016-11-26","201611260OTT"
"NJD",0,1,2,0,0,3,0,0,2,1,1,4,"A","Y","2016-11-26","201611260PIT"
"PIT",0,0,2,1,1,4,0,1,2,0,0,3,"H","Y","2016-11-26","201611260PIT"
"ANA",0,2,1,0,0,3,0,1,1,0,0,2,"A","N","2016-11-26","201611260SJS"
"SJS",0,1,1,0,0,2,0,2,1,0,0,3,"H","N","2016-11-26","201611260SJS"
"MIN",0,1,1,1,0,3,0,0,1,2,1,4,"A","Y","2016-11-26","201611260STL"
"STL",0,0,1,2,1,4,0,1,1,1,0,3,"H","Y","2016-11-26","201611260STL"
"TOR",0,1,1,2,0,4,0,0,0,2,0,2,"H","N","2016-11-26","201611260TOR"
"WSH",0,0,0,2,0,2,0,1,1,2,0,4,"A","N","2016-11-26","201611260TOR"
"BOS",0,0,3,1,0,4,0,0,0,1,0,1,"H","N","2016-11-27","201611270BOS"
"TBL",0,0,0,1,0,1,0,0,3,1,0,4,"A","N","2016-11-27","201611270BOS"
"CAR",0,0,3,0,0,3,0,2,0,0,0,2,"H","N","2016-11-27","201611270CAR"
"FLA",0,2,0,0,0,2,0,0,3,0,0,3,"A","N","2016-11-27","201611270CAR"
"ARI",0,1,0,1,0,2,0,0,0,1,0,1,"A","N","2016-11-27","201611270EDM"
"EDM",0,0,0,1,0,1,0,1,0,1,0,2,"H","N","2016-11-27","201611270EDM"
"NYR",0,0,0,0,0,0,0,0,2,0,0,2,"H","N","2016-11-27","201611270NYR"
"OTT",0,0,2,0,0,2,0,0,0,0,0,0,"A","N","2016-11-27","201611270NYR"
"CGY",0,1,0,2,0,3,0,1,3,1,0,5,"A","N","2016-11-27","201611270PHI"
"PHI",0,1,3,1,0,5,0,1,0,2,0,3,"H","N","2016-11-27","201611270PHI"
"NSH",0,0,0,0,0,0,0,0,1,2,0,3,"A","N","2016-11-27","201611270WPG"
"WPG",0,0,1,2,0,3,0,0,0,0,0,0,"H","N","2016-11-27","201611270WPG"
"CGY",0,0,0,1,0,1,1,1,0,0,0,2,"A","N","2016-11-28","201611280NYI"
"NYI",1,1,0,0,0,2,0,0,0,1,0,1,"H","N","2016-11-28","201611280NYI"
"DAL",0,0,1,2,0,3,1,1,1,1,0,4,"A","N","2016-11-28","201611280STL"
"STL",1,1,1,1,0,4,0,0,1,2,0,3,"H","N","2016-11-28","201611280STL"
"ANA",0,1,1,0,0,2,0,0,0,1,0,1,"H","N","2016-11-29","201611290ANA"
"MTL",0,0,0,1,0,1,0,1,1,0,0,2,"A","N","2016-11-29","201611290ANA"
"CBJ",0,1,2,2,0,5,0,0,0,1,0,1,"H","N","2016-11-29","201611290CBJ"
"TBL",0,0,0,1,0,1,0,1,2,2,0,5,"A","N","2016-11-29","201611290CBJ"
"CHI",0,1,0,0,1,2,0,0,0,1,0,1,"H","Y","2016-11-29","201611290CHI"
"FLA",0,0,0,1,0,1,0,1,0,0,1,2,"A","Y","2016-11-29","201611290CHI"
"COL",0,1,1,1,0,3,0,1,2,2,0,5,"H","N","2016-11-29","201611290COL"
"NSH",0,1,2,2,0,5,0,1,1,1,0,3,"A","N","2016-11-29","201611290COL"
"DAL",0,1,0,0,0,1,0,1,1,1,0,3,"A","N","2016-11-29","201611290DET"
"DET",0,1,1,1,0,3,0,1,0,0,0,1,"H","N","2016-11-29","201611290DET"
"EDM",0,0,1,1,0,2,0,1,3,0,0,4,"H","N","2016-11-29","201611290EDM"
"TOR",0,1,3,0,0,4,0,0,1,1,0,2,"A","N","2016-11-29","201611290EDM"
"CAR",0,2,0,0,0,2,0,0,1,2,0,3,"A","N","2016-11-29","201611290NYR"
"NYR",0,0,1,2,0,3,0,2,0,0,0,2,"H","N","2016-11-29","201611290NYR"
"BUF",0,3,1,1,0,5,0,1,2,1,0,4,"A","N","2016-11-29","201611290OTT"
"OTT",0,1,2,1,0,4,0,3,1,1,0,5,"H","N","2016-11-29","201611290OTT"
"BOS",0,0,0,2,0,2,0,2,0,0,1,3,"A","Y","2016-11-29","201611290PHI"
"PHI",0,2,0,0,1,3,0,0,0,2,0,2,"H","Y","2016-11-29","201611290PHI"
"ARI",0,0,1,0,0,1,1,0,1,0,0,2,"A","N","2016-11-29","201611290SJS"
"SJS",1,0,1,0,0,2,0,0,1,0,0,1,"H","N","2016-11-29","201611290SJS"
"MIN",0,1,1,2,0,4,0,0,2,3,0,5,"A","N","2016-11-29","201611290VAN"
"VAN",0,0,2,3,0,5,0,1,1,2,0,4,"H","N","2016-11-29","201611290VAN"
"NJD",0,0,0,2,0,2,0,0,2,1,0,3,"A","N","2016-11-29","201611290WPG"
"WPG",0,0,2,1,0,3,0,0,0,2,0,2,"H","N","2016-11-29","201611290WPG"
"CGY",0,3,0,0,0,3,0,0,0,0,0,0,"H","N","2016-11-30","201611300CGY"
"TOR",0,0,0,0,0,0,0,3,0,0,0,3,"A","N","2016-11-30","201611300CGY"
"LAK",0,0,1,0,0,1,0,3,0,1,0,4,"H","N","2016-11-30","201611300LAK"
"SJS",0,3,0,1,0,4,0,0,1,0,0,1,"A","N","2016-11-30","201611300LAK"
"NYI",0,1,2,2,0,5,0,0,0,3,0,3,"H","N","2016-11-30","201611300NYI"
"PIT",0,0,0,3,0,3,0,1,2,2,0,5,"A","N","2016-11-30","201611300NYI"
"ARI",0,2,0,1,0,3,0,1,1,2,0,4,"H","N","2016-12-01","201612010ARI"
"LAK",0,1,1,2,0,4,0,2,0,1,0,3,"A","N","2016-12-01","201612010ARI"
"BOS",0,0,0,1,1,2,0,0,1,0,0,1,"H","Y","2016-12-01","201612010BOS"
"CAR",0,0,1,0,0,1,0,0,0,1,1,2,"A","Y","2016-12-01","201612010BOS"
"BUF",0,1,1,2,0,4,0,1,2,0,0,3,"H","N","2016-12-01","201612010BUF"
"NYR",0,1,2,0,0,3,0,1,1,2,0,4,"A","N","2016-12-01","201612010BUF"
"CHI",1,0,3,0,0,4,0,1,1,1,0,3,"H","N","2016-12-01","201612010CHI"
"NJD",0,1,1,1,0,3,1,0,3,0,0,4,"A","N","2016-12-01","201612010CHI"
"CBJ",0,2,0,1,0,3,0,0,2,0,0,2,"A","N","2016-12-01","201612010COL"
"COL",0,0,2,0,0,2,0,2,0,1,0,3,"H","N","2016-12-01","201612010COL"
"DET",0,1,0,0,0,1,1,1,0,0,0,2,"H","N","2016-12-01","201612010DET"
"FLA",1,1,0,0,0,2,0,1,0,0,0,1,"A","N","2016-12-01","201612010DET"
"OTT",0,1,1,0,0,2,1,0,2,0,0,3,"H","N","2016-12-01","201612010OTT"
"PHI",1,0,2,0,0,3,0,1,1,0,0,2,"A","N","2016-12-01","201612010OTT"
"DAL",0,1,1,0,0,2,0,1,2,3,0,6,"A","N","2016-12-01","201612010PIT"
"PIT",0,1,2,3,0,6,0,1,1,0,0,2,"H","N","2016-12-01","201612010PIT"
"STL",0,3,1,1,0,5,0,1,1,2,0,4,"H","N","2016-12-01","201612010STL"
"TBL",0,1,1,2,0,4,0,3,1,1,0,5,"A","N","2016-12-01","201612010STL"
"ANA",0,0,2,1,0,3,0,0,0,1,0,1,"A","N","2016-12-01","201612010VAN"
"VAN",0,0,0,1,0,1,0,0,2,1,0,3,"H","N","2016-12-01","201612010VAN"
"EDM",0,1,3,2,0,6,0,2,0,1,0,3,"A","N","2016-12-01","201612010WPG"
"WPG",0,2,0,1,0,3,0,1,3,2,0,6,"H","N","2016-12-01","201612010WPG"
"NYI",0,0,0,3,0,3,0,0,0,0,0,0,"A","N","2016-12-01","201612010WSH"
"WSH",0,0,0,0,0,0,0,0,0,3,0,3,"H","N","2016-12-01","201612010WSH"
"CGY",0,2,0,0,1,3,0,1,0,1,0,2,"H","Y","2016-12-02","201612020CGY"
"MIN",0,1,0,1,0,2,0,2,0,0,1,3,"A","Y","2016-12-02","201612020CGY"
"MTL",0,0,0,1,0,1,0,2,0,0,0,2,"A","N","2016-12-02","201612020SJS"
"SJS",0,2,0,0,0,2,0,0,0,1,0,1,"H","N","2016-12-02","201612020SJS"
"ARI",0,0,2,0,0,2,0,1,0,1,1,3,"H","Y","2016-12-03","201612030ARI"
"CBJ",0,1,0,1,1,3,0,0,2,0,0,2,"A","Y","2016-12-03","201612030ARI"
"BOS",0,1,0,1,0,2,0,0,0,1,0,1,"A","N","2016-12-03","201612030BUF"
"BUF",0,0,0,1,0,1,0,1,0,1,0,2,"H","N","2016-12-03","201612030BUF"
"COL",0,0,0,0,0,0,0,1,1,1,0,3,"H","N","2016-12-03","201612030COL"
"DAL",0,1,1,1,0,3,0,0,0,0,0,0,"A","N","2016-12-03","201612030COL"
"ANA",0,0,1,1,0,2,1,0,2,0,0,3,"A","N","2016-12-03","201612030EDM"
"EDM",1,0,2,0,0,3,0,0,1,1,0,2,"H","N","2016-12-03","201612030EDM"
"NJD",1,1,0,3,0,5,0,2,2,0,0,4,"A","N","2016-12-03","201612030NSH"
"NSH",0,2,2,0,0,4,1,1,0,3,0,5,"H","N","2016-12-03","201612030NSH"
"CAR",0,0,1,1,0,2,0,1,0,3,0,4,"A","N","2016-12-03","201612030NYR"
"NYR",0,1,0,3,0,4,0,0,1,1,0,2,"H","N","2016-12-03","201612030NYR"
"FLA",0,0,0,0,0,0,0,2,0,0,0,2,"A","N","2016-12-03","201612030OTT"
"OTT",0,2,0,0,0,2,0,0,0,0,0,0,"H","N","2016-12-03","201612030OTT"
"CHI",0,1,0,0,0,1,0,0,3,0,0,3,"A","N","2016-12-03","201612030PHI"
"PHI",0,0,3,0,0,3,0,1,0,0,0,1,"H","N","2016-12-03","201612030PHI"
"DET",0,1,2,0,0,3,0,0,1,4,0,5,"A","N","2016-12-03","201612030PIT"
"PIT",0,0,1,4,0,5,0,1,2,0,0,3,"H","N","2016-12-03","201612030PIT"
"STL",0,0,2,0,0,2,1,1,1,0,0,3,"H","N","2016-12-03","201612030STL"
"WPG",1,1,1,0,0,3,0,0,2,0,0,2,"A","N","2016-12-03","201612030STL"
"TBL",0,0,1,0,1,2,0,0,0,1,0,1,"H","Y","2016-12-03","201612030TBL"
"WSH",0,0,0,1,0,1,0,0,1,0,1,2,"A","Y","2016-12-03","201612030TBL"
"TOR",0,0,1,1,0,2,0,1,1,0,1,3,"A","Y","2016-12-03","201612030VAN"
"VAN",0,1,1,0,1,3,0,0,1,1,0,2,"H","Y","2016-12-03","201612030VAN"
"CAR",1,0,0,0,0,1,0,0,0,0,0,0,"H","N","2016-12-04","201612040CAR"
"TBL",0,0,0,0,0,0,1,0,0,0,0,1,"A","N","2016-12-04","201612040CAR"
"ANA",0,0,1,2,0,3,0,1,5,2,0,8,"A","N","2016-12-04","201612040CGY"
"CGY",0,1,5,2,0,8,0,0,1,2,0,3,"H","N","2016-12-04","201612040CGY"
"CHI",0,0,0,1,0,1,0,0,1,1,0,2,"H","N","2016-12-04","201612040CHI"
"WPG",0,0,1,1,0,2,0,0,0,1,0,1,"A","N","2016-12-04","201612040CHI"
"EDM",0,1,0,0,0,1,1,1,0,0,0,2,"H","N","2016-12-04","201612040EDM"
"MIN",1,1,0,0,0,2,0,1,0,0,0,1,"A","N","2016-12-04","201612040EDM"
"LAK",0,0,4,0,0,4,0,1,2,1,1,5,"H","Y","2016-12-04","201612040LAK"
"MTL",0,1,2,1,1,5,0,0,4,0,0,4,"A","Y","2016-12-04","201612040LAK"
"NSH",0,0,2,0,0,2,0,1,2,1,0,4,"H","N","2016-12-04","201612040NSH"
"PHI",0,1,2,1,0,4,0,0,2,0,0,2,"A","N","2016-12-04","201612040NSH"
"DET",1,1,1,1,0,4,0,1,0,2,0,3,"A","N","2016-12-04","201612040NYI"
"NYI",0,1,0,2,0,3,1,1,1,1,0,4,"H","N","2016-12-04","201612040NYI"
"BOS",1,1,1,1,0,4,0,0,1,2,0,3,"H","N","2016-12-05","201612050BOS"
"FLA",0,0,1,2,0,3,1,1,1,1,0,4,"A","N","2016-12-05","201612050BOS"
"ARI",0,1,0,0,0,1,0,1,1,2,0,4,"A","N","2016-12-05","201612050CBJ"
"CBJ",0,1,1,2,0,4,0,1,0,0,0,1,"H","N","2016-12-05","201612050CBJ"
"OTT",0,2,2,1,0,5,0,2,3,3,0,8,"A","N","2016-12-05","201612050PIT"
"PIT",0,2,3,3,0,8,0,2,2,1,0,5,"H","N","2016-12-05","201612050PIT"
"BUF",0,1,1,0,0,2,1,0,1,1,0,3,"A","N","2016-12-05","201612050WSH"
"WSH",1,0,1,1,0,3,0,1,1,0,0,2,"H","N","2016-12-05","201612050WSH"
"BUF",1,2,0,1,0,4,0,0,2,1,0,3,"H","N","2016-12-06","201612060BUF"
"EDM",0,0,2,1,0,3,1,2,0,1,0,4,"A","N","2016-12-06","201612060BUF"
"ARI",0,0,0,0,0,0,0,1,2,1,0,4,"A","N","2016-12-06","201612060CHI"
"CHI",0,1,2,1,0,4,0,0,0,0,0,0,"H","N","2016-12-06","201612060CHI"
"CGY",0,0,1,1,0,2,0,1,0,0,0,1,"A","N","2016-12-06","201612060DAL"
"DAL",0,1,0,0,0,1,0,0,1,1,0,2,"H","N","2016-12-06","201612060DAL"
"NJD",0,1,2,0,0,3,0,0,1,1,0,2,"H","N","2016-12-06","201612060NJD"
"VAN",0,0,1,1,0,2,0,1,2,0,0,3,"A","N","2016-12-06","201612060NJD"
"COL",0,1,2,0,0,3,0,2,1,1,0,4,"A","N","2016-12-06","201612060NSH"
"NSH",0,2,1,1,0,4,0,1,2,0,0,3,"H","N","2016-12-06","201612060NSH"
"NYI",0,2,1,1,0,4,0,0,2,0,0,2,"H","N","2016-12-06","201612060NYI"
"NYR",0,0,2,0,0,2,0,2,1,1,0,4,"A","N","2016-12-06","201612060NYI"
"FLA",0,1,0,1,0,2,1,1,1,0,0,3,"A","N","2016-12-06","201612060PHI"
"PHI",1,1,1,0,0,3,0,1,0,1,0,2,"H","N","2016-12-06","201612060PHI"
"MTL",0,1,1,0,0,2,1,0,0,2,0,3,"A","N","2016-12-06","201612060STL"
"STL",1,0,0,2,0,3,0,1,1,0,0,2,"H","N","2016-12-06","201612060STL"
"DET",0,1,2,0,1,4,0,3,0,0,0,3,"A","Y","2016-12-06","201612060WPG"
"WPG",0,3,0,0,0,3,0,1,2,0,1,4,"H","Y","2016-12-06","201612060WPG"
"ANA",0,1,1,3,1,6,0,1,2,2,0,5,"H","Y","2016-12-07","201612070ANA"
"CAR",0,1,2,2,0,5,0,1,1,3,1,6,"A","Y","2016-12-07","201612070ANA"
"OTT",0,2,0,2,0,4,0,0,1,1,0,2,"A","N","2016-12-07","201612070SJS"
"SJS",0,0,1,1,0,2,0,2,0,2,0,4,"H","N","2016-12-07","201612070SJS"
"MIN",0,2,1,0,0,3,0,1,1,0,0,2,"A","N","2016-12-07","201612070TOR"
"TOR",0,1,1,0,0,2,0,2,1,0,0,3,"H","N","2016-12-07","201612070TOR"
"BOS",0,0,2,1,0,3,1,2,1,0,0,4,"A","N","2016-12-07","201612070WSH"
"WSH",1,2,1,0,0,4,0,0,2,1,0,3,"H","N","2016-12-07","201612070WSH"
"ARI",0,1,0,0,0,1,1,1,0,0,0,2,"H","N","2016-12-08","201612080ARI"
"CGY",1,1,0,0,0,2,0,1,0,0,0,1,"A","N","2016-12-08","201612080ARI"
"BOS",0,0,2,0,0,2,0,2,2,0,0,4,"H","N","2016-12-08","201612080BOS"
"COL",0,2,2,0,0,4,0,0,2,0,0,2,"A","N","2016-12-08","201612080BOS"
"DAL",0,2,3,0,0,5,0,1,0,1,0,2,"H","N","2016-12-08","201612080DAL"
"NSH",0,1,0,1,0,2,0,2,3,0,0,5,"A","N","2016-12-08","201612080DAL"
"FLA",0,0,1,0,0,1,0,3,0,2,0,5,"H","N","2016-12-08","201612080FLA"
"PIT",0,3,0,2,0,5,0,0,1,0,0,1,"A","N","2016-12-08","201612080FLA"
"CAR",0,1,1,1,0,3,0,0,0,1,0,1,"A","N","2016-12-08","201612080LAK"
"LAK",0,0,0,1,0,1,0,1,1,1,0,3,"H","N","2016-12-08","201612080LAK"
"MTL",0,2,1,2,0,5,0,1,0,1,0,2,"H","N","2016-12-08","201612080MTL"
"NJD",0,1,0,1,0,2,0,2,1,2,0,5,"A","N","2016-12-08","201612080MTL"
"NYI",0,2,0,1,0,3,0,1,1,0,0,2,"H","N","2016-12-08","201612080NYI"
"STL",0,1,1,0,0,2,0,2,0,1,0,3,"A","N","2016-12-08","201612080NYI"
"EDM",0,1,2,2,0,5,0,0,3,3,0,6,"A","N","2016-12-08","201612080PHI"
"PHI",0,0,3,3,0,6,0,1,2,2,0,5,"H","N","2016-12-08","201612080PHI"
"TBL",0,0,1,0,0,1,0,2,2,1,0,5,"H","N","2016-12-08","201612080TBL"
"VAN",0,2,2,1,0,5,0,0,1,0,0,1,"A","N","2016-12-08","201612080TBL"
"NYR",0,1,0,1,0,2,0,0,1,0,0,1,"A","N","2016-12-08","201612080WPG"
"WPG",0,0,1,0,0,1,0,1,0,1,0,2,"H","N","2016-12-08","201612080WPG"
"ANA",0,2,0,1,0,3,0,1,1,0,0,2,"H","N","2016-12-09","201612090ANA"
"SJS",0,1,1,0,0,2,0,2,0,1,0,3,"A","N","2016-12-09","201612090ANA"
"BUF",0,0,0,1,0,1,0,0,2,2,0,4,"H","N","2016-12-09","201612090BUF"
"WSH",0,0,2,2,0,4,0,0,0,1,0,1,"A","N","2016-12-09","201612090BUF"
"CHI",0,0,0,0,0,0,1,0,0,0,0,1,"H","N","2016-12-09","201612090CHI"
"NYR",1,0,0,0,0,1,0,0,0,0,0,0,"A","N","2016-12-09","201612090CHI"
"CBJ",0,1,2,1,0,4,0,0,1,0,0,1,"A","N","2016-12-09","201612090DET"
"DET",0,0,1,0,0,1,0,1,2,1,0,4,"H","N","2016-12-09","201612090DET"
"EDM",0,1,0,1,0,2,0,0,1,1,1,3,"A","Y","2016-12-09","201612090MIN"
"MIN",0,0,1,1,1,3,0,1,0,1,0,2,"H","Y","2016-12-09","201612090MIN"
"NJD",0,0,1,0,0,1,0,1,2,1,0,4,"H","N","2016-12-09","201612090NJD"
"STL",0,1,2,1,0,4,0,0,1,0,0,1,"A","N","2016-12-09","201612090NJD"
"ARI",0,2,1,1,0,4,0,1,0,0,0,1,"H","N","2016-12-10","201612100ARI"
"NSH",0,1,0,0,0,1,0,2,1,1,0,4,"A","N","2016-12-10","201612100ARI"
"BOS",0,0,1,0,0,1,0,0,2,2,0,4,"H","N","2016-12-10","201612100BOS"
"TOR",0,0,2,2,0,4,0,0,1,0,0,1,"A","N","2016-12-10","201612100BOS"
"CBJ",0,1,1,4,0,6,0,1,1,0,0,2,"H","N","2016-12-10","201612100CBJ"
"NYI",0,1,1,0,0,2,0,1,1,4,0,6,"A","N","2016-12-10","201612100CBJ"
"CGY",0,0,4,2,0,6,0,0,0,2,0,2,"H","N","2016-12-10","201612100CGY"
"WPG",0,0,0,2,0,2,0,0,4,2,0,6,"A","N","2016-12-10","201612100CGY"
"FLA",0,1,1,2,0,4,0,0,0,2,0,2,"H","N","2016-12-10","201612100FLA"
"VAN",0,0,0,2,0,2,0,1,1,2,0,4,"A","N","2016-12-10","201612100FLA"
"LAK",0,2,1,1,0,4,0,0,1,0,0,1,"H","N","2016-12-10","201612100LAK"
"OTT",0,0,1,0,0,1,0,2,1,1,0,4,"A","N","2016-12-10","201612100LAK"
"COL",0,1,0,0,0,1,0,6,3,1,0,10,"A","N","2016-12-10","201612100MTL"
"MTL",0,6,3,1,0,10,0,1,0,0,0,1,"H","N","2016-12-10","201612100MTL"
"DAL",0,1,0,1,0,2,0,1,0,3,0,4,"A","N","2016-12-10","201612100PHI"
"PHI",0,1,0,3,0,4,0,1,0,1,0,2,"H","N","2016-12-10","201612100PHI"
"CAR",0,1,1,1,0,3,0,2,2,0,0,4,"A","N","2016-12-10","201612100SJS"
"SJS",0,2,2,0,0,4,0,1,1,1,0,3,"H","N","2016-12-10","201612100SJS"
"PIT",0,1,1,2,0,4,0,1,2,0,0,3,"A","N","2016-12-10","201612100TBL"
"TBL",0,1,2,0,0,3,0,1,1,2,0,4,"H","N","2016-12-10","201612100TBL"
"ANA",0,3,1,1,0,5,0,1,0,0,0,1,"H","N","2016-12-11","201612110ANA"
"OTT",0,1,0,0,0,1,0,3,1,1,0,5,"A","N","2016-12-11","201612110ANA"
"CHI",0,0,2,1,0,3,0,0,1,0,0,1,"H","N","2016-12-11","201612110CHI"
"DAL",0,0,1,0,0,1,0,0,2,1,0,3,"A","N","2016-12-11","201612110CHI"
"DET",0,0,0,0,0,0,1,0,0,0,0,1,"H","N","2016-12-11","201612110DET"
"PHI",1,0,0,0,0,1,0,0,0,0,0,0,"A","N","2016-12-11","201612110DET"
"EDM",0,0,1,2,0,3,0,1,1,0,0,2,"H","N","2016-12-11","201612110EDM"
"WPG",0,1,1,0,0,2,0,0,1,2,0,3,"A","N","2016-12-11","201612110EDM"
"MIN",0,0,2,1,0,3,0,0,1,0,0,1,"H","N","2016-12-11","201612110MIN"
"STL",0,0,1,0,0,1,0,0,2,1,0,3,"A","N","2016-12-11","201612110MIN"
"NJD",0,0,0,0,0,0,0,1,2,2,0,5,"A","N","2016-12-11","201612110NYR"
"NYR",0,1,2,2,0,5,0,0,0,0,0,0,"H","N","2016-12-11","201612110NYR"
"COL",0,1,0,2,0,3,0,0,0,1,0,1,"A","N","2016-12-11","201612110TOR"
"TOR",0,0,0,1,0,1,0,1,0,2,0,3,"H","N","2016-12-11","201612110TOR"
"VAN",0,0,0,0,0,0,0,1,0,2,0,3,"A","N","2016-12-11","201612110WSH"
"WSH",0,1,0,2,0,3,0,0,0,0,0,0,"H","N","2016-12-11","201612110WSH"
"BOS",1,0,1,0,0,2,0,0,0,1,0,1,"A","N","2016-12-12","201612120MTL"
"MTL",0,0,0,1,0,1,1,0,1,0,0,2,"H","N","2016-12-12","201612120MTL"
"ARI",0,0,0,0,0,0,0,1,4,2,0,7,"A","N","2016-12-12","201612120PIT"
"PIT",0,1,4,2,0,7,0,0,0,0,0,0,"H","N","2016-12-12","201612120PIT"
"BUF",0,0,4,2,0,6,0,1,1,1,0,3,"H","N","2016-12-13","201612130BUF"
"LAK",0,1,1,1,0,3,0,0,4,2,0,6,"A","N","2016-12-13","201612130BUF"
"CAR",0,2,0,6,0,8,0,1,4,1,0,6,"H","N","2016-12-13","201612130CAR"
"VAN",0,1,4,1,0,6,0,2,0,6,0,8,"A","N","2016-12-13","201612130CAR"
"ANA",0,0,1,1,0,2,0,0,1,5,0,6,"A","N","2016-12-13","201612130DAL"
"DAL",0,0,1,5,0,6,0,0,1,1,0,2,"H","N","2016-12-13","201612130DAL"
"ARI",0,2,1,1,0,4,0,1,0,0,0,1,"A","N","2016-12-13","201612130DET"
"DET",0,1,0,0,0,1,0,2,1,1,0,4,"H","N","2016-12-13","201612130DET"
"CBJ",0,0,1,2,0,3,0,1,0,0,0,1,"A","N","2016-12-13","201612130EDM"
"EDM",0,1,0,0,0,1,0,0,1,2,0,3,"H","N","2016-12-13","201612130EDM"
"FLA",0,0,0,1,0,1,0,1,2,2,0,5,"A","N","2016-12-13","201612130MIN"
"MIN",0,1,2,2,0,5,0,0,0,1,0,1,"H","N","2016-12-13","201612130MIN"
"NSH",0,0,2,4,0,6,0,2,1,0,0,3,"H","N","2016-12-13","201612130NSH"
"STL",0,2,1,0,0,3,0,0,2,4,0,6,"A","N","2016-12-13","201612130NSH"
"NYI",0,1,1,0,0,2,0,0,2,2,0,4,"H","N","2016-12-13","201612130NYI"
"WSH",0,0,2,2,0,4,0,1,1,0,0,2,"A","N","2016-12-13","201612130NYI"
"CHI",0,0,2,0,0,2,0,0,1,0,0,1,"A","N","2016-12-13","201612130NYR"
"NYR",0,0,1,0,0,1,0,0,2,0,0,2,"H","N","2016-12-13","201612130NYR"
"SJS",0,0,0,2,1,3,0,1,1,0,0,2,"A","Y","2016-12-13","201612130TOR"
"TOR",0,1,1,0,0,2,0,0,0,2,1,3,"H","Y","2016-12-13","201612130TOR"
"CGY",0,1,0,2,0,3,0,2,2,2,0,6,"H","N","2016-12-14","201612140CGY"
"TBL",0,2,2,2,0,6,0,1,0,2,0,3,"A","N","2016-12-14","201612140CGY"
"COL",0,0,2,1,0,3,0,0,2,2,0,4,"H","N","2016-12-14","201612140COL"
"PHI",0,0,2,2,0,4,0,0,2,1,0,3,"A","N","2016-12-14","201612140COL"
"OTT",0,1,1,1,0,3,0,1,1,1,1,4,"H","Y","2016-12-14","201612140OTT"
"SJS",0,1,1,1,1,4,0,1,1,1,0,3,"A","Y","2016-12-14","201612140OTT"
"BOS",0,1,1,1,0,3,1,1,1,1,0,4,"A","N","2016-12-14","201612140PIT"
"PIT",1,1,1,1,0,4,0,1,1,1,0,3,"H","N","2016-12-14","201612140PIT"
"ANA",0,2,2,0,0,4,0,2,1,0,0,3,"A","N","2016-12-15","201612150BOS"
"BOS",0,2,1,0,0,3,0,2,2,0,0,4,"H","N","2016-12-15","201612150BOS"
"DAL",0,0,0,0,0,0,0,0,0,2,0,2,"H","N","2016-12-15","201612150DAL"
"NYR",0,0,0,2,0,2,0,0,0,0,0,0,"A","N","2016-12-15","201612150DAL"
"DET",0,1,0,0,0,1,0,1,1,2,0,4,"H","N","2016-12-15","201612150DET"
"LAK",0,1,1,2,0,4,0,1,0,0,0,1,"A","N","2016-12-15","201612150DET"
"MIN",0,3,0,2,0,5,0,1,1,0,0,2,"A","N","2016-12-15","201612150NSH"
"NSH",0,1,1,0,0,2,0,3,0,2,0,5,"H","N","2016-12-15","201612150NSH"
"CHI",0,3,1,1,0,5,0,3,1,0,0,4,"A","N","2016-12-15","201612150NYI"
"NYI",0,3,1,0,0,4,0,3,1,1,0,5,"H","N","2016-12-15","201612150NYI"
"NJD",0,2,0,0,0,2,0,1,2,2,0,5,"A","N","2016-12-15","201612150STL"
"STL",0,1,2,2,0,5,0,2,0,0,0,2,"H","N","2016-12-15","201612150STL"
"ARI",0,0,2,0,1,3,0,1,1,0,0,2,"A","Y","2016-12-15","201612150TOR"
"TOR",0,1,1,0,0,2,0,0,2,0,1,3,"H","Y","2016-12-15","201612150TOR"
"FLA",0,0,3,0,0,3,0,1,1,1,1,4,"A","Y","2016-12-15","201612150WPG"
"WPG",0,1,1,1,1,4,0,0,3,0,0,3,"H","Y","2016-12-15","201612150WPG"
"BUF",1,0,1,1,0,3,0,1,1,0,0,2,"H","N","2016-12-16","201612160BUF"
"NYI",0,1,1,0,0,2,1,0,1,1,0,3,"A","N","2016-12-16","201612160BUF"
"CAR",0,1,1,1,0,3,0,0,2,1,1,4,"H","Y","2016-12-16","201612160CAR"
"WSH",0,0,2,1,1,4,0,1,1,1,0,3,"A","Y","2016-12-16","201612160CAR"
"CBJ",0,2,2,0,0,4,0,1,0,0,0,1,"A","N","2016-12-16","201612160CGY"
"CGY",0,1,0,0,0,1,0,2,2,0,0,4,"H","N","2016-12-16","201612160CGY"
"COL",0,0,1,0,0,1,0,0,1,2,0,3,"H","N","2016-12-16","201612160COL"
"FLA",0,0,1,2,0,3,0,0,1,0,0,1,"A","N","2016-12-16","201612160COL"
"MTL",0,0,0,2,0,2,0,3,1,0,0,4,"H","N","2016-12-16","201612160MTL"
"SJS",0,3,1,0,0,4,0,0,0,2,0,2,"A","N","2016-12-16","201612160MTL"
"LAK",1,0,0,0,0,1,0,0,0,0,0,0,"A","N","2016-12-16","201612160PIT"
"PIT",0,0,0,0,0,0,1,0,0,0,0,1,"H","N","2016-12-16","201612160PIT"
"TBL",0,1,0,1,0,2,0,0,2,2,0,4,"A","N","2016-12-16","201612160VAN"
"VAN",0,0,2,2,0,4,0,1,0,1,0,2,"H","N","2016-12-16","201612160VAN"
"BUF",0,0,0,1,0,1,0,1,0,0,1,2,"A","Y","2016-12-17","201612170CAR"
"CAR",0,1,0,0,1,2,0,0,0,1,0,1,"H","Y","2016-12-17","201612170CAR"
"DAL",0,0,1,2,0,3,0,1,0,0,0,1,"H","N","2016-12-17","201612170DAL"
"PHI",0,1,0,0,0,1,0,0,1,2,0,3,"A","N","2016-12-17","201612170DAL"
"ANA",0,2,1,1,0,4,0,1,3,2,0,6,"A","N","2016-12-17","201612170DET"
"DET",0,1,3,2,0,6,0,2,1,1,0,4,"H","N","2016-12-17","201612170DET"
"EDM",0,0,1,1,1,3,0,0,1,1,0,2,"H","Y","2016-12-17","201612170EDM"
"TBL",0,0,1,1,0,2,0,0,1,1,1,3,"A","Y","2016-12-17","201612170EDM"
"ARI",0,0,0,1,0,1,0,1,1,2,0,4,"A","N","2016-12-17","201612170MIN"
"MIN",0,1,1,2,0,4,0,0,0,1,0,1,"H","N","2016-12-17","201612170MIN"
"NSH",0,0,1,0,0,1,0,1,0,0,1,2,"H","Y","2016-12-17","201612170NSH"
"NYR",0,1,0,0,1,2,0,0,1,0,0,1,"A","Y","2016-12-17","201612170NSH"
"NJD",0,1,0,0,0,1,0,1,1,1,0,3,"A","N","2016-12-17","201612170OTT"
"OTT",0,1,1,1,0,3,0,1,0,0,0,1,"H","N","2016-12-17","201612170OTT"
"CHI",0,1,2,3,0,6,0,1,3,0,0,4,"A","N","2016-12-17","201612170STL"
"STL",0,1,3,0,0,4,0,1,2,3,0,6,"H","N","2016-12-17","201612170STL"
"PIT",0,1,0,0,0,1,1,1,0,0,0,2,"A","N","2016-12-17","201612170TOR"
"TOR",1,1,0,0,0,2,0,1,0,0,0,1,"H","N","2016-12-17","201612170TOR"
"MTL",0,1,1,0,0,2,0,0,1,0,0,1,"A","N","2016-12-17","201612170WSH"
"WSH",0,0,1,0,0,1,0,1,1,0,0,2,"H","N","2016-12-17","201612170WSH"
"BOS",0,1,0,0,0,1,0,0,0,0,0,0,"H","N","2016-12-18","201612180BOS"
"LAK",0,0,0,0,0,0,0,1,0,0,0,1,"A","N","2016-12-18","201612180BOS"
"CHI",0,0,1,3,0,4,0,0,1,0,0,1,"H","N","2016-12-18","201612180CHI"
"SJS",0,0,1,0,0,1,0,0,1,3,0,4,"A","N","2016-12-18","201612180CHI"
"NYI",0,0,2,0,0,2,0,2,1,3,0,6,"H","N","2016-12-18","201612180NYI"
"OTT",0,2,1,3,0,6,0,0,2,0,0,2,"A","N","2016-12-18","201612180NYI"
"NJD",0,0,1,1,0,2,0,0,0,2,1,3,"A","Y","2016-12-18","201612180NYR"
"NYR",0,0,0,2,1,3,0,0,1,1,0,2,"H","Y","2016-12-18","201612180NYR"
"CBJ",1,0,2,1,0,4,0,0,0,3,0,3,"A","N","2016-12-18","201612180VAN"
"VAN",0,0,0,3,0,3,1,0,2,1,0,4,"H","N","2016-12-18","201612180VAN"
"COL",0,0,0,1,0,1,0,0,1,3,0,4,"A","N","2016-12-18","201612180WPG"
"WPG",0,0,1,3,0,4,0,0,0,1,0,1,"H","N","2016-12-18","201612180WPG"
"ARI",0,1,0,1,0,2,0,0,1,3,0,4,"H","N","2016-12-19","201612190ARI"
"CGY",0,0,1,3,0,4,0,1,0,1,0,2,"A","N","2016-12-19","201612190ARI"
"NSH",0,0,0,1,1,2,0,1,0,0,0,1,"A","Y","2016-12-19","201612190PHI"
"PHI",0,1,0,0,0,1,0,0,0,1,1,2,"H","Y","2016-12-19","201612190PHI"
"EDM",1,1,0,1,0,3,0,2,0,0,0,2,"A","N","2016-12-19","201612190STL"
"STL",0,2,0,0,0,2,1,1,0,1,0,3,"H","N","2016-12-19","201612190STL"
"ANA",0,0,1,2,0,3,0,0,1,1,0,2,"A","N","2016-12-19","201612190TOR"
"TOR",0,0,1,1,0,2,0,0,1,2,0,3,"H","N","2016-12-19","201612190TOR"
"BOS",0,0,0,2,0,2,0,2,1,1,0,4,"H","N","2016-12-20","201612200BOS"
"NYI",0,2,1,1,0,4,0,0,0,2,0,2,"A","N","2016-12-20","201612200BOS"
"CBJ",0,0,1,1,1,3,0,0,1,1,0,2,"H","Y","2016-12-20","201612200CBJ"
"LAK",0,0,1,1,0,2,0,0,1,1,1,3,"A","Y","2016-12-20","201612200CBJ"
"CHI",0,1,1,1,0,3,0,1,3,0,0,4,"H","N","2016-12-20","201612200CHI"
"OTT",0,1,3,0,0,4,0,1,1,1,0,3,"A","N","2016-12-20","201612200CHI"
"DAL",0,1,1,0,0,2,1,1,1,0,0,3,"H","N","2016-12-20","201612200DAL"
"STL",1,1,1,0,0,3,0,1,1,0,0,2,"A","N","2016-12-20","201612200DAL"
"BUF",0,0,2,1,0,3,0,1,1,1,1,4,"A","Y","2016-12-20","201612200FLA"
"FLA",0,1,1,1,1,4,0,0,2,1,0,3,"H","Y","2016-12-20","201612200FLA"
"COL",0,0,0,0,0,0,0,1,1,0,0,2,"A","N","2016-12-20","201612200MIN"
"MIN",0,1,1,0,0,2,0,0,0,0,0,0,"H","N","2016-12-20","201612200MIN"
"ANA",0,1,0,0,0,1,0,1,1,3,0,5,"A","N","2016-12-20","201612200MTL"
"MTL",0,1,1,3,0,5,0,1,0,0,0,1,"H","N","2016-12-20","201612200MTL"
"NJD",0,0,0,1,0,1,0,2,1,2,0,5,"H","N","2016-12-20","201612200NJD"
"NSH",0,2,1,2,0,5,0,0,0,1,0,1,"A","N","2016-12-20","201612200NJD"
"NYR",0,1,0,1,0,2,0,1,2,4,0,7,"A","N","2016-12-20","201612200PIT"
"PIT",0,1,2,4,0,7,0,1,0,1,0,2,"H","N","2016-12-20","201612200PIT"
"CGY",0,0,0,1,0,1,0,0,4,0,0,4,"A","N","2016-12-20","201612200SJS"
"SJS",0,0,4,0,0,4,0,0,0,1,0,1,"H","N","2016-12-20","201612200SJS"
"DET",0,0,0,1,0,1,0,1,3,0,0,4,"A","N","2016-12-20","201612200TBL"
"TBL",0,1,3,0,0,4,0,0,0,1,0,1,"H","N","2016-12-20","201612200TBL"
"VAN",0,0,1,3,0,4,0,1,0,0,0,1,"H","N","2016-12-20","201612200VAN"
"WPG",0,1,0,0,0,1,0,0,1,3,0,4,"A","N","2016-12-20","201612200VAN"
"ARI",0,0,1,1,0,2,0,2,1,0,0,3,"H","N","2016-12-21","201612210ARI"
"EDM",0,2,1,0,0,3,0,0,1,1,0,2,"A","N","2016-12-21","201612210ARI"
"PHI",0,0,2,0,1,3,0,1,1,0,0,2,"H","Y","2016-12-21","201612210PHI"
"WSH",0,1,1,0,0,2,0,0,2,0,1,3,"A","Y","2016-12-21","201612210PHI"
"BUF",0,0,0,1,0,1,0,2,0,1,0,3,"H","N","2016-12-22","201612220BUF"
"CAR",0,2,0,1,0,3,0,0,0,1,0,1,"A","N","2016-12-22","201612220BUF"
"CBJ",0,1,2,4,0,7,0,1,0,0,0,1,"H","N","2016-12-22","201612220CBJ"
"PIT",0,1,0,0,0,1,0,1,2,4,0,7,"A","N","2016-12-22","201612220CBJ"
"COL",0,0,0,0,0,0,0,3,2,1,0,6,"H","N","2016-12-22","201612220COL"
"TOR",0,3,2,1,0,6,0,0,0,0,0,0,"A","N","2016-12-22","201612220COL"
"BOS",0,0,2,1,0,3,0,0,0,1,0,1,"A","N","2016-12-22","201612220FLA"
"FLA",0,0,0,1,0,1,0,0,2,1,0,3,"H","N","2016-12-22","201612220FLA"
"MIN",0,0,2,2,0,4,0,0,2,0,0,2,"A","N","2016-12-22","201612220MTL"
"MTL",0,0,2,0,0,2,0,0,2,2,0,4,"H","N","2016-12-22","201612220MTL"
"NJD",0,2,1,1,0,4,0,0,0,0,0,0,"H","N","2016-12-22","201612220NJD"
"PHI",0,0,0,0,0,0,0,2,1,1,0,4,"A","N","2016-12-22","201612220NJD"
"LAK",0,1,0,3,0,4,0,0,0,0,0,0,"A","N","2016-12-22","201612220NSH"
"NSH",0,0,0,0,0,0,0,1,0,3,0,4,"H","N","2016-12-22","201612220NSH"
"ANA",0,0,1,0,0,1,1,0,1,0,0,2,"A","N","2016-12-22","201612220OTT"
"OTT",1,0,1,0,0,2,0,0,1,0,0,1,"H","N","2016-12-22","201612220OTT"
"STL",0,2,0,0,0,2,0,0,2,3,0,5,"A","N","2016-12-22","201612220TBL"
"TBL",0,0,2,3,0,5,0,2,0,0,0,2,"H","N","2016-12-22","201612220TBL"
"VAN",0,1,0,0,0,1,0,0,1,3,0,4,"H","N","2016-12-22","201612220VAN"
"WPG",0,0,1,3,0,4,0,1,0,0,0,1,"A","N","2016-12-22","201612220VAN"
"ARI",0,0,1,0,0,1,0,1,1,2,0,4,"H","N","2016-12-23","201612230ARI"
"TOR",0,1,1,2,0,4,0,0,1,0,0,1,"A","N","2016-12-23","201612230ARI"
"BOS",0,1,1,0,0,2,1,0,1,1,0,3,"A","N","2016-12-23","201612230CAR"
"CAR",1,0,1,1,0,3,0,1,1,0,0,2,"H","N","2016-12-23","201612230CAR"
"CBJ",0,1,1,0,0,2,0,0,0,1,0,1,"H","N","2016-12-23","201612230CBJ"
"MTL",0,0,0,1,0,1,0,1,1,0,0,2,"A","N","2016-12-23","201612230CBJ"
"CGY",0,0,3,1,0,4,0,1,0,0,0,1,"H","N","2016-12-23","201612230CGY"
"VAN",0,1,0,0,0,1,0,0,3,1,0,4,"A","N","2016-12-23","201612230CGY"
"CHI",0,0,1,0,0,1,1,0,0,1,0,2,"H","N","2016-12-23","201612230CHI"
"COL",1,0,0,1,0,2,0,0,1,0,0,1,"A","N","2016-12-23","201612230CHI"
"DAL",1,0,1,1,0,3,0,1,0,1,0,2,"H","N","2016-12-23","201612230DAL"
"LAK",0,1,0,1,0,2,1,0,1,1,0,3,"A","N","2016-12-23","201612230DAL"
"DET",0,0,1,2,1,4,0,1,2,0,0,3,"A","Y","2016-12-23","201612230FLA"
"FLA",0,1,2,0,0,3,0,0,1,2,1,4,"H","Y","2016-12-23","201612230FLA"
"BUF",0,0,0,1,0,1,0,1,2,2,0,5,"A","N","2016-12-23","201612230NYI"
"NYI",0,1,2,2,0,5,0,0,0,1,0,1,"H","N","2016-12-23","201612230NYI"
"MIN",0,1,5,1,0,7,0,1,2,1,0,4,"A","N","2016-12-23","201612230NYR"
"NYR",0,1,2,1,0,4,0,1,5,1,0,7,"H","N","2016-12-23","201612230NYR"
"NJD",0,0,1,0,0,1,0,1,2,1,0,4,"A","N","2016-12-23","201612230PIT"
"PIT",0,1,2,1,0,4,0,0,1,0,0,1,"H","N","2016-12-23","201612230PIT"
"EDM",0,0,0,2,0,2,1,0,1,1,0,3,"A","N","2016-12-23","201612230SJS"
"SJS",1,0,1,1,0,3,0,0,0,2,0,2,"H","N","2016-12-23","201612230SJS"
"TBL",0,0,0,0,0,0,0,2,1,1,0,4,"A","N","2016-12-23","201612230WSH"
"WSH",0,2,1,1,0,4,0,0,0,0,0,0,"H","N","2016-12-23","201612230WSH"
"ANA",0,0,1,1,0,2,1,1,1,0,0,3,"H","N","2016-12-27","201612270ANA"
"SJS",1,1,1,0,0,3,0,0,1,1,0,2,"A","N","2016-12-27","201612270ANA"
"ARI",0,0,1,1,0,2,0,0,2,1,0,3,"H","N","2016-12-27","201612270ARI"
"DAL",0,0,2,1,0,3,0,0,1,1,0,2,"A","N","2016-12-27","201612270ARI"
"BOS",0,2,1,0,0,3,0,3,0,1,0,4,"A","N","2016-12-27","201612270CBJ"
"CBJ",0,3,0,1,0,4,0,2,1,0,0,3,"H","N","2016-12-27","201612270CBJ"
"CHI",0,0,1,0,0,1,0,2,0,1,0,3,"H","N","2016-12-27","201612270CHI"
"WPG",0,2,0,1,0,3,0,0,1,0,0,1,"A","N","2016-12-27","201612270CHI"
"CGY",0,0,4,2,0,6,0,1,1,1,0,3,"A","N","2016-12-27","201612270COL"
"COL",0,1,1,1,0,3,0,0,4,2,0,6,"H","N","2016-12-27","201612270COL"
"BUF",0,2,1,1,0,4,0,0,2,1,0,3,"A","N","2016-12-27","201612270DET"
"DET",0,0,2,1,0,3,0,2,1,1,0,4,"H","N","2016-12-27","201612270DET"
"NJD",0,2,0,0,0,2,0,1,2,2,0,5,"H","N","2016-12-27","201612270NJD"
"PIT",0,1,2,2,0,5,0,2,0,0,0,2,"A","N","2016-12-27","201612270NJD"
"MIN",1,1,1,0,0,3,0,0,2,0,0,2,"A","N","2016-12-27","201612270NSH"
"NSH",0,0,2,0,0,2,1,1,1,0,0,3,"H","N","2016-12-27","201612270NSH"
"NYI",0,1,1,2,0,4,0,1,0,2,0,3,"H","N","2016-12-27","201612270NYI"
"WSH",0,1,0,2,0,3,0,1,1,2,0,4,"A","N","2016-12-27","201612270NYI"
"NYR",0,1,2,1,0,4,0,3,0,0,0,3,"H","N","2016-12-27","201612270NYR"
"OTT",0,3,0,0,0,3,0,1,2,1,0,4,"A","N","2016-12-27","201612270NYR"
"FLA",0,0,0,2,0,2,0,1,1,0,1,3,"H","Y","2016-12-28","201612280FLA"
"TOR",0,1,1,0,1,3,0,0,0,2,0,2,"A","Y","2016-12-28","201612280FLA"
"CAR",0,1,1,0,0,2,0,0,1,2,0,3,"A","N","2016-12-28","201612280PIT"
"PIT",0,0,1,2,0,3,0,1,1,0,0,2,"H","N","2016-12-28","201612280PIT"
"PHI",0,1,1,1,0,3,0,2,0,4,0,6,"A","N","2016-12-28","201612280STL"
"STL",0,2,0,4,0,6,0,1,1,1,0,3,"H","N","2016-12-28","201612280STL"
"MTL",0,2,1,0,0,3,1,1,0,2,0,4,"A","N","2016-12-28","201612280TBL"
"TBL",1,1,0,2,0,4,0,2,1,0,0,3,"H","N","2016-12-28","201612280TBL"
"LAK",0,0,0,1,0,1,0,1,1,0,0,2,"A","N","2016-12-28","201612280VAN"
"VAN",0,1,1,0,0,2,0,0,0,1,0,1,"H","N","2016-12-28","201612280VAN"
"ARI",0,1,1,1,0,3,0,2,1,3,0,6,"H","N","2016-12-29","201612290ARI"
"NYR",0,2,1,3,0,6,0,1,1,1,0,3,"A","N","2016-12-29","201612290ARI"
"BOS",0,0,2,2,0,4,0,2,0,0,0,2,"A","N","2016-12-29","201612290BUF"
"BUF",0,2,0,0,0,2,0,0,2,2,0,4,"H","N","2016-12-29","201612290BUF"
"ANA",0,0,1,2,0,3,0,1,0,0,0,1,"A","N","2016-12-29","201612290CGY"
"CGY",0,1,0,0,0,1,0,0,1,2,0,3,"H","N","2016-12-29","201612290CGY"
"COL",0,1,0,1,0,2,0,2,1,1,0,4,"A","N","2016-12-29","201612290DAL"
"DAL",0,2,1,1,0,4,0,1,0,1,0,2,"H","N","2016-12-29","201612290DAL"
"EDM",0,0,1,2,0,3,0,0,0,1,0,1,"H","N","2016-12-29","201612290EDM"
"LAK",0,0,0,1,0,1,0,0,1,2,0,3,"A","N","2016-12-29","201612290EDM"
"FLA",0,1,1,0,0,2,1,0,1,1,0,3,"H","N","2016-12-29","201612290FLA"
"MTL",1,0,1,1,0,3,0,1,1,0,0,2,"A","N","2016-12-29","201612290FLA"
"MIN",0,1,3,2,0,6,0,1,1,2,0,4,"H","N","2016-12-29","201612290MIN"
"NYI",0,1,1,2,0,4,0,1,3,2,0,6,"A","N","2016-12-29","201612290MIN"
"CHI",0,1,0,2,0,3,0,1,0,1,0,2,"A","N","2016-12-29","201612290NSH"
"NSH",0,1,0,1,0,2,0,1,0,2,0,3,"H","N","2016-12-29","201612290NSH"
"DET",1,1,1,0,0,3,0,1,1,0,0,2,"A","N","2016-12-29","201612290OTT"
"OTT",0,1,1,0,0,2,1,1,1,0,0,3,"H","N","2016-12-29","201612290OTT"
"TBL",0,0,2,0,0,2,1,1,1,0,0,3,"H","N","2016-12-29","201612290TBL"
"TOR",1,1,1,0,0,3,0,0,2,0,0,2,"A","N","2016-12-29","201612290TBL"
"CBJ",0,2,1,2,0,5,0,1,0,2,0,3,"A","N","2016-12-29","201612290WPG"
"WPG",0,1,0,2,0,3,0,2,1,2,0,5,"H","N","2016-12-29","201612290WPG"
"NJD",0,0,1,0,1,2,0,0,0,1,0,1,"A","Y","2016-12-29","201612290WSH"
"WSH",0,0,0,1,0,1,0,0,1,0,1,2,"H","Y","2016-12-29","201612290WSH"
"CAR",0,2,0,1,0,3,0,1,0,1,0,2,"H","N","2016-12-30","201612300CAR"
"CHI",0,1,0,1,0,2,0,2,0,1,0,3,"A","N","2016-12-30","201612300CAR"
"PHI",0,0,0,0,0,0,0,1,0,1,0,2,"A","N","2016-12-30","201612300SJS"
"SJS",0,1,0,1,0,2,0,0,0,0,0,0,"H","N","2016-12-30","201612300SJS"
"NSH",0,0,3,1,0,4,0,0,0,0,0,0,"A","N","2016-12-30","201612300STL"
"STL",0,0,0,0,0,0,0,0,3,1,0,4,"H","N","2016-12-30","201612300STL"
"ANA",0,1,1,0,0,2,1,0,1,1,0,3,"A","N","2016-12-30","201612300VAN"
"VAN",1,0,1,1,0,3,0,1,1,0,0,2,"H","N","2016-12-30","201612300VAN"
"BOS",0,1,2,0,0,3,0,0,1,0,0,1,"H","N","2016-12-31","201612310BOS"
"BUF",0,0,1,0,0,1,0,1,2,0,0,3,"A","N","2016-12-31","201612310BOS"
"ARI",0,0,1,1,0,2,0,4,0,0,0,4,"A","N","2016-12-31","201612310CGY"
"CGY",0,4,0,0,0,4,0,0,1,1,0,2,"H","N","2016-12-31","201612310CGY"
"COL",0,2,0,0,0,2,0,2,2,2,0,6,"H","N","2016-12-31","201612310COL"
"NYR",0,2,2,2,0,6,0,2,0,0,0,2,"A","N","2016-12-31","201612310COL"
"DAL",0,0,1,0,0,1,0,3,0,0,0,3,"H","N","2016-12-31","201612310DAL"
"FLA",0,3,0,0,0,3,0,0,1,0,0,1,"A","N","2016-12-31","201612310DAL"
"EDM",0,0,1,1,0,2,0,0,1,1,1,3,"H","Y","2016-12-31","201612310EDM"
"VAN",0,0,1,1,1,3,0,0,1,1,0,2,"A","Y","2016-12-31","201612310EDM"
"LAK",0,1,1,1,0,3,0,0,0,2,0,2,"H","N","2016-12-31","201612310LAK"
"SJS",0,0,0,2,0,2,0,1,1,1,0,3,"A","N","2016-12-31","201612310LAK"
"CBJ",0,1,3,0,0,4,0,0,1,1,0,2,"A","N","2016-12-31","201612310MIN"
"MIN",0,0,1,1,0,2,0,1,3,0,0,4,"H","N","2016-12-31","201612310MIN"
"NJD",0,0,1,1,0,2,0,2,3,1,0,6,"H","N","2016-12-31","201612310NJD"
"WSH",0,2,3,1,0,6,0,0,1,1,0,2,"A","N","2016-12-31","201612310NJD"
"MTL",0,1,1,1,0,3,1,0,2,1,0,4,"A","N","2016-12-31","201612310PIT"
"PIT",1,0,2,1,0,4,0,1,1,1,0,3,"H","N","2016-12-31","201612310PIT"
"CAR",0,0,1,0,0,1,0,2,1,0,0,3,"A","N","2016-12-31","201612310TBL"
"TBL",0,2,1,0,0,3,0,0,1,0,0,1,"H","N","2016-12-31","201612310TBL"
"NYI",0,2,2,2,0,6,0,0,1,1,0,2,"A","N","2016-12-31","201612310WPG"
"WPG",0,0,1,1,0,2,0,2,2,2,0,6,"H","N","2016-12-31","201612310WPG"
"ANA",0,2,1,0,1,4,0,1,2,0,0,3,"H","Y","2017-01-01","201701010ANA"
"PHI",0,1,2,0,0,3,0,2,1,0,1,4,"A","Y","2017-01-01","201701010ANA"
"DET",0,0,1,3,0,4,1,0,0,4,0,5,"A","N","2017-01-01","201701010TOR"
"TOR",1,0,0,4,0,5,0,0,1,3,0,4,"H","N","2017-01-01","201701010TOR"
"OTT",0,0,1,0,0,1,0,0,1,1,0,2,"A","N","2017-01-01","201701010WSH"
"WSH",0,0,1,1,0,2,0,0,1,0,0,1,"H","N","2017-01-01","201701010WSH"
"BOS",0,0,0,0,0,0,0,1,0,2,0,3,"A","N","2017-01-02","201701020NJD"
"NJD",0,1,0,2,0,3,0,0,0,0,0,0,"H","N","2017-01-02","201701020NJD"
"CHI",0,1,0,0,0,1,0,0,1,3,0,4,"A","N","2017-01-02","201701020STL"
"STL",0,0,1,3,0,4,0,1,0,0,0,1,"H","N","2017-01-02","201701020STL"
"COL",0,0,1,1,0,2,0,0,2,1,0,3,"A","N","2017-01-02","201701020VAN"
"VAN",0,0,2,1,0,3,0,0,1,1,0,2,"H","N","2017-01-02","201701020VAN"
"CAR",0,0,0,1,0,1,0,0,1,2,0,3,"H","N","2017-01-03","201701030CAR"
"NJD",0,0,1,2,0,3,0,0,0,1,0,1,"A","N","2017-01-03","201701030CAR"
"CBJ",0,1,1,1,0,3,0,0,1,0,0,1,"H","N","2017-01-03","201701030CBJ"
"EDM",0,0,1,0,0,1,0,1,1,1,0,3,"A","N","2017-01-03","201701030CBJ"
"MTL",1,0,0,1,0,2,0,0,1,0,0,1,"A","N","2017-01-03","201701030NSH"
"NSH",0,0,1,0,0,1,1,0,0,1,0,2,"H","N","2017-01-03","201701030NSH"
"BUF",0,2,1,1,0,4,0,0,1,0,0,1,"A","N","2017-01-03","201701030NYR"
"NYR",0,0,1,0,0,1,0,2,1,1,0,4,"H","N","2017-01-03","201701030NYR"
"LAK",1,0,0,1,0,2,0,0,1,0,0,1,"A","N","2017-01-03","201701030SJS"
"SJS",0,0,1,0,0,1,1,0,0,1,0,2,"H","N","2017-01-03","201701030SJS"
"TBL",0,0,1,3,0,4,0,1,3,2,0,6,"H","N","2017-01-03","201701030TBL"
"WPG",0,1,3,2,0,6,0,0,1,3,0,4,"A","N","2017-01-03","201701030TBL"
"TOR",0,3,1,1,0,5,1,2,0,3,0,6,"A","N","2017-01-03","201701030WSH"
"WSH",1,2,0,3,0,6,0,3,1,1,0,5,"H","N","2017-01-03","201701030WSH"
"ANA",0,1,0,1,0,2,0,0,0,0,0,0,"H","N","2017-01-04","201701040ANA"
"DET",0,0,0,0,0,0,0,1,0,1,0,2,"A","N","2017-01-04","201701040ANA"
"CGY",0,1,1,2,0,4,0,0,0,1,0,1,"H","N","2017-01-04","201701040CGY"
"COL",0,0,0,1,0,1,0,1,1,2,0,4,"A","N","2017-01-04","201701040CGY"
"DAL",0,1,1,1,0,3,1,1,0,2,0,4,"H","N","2017-01-04","201701040DAL"
"MTL",1,1,0,2,0,4,0,1,1,1,0,3,"A","N","2017-01-04","201701040DAL"
"FLA",0,0,1,0,0,1,0,0,2,2,0,4,"H","N","2017-01-04","201701040FLA"
"WPG",0,0,2,2,0,4,0,0,1,0,0,1,"A","N","2017-01-04","201701040FLA"
"NYR",0,0,1,4,0,5,0,0,0,2,0,2,"A","N","2017-01-04","201701040PHI"
"PHI",0,0,0,2,0,2,0,0,1,4,0,5,"H","N","2017-01-04","201701040PHI"
"ARI",0,0,0,0,0,0,0,1,0,2,0,3,"A","N","2017-01-04","201701040VAN"
"VAN",0,1,0,2,0,3,0,0,0,0,0,0,"H","N","2017-01-04","201701040VAN"
"BOS",0,1,1,1,0,3,0,1,1,2,0,4,"H","N","2017-01-05","201701050BOS"
"EDM",0,1,1,2,0,4,0,1,1,1,0,3,"A","N","2017-01-05","201701050BOS"
"BUF",0,1,1,1,0,3,1,1,1,1,0,4,"A","N","2017-01-05","201701050CHI"
"CHI",1,1,1,1,0,4,0,1,1,1,0,3,"H","N","2017-01-05","201701050CHI"
"DET",0,3,0,1,0,4,0,0,0,0,0,0,"A","N","2017-01-05","201701050LAK"
"LAK",0,0,0,0,0,0,0,3,0,1,0,4,"H","N","2017-01-05","201701050LAK"
"MIN",0,0,1,4,0,5,0,0,2,2,0,4,"A","N","2017-01-05","201701050SJS"
"SJS",0,0,2,2,0,4,0,0,1,4,0,5,"H","N","2017-01-05","201701050SJS"
"CAR",0,1,1,2,0,4,0,0,2,0,0,2,"A","N","2017-01-05","201701050STL"
"STL",0,0,2,0,0,2,0,1,1,2,0,4,"H","N","2017-01-05","201701050STL"
"NSH",0,1,3,2,0,6,0,0,1,0,0,1,"A","N","2017-01-05","201701050TBL"
"TBL",0,0,1,0,0,1,0,1,3,2,0,6,"H","N","2017-01-05","201701050TBL"
"CBJ",0,0,0,0,0,0,0,2,2,1,0,5,"A","N","2017-01-05","201701050WSH"
"WSH",0,2,2,1,0,5,0,0,0,0,0,0,"H","N","2017-01-05","201701050WSH"
"ANA",1,1,1,0,0,3,0,0,1,1,0,2,"H","N","2017-01-06","201701060ANA"
"ARI",0,0,1,1,0,2,1,1,1,0,0,3,"A","N","2017-01-06","201701060ANA"
"CAR",0,0,1,0,0,1,0,1,1,0,0,2,"A","N","2017-01-06","201701060CHI"
"CHI",0,1,1,0,0,2,0,0,1,0,0,1,"H","N","2017-01-06","201701060CHI"
"COL",1,1,0,0,0,2,0,0,1,0,0,1,"H","N","2017-01-06","201701060COL"
"NYI",0,0,1,0,0,1,1,1,0,0,0,2,"A","N","2017-01-06","201701060COL"
"FLA",0,1,0,1,0,2,0,0,0,1,0,1,"H","N","2017-01-06","201701060FLA"
"NSH",0,0,0,1,0,1,0,1,0,1,0,2,"A","N","2017-01-06","201701060FLA"
"NJD",0,0,0,2,0,2,0,4,0,0,0,4,"H","N","2017-01-06","201701060NJD"
"TOR",0,4,0,0,0,4,0,0,0,2,0,2,"A","N","2017-01-06","201701060NJD"
"CGY",0,1,0,1,0,2,0,2,1,1,0,4,"A","N","2017-01-06","201701060VAN"
"VAN",0,2,1,1,0,4,0,1,0,1,0,2,"H","N","2017-01-06","201701060VAN"
"ARI",0,0,0,1,1,2,0,0,1,0,0,1,"H","Y","2017-01-07","201701070ARI"
"NYI",0,0,1,0,0,1,0,0,0,1,1,2,"A","Y","2017-01-07","201701070ARI"
"BUF",0,1,0,3,0,4,0,1,2,0,0,3,"H","N","2017-01-07","201701070BUF"
"WPG",0,1,2,0,0,3,0,1,0,3,0,4,"A","N","2017-01-07","201701070BUF"
"CBJ",0,3,1,0,0,4,0,1,1,3,0,5,"H","N","2017-01-07","201701070CBJ"
"NYR",0,1,1,3,0,5,0,3,1,0,0,4,"A","N","2017-01-07","201701070CBJ"
"CGY",0,2,0,1,0,3,0,0,1,0,0,1,"H","N","2017-01-07","201701070CGY"
"VAN",0,0,1,0,0,1,0,2,0,1,0,3,"A","N","2017-01-07","201701070CGY"
"BOS",0,1,2,1,0,4,0,0,0,0,0,0,"A","N","2017-01-07","201701070FLA"
"FLA",0,0,0,0,0,0,0,1,2,1,0,4,"H","N","2017-01-07","201701070FLA"
"LAK",1,0,2,1,0,4,0,2,0,1,0,3,"H","N","2017-01-07","201701070LAK"
"MIN",0,2,0,1,0,3,1,0,2,1,0,4,"A","N","2017-01-07","201701070LAK"
"EDM",1,0,0,1,0,2,0,1,0,0,0,1,"A","N","2017-01-07","201701070NJD"
"NJD",0,1,0,0,0,1,1,0,0,1,0,2,"H","N","2017-01-07","201701070NJD"
"OTT",0,0,0,0,0,0,0,1,0,0,0,1,"H","N","2017-01-07","201701070OTT"
"WSH",0,1,0,0,0,1,0,0,0,0,0,0,"A","N","2017-01-07","201701070OTT"
"PHI",0,0,4,0,0,4,0,1,1,0,0,2,"H","N","2017-01-07","201701070PHI"
"TBL",0,1,1,0,0,2,0,0,4,0,0,4,"A","N","2017-01-07","201701070PHI"
"DET",0,1,0,2,0,3,0,3,0,3,0,6,"A","N","2017-01-07","201701070SJS"
"SJS",0,3,0,3,0,6,0,1,0,2,0,3,"H","N","2017-01-07","201701070SJS"
"DAL",0,1,2,0,0,3,0,2,1,1,0,4,"A","N","2017-01-07","201701070STL"
"STL",0,2,1,1,0,4,0,1,2,0,0,3,"H","N","2017-01-07","201701070STL"
"MTL",0,3,1,1,0,5,0,2,1,0,0,3,"A","N","2017-01-07","201701070TOR"
"TOR",0,2,1,0,0,3,0,3,1,1,0,5,"H","N","2017-01-07","201701070TOR"
"ANA",0,1,0,0,0,1,0,0,2,0,0,2,"H","N","2017-01-08","201701080ANA"
"MIN",0,0,2,0,0,2,0,1,0,0,0,1,"A","N","2017-01-08","201701080ANA"
"BOS",0,1,0,2,0,3,1,0,2,1,0,4,"A","N","2017-01-08","201701080CAR"
"CAR",1,0,2,1,0,4,0,1,0,2,0,3,"H","N","2017-01-08","201701080CAR"
"CBJ",1,0,1,0,0,2,0,0,0,1,0,1,"H","N","2017-01-08","201701080CBJ"
"PHI",0,0,0,1,0,1,1,0,1,0,0,2,"A","N","2017-01-08","201701080CBJ"
"CHI",0,2,0,3,0,5,0,1,0,1,0,2,"H","N","2017-01-08","201701080CHI"
"NSH",0,1,0,1,0,2,0,2,0,3,0,5,"A","N","2017-01-08","201701080CHI"
"EDM",0,0,3,0,0,3,0,2,2,1,0,5,"A","N","2017-01-08","201701080OTT"
"OTT",0,2,2,1,0,5,0,0,3,0,0,3,"H","N","2017-01-08","201701080OTT"
"PIT",0,0,2,4,0,6,0,0,1,1,0,2,"H","N","2017-01-08","201701080PIT"
"TBL",0,0,1,1,0,2,0,0,2,4,0,6,"A","N","2017-01-08","201701080PIT"
"DAL",0,1,2,3,0,6,0,0,1,3,0,4,"A","N","2017-01-09","201701090LAK"
"LAK",0,0,1,3,0,4,0,1,2,3,0,6,"H","N","2017-01-09","201701090LAK"
"MTL",0,0,0,1,0,1,0,1,0,3,0,4,"H","N","2017-01-09","201701090MTL"
"WSH",0,1,0,3,0,4,0,0,0,1,0,1,"A","N","2017-01-09","201701090MTL"
"FLA",0,1,0,2,0,3,0,0,0,0,0,0,"A","N","2017-01-09","201701090NJD"
"NJD",0,0,0,0,0,0,0,1,0,2,0,3,"H","N","2017-01-09","201701090NJD"
"CGY",0,0,0,0,0,0,0,1,0,1,0,2,"A","N","2017-01-09","201701090WPG"
"WPG",0,1,0,1,0,2,0,0,0,0,0,0,"H","N","2017-01-09","201701090WPG"
"ANA",0,0,1,1,0,2,0,0,0,0,0,0,"H","N","2017-01-10","201701100ANA"
"DAL",0,0,0,0,0,0,0,0,1,1,0,2,"A","N","2017-01-10","201701100ANA"
"BUF",0,0,3,1,0,4,0,0,0,1,0,1,"H","N","2017-01-10","201701100BUF"
"PHI",0,0,0,1,0,1,0,0,3,1,0,4,"A","N","2017-01-10","201701100BUF"
"CAR",0,0,3,2,0,5,0,1,2,0,0,3,"H","N","2017-01-10","201701100CAR"
"CBJ",0,1,2,0,0,3,0,0,3,2,0,5,"A","N","2017-01-10","201701100CAR"
"CHI",1,2,1,0,0,4,0,0,3,0,0,3,"H","N","2017-01-10","201701100CHI"
"DET",0,0,3,0,0,3,1,2,1,0,0,4,"A","N","2017-01-10","201701100CHI"
"EDM",0,1,0,2,0,3,0,2,2,1,0,5,"H","N","2017-01-10","201701100EDM"
"SJS",0,2,2,1,0,5,0,1,0,2,0,3,"A","N","2017-01-10","201701100EDM"
"NSH",1,0,1,0,0,2,0,0,0,1,0,1,"H","N","2017-01-10","201701100NSH"
"VAN",0,0,0,1,0,1,1,0,1,0,0,2,"A","N","2017-01-10","201701100NSH"
"BOS",0,3,1,1,0,5,0,0,1,2,0,3,"A","N","2017-01-10","201701100STL"
"STL",0,0,1,2,0,3,0,3,1,1,0,5,"H","N","2017-01-10","201701100STL"
"CGY",0,1,1,1,0,3,0,2,0,0,0,2,"H","N","2017-01-11","201701110CGY"
"SJS",0,2,0,0,0,2,0,1,1,1,0,3,"A","N","2017-01-11","201701110CGY"
"FLA",0,1,1,0,0,2,0,1,0,0,0,1,"A","N","2017-01-11","201701110NYI"
"NYI",0,1,0,0,0,1,0,1,1,0,0,2,"H","N","2017-01-11","201701110NYI"
"MTL",0,3,2,2,0,7,0,2,1,1,0,4,"A","N","2017-01-11","201701110WPG"
"WPG",0,2,1,1,0,4,0,3,2,2,0,7,"H","N","2017-01-11","201701110WPG"
"PIT",0,0,0,2,0,2,0,1,1,3,0,5,"A","N","2017-01-11","201701110WSH"
"WSH",0,1,1,3,0,5,0,0,0,2,0,2,"H","N","2017-01-11","201701110WSH"
"ANA",0,2,1,1,0,4,0,1,0,0,0,1,"A","N","2017-01-12","201701120COL"
"COL",0,1,0,0,0,1,0,2,1,1,0,4,"H","N","2017-01-12","201701120COL"
"DAL",0,1,3,1,0,5,0,2,0,0,0,2,"H","N","2017-01-12","201701120DAL"
"DET",0,2,0,0,0,2,0,1,3,1,0,5,"A","N","2017-01-12","201701120DAL"
"EDM",1,0,1,1,0,3,0,1,1,0,0,2,"H","N","2017-01-12","201701120EDM"
"NJD",0,1,1,0,0,2,1,0,1,1,0,3,"A","N","2017-01-12","201701120EDM"
"LAK",0,2,3,0,0,5,0,0,1,0,0,1,"H","N","2017-01-12","201701120LAK"
"STL",0,0,1,0,0,1,0,2,3,0,0,5,"A","N","2017-01-12","201701120LAK"
"MIN",0,1,3,3,0,7,0,0,0,1,0,1,"H","N","2017-01-12","201701120MIN"
"MTL",0,0,0,1,0,1,0,1,3,3,0,7,"A","N","2017-01-12","201701120MIN"
"BOS",0,0,1,0,0,1,0,0,2,0,0,2,"A","N","2017-01-12","201701120NSH"
"NSH",0,0,2,0,0,2,0,0,1,0,0,1,"H","N","2017-01-12","201701120NSH"
"OTT",0,2,1,1,0,4,0,0,1,0,0,1,"H","N","2017-01-12","201701120OTT"
"PIT",0,0,1,0,0,1,0,2,1,1,0,4,"A","N","2017-01-12","201701120OTT"
"PHI",0,1,2,1,1,5,0,1,3,0,0,4,"H","Y","2017-01-12","201701120PHI"
"VAN",0,1,3,0,0,4,0,1,2,1,1,5,"A","Y","2017-01-12","201701120PHI"
"BUF",0,1,0,1,0,2,0,1,2,1,0,4,"A","N","2017-01-12","201701120TBL"
"TBL",0,1,2,1,0,4,0,1,0,1,0,2,"H","N","2017-01-12","201701120TBL"
"ARI",0,4,0,0,0,4,0,1,0,2,0,3,"H","N","2017-01-13","201701130ARI"
"WPG",0,1,0,2,0,3,0,4,0,0,0,4,"A","N","2017-01-13","201701130ARI"
"BUF",0,1,1,0,0,2,0,0,3,2,0,5,"A","N","2017-01-13","201701130CAR"
"CAR",0,0,3,2,0,5,0,1,1,0,0,2,"H","N","2017-01-13","201701130CAR"
"CGY",0,0,1,0,0,1,0,2,0,0,0,2,"H","N","2017-01-13","201701130CGY"
"NJD",0,2,0,0,0,2,0,0,1,0,0,1,"A","N","2017-01-13","201701130CGY"
"FLA",0,1,0,1,0,2,0,2,1,2,0,5,"H","N","2017-01-13","201701130FLA"
"NYI",0,2,1,2,0,5,0,1,0,1,0,2,"A","N","2017-01-13","201701130FLA"
"NYR",0,0,1,1,0,2,0,2,1,1,0,4,"H","N","2017-01-13","201701130NYR"
"TOR",0,2,1,1,0,4,0,0,1,1,0,2,"A","N","2017-01-13","201701130NYR"
"CBJ",0,0,1,2,0,3,0,1,0,0,0,1,"A","N","2017-01-13","201701130TBL"
"TBL",0,1,0,0,0,1,0,0,1,2,0,3,"H","N","2017-01-13","201701130TBL"
"CHI",0,0,0,0,0,0,0,3,1,2,0,6,"A","N","2017-01-13","201701130WSH"
"WSH",0,3,1,2,0,6,0,0,0,0,0,0,"H","N","2017-01-13","201701130WSH"
"ANA",0,1,0,2,0,3,0,0,0,0,0,0,"A","N","2017-01-14","201701140ARI"
"ARI",0,0,0,0,0,0,0,1,0,2,0,3,"H","N","2017-01-14","201701140ARI"
"BOS",0,1,4,1,0,6,0,1,2,0,0,3,"H","N","2017-01-14","201701140BOS"
"PHI",0,1,2,0,0,3,0,1,4,1,0,6,"A","N","2017-01-14","201701140BOS"
"CAR",0,1,3,3,0,7,0,2,1,1,0,4,"H","N","2017-01-14","201701140CAR"
"NYI",0,2,1,1,0,4,0,1,3,3,0,7,"A","N","2017-01-14","201701140CAR"
"COL",0,1,1,0,0,2,0,0,1,2,0,3,"H","N","2017-01-14","201701140COL"
"NSH",0,0,1,2,0,3,0,1,1,0,0,2,"A","N","2017-01-14","201701140COL"
"DAL",0,1,2,1,0,4,0,4,0,1,0,5,"H","N","2017-01-14","201701140DAL"
"MIN",0,4,0,1,0,5,0,1,2,1,0,4,"A","N","2017-01-14","201701140DAL"
"DET",0,0,3,3,0,6,0,1,2,0,0,3,"H","N","2017-01-14","201701140DET"
"PIT",0,1,2,0,0,3,0,0,3,3,0,6,"A","N","2017-01-14","201701140DET"
"CGY",0,0,1,0,0,1,0,0,1,0,1,2,"A","Y","2017-01-14","201701140EDM"
"EDM",0,0,1,0,1,2,0,0,1,0,0,1,"H","Y","2017-01-14","201701140EDM"
"CBJ",0,2,0,1,0,3,0,1,2,1,0,4,"A","N","2017-01-14","201701140FLA"
"FLA",0,1,2,1,0,4,0,2,0,1,0,3,"H","N","2017-01-14","201701140FLA"
"LAK",1,1,0,1,0,3,0,0,1,1,0,2,"H","N","2017-01-14","201701140LAK"
"WPG",0,0,1,1,0,2,1,1,0,1,0,3,"A","N","2017-01-14","201701140LAK"
"MTL",0,0,2,3,0,5,0,1,2,1,0,4,"H","N","2017-01-14","201701140MTL"
"NYR",0,1,2,1,0,4,0,0,2,3,0,5,"A","N","2017-01-14","201701140MTL"
"OTT",0,0,2,0,0,2,0,1,1,2,0,4,"H","N","2017-01-14","201701140OTT"
"TOR",0,1,1,2,0,4,0,0,2,0,0,2,"A","N","2017-01-14","201701140OTT"
"SJS",0,0,0,0,0,0,0,0,2,2,0,4,"H","N","2017-01-14","201701140SJS"
"STL",0,0,2,2,0,4,0,0,0,0,0,0,"A","N","2017-01-14","201701140SJS"
"ANA",0,0,0,1,0,1,1,0,1,0,0,2,"H","N","2017-01-15","201701150ANA"
"STL",1,0,1,0,0,2,0,0,0,1,0,1,"A","N","2017-01-15","201701150ANA"
"CHI",0,1,1,0,0,2,0,0,2,1,0,3,"H","N","2017-01-15","201701150CHI"
"MIN",0,0,2,1,0,3,0,1,1,0,0,2,"A","N","2017-01-15","201701150CHI"
"NJD",1,0,1,0,0,2,0,0,1,0,0,1,"A","N","2017-01-15","201701150VAN"
"VAN",0,0,1,0,0,1,1,0,1,0,0,2,"H","N","2017-01-15","201701150VAN"
"PHI",0,0,0,0,0,0,0,0,1,4,0,5,"A","N","2017-01-15","201701150WSH"
"WSH",0,0,1,4,0,5,0,0,0,0,0,0,"H","N","2017-01-15","201701150WSH"
"BOS",0,0,0,0,0,0,0,0,3,1,0,4,"H","N","2017-01-16","201701160BOS"
"NYI",0,0,3,1,0,4,0,0,0,0,0,0,"A","N","2017-01-16","201701160BOS"
"BUF",0,2,1,1,0,4,0,1,0,0,0,1,"H","N","2017-01-16","201701160BUF"
"DAL",0,1,0,0,0,1,0,2,1,1,0,4,"A","N","2017-01-16","201701160BUF"
"DET",0,0,1,0,0,1,0,0,0,0,0,0,"H","N","2017-01-16","201701160DET"
"MTL",0,0,0,0,0,0,0,0,1,0,0,1,"A","N","2017-01-16","201701160DET"
"ARI",0,0,1,0,0,1,0,1,2,0,0,3,"A","N","2017-01-16","201701160EDM"
"EDM",0,1,2,0,0,3,0,0,1,0,0,1,"H","N","2017-01-16","201701160EDM"
"LAK",0,1,0,0,0,1,0,1,1,0,0,2,"H","N","2017-01-16","201701160LAK"
"TBL",0,1,1,0,0,2,0,1,0,0,0,1,"A","N","2017-01-16","201701160LAK"
"PIT",1,0,6,1,0,8,0,2,3,2,0,7,"H","N","2017-01-16","201701160PIT"
"WSH",0,2,3,2,0,7,1,0,6,1,0,8,"A","N","2017-01-16","201701160PIT"
"SJS",0,1,2,2,0,5,0,0,0,2,0,2,"H","N","2017-01-16","201701160SJS"
"WPG",0,0,0,2,0,2,0,1,2,2,0,5,"A","N","2017-01-16","201701160SJS"
"ANA",1,0,1,0,0,2,0,0,1,0,0,1,"H","N","2017-01-17","201701170ANA"
"TBL",0,0,1,0,0,1,1,0,1,0,0,2,"A","N","2017-01-17","201701170ANA"
"CAR",0,1,0,0,0,1,0,2,2,0,0,4,"A","N","2017-01-17","201701170CBJ"
"CBJ",0,2,2,0,0,4,0,1,0,0,0,1,"H","N","2017-01-17","201701170CBJ"
"CGY",0,1,3,1,0,5,0,2,0,0,0,2,"H","N","2017-01-17","201701170CGY"
"FLA",0,2,0,0,0,2,0,1,3,1,0,5,"A","N","2017-01-17","201701170CGY"
"CHI",0,2,1,3,0,6,0,1,3,0,0,4,"A","N","2017-01-17","201701170COL"
"COL",0,1,3,0,0,4,0,2,1,3,0,6,"H","N","2017-01-17","201701170COL"
"MIN",0,1,1,1,0,3,0,0,1,3,0,4,"H","N","2017-01-17","201701170MIN"
"NJD",0,0,1,3,0,4,0,1,1,1,0,3,"A","N","2017-01-17","201701170MIN"
"DAL",0,3,4,0,0,7,0,1,2,3,0,6,"A","N","2017-01-17","201701170NYR"
"NYR",0,1,2,3,0,6,0,3,4,0,0,7,"H","N","2017-01-17","201701170NYR"
"OTT",0,1,2,3,0,6,0,1,1,2,0,4,"A","N","2017-01-17","201701170STL"
"STL",0,1,1,2,0,4,0,1,2,3,0,6,"H","N","2017-01-17","201701170STL"
"BUF",0,2,0,1,0,3,0,0,3,1,0,4,"A","N","2017-01-17","201701170TOR"
"TOR",0,0,3,1,0,4,0,2,0,1,0,3,"H","N","2017-01-17","201701170TOR"
"NSH",0,0,0,0,0,0,0,0,0,1,0,1,"A","N","2017-01-17","201701170VAN"
"VAN",0,0,0,1,0,1,0,0,0,0,0,0,"H","N","2017-01-17","201701170VAN"
"BOS",0,4,1,0,0,5,0,1,3,1,1,6,"A","Y","2017-01-18","201701180DET"
"DET",0,1,3,1,1,6,0,4,1,0,0,5,"H","Y","2017-01-18","201701180DET"
"EDM",1,2,0,1,0,4,0,1,1,1,0,3,"H","N","2017-01-18","201701180EDM"
"FLA",0,1,1,1,0,3,1,2,0,1,0,4,"A","N","2017-01-18","201701180EDM"
"LAK",0,1,1,0,0,2,0,2,1,0,0,3,"H","N","2017-01-18","201701180LAK"
"SJS",0,2,1,0,0,3,0,1,1,0,0,2,"A","N","2017-01-18","201701180LAK"
"MTL",0,0,1,0,0,1,0,1,2,1,0,4,"H","N","2017-01-18","201701180MTL"
"PIT",0,1,2,1,0,4,0,0,1,0,0,1,"A","N","2017-01-18","201701180MTL"
"ARI",0,2,0,1,0,3,0,1,3,2,0,6,"A","N","2017-01-18","201701180WPG"
"WPG",0,1,3,2,0,6,0,2,0,1,0,3,"H","N","2017-01-18","201701180WPG"
"ANA",0,0,0,2,0,2,0,0,1,0,0,1,"H","N","2017-01-19","201701190ANA"
"COL",0,0,1,0,0,1,0,0,0,2,0,2,"A","N","2017-01-19","201701190ANA"
"CBJ",0,0,0,0,0,0,0,1,1,0,0,2,"H","N","2017-01-19","201701190CBJ"
"OTT",0,1,1,0,0,2,0,0,0,0,0,0,"A","N","2017-01-19","201701190CBJ"
"CGY",0,0,0,3,0,3,0,1,2,1,0,4,"H","N","2017-01-19","201701190CGY"
"NSH",0,1,2,1,0,4,0,0,0,3,0,3,"A","N","2017-01-19","201701190CGY"
"ARI",0,1,2,0,0,3,0,2,1,1,0,4,"A","N","2017-01-19","201701190MIN"
"MIN",0,2,1,1,0,4,0,1,2,0,0,3,"H","N","2017-01-19","201701190MIN"
"DAL",0,0,0,0,0,0,0,1,0,2,0,3,"A","N","2017-01-19","201701190NYI"
"NYI",0,1,0,2,0,3,0,0,0,0,0,0,"H","N","2017-01-19","201701190NYI"
"SJS",0,0,1,1,0,2,0,0,1,0,0,1,"H","N","2017-01-19","201701190SJS"
"TBL",0,0,1,0,0,1,0,0,1,1,0,2,"A","N","2017-01-19","201701190SJS"
"STL",0,0,1,2,0,3,0,2,4,1,0,7,"H","N","2017-01-19","201701190STL"
"WSH",0,2,4,1,0,7,0,0,1,2,0,3,"A","N","2017-01-19","201701190STL"
"NYR",0,2,1,2,0,5,0,1,1,0,0,2,"A","N","2017-01-19","201701190TOR"
"TOR",0,1,1,0,0,2,0,2,1,2,0,5,"H","N","2017-01-19","201701190TOR"
"BOS",0,0,0,0,0,0,0,0,0,1,0,1,"H","N","2017-01-20","201701200BOS"
"CHI",0,0,0,1,0,1,0,0,0,0,0,0,"A","N","2017-01-20","201701200BOS"
"BUF",1,0,1,1,0,3,0,1,0,1,0,2,"H","N","2017-01-20","201701200BUF"
"DET",0,1,0,1,0,2,1,0,1,1,0,3,"A","N","2017-01-20","201701200BUF"
"CAR",0,0,0,1,0,1,0,1,4,2,0,7,"H","N","2017-01-20","201701200CAR"
"PIT",0,1,4,2,0,7,0,0,0,1,0,1,"A","N","2017-01-20","201701200CAR"
"EDM",0,0,1,1,0,2,0,0,1,1,1,3,"H","Y","2017-01-20","201701200EDM"
"NSH",0,0,1,1,1,3,0,0,1,1,0,2,"A","Y","2017-01-20","201701200EDM"
"MTL",0,1,0,2,0,3,0,1,0,0,0,1,"A","N","2017-01-20","201701200NJD"
"NJD",0,1,0,0,0,1,0,1,0,2,0,3,"H","N","2017-01-20","201701200NJD"
"FLA",0,0,1,0,0,1,0,0,1,1,0,2,"A","N","2017-01-20","201701200VAN"
"VAN",0,0,1,1,0,2,0,0,1,0,0,1,"H","N","2017-01-20","201701200VAN"
"ARI",0,2,3,0,0,5,0,1,0,2,0,3,"H","N","2017-01-21","201701210ARI"
"TBL",0,1,0,2,0,3,0,2,3,0,0,5,"A","N","2017-01-21","201701210ARI"
"CAR",0,0,2,0,0,2,0,2,0,1,0,3,"A","N","2017-01-21","201701210CBJ"
"CBJ",0,2,0,1,0,3,0,0,2,0,0,2,"H","N","2017-01-21","201701210CBJ"
"CGY",0,0,1,2,0,3,0,3,3,1,0,7,"H","N","2017-01-21","201701210CGY"
"EDM",0,3,3,1,0,7,0,0,1,2,0,3,"A","N","2017-01-21","201701210CGY"
"DAL",0,1,2,0,0,3,1,1,0,2,0,4,"H","N","2017-01-21","201701210DAL"
"WSH",1,1,0,2,0,4,0,1,2,0,0,3,"A","N","2017-01-21","201701210DAL"
"ANA",0,2,1,0,0,3,0,1,1,3,0,5,"A","N","2017-01-21","201701210MIN"
"MIN",0,1,1,3,0,5,0,2,1,0,0,3,"H","N","2017-01-21","201701210MIN"
"BUF",1,0,1,1,0,3,0,0,2,0,0,2,"A","N","2017-01-21","201701210MTL"
"MTL",0,0,2,0,0,2,1,0,1,1,0,3,"H","N","2017-01-21","201701210MTL"
"LAK",0,0,0,2,0,2,0,1,1,2,0,4,"A","N","2017-01-21","201701210NYI"
"NYI",0,1,1,2,0,4,0,0,0,2,0,2,"H","N","2017-01-21","201701210NYI"
"NJD",0,1,2,1,0,4,0,1,0,0,0,1,"A","N","2017-01-21","201701210PHI"
"PHI",0,1,0,0,0,1,0,1,2,1,0,4,"H","N","2017-01-21","201701210PHI"
"COL",0,0,1,1,0,2,1,1,1,0,0,3,"A","N","2017-01-21","201701210SJS"
"SJS",1,1,1,0,0,3,0,0,1,1,0,2,"H","N","2017-01-21","201701210SJS"
"OTT",0,1,0,1,1,3,0,0,1,1,0,2,"A","Y","2017-01-21","201701210TOR"
"TOR",0,0,1,1,0,2,0,1,0,1,1,3,"H","Y","2017-01-21","201701210TOR"
"STL",0,1,0,2,0,3,0,1,1,3,0,5,"A","N","2017-01-21","201701210WPG"
"WPG",0,1,1,3,0,5,0,1,0,2,0,3,"H","N","2017-01-21","201701210WPG"
"CHI",0,2,0,2,0,4,0,0,0,2,0,2,"H","N","2017-01-22","201701220CHI"
"VAN",0,0,0,2,0,2,0,2,0,2,0,4,"A","N","2017-01-22","201701220CHI"
"DET",0,0,0,0,0,0,1,0,0,0,0,1,"H","N","2017-01-22","201701220DET"
"NYR",1,0,0,0,0,1,0,0,0,0,0,0,"A","N","2017-01-22","201701220DET"
"MIN",0,2,0,0,0,2,0,0,1,3,0,4,"H","N","2017-01-22","201701220MIN"
"NSH",0,0,1,3,0,4,0,2,0,0,0,2,"A","N","2017-01-22","201701220MIN"
"NYI",0,1,1,0,0,2,1,0,1,1,0,3,"H","N","2017-01-22","201701220NYI"
"PHI",1,0,1,1,0,3,0,1,1,0,0,2,"A","N","2017-01-22","201701220NYI"
"CBJ",1,2,1,3,0,7,0,2,3,1,0,6,"A","N","2017-01-22","201701220OTT"
"OTT",0,2,3,1,0,6,1,2,1,3,0,7,"H","N","2017-01-22","201701220OTT"
"BOS",0,0,1,0,0,1,0,0,2,3,0,5,"A","N","2017-01-22","201701220PIT"
"PIT",0,0,2,3,0,5,0,0,1,0,0,1,"H","N","2017-01-22","201701220PIT"
"ARI",1,0,2,0,0,3,0,1,1,0,0,2,"H","N","2017-01-23","201701230ARI"
"FLA",0,1,1,0,0,2,1,0,2,0,0,3,"A","N","2017-01-23","201701230ARI"
"COL",0,0,1,1,0,2,0,1,0,4,0,5,"H","N","2017-01-23","201701230COL"
"SJS",0,1,0,4,0,5,0,0,1,1,0,2,"A","N","2017-01-23","201701230COL"
"LAK",0,0,1,1,0,2,0,1,1,1,0,3,"A","N","2017-01-23","201701230NYR"
"NYR",0,1,1,1,0,3,0,0,1,1,0,2,"H","N","2017-01-23","201701230NYR"
"CGY",0,0,0,0,0,0,0,1,2,1,0,4,"A","N","2017-01-23","201701230TOR"
"TOR",0,1,2,1,0,4,0,0,0,0,0,0,"H","N","2017-01-23","201701230TOR"
"ANA",0,2,0,1,0,3,0,1,0,1,0,2,"A","N","2017-01-23","201701230WPG"
"WPG",0,1,0,1,0,2,0,2,0,1,0,3,"H","N","2017-01-23","201701230WPG"
"CAR",0,1,0,0,0,1,0,2,2,2,0,6,"A","N","2017-01-23","201701230WSH"
"WSH",0,2,2,2,0,6,0,1,0,0,0,1,"H","N","2017-01-23","201701230WSH"
"BOS",1,2,0,1,0,4,0,1,2,0,0,3,"H","N","2017-01-24","201701240BOS"
"DET",0,1,2,0,0,3,1,2,0,1,0,4,"A","N","2017-01-24","201701240BOS"
"CHI",0,1,1,0,0,2,0,1,0,4,0,5,"H","N","2017-01-24","201701240CHI"
"TBL",0,1,0,4,0,5,0,1,1,0,0,2,"A","N","2017-01-24","201701240CHI"
"DAL",0,0,2,0,0,2,0,1,1,0,1,3,"H","Y","2017-01-24","201701240DAL"
"MIN",0,1,1,0,1,3,0,0,2,0,0,2,"A","Y","2017-01-24","201701240DAL"
"CGY",0,0,0,1,0,1,0,1,2,2,0,5,"A","N","2017-01-24","201701240MTL"
"MTL",0,1,2,2,0,5,0,0,0,1,0,1,"H","N","2017-01-24","201701240MTL"
"LAK",0,3,0,0,0,3,0,0,0,1,0,1,"A","N","2017-01-24","201701240NJD"
"NJD",0,0,0,1,0,1,0,3,0,0,0,3,"H","N","2017-01-24","201701240NJD"
"BUF",1,0,2,2,0,5,0,1,1,2,0,4,"A","N","2017-01-24","201701240NSH"
"NSH",0,1,1,2,0,4,1,0,2,2,0,5,"H","N","2017-01-24","201701240NSH"
"CBJ",0,1,0,1,0,2,0,0,2,2,0,4,"A","N","2017-01-24","201701240NYI"
"NYI",0,0,2,2,0,4,0,1,0,1,0,2,"H","N","2017-01-24","201701240NYI"
"OTT",0,2,1,0,0,3,0,0,0,0,0,0,"H","N","2017-01-24","201701240OTT"
"WSH",0,0,0,0,0,0,0,2,1,0,0,3,"A","N","2017-01-24","201701240OTT"
"PIT",0,0,0,0,0,0,0,1,1,1,0,3,"H","N","2017-01-24","201701240PIT"
"STL",0,1,1,1,0,3,0,0,0,0,0,0,"A","N","2017-01-24","201701240PIT"
"SJS",0,1,1,2,0,4,0,1,1,1,0,3,"A","N","2017-01-24","201701240WPG"
"WPG",0,1,1,1,0,3,0,1,1,2,0,4,"H","N","2017-01-24","201701240WPG"
"ANA",0,0,0,0,0,0,0,0,3,1,0,4,"H","N","2017-01-25","201701250ANA"
"EDM",0,0,3,1,0,4,0,0,0,0,0,0,"A","N","2017-01-25","201701250ANA"
"COL",0,0,1,1,0,2,0,1,1,1,0,3,"H","N","2017-01-25","201701250COL"
"VAN",0,1,1,1,0,3,0,0,1,1,0,2,"A","N","2017-01-25","201701250COL"
"DET",0,0,0,0,0,0,0,1,1,2,0,4,"H","N","2017-01-25","201701250DET"
"TOR",0,1,1,2,0,4,0,0,0,0,0,0,"A","N","2017-01-25","201701250DET"
"NYR",0,0,0,0,0,0,0,0,0,2,0,2,"H","N","2017-01-25","201701250NYR"
"PHI",0,0,0,2,0,2,0,0,0,0,0,0,"A","N","2017-01-25","201701250NYR"
"ARI",0,0,1,2,0,3,0,0,0,0,0,0,"H","N","2017-01-26","201701260ARI"
"VAN",0,0,0,0,0,0,0,0,1,2,0,3,"A","N","2017-01-26","201701260ARI"
"BOS",0,0,3,1,0,4,0,2,0,1,0,3,"H","N","2017-01-26","201701260BOS"
"PIT",0,2,0,1,0,3,0,0,3,1,0,4,"A","N","2017-01-26","201701260BOS"
"CAR",0,0,0,0,0,0,0,0,0,3,0,3,"H","N","2017-01-26","201701260CAR"
"LAK",0,0,0,3,0,3,0,0,0,0,0,0,"A","N","2017-01-26","201701260CAR"
"CHI",0,1,2,0,0,3,0,2,0,3,0,5,"H","N","2017-01-26","201701260CHI"
"WPG",0,2,0,3,0,5,0,1,2,0,0,3,"A","N","2017-01-26","201701260CHI"
"BUF",0,2,1,0,0,3,0,1,3,0,0,4,"A","N","2017-01-26","201701260DAL"
"DAL",0,1,3,0,0,4,0,2,1,0,0,3,"H","N","2017-01-26","201701260DAL"
"FLA",1,1,0,0,0,2,0,1,0,0,0,1,"H","N","2017-01-26","201701260FLA"
"TBL",0,1,0,0,0,1,1,1,0,0,0,2,"A","N","2017-01-26","201701260FLA"
"MIN",0,0,3,2,0,5,0,0,1,0,0,1,"H","N","2017-01-26","201701260MIN"
"STL",0,0,1,0,0,1,0,0,3,2,0,5,"A","N","2017-01-26","201701260MIN"
"NJD",0,0,2,0,0,2,0,2,2,1,0,5,"H","N","2017-01-26","201701260NJD"
"WSH",0,2,2,1,0,5,0,0,2,0,0,2,"A","N","2017-01-26","201701260NJD"
"CBJ",0,1,0,2,0,3,0,0,2,2,0,4,"A","N","2017-01-26","201701260NSH"
"NSH",0,0,2,2,0,4,0,1,0,2,0,3,"H","N","2017-01-26","201701260NSH"
"MTL",0,0,1,0,0,1,0,1,0,2,0,3,"A","N","2017-01-26","201701260NYI"
"NYI",0,1,0,2,0,3,0,0,1,0,0,1,"H","N","2017-01-26","201701260NYI"
"CGY",1,0,2,0,0,3,0,0,0,2,0,2,"A","N","2017-01-26","201701260OTT"
"OTT",0,0,0,2,0,2,1,0,2,0,0,3,"H","N","2017-01-26","201701260OTT"
"PHI",0,1,0,1,0,2,0,0,1,0,0,1,"H","N","2017-01-26","201701260PHI"
"TOR",0,0,1,0,0,1,0,1,0,1,0,2,"A","N","2017-01-26","201701260PHI"
"EDM",0,1,1,2,0,4,0,1,0,0,0,1,"A","N","2017-01-26","201701260SJS"
"SJS",0,1,0,0,0,1,0,1,1,2,0,4,"H","N","2017-01-26","201701260SJS"
"ANA",0,1,1,3,0,5,0,0,1,0,0,1,"H","N","2017-01-31","201701310ANA"
"COL",0,0,1,0,0,1,0,1,1,3,0,5,"A","N","2017-01-31","201701310ANA"
"ARI",0,1,1,0,0,2,0,1,1,1,0,3,"H","N","2017-01-31","201701310ARI"
"LAK",0,1,1,1,0,3,0,1,1,0,0,2,"A","N","2017-01-31","201701310ARI"
"CAR",0,2,2,1,0,5,0,0,0,1,0,1,"H","N","2017-01-31","201701310CAR"
"PHI",0,0,0,1,0,1,0,2,2,1,0,5,"A","N","2017-01-31","201701310CAR"
"DAL",0,5,1,0,0,6,0,1,2,0,0,3,"H","N","2017-01-31","201701310DAL"
"TOR",0,1,2,0,0,3,0,5,1,0,0,6,"A","N","2017-01-31","201701310DAL"
"DET",0,0,1,2,0,3,0,2,1,1,0,4,"H","N","2017-01-31","201701310DET"
"NJD",0,2,1,1,0,4,0,0,1,2,0,3,"A","N","2017-01-31","201701310DET"
"EDM",0,0,2,0,0,2,0,2,2,1,0,5,"H","N","2017-01-31","201701310EDM"
"MIN",0,2,2,1,0,5,0,0,2,0,0,2,"A","N","2017-01-31","201701310EDM"
"FLA",0,2,2,2,0,6,0,3,1,1,0,5,"H","N","2017-01-31","201701310FLA"
"OTT",0,3,1,1,0,5,0,2,2,2,0,6,"A","N","2017-01-31","201701310FLA"
"BUF",0,0,0,2,0,2,0,1,3,1,0,5,"A","N","2017-01-31","201701310MTL"
"MTL",0,1,3,1,0,5,0,0,0,2,0,2,"H","N","2017-01-31","201701310MTL"
"NYI",0,0,1,2,0,3,0,1,0,1,0,2,"H","N","2017-01-31","201701310NYI"
"WSH",0,1,0,1,0,2,0,0,1,2,0,3,"A","N","2017-01-31","201701310NYI"
"CBJ",0,1,4,1,0,6,0,0,0,4,0,4,"A","N","2017-01-31","201701310NYR"
"NYR",0,0,0,4,0,4,0,1,4,1,0,6,"H","N","2017-01-31","201701310NYR"
"NSH",0,1,0,1,0,2,0,1,3,0,0,4,"A","N","2017-01-31","201701310PIT"
"PIT",0,1,3,0,0,4,0,1,0,1,0,2,"H","N","2017-01-31","201701310PIT"
"CHI",0,0,1,0,0,1,0,0,1,2,0,3,"A","N","2017-01-31","201701310SJS"
"SJS",0,0,1,2,0,3,0,0,1,0,0,1,"H","N","2017-01-31","201701310SJS"
"STL",0,1,1,1,0,3,0,1,2,2,0,5,"H","N","2017-01-31","201701310STL"
"WPG",0,1,2,2,0,5,0,1,1,1,0,3,"A","N","2017-01-31","201701310STL"
"BOS",0,0,2,2,0,4,0,0,1,2,0,3,"A","N","2017-01-31","201701310TBL"
"TBL",0,0,1,2,0,3,0,0,2,2,0,4,"H","N","2017-01-31","201701310TBL"
"CGY",0,2,0,3,0,5,0,0,1,0,0,1,"H","N","2017-02-01","201702010CGY"
"MIN",0,0,1,0,0,1,0,2,0,3,0,5,"A","N","2017-02-01","201702010CGY"
"COL",0,0,0,0,0,0,0,3,0,2,0,5,"A","N","2017-02-01","201702010LAK"
"LAK",0,3,0,2,0,5,0,0,0,0,0,0,"H","N","2017-02-01","201702010LAK"
"BOS",0,1,1,1,0,3,0,2,1,2,0,5,"A","N","2017-02-01","201702010WSH"
"WSH",0,2,1,2,0,5,0,1,1,1,0,3,"H","N","2017-02-01","201702010WSH"
"ARI",0,0,3,0,0,3,0,3,1,0,0,4,"H","N","2017-02-02","201702020ARI"
"CHI",0,3,1,0,0,4,0,0,3,0,0,3,"A","N","2017-02-02","201702020ARI"
"BUF",0,0,0,1,0,1,1,0,1,0,0,2,"H","N","2017-02-02","201702020BUF"
"NYR",1,0,1,0,0,2,0,0,0,1,0,1,"A","N","2017-02-02","201702020BUF"
"DAL",0,2,1,0,0,3,0,2,2,0,0,4,"H","N","2017-02-02","201702020DAL"
"WPG",0,2,2,0,0,4,0,2,1,0,0,3,"A","N","2017-02-02","201702020DAL"
"EDM",0,0,0,0,0,0,0,0,2,0,0,2,"A","N","2017-02-02","201702020NSH"
"NSH",0,0,2,0,0,2,0,0,0,0,0,0,"H","N","2017-02-02","201702020NSH"
"MTL",0,1,0,0,0,1,0,0,1,2,0,3,"A","N","2017-02-02","201702020PHI"
"PHI",0,0,1,2,0,3,0,1,0,0,0,1,"H","N","2017-02-02","201702020PHI"
"STL",0,1,3,1,0,5,0,1,0,0,0,1,"H","N","2017-02-02","201702020STL"
"TOR",0,1,0,0,0,1,0,1,3,1,0,5,"A","N","2017-02-02","201702020STL"
"OTT",0,0,2,3,0,5,0,0,1,1,0,2,"A","N","2017-02-02","201702020TBL"
"TBL",0,0,1,1,0,2,0,0,2,3,0,5,"H","N","2017-02-02","201702020TBL"
"SJS",0,2,0,2,0,4,0,0,0,1,0,1,"A","N","2017-02-02","201702020VAN"
"VAN",0,0,0,1,0,1,0,2,0,2,0,4,"H","N","2017-02-02","201702020VAN"
"CAR",0,1,0,1,0,2,0,0,1,0,0,1,"H","N","2017-02-03","201702030CAR"
"EDM",0,0,1,0,0,1,0,1,0,1,0,2,"A","N","2017-02-03","201702030CAR"
"DET",0,1,3,1,0,5,0,2,1,1,0,4,"H","N","2017-02-03","201702030DET"
"NYI",0,2,1,1,0,4,0,1,3,1,0,5,"A","N","2017-02-03","201702030DET"
"ANA",0,1,0,0,0,1,0,1,1,0,0,2,"A","N","2017-02-03","201702030FLA"
"FLA",0,1,1,0,0,2,0,1,0,0,0,1,"H","N","2017-02-03","201702030FLA"
"CGY",1,1,1,1,0,4,0,0,3,0,0,3,"A","N","2017-02-03","201702030NJD"
"NJD",0,0,3,0,0,3,1,1,1,1,0,4,"H","N","2017-02-03","201702030NJD"
"CBJ",0,0,1,2,0,3,1,2,1,0,0,4,"A","N","2017-02-03","201702030PIT"
"PIT",1,2,1,0,0,4,0,0,1,2,0,3,"H","N","2017-02-03","201702030PIT"
"BOS",0,1,2,2,0,5,0,1,3,2,0,6,"H","N","2017-02-04","201702040BOS"
"TOR",0,1,3,2,0,6,0,1,2,2,0,5,"A","N","2017-02-04","201702040BOS"
"BUF",0,1,1,2,0,4,0,0,0,0,0,0,"H","N","2017-02-04","201702040BUF"
"OTT",0,0,0,0,0,0,0,1,1,2,0,4,"A","N","2017-02-04","201702040BUF"
"CBJ",0,0,0,1,0,1,0,1,2,2,0,5,"H","N","2017-02-04","201702040CBJ"
"NJD",0,1,2,2,0,5,0,0,0,1,0,1,"A","N","2017-02-04","201702040CBJ"
"COL",0,2,1,2,0,5,0,1,1,0,0,2,"H","N","2017-02-04","201702040COL"
"WPG",0,1,1,0,0,2,0,2,1,2,0,5,"A","N","2017-02-04","201702040COL"
"CHI",0,0,2,3,0,5,0,0,1,2,0,3,"A","N","2017-02-04","201702040DAL"
"DAL",0,0,1,2,0,3,0,0,2,3,0,5,"H","N","2017-02-04","201702040DAL"
"MTL",0,1,0,1,0,2,0,1,1,1,0,3,"H","N","2017-02-04","201702040MTL"
"WSH",0,1,1,1,0,3,0,1,0,1,0,2,"A","N","2017-02-04","201702040MTL"
"DET",0,1,0,0,0,1,0,0,0,0,0,0,"A","N","2017-02-04","201702040NSH"
"NSH",0,0,0,0,0,0,0,1,0,0,0,1,"H","N","2017-02-04","201702040NSH"
"CAR",1,1,3,0,0,5,0,1,2,1,0,4,"A","N","2017-02-04","201702040NYI"
"NYI",0,1,2,1,0,4,1,1,3,0,0,5,"H","N","2017-02-04","201702040NYI"
"LAK",1,0,0,0,0,1,0,0,0,0,0,0,"A","N","2017-02-04","201702040PHI"
"PHI",0,0,0,0,0,0,1,0,0,0,0,1,"H","N","2017-02-04","201702040PHI"
"ARI",0,0,1,1,1,3,0,0,1,1,0,2,"A","Y","2017-02-04","201702040SJS"
"SJS",0,0,1,1,0,2,0,0,1,1,1,3,"H","Y","2017-02-04","201702040SJS"
"PIT",0,1,2,1,0,4,0,0,0,1,0,1,"A","N","2017-02-04","201702040STL"
"STL",0,0,0,1,0,1,0,1,2,1,0,4,"H","N","2017-02-04","201702040STL"
"ANA",0,1,0,1,0,2,0,1,1,0,1,3,"A","Y","2017-02-04","201702040TBL"
"TBL",0,1,1,0,1,3,0,1,0,1,0,2,"H","Y","2017-02-04","201702040TBL"
"MIN",0,2,3,1,0,6,0,1,2,0,0,3,"A","N","2017-02-04","201702040VAN"
"VAN",0,1,2,0,0,3,0,2,3,1,0,6,"H","N","2017-02-04","201702040VAN"
"EDM",0,0,0,0,1,1,0,0,0,0,0,0,"A","Y","2017-02-05","201702050MTL"
"MTL",0,0,0,0,0,0,0,0,0,0,1,1,"H","Y","2017-02-05","201702050MTL"
"CGY",0,1,0,2,0,3,0,1,0,3,0,4,"A","N","2017-02-05","201702050NYR"
"NYR",0,1,0,3,0,4,0,1,0,2,0,3,"H","N","2017-02-05","201702050NYR"
"LAK",0,0,0,0,0,0,0,2,2,1,0,5,"A","N","2017-02-05","201702050WSH"
"WSH",0,2,2,1,0,5,0,0,0,0,0,0,"H","N","2017-02-05","201702050WSH"
"BUF",0,0,0,1,0,1,0,0,1,1,0,2,"A","N","2017-02-06","201702060NJD"
"NJD",0,0,1,1,0,2,0,0,0,1,0,1,"H","N","2017-02-06","201702060NJD"
"NYI",1,2,1,2,0,6,0,2,2,1,0,5,"H","N","2017-02-06","201702060NYI"
"TOR",0,2,2,1,0,5,1,2,1,2,0,6,"A","N","2017-02-06","201702060NYI"
"PHI",0,0,0,0,0,0,0,0,1,1,0,2,"H","N","2017-02-06","201702060PHI"
"STL",0,0,1,1,0,2,0,0,0,0,0,0,"A","N","2017-02-06","201702060PHI"
"BUF",1,1,0,3,0,5,0,2,1,1,0,4,"H","N","2017-02-07","201702070BUF"
"SJS",0,2,1,1,0,4,1,1,0,3,0,5,"A","N","2017-02-07","201702070BUF"
"COL",0,2,1,1,0,4,0,0,0,0,0,0,"H","N","2017-02-07","201702070COL"
"MTL",0,0,0,0,0,0,0,2,1,1,0,4,"A","N","2017-02-07","201702070COL"
"CBJ",1,2,0,0,0,3,0,1,1,0,0,2,"A","N","2017-02-07","201702070DET"
"DET",0,1,1,0,0,2,1,2,0,0,0,3,"H","N","2017-02-07","201702070DET"
"NSH",0,2,0,2,0,4,0,1,0,1,0,2,"H","N","2017-02-07","201702070NSH"
"VAN",0,1,0,1,0,2,0,2,0,2,0,4,"A","N","2017-02-07","201702070NSH"
"ANA",0,0,1,0,0,1,0,1,1,2,0,4,"A","N","2017-02-07","201702070NYR"
"NYR",0,1,1,2,0,4,0,0,1,0,0,1,"H","N","2017-02-07","201702070NYR"
"OTT",0,0,0,0,0,0,0,0,2,4,0,6,"H","N","2017-02-07","201702070OTT"
"STL",0,0,2,4,0,6,0,0,0,0,0,0,"A","N","2017-02-07","201702070OTT"
"CGY",0,0,2,0,1,3,0,0,0,2,0,2,"A","Y","2017-02-07","201702070PIT"
"PIT",0,0,0,2,0,2,0,0,2,0,1,3,"H","Y","2017-02-07","201702070PIT"
"LAK",0,0,0,0,0,0,0,1,3,1,0,5,"A","N","2017-02-07","201702070TBL"
"TBL",0,1,3,1,0,5,0,0,0,0,0,0,"H","N","2017-02-07","201702070TBL"
"DAL",0,0,0,1,0,1,0,1,1,1,0,3,"A","N","2017-02-07","201702070TOR"
"TOR",0,1,1,1,0,3,0,0,0,1,0,1,"H","N","2017-02-07","201702070TOR"
"MIN",0,2,1,1,0,4,0,0,2,0,0,2,"A","N","2017-02-07","201702070WPG"
"WPG",0,0,2,0,0,2,0,2,1,1,0,4,"H","N","2017-02-07","201702070WPG"
"CAR",0,0,0,0,0,0,0,2,0,3,0,5,"A","N","2017-02-07","201702070WSH"
"WSH",0,2,0,3,0,5,0,0,0,0,0,0,"H","N","2017-02-07","201702070WSH"
"CHI",1,1,2,0,0,4,0,0,2,1,0,3,"A","N","2017-02-08","201702080MIN"
"MIN",0,0,2,1,0,3,1,1,2,0,0,4,"H","N","2017-02-08","201702080MIN"
"ARI",0,0,3,1,0,4,1,2,0,2,0,5,"H","N","2017-02-09","201702090ARI"
"MTL",1,2,0,2,0,5,0,0,3,1,0,4,"A","N","2017-02-09","201702090ARI"
"BOS",0,3,2,1,0,6,0,1,1,1,0,3,"H","N","2017-02-09","201702090BOS"
"SJS",0,1,1,1,0,3,0,3,2,1,0,6,"A","N","2017-02-09","201702090BOS"
"ANA",0,1,0,4,0,5,0,0,1,1,0,2,"A","N","2017-02-09","201702090BUF"
"BUF",0,0,1,1,0,2,0,1,0,4,0,5,"H","N","2017-02-09","201702090BUF"
"CBJ",0,0,0,0,0,0,0,0,2,1,0,3,"H","N","2017-02-09","201702090CBJ"
"VAN",0,0,2,1,0,3,0,0,0,0,0,0,"A","N","2017-02-09","201702090CBJ"
"COL",0,0,0,1,0,1,0,1,2,1,0,4,"H","N","2017-02-09","201702090COL"
"PIT",0,1,2,1,0,4,0,0,0,1,0,1,"A","N","2017-02-09","201702090COL"
"FLA",0,1,0,2,0,3,0,3,3,0,0,6,"H","N","2017-02-09","201702090FLA"
"LAK",0,3,3,0,0,6,0,1,0,2,0,3,"A","N","2017-02-09","201702090FLA"
"NSH",0,1,1,1,0,3,0,0,2,2,0,4,"A","N","2017-02-09","201702090NYR"
"NYR",0,0,2,2,0,4,0,1,1,1,0,3,"H","N","2017-02-09","201702090NYR"
"DAL",0,0,2,0,0,2,0,2,0,1,0,3,"A","N","2017-02-09","201702090OTT"
"OTT",0,2,0,1,0,3,0,0,2,0,0,2,"H","N","2017-02-09","201702090OTT"
"NYI",0,1,1,1,0,3,0,1,0,0,0,1,"A","N","2017-02-09","201702090PHI"
"PHI",0,1,0,0,0,1,0,1,1,1,0,3,"H","N","2017-02-09","201702090PHI"
"STL",1,1,0,0,0,2,0,0,1,0,0,1,"A","N","2017-02-09","201702090TOR"
"TOR",0,0,1,0,0,1,1,1,0,0,0,2,"H","N","2017-02-09","201702090TOR"
"DET",0,2,0,1,0,3,0,2,1,3,0,6,"A","N","2017-02-09","201702090WSH"
"WSH",0,2,1,3,0,6,0,2,0,1,0,3,"H","N","2017-02-09","201702090WSH"
"MIN",0,0,1,0,1,2,0,0,1,0,0,1,"H","Y","2017-02-10","201702100MIN"
"TBL",0,0,1,0,0,1,0,0,1,0,1,2,"A","Y","2017-02-10","201702100MIN"
"CHI",0,1,1,3,0,5,0,0,1,1,0,2,"A","N","2017-02-10","201702100WPG"
"WPG",0,0,1,1,0,2,0,1,1,3,0,5,"H","N","2017-02-10","201702100WPG"
"ARI",1,0,2,1,0,4,0,0,1,2,0,3,"H","N","2017-02-11","201702110ARI"
"PIT",0,0,1,2,0,3,1,0,2,1,0,4,"A","N","2017-02-11","201702110ARI"
"BOS",0,2,0,2,0,4,0,1,1,1,0,3,"H","N","2017-02-11","201702110BOS"
"VAN",0,1,1,1,0,3,0,2,0,2,0,4,"A","N","2017-02-11","201702110BOS"
"CBJ",0,1,1,0,0,2,0,1,0,0,0,1,"H","N","2017-02-11","201702110CBJ"
"DET",0,1,0,0,0,1,0,1,1,0,0,2,"A","N","2017-02-11","201702110CBJ"
"CAR",0,0,1,1,0,2,0,3,1,1,0,5,"A","N","2017-02-11","201702110DAL"
"DAL",0,3,1,1,0,5,0,0,1,1,0,2,"H","N","2017-02-11","201702110DAL"
"CHI",0,2,2,1,0,5,0,1,0,0,0,1,"A","N","2017-02-11","201702110EDM"
"EDM",0,1,0,0,0,1,0,2,2,1,0,5,"H","N","2017-02-11","201702110EDM"
"MTL",0,1,1,0,0,2,0,1,2,1,0,4,"H","N","2017-02-11","201702110MTL"
"STL",0,1,2,1,0,4,0,1,1,0,0,2,"A","N","2017-02-11","201702110MTL"
"FLA",0,1,4,2,0,7,0,1,2,1,0,4,"A","N","2017-02-11","201702110NSH"
"NSH",0,1,2,1,0,4,0,1,4,2,0,7,"H","N","2017-02-11","201702110NSH"
"COL",0,1,1,0,0,2,0,1,0,3,0,4,"A","N","2017-02-11","201702110NYR"
"NYR",0,1,0,3,0,4,0,1,1,0,0,2,"H","N","2017-02-11","201702110NYR"
"NYI",0,0,0,0,0,0,0,1,2,0,0,3,"A","N","2017-02-11","201702110OTT"
"OTT",0,1,2,0,0,3,0,0,0,0,0,0,"H","N","2017-02-11","201702110OTT"
"PHI",1,0,0,1,0,2,0,0,0,1,0,1,"H","N","2017-02-11","201702110PHI"
"SJS",0,0,0,1,0,1,1,0,0,1,0,2,"A","N","2017-02-11","201702110PHI"
"BUF",0,3,0,0,0,3,0,0,1,0,0,1,"A","N","2017-02-11","201702110TOR"
"TOR",0,0,1,0,0,1,0,3,0,0,0,3,"H","N","2017-02-11","201702110TOR"
"TBL",0,2,1,1,0,4,0,0,0,1,0,1,"A","N","2017-02-11","201702110WPG"
"WPG",0,0,0,1,0,1,0,2,1,1,0,4,"H","N","2017-02-11","201702110WPG"
"ANA",0,0,2,2,0,4,0,3,1,2,0,6,"A","N","2017-02-11","201702110WSH"
"WSH",0,3,1,2,0,6,0,0,2,2,0,4,"H","N","2017-02-11","201702110WSH"
"BOS",0,1,2,1,0,4,0,0,0,0,0,0,"H","N","2017-02-12","201702120BOS"
"MTL",0,0,0,0,0,0,0,1,2,1,0,4,"A","N","2017-02-12","201702120BOS"
"BUF",0,2,0,0,0,2,0,2,2,0,0,4,"H","N","2017-02-12","201702120BUF"
"VAN",0,2,2,0,0,4,0,2,0,0,0,2,"A","N","2017-02-12","201702120BUF"
"DET",0,0,2,1,0,3,0,2,1,3,0,6,"A","N","2017-02-12","201702120MIN"
"MIN",0,2,1,3,0,6,0,0,2,1,0,3,"H","N","2017-02-12","201702120MIN"
"NJD",0,1,0,0,0,1,0,0,3,1,0,4,"H","N","2017-02-12","201702120NJD"
"SJS",0,0,3,1,0,4,0,1,0,0,0,1,"A","N","2017-02-12","201702120NJD"
"DAL",0,2,1,0,0,3,0,0,1,4,0,5,"A","N","2017-02-12","201702120NSH"
"NSH",0,0,1,4,0,5,0,2,1,0,0,3,"H","N","2017-02-12","201702120NSH"
"COL",0,1,0,0,0,1,0,1,1,3,0,5,"A","N","2017-02-12","201702120NYI"
"NYI",0,1,1,3,0,5,0,1,0,0,0,1,"H","N","2017-02-12","201702120NYI"
"CBJ",0,1,0,1,0,2,0,0,1,2,0,3,"H","N","2017-02-13","201702130CBJ"
"NYR",0,0,1,2,0,3,0,1,0,1,0,2,"A","N","2017-02-13","201702130CBJ"
"ARI",0,1,3,1,0,5,0,0,0,0,0,0,"A","N","2017-02-13","201702130CGY"
"CGY",0,0,0,0,0,0,0,1,3,1,0,5,"H","N","2017-02-13","201702130CGY"
"ARI",0,1,1,0,0,2,0,0,3,2,0,5,"A","N","2017-02-14","201702140EDM"
"EDM",0,0,3,2,0,5,0,1,1,0,0,2,"H","N","2017-02-14","201702140EDM"
"ANA",0,1,0,0,0,1,0,0,0,0,0,0,"A","N","2017-02-14","201702140MIN"
"MIN",0,0,0,0,0,0,0,1,0,0,0,1,"H","N","2017-02-14","201702140MIN"
"COL",0,0,2,0,0,2,0,1,2,0,0,3,"A","N","2017-02-14","201702140NJD"
"NJD",0,1,2,0,0,3,0,0,2,0,0,2,"H","N","2017-02-14","201702140NJD"
"BUF",0,1,0,2,0,3,0,1,1,0,0,2,"A","N","2017-02-14","201702140OTT"
"OTT",0,1,1,0,0,2,0,1,0,2,0,3,"H","N","2017-02-14","201702140OTT"
"PIT",0,0,1,3,0,4,0,0,0,0,0,0,"H","N","2017-02-14","201702140PIT"
"VAN",0,0,0,0,0,0,0,0,1,3,0,4,"A","N","2017-02-14","201702140PIT"
"NYI",0,0,1,0,0,1,0,2,1,4,0,7,"A","N","2017-02-14","201702140TOR"
"TOR",0,2,1,4,0,7,0,0,1,0,0,1,"H","N","2017-02-14","201702140TOR"
"DAL",0,0,2,0,0,2,0,1,1,3,0,5,"A","N","2017-02-14","201702140WPG"
"WPG",0,1,1,3,0,5,0,0,2,0,0,2,"H","N","2017-02-14","201702140WPG"
"CBJ",0,2,2,1,0,5,0,0,1,1,0,2,"H","N","2017-02-15","201702150CBJ"
"TOR",0,0,1,1,0,2,0,2,2,1,0,5,"A","N","2017-02-15","201702150CBJ"
"CGY",0,1,1,1,0,3,0,1,0,0,0,1,"H","N","2017-02-15","201702150CGY"
"PHI",0,1,0,0,0,1,0,1,1,1,0,3,"A","N","2017-02-15","201702150CGY"
"DET",0,0,0,0,0,0,0,1,0,1,0,2,"H","N","2017-02-15","201702150DET"
"STL",0,1,0,1,0,2,0,0,0,0,0,0,"A","N","2017-02-15","201702150DET"
"FLA",1,3,0,2,0,6,0,2,1,2,0,5,"A","N","2017-02-15","201702150SJS"
"SJS",0,2,1,2,0,5,1,3,0,2,0,6,"H","N","2017-02-15","201702150SJS"
"BUF",0,0,1,1,0,2,0,0,0,0,0,0,"H","N","2017-02-16","201702160BUF"
"COL",0,0,0,0,0,0,0,0,1,1,0,2,"A","N","2017-02-16","201702160BUF"
"EDM",0,2,3,1,0,6,0,0,2,1,0,3,"H","N","2017-02-16","201702160EDM"
"PHI",0,0,2,1,0,3,0,2,3,1,0,6,"A","N","2017-02-16","201702160EDM"
"ARI",0,2,0,3,0,5,0,0,0,3,0,3,"A","N","2017-02-16","201702160LAK"
"LAK",0,0,0,3,0,3,0,2,0,3,0,5,"H","N","2017-02-16","201702160LAK"
"DAL",0,0,0,1,0,1,0,1,1,1,0,3,"A","N","2017-02-16","201702160MIN"
"MIN",0,1,1,1,0,3,0,0,0,1,0,1,"H","N","2017-02-16","201702160MIN"
"NJD",0,0,0,0,0,0,0,0,1,2,0,3,"H","N","2017-02-16","201702160NJD"
"OTT",0,0,1,2,0,3,0,0,0,0,0,0,"A","N","2017-02-16","201702160NJD"
"NYI",0,0,2,2,0,4,0,1,0,1,0,2,"H","N","2017-02-16","201702160NYI"
"NYR",0,1,0,1,0,2,0,0,2,2,0,4,"A","N","2017-02-16","201702160NYI"
"PIT",1,2,0,1,0,4,0,0,1,2,0,3,"H","N","2017-02-16","201702160PIT"
"WPG",0,0,1,2,0,3,1,2,0,1,0,4,"A","N","2017-02-16","201702160PIT"
"STL",0,2,0,2,0,4,0,1,1,1,0,3,"H","N","2017-02-16","201702160STL"
"VAN",0,1,1,1,0,3,0,2,0,2,0,4,"A","N","2017-02-16","201702160STL"
"ANA",0,0,1,0,0,1,0,0,3,1,0,4,"H","N","2017-02-17","201702170ANA"
"FLA",0,0,3,1,0,4,0,0,1,0,0,1,"A","N","2017-02-17","201702170ANA"
"CAR",0,1,0,0,0,1,1,1,0,0,0,2,"H","N","2017-02-17","201702170CAR"
"COL",1,1,0,0,0,2,0,1,0,0,0,1,"A","N","2017-02-17","201702170CAR"
"CBJ",1,0,1,0,0,2,0,0,1,0,0,1,"H","N","2017-02-17","201702170CBJ"
"PIT",0,0,1,0,0,1,1,0,1,0,0,2,"A","N","2017-02-17","201702170CBJ"
"ARI",0,0,0,1,0,1,0,2,1,1,0,4,"H","N","2017-02-18","201702180ARI"
"SJS",0,2,1,1,0,4,0,0,0,1,0,1,"A","N","2017-02-18","201702180ARI"
"BUF",0,1,2,0,0,3,0,1,0,1,0,2,"H","N","2017-02-18","201702180BUF"
"STL",0,1,0,1,0,2,0,1,2,0,0,3,"A","N","2017-02-18","201702180BUF"
"CHI",0,0,0,1,0,1,0,0,1,2,0,3,"H","N","2017-02-18","201702180CHI"
"EDM",0,0,1,2,0,3,0,0,0,1,0,1,"A","N","2017-02-18","201702180CHI"
"DAL",1,2,0,1,0,4,0,2,1,0,0,3,"H","N","2017-02-18","201702180DAL"
"TBL",0,2,1,0,0,3,1,2,0,1,0,4,"A","N","2017-02-18","201702180DAL"
"DET",0,1,1,0,1,3,0,0,1,1,0,2,"H","Y","2017-02-18","201702180DET"
"WSH",0,0,1,1,0,2,0,1,1,0,1,3,"A","Y","2017-02-18","201702180DET"
"FLA",0,1,1,1,0,3,0,0,2,0,0,2,"A","N","2017-02-18","201702180LAK"
"LAK",0,0,2,0,0,2,0,1,1,1,0,3,"H","N","2017-02-18","201702180LAK"
"MIN",0,1,1,3,0,5,0,0,0,2,0,2,"H","N","2017-02-18","201702180MIN"
"NSH",0,0,0,2,0,2,0,1,1,3,0,5,"A","N","2017-02-18","201702180MIN"
"MTL",0,1,0,0,0,1,0,0,1,2,0,3,"H","N","2017-02-18","201702180MTL"
"WPG",0,0,1,2,0,3,0,1,0,0,0,1,"A","N","2017-02-18","201702180MTL"
"NJD",0,1,1,1,0,3,0,0,0,2,0,2,"H","N","2017-02-18","201702180NJD"
"NYI",0,0,0,2,0,2,0,1,1,1,0,3,"A","N","2017-02-18","201702180NJD"
"OTT",0,2,0,4,0,6,0,0,2,1,0,3,"A","N","2017-02-18","201702180TOR"
"TOR",0,0,2,1,0,3,0,2,0,4,0,6,"H","N","2017-02-18","201702180TOR"
"CGY",0,0,0,1,0,1,1,1,0,0,0,2,"A","N","2017-02-18","201702180VAN"
"VAN",1,1,0,0,0,2,0,0,0,1,0,1,"H","N","2017-02-18","201702180VAN"
"ANA",0,0,1,0,0,1,0,0,0,0,0,0,"H","N","2017-02-19","201702190ANA"
"LAK",0,0,0,0,0,0,0,0,1,0,0,1,"A","N","2017-02-19","201702190ANA"
"BUF",0,1,0,0,0,1,0,1,2,2,0,5,"H","N","2017-02-19","201702190BUF"
"CHI",0,1,2,2,0,5,0,1,0,0,0,1,"A","N","2017-02-19","201702190BUF"
"CAR",0,0,0,0,0,0,0,0,2,2,0,4,"H","N","2017-02-19","201702190CAR"
"TOR",0,0,2,2,0,4,0,0,0,0,0,0,"A","N","2017-02-19","201702190CAR"
"CBJ",0,0,2,1,0,3,0,1,2,1,0,4,"H","N","2017-02-19","201702190CBJ"
"NSH",0,1,2,1,0,4,0,0,2,1,0,3,"A","N","2017-02-19","201702190CBJ"
"COL",0,0,0,2,0,2,1,1,1,0,0,3,"H","N","2017-02-19","201702190COL"
"TBL",1,1,1,0,0,3,0,0,0,2,0,2,"A","N","2017-02-19","201702190COL"
"NJD",0,1,2,1,0,4,0,1,3,2,0,6,"A","N","2017-02-19","201702190NYI"
"NYI",0,1,3,2,0,6,0,1,2,1,0,4,"H","N","2017-02-19","201702190NYI"
"NYR",0,1,0,1,0,2,0,0,1,0,0,1,"H","N","2017-02-19","201702190NYR"
"WSH",0,0,1,0,0,1,0,1,0,1,0,2,"A","N","2017-02-19","201702190NYR"
"OTT",0,0,1,1,0,2,0,2,0,1,0,3,"H","N","2017-02-19","201702190OTT"
"WPG",0,2,0,1,0,3,0,0,1,1,0,2,"A","N","2017-02-19","201702190OTT"
"DET",0,2,0,3,0,5,0,1,0,1,0,2,"A","N","2017-02-19","201702190PIT"
"PIT",0,1,0,1,0,2,0,2,0,3,0,5,"H","N","2017-02-19","201702190PIT"
"BOS",1,1,0,0,0,2,0,0,1,0,0,1,"A","N","2017-02-19","201702190SJS"
"SJS",0,0,1,0,0,1,1,1,0,0,0,2,"H","N","2017-02-19","201702190SJS"
"PHI",0,1,2,0,0,3,0,0,2,0,0,2,"A","N","2017-02-19","201702190VAN"
"VAN",0,0,2,0,0,2,0,1,2,0,0,3,"H","N","2017-02-19","201702190VAN"
"ANA",0,0,1,1,0,2,0,3,0,0,0,3,"A","N","2017-02-20","201702200ARI"
"ARI",0,3,0,0,0,3,0,0,1,1,0,2,"H","N","2017-02-20","201702200ARI"
"FLA",0,1,0,1,0,2,0,0,0,1,0,1,"A","N","2017-02-20","201702200STL"
"STL",0,0,0,1,0,1,0,1,0,1,0,2,"H","N","2017-02-20","201702200STL"
"CAR",0,1,0,0,0,1,0,1,1,1,0,3,"H","N","2017-02-21","201702210CAR"
"PIT",0,1,1,1,0,3,0,1,0,0,0,1,"A","N","2017-02-21","201702210CAR"
"COL",0,0,1,0,0,1,0,0,2,0,0,2,"H","N","2017-02-21","201702210COL"
"LAK",0,0,2,0,0,2,0,0,1,0,0,1,"A","N","2017-02-21","201702210COL"
"DET",0,1,0,0,0,1,0,1,1,1,0,3,"H","N","2017-02-21","201702210DET"
"NYI",0,1,1,1,0,3,0,1,0,0,0,1,"A","N","2017-02-21","201702210DET"
"CHI",0,0,2,3,0,5,0,0,1,2,0,3,"A","N","2017-02-21","201702210MIN"
"MIN",0,0,1,2,0,3,0,0,2,3,0,5,"H","N","2017-02-21","201702210MIN"
"NJD",0,0,0,1,0,1,0,0,1,1,0,2,"H","N","2017-02-21","201702210NJD"
"OTT",0,0,1,1,0,2,0,0,0,1,0,1,"A","N","2017-02-21","201702210NJD"
"CGY",1,3,1,1,0,6,0,1,4,0,0,5,"A","N","2017-02-21","201702210NSH"
"NSH",0,1,4,0,0,5,1,3,1,1,0,6,"H","N","2017-02-21","201702210NSH"
"MTL",0,1,1,0,1,3,0,1,1,0,0,2,"A","Y","2017-02-21","201702210NYR"
"NYR",0,1,1,0,0,2,0,1,1,0,1,3,"H","Y","2017-02-21","201702210NYR"
"EDM",0,0,1,0,0,1,0,1,1,2,0,4,"A","N","2017-02-21","201702210TBL"
"TBL",0,1,1,2,0,4,0,0,1,0,0,1,"H","N","2017-02-21","201702210TBL"
"TOR",1,1,2,1,0,5,0,2,2,0,0,4,"H","N","2017-02-21","201702210TOR"
"WPG",0,2,2,0,0,4,1,1,2,1,0,5,"A","N","2017-02-21","201702210TOR"
"ANA",0,0,3,2,0,5,0,1,1,1,0,3,"H","N","2017-02-22","201702220ANA"
"BOS",0,1,1,1,0,3,0,0,3,2,0,5,"A","N","2017-02-22","201702220ANA"
"EDM",0,1,2,1,0,4,0,0,3,0,0,3,"A","N","2017-02-22","201702220FLA"
"FLA",0,0,3,0,0,3,0,1,2,1,0,4,"H","N","2017-02-22","201702220FLA"
"PHI",0,0,1,0,0,1,0,2,1,1,0,4,"H","N","2017-02-22","201702220PHI"
"WSH",0,2,1,1,0,4,0,0,1,0,0,1,"A","N","2017-02-22","201702220PHI"
"ARI",0,3,0,0,0,3,0,3,2,1,0,6,"A","N","2017-02-23","201702230CHI"
"CHI",0,3,2,1,0,6,0,3,0,0,0,3,"H","N","2017-02-23","201702230CHI"
"BOS",0,1,1,2,0,4,0,1,0,0,0,1,"A","N","2017-02-23","201702230LAK"
"LAK",0,1,0,0,0,1,0,1,1,2,0,4,"H","N","2017-02-23","201702230LAK"
"MTL",0,0,0,0,0,0,0,1,1,1,0,3,"H","N","2017-02-23","201702230MTL"
"NYI",0,1,1,1,0,3,0,0,0,0,0,0,"A","N","2017-02-23","201702230MTL"
"COL",0,1,1,0,0,2,0,1,2,1,0,4,"A","N","2017-02-23","201702230NSH"
"NSH",0,1,2,1,0,4,0,1,1,0,0,2,"H","N","2017-02-23","201702230NSH"
"CGY",0,0,2,1,0,3,0,1,0,1,0,2,"A","N","2017-02-23","201702230TBL"
"TBL",0,1,0,1,0,2,0,0,2,1,0,3,"H","N","2017-02-23","201702230TBL"
"NYR",0,0,0,1,1,2,0,1,0,0,0,1,"A","Y","2017-02-23","201702230TOR"
"TOR",0,1,0,0,0,1,0,0,0,1,1,2,"H","Y","2017-02-23","201702230TOR"
"CAR",0,1,2,0,0,3,0,0,0,0,0,0,"H","N","2017-02-24","201702240CAR"
"OTT",0,0,0,0,0,0,0,1,2,0,0,3,"A","N","2017-02-24","201702240CAR"
"ARI",0,1,1,0,0,2,0,1,1,3,0,5,"A","N","2017-02-24","201702240DAL"
"DAL",0,1,1,3,0,5,0,1,1,0,0,2,"H","N","2017-02-24","201702240DAL"
"CGY",0,3,1,0,0,4,0,2,0,0,0,2,"A","N","2017-02-24","201702240FLA"
"FLA",0,2,0,0,0,2,0,3,1,0,0,4,"H","N","2017-02-24","201702240FLA"
"EDM",0,0,1,0,0,1,0,1,0,1,0,2,"A","N","2017-02-24","201702240WSH"
"WSH",0,1,0,1,0,2,0,0,1,0,0,1,"H","N","2017-02-24","201702240WSH"
"CBJ",0,3,2,2,0,7,0,0,0,0,0,0,"H","N","2017-02-25","201702250CBJ"
"NYI",0,0,0,0,0,0,0,3,2,2,0,7,"A","N","2017-02-25","201702250CBJ"
"BUF",0,1,2,0,0,3,0,3,1,1,0,5,"A","N","2017-02-25","201702250COL"
"COL",0,3,1,1,0,5,0,1,2,0,0,3,"H","N","2017-02-25","201702250COL"
"ANA",0,1,0,0,0,1,0,0,0,4,0,4,"A","N","2017-02-25","201702250LAK"
"LAK",0,0,0,4,0,4,0,1,0,0,0,1,"H","N","2017-02-25","201702250LAK"
"NJD",0,0,1,2,0,3,1,2,0,1,0,4,"H","N","2017-02-25","201702250NJD"
"NYR",1,2,0,1,0,4,0,0,1,2,0,3,"A","N","2017-02-25","201702250NJD"
"NSH",0,0,3,2,0,5,0,1,0,1,0,2,"H","N","2017-02-25","201702250NSH"
"WSH",0,1,0,1,0,2,0,0,3,2,0,5,"A","N","2017-02-25","201702250NSH"
"PHI",0,0,1,1,0,2,0,1,1,2,0,4,"A","N","2017-02-25","201702250PIT"
"PIT",0,1,1,2,0,4,0,0,1,1,0,2,"H","N","2017-02-25","201702250PIT"
"MTL",1,0,2,0,0,3,0,1,0,1,0,2,"A","N","2017-02-25","201702250TOR"
"TOR",0,1,0,1,0,2,1,0,2,0,0,3,"H","N","2017-02-25","201702250TOR"
"SJS",0,0,2,2,0,4,0,0,1,0,0,1,"A","N","2017-02-25","201702250VAN"
"VAN",0,0,1,0,0,1,0,0,2,2,0,4,"H","N","2017-02-25","201702250VAN"
"ARI",0,0,0,3,0,3,0,1,1,0,0,2,"H","N","2017-02-26","201702260ARI"
"BUF",0,1,1,0,0,2,0,0,0,3,0,3,"A","N","2017-02-26","201702260ARI"
"CAR",0,1,0,0,0,1,0,0,2,1,0,3,"H","N","2017-02-26","201702260CAR"
"CGY",0,0,2,1,0,3,0,1,0,0,0,1,"A","N","2017-02-26","201702260CAR"
"CHI",0,2,0,2,0,4,0,1,1,0,0,2,"H","N","2017-02-26","201702260CHI"
"STL",0,1,1,0,0,2,0,2,0,2,0,4,"A","N","2017-02-26","201702260CHI"
"BOS",0,2,2,2,0,6,0,0,2,1,0,3,"A","N","2017-02-26","201702260DAL"
"DAL",0,0,2,1,0,3,0,2,2,2,0,6,"H","N","2017-02-26","201702260DAL"
"FLA",0,1,0,0,0,1,0,1,1,0,0,2,"H","N","2017-02-26","201702260FLA"
"OTT",0,1,1,0,0,2,0,1,0,0,0,1,"A","N","2017-02-26","201702260FLA"
"EDM",0,1,3,0,0,4,0,2,2,1,0,5,"A","N","2017-02-26","201702260NSH"
"NSH",0,2,2,1,0,5,0,1,3,0,0,4,"H","N","2017-02-26","201702260NSH"
"CBJ",0,2,1,2,0,5,0,1,0,1,0,2,"A","N","2017-02-26","201702260NYR"
"NYR",0,1,0,1,0,2,0,2,1,2,0,5,"H","N","2017-02-26","201702260NYR"
"LAK",0,2,1,1,0,4,1,1,2,1,0,5,"A","N","2017-02-27","201702270MIN"
"MIN",1,1,2,1,0,5,0,2,1,1,0,4,"H","N","2017-02-27","201702270MIN"
"MTL",1,0,0,3,0,4,0,1,0,2,0,3,"A","N","2017-02-27","201702270NJD"
"NJD",0,1,0,2,0,3,1,0,0,3,0,4,"H","N","2017-02-27","201702270NJD"
"OTT",0,1,0,0,0,1,0,0,4,1,0,5,"A","N","2017-02-27","201702270TBL"
"TBL",0,0,4,1,0,5,0,1,0,0,0,1,"H","N","2017-02-27","201702270TBL"
"ARI",0,0,1,0,0,1,0,1,3,0,0,4,"A","N","2017-02-28","201702280BOS"
"BOS",0,1,3,0,0,4,0,0,1,0,0,1,"H","N","2017-02-28","201702280BOS"
"BUF",0,2,1,1,0,4,1,1,1,2,0,5,"H","N","2017-02-28","201702280BUF"
"NSH",1,1,1,2,0,5,0,2,1,1,0,4,"A","N","2017-02-28","201702280BUF"
"CGY",1,0,1,0,0,2,0,1,0,0,0,1,"H","N","2017-02-28","201702280CGY"
"LAK",0,1,0,0,0,1,1,0,1,0,0,2,"A","N","2017-02-28","201702280CGY"
"DAL",0,0,0,3,0,3,0,1,1,0,0,2,"H","N","2017-02-28","201702280DAL"
"PIT",0,1,1,0,0,2,0,0,0,3,0,3,"A","N","2017-02-28","201702280DAL"
"CAR",0,0,1,1,0,2,0,2,0,0,1,3,"A","Y","2017-02-28","201702280FLA"
"FLA",0,2,0,0,1,3,0,0,1,1,0,2,"H","Y","2017-02-28","201702280FLA"
"CBJ",0,0,0,0,0,0,1,0,0,0,0,1,"A","N","2017-02-28","201702280MTL"
"MTL",1,0,0,0,0,1,0,0,0,0,0,0,"H","N","2017-02-28","201702280MTL"
"NYR",0,1,0,0,0,1,0,0,2,2,0,4,"H","N","2017-02-28","201702280NYR"
"WSH",0,0,2,2,0,4,0,1,0,0,0,1,"A","N","2017-02-28","201702280NYR"
"COL",0,0,0,0,0,0,0,3,1,0,0,4,"A","N","2017-02-28","201702280PHI"
"PHI",0,3,1,0,0,4,0,0,0,0,0,0,"H","N","2017-02-28","201702280PHI"
"SJS",0,0,1,2,0,3,0,0,1,0,0,1,"H","N","2017-02-28","201702280SJS"
"TOR",0,0,1,0,0,1,0,0,1,2,0,3,"A","N","2017-02-28","201702280SJS"
"EDM",0,1,1,0,0,2,0,1,0,0,0,1,"A","N","2017-02-28","201702280STL"
"STL",0,1,0,0,0,1,0,1,1,0,0,2,"H","N","2017-02-28","201702280STL"
"DET",1,2,0,0,0,3,0,0,1,1,0,2,"A","N","2017-02-28","201702280VAN"
"VAN",0,0,1,1,0,2,1,2,0,0,0,3,"H","N","2017-02-28","201702280VAN"
"MIN",0,3,2,1,0,6,0,1,2,2,0,5,"A","N","2017-02-28","201702280WPG"
"WPG",0,1,2,2,0,5,0,3,2,1,0,6,"H","N","2017-02-28","201702280WPG"
"CHI",0,0,2,2,0,4,0,0,1,0,0,1,"H","N","2017-03-01","201703010CHI"
"PIT",0,0,1,0,0,1,0,0,2,2,0,4,"A","N","2017-03-01","201703010CHI"
"CAR",0,2,0,1,0,3,1,1,0,2,0,4,"A","N","2017-03-01","201703010TBL"
"TBL",1,1,0,2,0,4,0,2,0,1,0,3,"H","N","2017-03-01","201703010TBL"
"BOS",0,0,0,1,0,1,0,0,0,2,0,2,"H","N","2017-03-02","201703020BOS"
"NYR",0,0,0,2,0,2,0,0,0,1,0,1,"A","N","2017-03-02","201703020BOS"
"ARI",0,1,1,1,0,3,0,1,2,3,0,6,"A","N","2017-03-02","201703020BUF"
"BUF",0,1,2,3,0,6,0,1,1,1,0,3,"H","N","2017-03-02","201703020BUF"
"CBJ",0,0,0,1,0,1,0,0,0,0,0,0,"H","N","2017-03-02","201703020CBJ"
"MIN",0,0,0,0,0,0,0,0,0,1,0,1,"A","N","2017-03-02","201703020CBJ"
"DAL",0,1,2,1,0,4,0,1,1,3,0,5,"H","N","2017-03-02","201703020DAL"
"NYI",0,1,1,3,0,5,0,1,2,1,0,4,"A","N","2017-03-02","201703020DAL"
"LAK",0,0,0,2,1,3,0,1,1,0,0,2,"H","Y","2017-03-02","201703020LAK"
"TOR",0,1,1,0,0,2,0,0,0,2,1,3,"A","Y","2017-03-02","201703020LAK"
"MTL",0,0,0,2,0,2,0,1,0,0,0,1,"H","N","2017-03-02","201703020MTL"
"NSH",0,1,0,0,0,1,0,0,0,2,0,2,"A","N","2017-03-02","201703020MTL"
"COL",0,0,0,1,0,1,0,1,1,0,0,2,"A","N","2017-03-02","201703020OTT"
"OTT",0,1,1,0,0,2,0,0,0,1,0,1,"H","N","2017-03-02","201703020OTT"
"FLA",0,0,1,0,0,1,0,0,0,1,1,2,"A","Y","2017-03-02","201703020PHI"
"PHI",0,0,0,1,1,2,0,0,1,0,0,1,"H","Y","2017-03-02","201703020PHI"
"SJS",0,1,2,0,0,3,0,1,0,0,0,1,"H","N","2017-03-02","201703020SJS"
"VAN",0,1,0,0,0,1,0,1,2,0,0,3,"A","N","2017-03-02","201703020SJS"
"NJD",0,0,0,0,0,0,0,0,0,1,0,1,"A","N","2017-03-02","201703020WSH"
"WSH",0,0,0,1,0,1,0,0,0,0,0,0,"H","N","2017-03-02","201703020WSH"
"ANA",0,1,2,2,0,5,0,1,1,0,0,2,"H","N","2017-03-03","201703030ANA"
"TOR",0,1,1,0,0,2,0,1,2,2,0,5,"A","N","2017-03-03","201703030ANA"
"ARI",0,2,0,2,0,4,0,1,1,0,0,2,"A","N","2017-03-03","201703030CAR"
"CAR",0,1,1,0,0,2,0,2,0,2,0,4,"H","N","2017-03-03","201703030CAR"
"CGY",1,2,0,0,0,3,0,1,0,1,0,2,"H","N","2017-03-03","201703030CGY"
"DET",0,1,0,1,0,2,1,2,0,0,0,3,"A","N","2017-03-03","201703030CGY"
"CHI",0,0,0,1,1,2,0,0,1,0,0,1,"H","Y","2017-03-03","201703030CHI"
"NYI",0,0,1,0,0,1,0,0,0,1,1,2,"A","Y","2017-03-03","201703030CHI"
"PIT",0,0,2,3,0,5,0,0,1,1,0,2,"H","N","2017-03-03","201703030PIT"
"TBL",0,0,1,1,0,2,0,0,2,3,0,5,"A","N","2017-03-03","201703030PIT"
"STL",0,0,0,0,0,0,0,1,0,2,0,3,"A","N","2017-03-03","201703030WPG"
"WPG",0,1,0,2,0,3,0,0,0,0,0,0,"H","N","2017-03-03","201703030WPG"
"BOS",0,0,2,1,0,3,0,0,1,1,0,2,"H","N","2017-03-04","201703040BOS"
"NJD",0,0,1,1,0,2,0,0,2,1,0,3,"A","N","2017-03-04","201703040BOS"
"BUF",0,1,0,0,0,1,0,0,1,0,1,2,"H","Y","2017-03-04","201703040BUF"
"TBL",0,0,1,0,1,2,0,1,0,0,0,1,"A","Y","2017-03-04","201703040BUF"
"DET",0,1,0,2,0,3,0,2,0,2,0,4,"A","N","2017-03-04","201703040EDM"
"EDM",0,2,0,2,0,4,0,1,0,2,0,3,"H","N","2017-03-04","201703040EDM"
"DAL",0,1,0,1,0,2,0,1,0,0,0,1,"A","N","2017-03-04","201703040FLA"
"FLA",0,1,0,0,0,1,0,1,0,1,0,2,"H","N","2017-03-04","201703040FLA"
"LAK",0,0,1,2,0,3,0,2,2,0,0,4,"H","N","2017-03-04","201703040LAK"
"VAN",0,2,2,0,0,4,0,0,1,2,0,3,"A","N","2017-03-04","201703040LAK"
"CHI",0,1,2,2,0,5,0,0,2,1,0,3,"A","N","2017-03-04","201703040NSH"
"NSH",0,0,2,1,0,3,0,1,2,2,0,5,"H","N","2017-03-04","201703040NSH"
"MTL",0,1,2,1,0,4,0,0,0,1,0,1,"A","N","2017-03-04","201703040NYR"
"NYR",0,0,0,1,0,1,0,1,2,1,0,4,"H","N","2017-03-04","201703040NYR"
"CBJ",0,1,0,1,0,2,0,1,1,1,0,3,"A","N","2017-03-04","201703040OTT"
"OTT",0,1,1,1,0,3,0,1,0,1,0,2,"H","N","2017-03-04","201703040OTT"
"COL",0,0,0,1,0,1,0,3,2,1,0,6,"A","N","2017-03-04","201703040WPG"
"WPG",0,3,2,1,0,6,0,0,0,1,0,1,"H","N","2017-03-04","201703040WPG"
"PHI",0,0,0,1,0,1,1,0,0,1,0,2,"A","N","2017-03-04","201703040WSH"
"WSH",1,0,0,1,0,2,0,0,0,1,0,1,"H","N","2017-03-04","201703040WSH"
"ANA",0,0,0,1,0,1,0,1,1,0,0,2,"H","N","2017-03-05","201703050ANA"
"VAN",0,1,1,0,0,2,0,0,0,1,0,1,"A","N","2017-03-05","201703050ANA"
"ARI",0,0,1,0,0,1,0,0,1,1,0,2,"H","N","2017-03-05","201703050ARI"
"CAR",0,0,1,1,0,2,0,0,1,0,0,1,"A","N","2017-03-05","201703050ARI"
"CGY",0,4,0,1,0,5,0,0,1,1,0,2,"H","N","2017-03-05","201703050CGY"
"NYI",0,0,1,1,0,2,0,4,0,1,0,5,"A","N","2017-03-05","201703050CGY"
"COL",0,0,0,0,0,0,0,2,1,0,0,3,"H","N","2017-03-05","201703050COL"
"STL",0,2,1,0,0,3,0,0,0,0,0,0,"A","N","2017-03-05","201703050COL"
"MIN",0,2,0,1,0,3,0,1,0,0,0,1,"H","N","2017-03-05","201703050MIN"
"SJS",0,1,0,0,0,1,0,2,0,1,0,3,"A","N","2017-03-05","201703050MIN"
"CBJ",0,0,2,1,0,3,0,0,0,0,0,0,"A","N","2017-03-05","201703050NJD"
"NJD",0,0,0,0,0,0,0,0,2,1,0,3,"H","N","2017-03-05","201703050NJD"
"BUF",0,3,0,0,0,3,0,0,2,2,0,4,"A","N","2017-03-05","201703050PIT"
"PIT",0,0,2,2,0,4,0,3,0,0,0,3,"H","N","2017-03-05","201703050PIT"
"BOS",0,1,0,1,0,2,0,2,0,2,0,4,"A","N","2017-03-06","201703060OTT"
"OTT",0,2,0,2,0,4,0,1,0,1,0,2,"H","N","2017-03-06","201703060OTT"
"NYR",1,0,0,0,0,1,0,0,0,0,0,0,"A","N","2017-03-06","201703060TBL"
"TBL",0,0,0,0,0,0,1,0,0,0,0,1,"H","N","2017-03-06","201703060TBL"
"SJS",0,1,0,2,0,3,0,1,0,1,0,2,"A","N","2017-03-06","201703060WPG"
"WPG",0,1,0,1,0,2,0,1,0,2,0,3,"H","N","2017-03-06","201703060WPG"
"DAL",0,1,2,1,0,4,0,0,1,1,0,2,"A","N","2017-03-06","201703060WSH"
"WSH",0,0,1,1,0,2,0,1,2,1,0,4,"H","N","2017-03-06","201703060WSH"
"ANA",0,1,2,0,1,4,0,2,1,0,0,3,"H","Y","2017-03-07","201703070ANA"
"NSH",0,2,1,0,0,3,0,1,2,0,1,4,"A","Y","2017-03-07","201703070ANA"
"BUF",0,1,1,1,0,3,0,1,3,2,0,6,"H","N","2017-03-07","201703070BUF"
"PHI",0,1,3,2,0,6,0,1,1,1,0,3,"A","N","2017-03-07","201703070BUF"
"CBJ",0,0,0,2,0,2,0,0,0,0,0,0,"H","N","2017-03-07","201703070CBJ"
"NJD",0,0,0,0,0,0,0,0,0,2,0,2,"A","N","2017-03-07","201703070CBJ"
"CAR",0,1,0,0,0,1,0,0,2,1,0,3,"A","N","2017-03-07","201703070COL"
"COL",0,0,2,1,0,3,0,1,0,0,0,1,"H","N","2017-03-07","201703070COL"
"EDM",0,0,1,0,0,1,0,1,1,2,0,4,"H","N","2017-03-07","201703070EDM"
"NYI",0,1,1,2,0,4,0,0,1,0,0,1,"A","N","2017-03-07","201703070EDM"
"FLA",0,0,1,1,0,2,0,2,2,1,0,5,"H","N","2017-03-07","201703070FLA"
"NYR",0,2,2,1,0,5,0,0,1,1,0,2,"A","N","2017-03-07","201703070FLA"
"MIN",0,0,0,1,0,1,0,1,0,1,0,2,"H","N","2017-03-07","201703070MIN"
"STL",0,1,0,1,0,2,0,0,0,1,0,1,"A","N","2017-03-07","201703070MIN"
"DET",0,0,1,1,0,2,0,2,1,0,0,3,"A","N","2017-03-07","201703070TOR"
"TOR",0,2,1,0,0,3,0,0,1,1,0,2,"H","N","2017-03-07","201703070TOR"
"MTL",1,1,0,0,0,2,0,0,0,1,0,1,"A","N","2017-03-07","201703070VAN"
"VAN",0,0,0,1,0,1,1,1,0,0,0,2,"H","N","2017-03-07","201703070VAN"
"BOS",0,4,1,1,0,6,0,0,1,0,0,1,"H","N","2017-03-08","201703080BOS"
"DET",0,0,1,0,0,1,0,4,1,1,0,6,"A","N","2017-03-08","201703080BOS"
"DAL",0,0,1,1,0,2,0,2,2,1,0,5,"H","N","2017-03-08","201703080DAL"
"OTT",0,2,2,1,0,5,0,0,1,1,0,2,"A","N","2017-03-08","201703080DAL"
"PIT",0,2,4,1,0,7,0,3,0,1,0,4,"A","N","2017-03-08","201703080WPG"
"WPG",0,3,0,1,0,4,0,2,4,1,0,7,"H","N","2017-03-08","201703080WPG"
"ARI",0,0,2,0,0,2,1,0,1,1,0,3,"H","N","2017-03-09","201703090ARI"
"OTT",1,0,1,1,0,3,0,0,2,0,0,2,"A","N","2017-03-09","201703090ARI"
"CAR",0,2,0,2,0,4,0,1,2,0,0,3,"H","N","2017-03-09","201703090CAR"
"NYR",0,1,2,0,0,3,0,2,0,2,0,4,"A","N","2017-03-09","201703090CAR"
"CGY",0,1,3,1,0,5,0,0,0,0,0,0,"H","N","2017-03-09","201703090CGY"
"MTL",0,0,0,0,0,0,0,1,3,1,0,5,"A","N","2017-03-09","201703090CGY"
"ANA",0,0,1,0,0,1,0,0,0,0,0,0,"A","N","2017-03-09","201703090CHI"
"CHI",0,0,0,0,0,0,0,0,1,0,0,1,"H","N","2017-03-09","201703090CHI"
"COL",0,0,1,2,0,3,0,0,0,2,0,2,"H","N","2017-03-09","201703090COL"
"NJD",0,0,0,2,0,2,0,0,1,2,0,3,"A","N","2017-03-09","201703090COL"
"LAK",1,0,1,1,0,3,0,1,0,1,0,2,"H","N","2017-03-09","201703090LAK"
"NSH",0,1,0,1,0,2,1,0,1,1,0,3,"A","N","2017-03-09","201703090LAK"
"SJS",0,1,2,1,0,4,0,1,1,0,0,2,"H","N","2017-03-09","201703090SJS"
"WSH",0,1,1,0,0,2,0,1,2,1,0,4,"A","N","2017-03-09","201703090SJS"
"MIN",0,0,0,1,0,1,0,2,1,1,0,4,"A","N","2017-03-09","201703090TBL"
"TBL",0,2,1,1,0,4,0,0,0,1,0,1,"H","N","2017-03-09","201703090TBL"
"PHI",0,1,0,1,0,2,0,1,1,2,0,4,"A","N","2017-03-09","201703090TOR"
"TOR",0,1,1,2,0,4,0,1,0,1,0,2,"H","N","2017-03-09","201703090TOR"
"NYI",1,1,2,0,0,4,0,0,2,1,0,3,"A","N","2017-03-09","201703090VAN"
"VAN",0,0,2,1,0,3,1,1,2,0,0,4,"H","N","2017-03-09","201703090VAN"
"BUF",0,1,1,1,0,3,0,2,1,1,0,4,"A","N","2017-03-10","201703100CBJ"
"CBJ",0,2,1,1,0,4,0,1,1,1,0,3,"H","N","2017-03-10","201703100CBJ"
"CHI",0,1,1,0,0,2,0,2,1,1,0,4,"A","N","2017-03-10","201703100DET"
"DET",0,2,1,1,0,4,0,1,1,0,0,2,"H","N","2017-03-10","201703100DET"
"EDM",0,0,1,1,0,2,0,2,0,0,1,3,"H","Y","2017-03-10","201703100EDM"
"PIT",0,2,0,0,1,3,0,0,1,1,0,2,"A","Y","2017-03-10","201703100EDM"
"FLA",0,2,1,1,0,4,0,1,2,4,0,7,"H","N","2017-03-10","201703100FLA"
"MIN",0,1,2,4,0,7,0,2,1,1,0,4,"A","N","2017-03-10","201703100FLA"
"ANA",0,2,0,1,0,3,0,1,1,2,0,4,"A","N","2017-03-10","201703100STL"
"STL",0,1,1,2,0,4,0,2,0,1,0,3,"H","N","2017-03-10","201703100STL"
"ARI",0,3,1,1,0,5,0,0,2,2,0,4,"H","N","2017-03-11","201703110ARI"
"NJD",0,0,2,2,0,4,0,3,1,1,0,5,"A","N","2017-03-11","201703110ARI"
"BOS",0,1,0,1,0,2,0,0,1,0,0,1,"H","N","2017-03-11","201703110BOS"
"PHI",0,0,1,0,0,1,0,1,0,1,0,2,"A","N","2017-03-11","201703110BOS"
"BUF",0,0,3,2,0,5,0,3,0,0,0,3,"H","N","2017-03-11","201703110BUF"
"CBJ",0,3,0,0,0,3,0,0,3,2,0,5,"A","N","2017-03-11","201703110BUF"
"CAR",0,1,1,0,0,2,1,1,1,0,0,3,"H","N","2017-03-11","201703110CAR"
"TOR",1,1,1,0,0,3,0,1,1,0,0,2,"A","N","2017-03-11","201703110CAR"
"COL",0,1,0,1,0,2,0,0,3,1,0,4,"H","N","2017-03-11","201703110COL"
"OTT",0,0,3,1,0,4,0,1,0,1,0,2,"A","N","2017-03-11","201703110COL"
"LAK",0,1,1,2,0,4,0,1,1,0,0,2,"H","N","2017-03-11","201703110LAK"
"WSH",0,1,1,0,0,2,0,1,1,2,0,4,"A","N","2017-03-11","201703110LAK"
"NSH",0,1,1,1,0,3,0,1,0,0,0,1,"A","N","2017-03-11","201703110SJS"
"SJS",0,1,0,0,0,1,0,1,1,1,0,3,"H","N","2017-03-11","201703110SJS"
"NYI",0,0,1,2,0,3,0,1,3,0,0,4,"A","N","2017-03-11","201703110STL"
"STL",0,1,3,0,0,4,0,0,1,2,0,3,"H","N","2017-03-11","201703110STL"
"FLA",0,2,0,0,0,2,0,0,2,1,0,3,"A","N","2017-03-11","201703110TBL"
"TBL",0,0,2,1,0,3,0,2,0,0,0,2,"H","N","2017-03-11","201703110TBL"
"PIT",0,0,1,2,0,3,0,0,0,0,0,0,"A","N","2017-03-11","201703110VAN"
"VAN",0,0,0,0,0,0,0,0,1,2,0,3,"H","N","2017-03-11","201703110VAN"
"CGY",0,1,1,1,0,3,0,0,0,0,0,0,"A","N","2017-03-11","201703110WPG"
"WPG",0,0,0,0,0,0,0,1,1,1,0,3,"H","N","2017-03-11","201703110WPG"
"ANA",0,0,3,2,0,5,0,0,1,1,0,2,"H","N","2017-03-12","201703120ANA"
"WSH",0,0,1,1,0,2,0,0,3,2,0,5,"A","N","2017-03-12","201703120ANA"
"CHI",0,2,1,1,0,4,0,1,0,1,0,2,"H","N","2017-03-12","201703120CHI"
"MIN",0,1,0,1,0,2,0,2,1,1,0,4,"A","N","2017-03-12","201703120CHI"
"DET",0,0,1,0,0,1,0,1,2,1,0,4,"H","N","2017-03-12","201703120DET"
"NYR",0,1,2,1,0,4,0,0,1,0,0,1,"A","N","2017-03-12","201703120DET"
"EDM",0,0,1,0,0,1,0,0,0,4,0,4,"H","N","2017-03-12","201703120EDM"
"MTL",0,0,0,4,0,4,0,0,1,0,0,1,"A","N","2017-03-12","201703120EDM"
"DAL",0,1,0,0,0,1,0,2,2,1,0,5,"A","N","2017-03-12","201703120SJS"
"SJS",0,2,2,1,0,5,0,1,0,0,0,1,"H","N","2017-03-12","201703120SJS"
"ARI",0,0,1,0,0,1,0,0,0,0,0,0,"H","N","2017-03-13","201703130ARI"
"COL",0,0,0,0,0,0,0,0,1,0,0,1,"A","N","2017-03-13","201703130ARI"
"CGY",0,1,1,1,1,4,0,2,0,1,0,3,"H","Y","2017-03-13","201703130CGY"
"PIT",0,2,0,1,0,3,0,1,1,1,1,4,"A","Y","2017-03-13","201703130CGY"
"LAK",0,0,0,1,0,1,0,0,1,2,0,3,"H","N","2017-03-13","201703130LAK"
"STL",0,0,1,2,0,3,0,0,0,1,0,1,"A","N","2017-03-13","201703130LAK"
"NSH",1,2,1,1,0,5,0,2,2,0,0,4,"H","N","2017-03-13","201703130NSH"
"WPG",0,2,2,0,0,4,1,2,1,1,0,5,"A","N","2017-03-13","201703130NSH"
"CAR",0,2,4,2,0,8,0,2,2,0,0,4,"A","N","2017-03-13","201703130NYI"
"NYI",0,2,2,0,0,4,0,2,4,2,0,8,"H","N","2017-03-13","201703130NYI"
"NYR",0,1,1,0,0,2,0,1,1,1,0,3,"H","N","2017-03-13","201703130NYR"
"TBL",0,1,1,1,0,3,0,1,1,0,0,2,"A","N","2017-03-13","201703130NYR"
"CBJ",0,2,1,2,0,5,0,1,2,0,0,3,"A","N","2017-03-13","201703130PHI"
"PHI",0,1,2,0,0,3,0,2,1,2,0,5,"H","N","2017-03-13","201703130PHI"
"BOS",0,1,1,4,0,6,0,2,1,0,0,3,"A","N","2017-03-13","201703130VAN"
"VAN",0,2,1,0,0,3,0,1,1,4,0,6,"H","N","2017-03-13","201703130VAN"
"CAR",0,1,1,0,0,2,1,0,2,0,0,3,"H","N","2017-03-14","201703140CAR"
"NYI",1,0,2,0,0,3,0,1,1,0,0,2,"A","N","2017-03-14","201703140CAR"
"DAL",0,0,1,0,0,1,0,2,3,2,0,7,"A","N","2017-03-14","201703140EDM"
"EDM",0,2,3,2,0,7,0,0,1,0,0,1,"H","N","2017-03-14","201703140EDM"
"FLA",0,3,3,1,0,7,0,1,1,0,0,2,"H","N","2017-03-14","201703140FLA"
"TOR",0,1,1,0,0,2,0,3,3,1,0,7,"A","N","2017-03-14","201703140FLA"
"ARI",0,0,0,2,1,3,0,0,1,1,0,2,"A","Y","2017-03-14","201703140LAK"
"LAK",0,0,1,1,0,2,0,0,0,2,1,3,"H","Y","2017-03-14","201703140LAK"
"CHI",0,1,1,2,0,4,0,0,0,2,0,2,"A","N","2017-03-14","201703140MTL"
"MTL",0,0,0,2,0,2,0,1,1,2,0,4,"H","N","2017-03-14","201703140MTL"
"OTT",0,0,1,0,0,1,1,1,0,0,0,2,"H","N","2017-03-14","201703140OTT"
"TBL",1,1,0,0,0,2,0,0,1,0,0,1,"A","N","2017-03-14","201703140OTT"
"BUF",0,1,0,0,0,1,0,0,2,2,0,4,"A","N","2017-03-14","201703140SJS"
"SJS",0,0,2,2,0,4,0,1,0,0,0,1,"H","N","2017-03-14","201703140SJS"
"MIN",0,0,0,2,0,2,0,1,2,1,0,4,"A","N","2017-03-14","201703140WSH"
"WSH",0,1,2,1,0,4,0,0,0,2,0,2,"H","N","2017-03-14","201703140WSH"
"ANA",0,1,1,0,0,2,0,0,0,1,0,1,"H","N","2017-03-15","201703150ANA"
"STL",0,0,0,1,0,1,0,1,1,0,0,2,"A","N","2017-03-15","201703150ANA"
"BOS",0,1,2,2,0,5,0,1,1,0,0,2,"A","N","2017-03-15","201703150CGY"
"CGY",0,1,1,0,0,2,0,1,2,2,0,5,"H","N","2017-03-15","201703150CGY"
"COL",0,0,1,2,0,3,0,1,0,0,0,1,"H","N","2017-03-15","201703150COL"
"DET",0,1,0,0,0,1,0,0,1,2,0,3,"A","N","2017-03-15","201703150COL"
"PHI",0,0,2,2,0,4,0,0,0,0,0,0,"H","N","2017-03-15","201703150PHI"
"PIT",0,0,0,0,0,0,0,0,2,2,0,4,"A","N","2017-03-15","201703150PHI"
"ARI",0,0,2,2,0,4,0,1,1,2,1,5,"H","Y","2017-03-16","201703160ARI"
"DET",0,1,1,2,1,5,0,0,2,2,0,4,"A","Y","2017-03-16","201703160ARI"
"CAR",0,1,0,2,0,3,0,1,0,0,0,1,"H","N","2017-03-16","201703160CAR"
"MIN",0,1,0,0,0,1,0,1,0,2,0,3,"A","N","2017-03-16","201703160CAR"
"CBJ",0,0,2,0,0,2,0,1,0,0,0,1,"H","N","2017-03-16","201703160CBJ"
"FLA",0,1,0,0,0,1,0,0,2,0,0,2,"A","N","2017-03-16","201703160CBJ"
"BOS",0,2,2,0,0,4,0,4,3,0,0,7,"A","N","2017-03-16","201703160EDM"
"EDM",0,4,3,0,0,7,0,2,2,0,0,4,"H","N","2017-03-16","201703160EDM"
"BUF",0,0,0,0,0,0,0,0,0,2,0,2,"A","N","2017-03-16","201703160LAK"
"LAK",0,0,0,2,0,2,0,0,0,0,0,0,"H","N","2017-03-16","201703160LAK"
"NJD",0,1,2,3,0,6,0,1,1,0,0,2,"H","N","2017-03-16","201703160NJD"
"PHI",0,1,1,0,0,2,0,1,2,3,0,6,"A","N","2017-03-16","201703160NJD"
"NYI",0,1,0,1,0,2,0,2,2,0,0,4,"H","N","2017-03-16","201703160NYI"
"WPG",0,2,2,0,0,4,0,1,0,1,0,2,"A","N","2017-03-16","201703160NYI"
"CHI",0,0,0,2,0,2,0,0,0,1,0,1,"A","N","2017-03-16","201703160OTT"
"OTT",0,0,0,1,0,1,0,0,0,2,0,2,"H","N","2017-03-16","201703160OTT"
"SJS",0,1,0,0,0,1,0,1,1,2,0,4,"H","N","2017-03-16","201703160SJS"
"STL",0,1,1,2,0,4,0,1,0,0,0,1,"A","N","2017-03-16","201703160SJS"
"TBL",0,0,0,0,0,0,0,1,4,0,0,5,"H","N","2017-03-16","201703160TBL"
"TOR",0,1,4,0,0,5,0,0,0,0,0,0,"A","N","2017-03-16","201703160TBL"
"DAL",0,2,0,2,0,4,0,1,1,0,0,2,"A","N","2017-03-16","201703160VAN"
"VAN",0,1,1,0,0,2,0,2,0,2,0,4,"H","N","2017-03-16","201703160VAN"
"NSH",1,0,1,0,0,2,0,1,0,0,0,1,"A","N","2017-03-16","201703160WSH"
"WSH",0,1,0,0,0,1,1,0,1,0,0,2,"H","N","2017-03-16","201703160WSH"
"ANA",0,1,0,0,0,1,0,0,1,0,1,2,"H","Y","2017-03-17","201703170ANA"
"BUF",0,0,1,0,1,2,0,1,0,0,0,1,"A","Y","2017-03-17","201703170ANA"
"CGY",0,1,2,0,0,3,0,0,0,1,0,1,"H","N","2017-03-17","201703170CGY"
"DAL",0,0,0,1,0,1,0,1,2,0,0,3,"A","N","2017-03-17","201703170CGY"
"FLA",0,0,2,1,1,4,0,2,0,1,0,3,"A","Y","2017-03-17","201703170NYR"
"NYR",0,2,0,1,0,3,0,0,2,1,1,4,"H","Y","2017-03-17","201703170NYR"
"NJD",0,2,1,1,0,4,0,3,1,2,0,6,"A","N","2017-03-17","201703170PIT"
"PIT",0,3,1,2,0,6,0,2,1,1,0,4,"H","N","2017-03-17","201703170PIT"
"ARI",0,0,0,0,0,0,0,1,1,1,0,3,"H","N","2017-03-18","201703180ARI"
"STL",0,1,1,1,0,3,0,0,0,0,0,0,"A","N","2017-03-18","201703180ARI"
"CAR",0,2,1,1,0,4,0,0,1,1,0,2,"H","N","2017-03-18","201703180CAR"
"NSH",0,0,1,1,0,2,0,2,1,1,0,4,"A","N","2017-03-18","201703180CAR"
"COL",0,0,0,1,0,1,0,0,1,4,0,5,"A","N","2017-03-18","201703180DET"
"DET",0,0,1,4,0,5,0,0,0,1,0,1,"H","N","2017-03-18","201703180DET"
"EDM",0,0,1,1,0,2,0,0,0,0,0,0,"H","N","2017-03-18","201703180EDM"
"VAN",0,0,0,0,0,0,0,0,1,1,0,2,"A","N","2017-03-18","201703180EDM"
"MIN",0,1,0,1,0,2,0,1,2,0,0,3,"H","N","2017-03-18","201703180MIN"
"NYR",0,1,2,0,0,3,0,1,0,1,0,2,"A","N","2017-03-18","201703180MIN"
"CBJ",1,0,2,0,0,3,0,1,0,1,0,2,"A","N","2017-03-18","201703180NYI"
"NYI",0,1,0,1,0,2,1,0,2,0,0,3,"H","N","2017-03-18","201703180NYI"
"MTL",0,0,1,2,1,4,0,0,2,1,0,3,"A","Y","2017-03-18","201703180OTT"
"OTT",0,0,2,1,0,3,0,0,1,2,1,4,"H","Y","2017-03-18","201703180OTT"
"ANA",0,1,1,0,0,2,0,1,0,0,0,1,"A","N","2017-03-18","201703180SJS"
"SJS",0,1,0,0,0,1,0,1,1,0,0,2,"H","N","2017-03-18","201703180SJS"
"TBL",0,2,0,1,0,3,0,2,0,3,0,5,"H","N","2017-03-18","201703180TBL"
"WSH",0,2,0,3,0,5,0,2,0,1,0,3,"A","N","2017-03-18","201703180TBL"
"CHI",1,0,1,0,0,2,0,1,0,0,0,1,"A","N","2017-03-18","201703180TOR"
"TOR",0,1,0,0,0,1,1,0,1,0,0,2,"H","N","2017-03-18","201703180TOR"
"CGY",0,2,2,1,0,5,0,1,1,0,0,2,"H","N","2017-03-19","201703190CGY"
"LAK",0,1,1,0,0,2,0,2,2,1,0,5,"A","N","2017-03-19","201703190CGY"
"CHI",0,1,0,5,0,6,0,2,1,0,0,3,"H","N","2017-03-19","201703190CHI"
"COL",0,2,1,0,0,3,0,1,0,5,0,6,"A","N","2017-03-19","201703190CHI"
"MTL",0,2,0,2,0,4,0,1,0,0,0,1,"H","N","2017-03-19","201703190MTL"
"OTT",0,1,0,0,0,1,0,2,0,2,0,4,"A","N","2017-03-19","201703190MTL"
"CBJ",0,2,1,1,0,4,0,1,0,0,0,1,"A","N","2017-03-19","201703190NJD"
"NJD",0,1,0,0,0,1,0,2,1,1,0,4,"H","N","2017-03-19","201703190NJD"
"CAR",0,0,2,1,0,3,1,1,1,1,0,4,"A","N","2017-03-19","201703190PHI"
"PHI",1,1,1,1,0,4,0,0,2,1,0,3,"H","N","2017-03-19","201703190PHI"
"FLA",0,0,0,0,0,0,0,1,2,1,0,4,"A","N","2017-03-19","201703190PIT"
"PIT",0,1,2,1,0,4,0,0,0,0,0,0,"H","N","2017-03-19","201703190PIT"
"MIN",0,0,4,0,0,4,0,3,1,1,0,5,"A","N","2017-03-19","201703190WPG"
"WPG",0,3,1,1,0,5,0,0,4,0,0,4,"H","N","2017-03-19","201703190WPG"
"DAL",0,0,1,0,0,1,0,0,0,0,0,0,"H","N","2017-03-20","201703200DAL"
"SJS",0,0,0,0,0,0,0,0,1,0,0,1,"A","N","2017-03-20","201703200DAL"
"BUF",0,1,1,0,0,2,0,0,1,0,0,1,"A","N","2017-03-20","201703200DET"
"DET",0,0,1,0,0,1,0,1,1,0,0,2,"H","N","2017-03-20","201703200DET"
"EDM",0,2,0,0,0,2,0,0,0,0,0,0,"H","N","2017-03-20","201703200EDM"
"LAK",0,0,0,0,0,0,0,2,0,0,0,2,"A","N","2017-03-20","201703200EDM"
"ARI",0,0,0,1,0,1,0,0,2,1,0,3,"A","N","2017-03-20","201703200NSH"
"NSH",0,0,2,1,0,3,0,0,0,1,0,1,"H","N","2017-03-20","201703200NSH"
"BOS",0,1,0,1,0,2,0,1,0,3,0,4,"A","N","2017-03-20","201703200TOR"
"TOR",0,1,0,3,0,4,0,1,0,1,0,2,"H","N","2017-03-20","201703200TOR"
"BOS",0,1,0,1,0,2,0,1,1,1,0,3,"H","N","2017-03-21","201703210BOS"
"OTT",0,1,1,1,0,3,0,1,0,1,0,2,"A","N","2017-03-21","201703210BOS"
"BUF",0,0,0,1,0,1,0,1,0,2,0,3,"H","N","2017-03-21","201703210BUF"
"PIT",0,1,0,2,0,3,0,0,0,1,0,1,"A","N","2017-03-21","201703210BUF"
"CHI",0,0,1,3,0,4,1,1,2,1,0,5,"H","N","2017-03-21","201703210CHI"
"VAN",1,1,2,1,0,5,0,0,1,3,0,4,"A","N","2017-03-21","201703210CHI"
"COL",0,1,0,1,0,2,0,0,1,3,0,4,"H","N","2017-03-21","201703210COL"
"STL",0,0,1,3,0,4,0,1,0,1,0,2,"A","N","2017-03-21","201703210COL"
"CAR",0,2,1,1,0,4,0,2,1,0,0,3,"A","N","2017-03-21","201703210FLA"
"FLA",0,2,1,0,0,3,0,2,1,1,0,4,"H","N","2017-03-21","201703210FLA"
"MIN",0,1,2,0,0,3,0,0,2,0,0,2,"H","N","2017-03-21","201703210MIN"
"SJS",0,0,2,0,0,2,0,1,2,0,0,3,"A","N","2017-03-21","201703210MIN"
"DET",1,1,0,0,0,2,0,0,0,1,0,1,"A","N","2017-03-21","201703210MTL"
"MTL",0,0,0,1,0,1,1,1,0,0,0,2,"H","N","2017-03-21","201703210MTL"
"NJD",1,0,2,0,0,3,0,0,1,1,0,2,"H","N","2017-03-21","201703210NJD"
"NYR",0,0,1,1,0,2,1,0,2,0,0,3,"A","N","2017-03-21","201703210NJD"
"ARI",0,1,1,3,0,5,0,1,2,0,0,3,"A","N","2017-03-21","201703210TBL"
"TBL",0,1,2,0,0,3,0,1,1,3,0,5,"H","N","2017-03-21","201703210TBL"
"PHI",0,0,1,1,0,2,0,0,1,2,0,3,"A","N","2017-03-21","201703210WPG"
"WPG",0,0,1,2,0,3,0,0,1,1,0,2,"H","N","2017-03-21","201703210WPG"
"CGY",0,1,0,1,0,2,0,1,2,1,0,4,"A","N","2017-03-21","201703210WSH"
"WSH",0,1,2,1,0,4,0,1,0,1,0,2,"H","N","2017-03-21","201703210WSH"
"ANA",0,2,2,0,0,4,0,2,0,1,0,3,"H","N","2017-03-22","201703220ANA"
"EDM",0,2,0,1,0,3,0,2,2,0,0,4,"A","N","2017-03-22","201703220ANA"
"CBJ",0,0,2,0,0,2,0,2,1,2,0,5,"H","N","2017-03-22","201703220CBJ"
"TOR",0,2,1,2,0,5,0,0,2,0,0,2,"A","N","2017-03-22","201703220CBJ"
"NYI",0,0,1,2,0,3,0,0,2,0,0,2,"A","N","2017-03-22","201703220NYR"
"NYR",0,0,2,0,0,2,0,0,1,2,0,3,"H","N","2017-03-22","201703220NYR"
"BOS",0,0,3,0,0,3,0,0,3,3,0,6,"H","N","2017-03-23","201703230BOS"
"TBL",0,0,3,3,0,6,0,0,3,0,0,3,"A","N","2017-03-23","201703230BOS"
"CHI",0,1,0,1,1,3,0,0,1,1,0,2,"H","Y","2017-03-23","201703230CHI"
"DAL",0,0,1,1,0,2,0,1,0,1,1,3,"A","Y","2017-03-23","201703230CHI"
"COL",0,2,2,0,0,4,0,1,1,5,0,7,"H","N","2017-03-23","201703230COL"
"EDM",0,1,1,5,0,7,0,2,2,0,0,4,"A","N","2017-03-23","201703230COL"
"ARI",0,1,0,0,0,1,0,0,3,0,0,3,"A","N","2017-03-23","201703230FLA"
"FLA",0,0,3,0,0,3,0,1,0,0,0,1,"H","N","2017-03-23","201703230FLA"
"LAK",0,1,1,3,0,5,0,2,0,0,0,2,"H","N","2017-03-23","201703230LAK"
"WPG",0,2,0,0,0,2,0,1,1,3,0,5,"A","N","2017-03-23","201703230LAK"
"MIN",0,1,0,0,0,1,0,1,1,1,0,3,"H","N","2017-03-23","201703230MIN"
"PHI",0,1,1,1,0,3,0,1,0,0,0,1,"A","N","2017-03-23","201703230MIN"
"CAR",0,1,1,2,0,4,0,1,0,0,0,1,"A","N","2017-03-23","201703230MTL"
"MTL",0,1,0,0,0,1,0,1,1,2,0,4,"H","N","2017-03-23","201703230MTL"
"CGY",0,0,1,0,0,1,0,0,2,1,0,3,"A","N","2017-03-23","201703230NSH"
"NSH",0,0,2,1,0,3,0,0,1,0,0,1,"H","N","2017-03-23","201703230NSH"
"OTT",0,0,0,1,1,2,0,0,1,0,0,1,"H","Y","2017-03-23","201703230OTT"
"PIT",0,0,1,0,0,1,0,0,0,1,1,2,"A","Y","2017-03-23","201703230OTT"
"STL",0,1,1,2,0,4,0,1,0,0,0,1,"H","N","2017-03-23","201703230STL"
"VAN",0,1,0,0,0,1,0,1,1,2,0,4,"A","N","2017-03-23","201703230STL"
"NJD",0,1,0,1,0,2,0,2,1,1,0,4,"A","N","2017-03-23","201703230TOR"
"TOR",0,2,1,1,0,4,0,1,0,1,0,2,"H","N","2017-03-23","201703230TOR"
"CBJ",0,0,0,1,0,1,0,0,0,1,1,2,"A","Y","2017-03-23","201703230WSH"
"WSH",0,0,0,1,1,2,0,0,0,1,0,1,"H","Y","2017-03-23","201703230WSH"
"ANA",0,1,1,1,0,3,0,0,1,0,0,1,"H","N","2017-03-24","201703240ANA"
"WPG",0,0,1,0,0,1,0,1,1,1,0,3,"A","N","2017-03-24","201703240ANA"
"DAL",0,1,3,2,0,6,0,0,1,0,0,1,"H","N","2017-03-24","201703240DAL"
"SJS",0,0,1,0,0,1,0,1,3,2,0,6,"A","N","2017-03-24","201703240DAL"
"DET",0,0,1,0,0,1,1,0,0,1,0,2,"H","N","2017-03-24","201703240DET"
"TBL",1,0,0,1,0,2,0,0,1,0,0,1,"A","N","2017-03-24","201703240DET"
"NYI",0,0,3,0,1,4,0,0,2,1,0,3,"A","Y","2017-03-24","201703240PIT"
"PIT",0,0,2,1,0,3,0,0,3,0,1,4,"H","Y","2017-03-24","201703240PIT"
"BUF",0,2,3,0,0,5,0,1,1,0,0,2,"H","N","2017-03-25","201703250BUF"
"TOR",0,1,1,0,0,2,0,2,3,0,0,5,"A","N","2017-03-25","201703250BUF"
"CBJ",0,0,1,0,0,1,0,0,0,0,0,0,"H","N","2017-03-25","201703250CBJ"
"PHI",0,0,0,0,0,0,0,0,1,0,0,1,"A","N","2017-03-25","201703250CBJ"
"COL",0,1,0,0,0,1,0,2,0,2,0,4,"A","N","2017-03-25","201703250EDM"
"EDM",0,2,0,2,0,4,0,1,0,0,0,1,"H","N","2017-03-25","201703250EDM"
"CHI",0,0,0,0,0,0,0,0,3,4,0,7,"A","N","2017-03-25","201703250FLA"
"FLA",0,0,3,4,0,7,0,0,0,0,0,0,"H","N","2017-03-25","201703250FLA"
"LAK",0,0,0,0,0,0,0,0,1,2,0,3,"H","N","2017-03-25","201703250LAK"
"NYR",0,0,1,2,0,3,0,0,0,0,0,0,"A","N","2017-03-25","201703250LAK"
"MIN",0,0,0,2,0,2,0,0,4,0,0,4,"H","N","2017-03-25","201703250MIN"
"VAN",0,0,4,0,0,4,0,0,0,2,0,2,"A","N","2017-03-25","201703250MIN"
"MTL",0,1,2,0,0,3,0,0,1,0,0,1,"H","N","2017-03-25","201703250MTL"
"OTT",0,0,1,0,0,1,0,1,2,0,0,3,"A","N","2017-03-25","201703250MTL"
"CAR",0,0,1,2,0,3,0,0,1,0,0,1,"A","N","2017-03-25","201703250NJD"
"NJD",0,0,1,0,0,1,0,0,1,2,0,3,"H","N","2017-03-25","201703250NJD"
"NSH",0,2,2,3,0,7,0,0,2,0,0,2,"H","N","2017-03-25","201703250NSH"
"SJS",0,0,2,0,0,2,0,2,2,3,0,7,"A","N","2017-03-25","201703250NSH"
"BOS",0,1,0,1,0,2,0,1,0,0,0,1,"A","N","2017-03-25","201703250NYI"
"NYI",0,1,0,0,0,1,0,1,0,1,0,2,"H","N","2017-03-25","201703250NYI"
"CGY",1,1,0,1,0,3,0,0,1,1,0,2,"A","N","2017-03-25","201703250STL"
"STL",0,0,1,1,0,2,1,1,0,1,0,3,"H","N","2017-03-25","201703250STL"
"ARI",0,0,0,1,0,1,0,1,0,3,0,4,"A","N","2017-03-25","201703250WSH"
"WSH",0,1,0,3,0,4,0,0,0,1,0,1,"H","N","2017-03-25","201703250WSH"
"ANA",0,2,1,3,0,6,0,2,1,0,0,3,"H","N","2017-03-26","201703260ANA"
"NYR",0,2,1,0,0,3,0,2,1,3,0,6,"A","N","2017-03-26","201703260ANA"
"DET",1,1,0,1,0,3,0,1,1,0,0,2,"H","N","2017-03-26","201703260DET"
"MIN",0,1,1,0,0,2,1,1,0,1,0,3,"A","N","2017-03-26","201703260DET"
"DAL",1,0,0,1,0,2,0,1,0,0,0,1,"A","N","2017-03-26","201703260NJD"
"NJD",0,1,0,0,0,1,1,0,0,1,0,2,"H","N","2017-03-26","201703260NJD"
"PHI",0,1,1,4,0,6,0,1,0,1,0,2,"A","N","2017-03-26","201703260PIT"
"PIT",0,1,0,1,0,2,0,1,1,4,0,6,"H","N","2017-03-26","201703260PIT"
"VAN",0,1,0,0,0,1,0,0,1,1,0,2,"A","N","2017-03-26","201703260WPG"
"WPG",0,0,1,1,0,2,0,1,0,0,0,1,"H","N","2017-03-26","201703260WPG"
"BUF",0,2,2,0,0,4,0,0,2,0,0,2,"H","N","2017-03-27","201703270BUF"
"FLA",0,0,2,0,0,2,0,2,2,0,0,4,"A","N","2017-03-27","201703270BUF"
"CAR",0,1,1,1,0,3,1,0,2,1,0,4,"H","N","2017-03-27","201703270CAR"
"DET",1,0,2,1,0,4,0,1,1,1,0,3,"A","N","2017-03-27","201703270CAR"
"CGY",0,1,1,2,0,4,0,0,0,2,0,2,"H","N","2017-03-27","201703270CGY"
"COL",0,0,0,2,0,2,0,1,1,2,0,4,"A","N","2017-03-27","201703270CGY"
"NSH",0,1,1,1,0,3,0,0,1,0,0,1,"A","N","2017-03-27","201703270NYI"
"NYI",0,0,1,0,0,1,0,1,1,1,0,3,"H","N","2017-03-27","201703270NYI"
"ARI",0,0,0,1,0,1,0,0,2,2,0,4,"A","N","2017-03-27","201703270STL"
"STL",0,0,2,2,0,4,0,0,0,1,0,1,"H","N","2017-03-27","201703270STL"
"CHI",0,3,1,0,0,4,1,1,3,0,0,5,"A","N","2017-03-27","201703270TBL"
"TBL",1,1,3,0,0,5,0,3,1,0,0,4,"H","N","2017-03-27","201703270TBL"
"BOS",0,2,0,2,0,4,0,0,0,1,0,1,"H","N","2017-03-28","201703280BOS"
"NSH",0,0,0,1,0,1,0,2,0,2,0,4,"A","N","2017-03-28","201703280BOS"
"CAR",0,2,1,1,0,4,0,0,0,1,0,1,"H","N","2017-03-28","201703280CAR"
"DET",0,0,0,1,0,1,0,2,1,1,0,4,"A","N","2017-03-28","201703280CAR"
"BUF",0,0,1,0,0,1,0,2,0,1,0,3,"A","N","2017-03-28","201703280CBJ"
"CBJ",0,2,0,1,0,3,0,0,1,0,0,1,"H","N","2017-03-28","201703280CBJ"
"EDM",0,1,1,0,0,2,0,1,0,0,0,1,"H","N","2017-03-28","201703280EDM"
"LAK",0,1,0,0,0,1,0,1,1,0,0,2,"A","N","2017-03-28","201703280EDM"
"MIN",0,0,2,2,0,4,1,1,2,1,0,5,"H","N","2017-03-28","201703280MIN"
"WSH",1,1,2,1,0,5,0,0,2,2,0,4,"A","N","2017-03-28","201703280MIN"
"DAL",0,1,0,0,0,1,0,0,1,3,0,4,"A","N","2017-03-28","201703280MTL"
"MTL",0,0,1,3,0,4,0,1,0,0,0,1,"H","N","2017-03-28","201703280MTL"
"NJD",0,2,1,0,0,3,0,1,1,1,1,4,"H","Y","2017-03-28","201703280NJD"
"WPG",0,1,1,1,1,4,0,2,1,0,0,3,"A","Y","2017-03-28","201703280NJD"
"OTT",0,1,0,1,0,2,0,1,0,1,1,3,"A","Y","2017-03-28","201703280PHI"
"PHI",0,1,0,1,1,3,0,1,0,1,0,2,"H","Y","2017-03-28","201703280PHI"
"NYR",0,1,1,2,0,4,1,2,1,1,0,5,"A","N","2017-03-28","201703280SJS"
"SJS",1,2,1,1,0,5,0,1,1,2,0,4,"H","N","2017-03-28","201703280SJS"
"FLA",0,0,1,1,0,2,0,2,0,1,0,3,"A","N","2017-03-28","201703280TOR"
"TOR",0,2,0,1,0,3,0,0,1,1,0,2,"H","N","2017-03-28","201703280TOR"
"ANA",0,3,1,0,0,4,0,0,0,1,0,1,"A","N","2017-03-28","201703280VAN"
"VAN",0,0,0,1,0,1,0,3,1,0,0,4,"H","N","2017-03-28","201703280VAN"
"ARI",0,0,0,1,0,1,0,1,1,1,0,3,"H","N","2017-03-29","201703290ARI"
"STL",0,1,1,1,0,3,0,0,0,1,0,1,"A","N","2017-03-29","201703290ARI"
"CGY",0,1,0,0,0,1,0,1,1,2,0,4,"H","N","2017-03-29","201703290CGY"
"LAK",0,1,1,2,0,4,0,1,0,0,0,1,"A","N","2017-03-29","201703290CGY"
"COL",0,1,1,1,0,3,0,2,2,1,0,5,"H","N","2017-03-29","201703290COL"
"WSH",0,2,2,1,0,5,0,1,1,1,0,3,"A","N","2017-03-29","201703290COL"
"CHI",0,4,0,1,0,5,0,0,0,1,0,1,"A","N","2017-03-29","201703290PIT"
"PIT",0,0,0,1,0,1,0,4,0,1,0,5,"H","N","2017-03-29","201703290PIT"
"BOS",0,1,1,0,0,2,0,0,0,0,0,0,"H","N","2017-03-30","201703300BOS"
"DAL",0,0,0,0,0,0,0,1,1,0,0,2,"A","N","2017-03-30","201703300BOS"
"CAR",1,0,0,1,0,2,0,0,1,0,0,1,"H","N","2017-03-30","201703300CAR"
"CBJ",0,0,1,0,0,1,1,0,0,1,0,2,"A","N","2017-03-30","201703300CAR"
"EDM",0,2,0,1,0,3,0,1,0,1,0,2,"H","N","2017-03-30","201703300EDM"
"SJS",0,1,0,1,0,2,0,2,0,1,0,3,"A","N","2017-03-30","201703300EDM"
"MIN",0,1,2,2,0,5,0,1,0,0,0,1,"H","N","2017-03-30","201703300MIN"
"OTT",0,1,0,0,0,1,0,1,2,2,0,5,"A","N","2017-03-30","201703300MIN"
"FLA",0,0,1,1,0,2,0,3,0,3,0,6,"A","N","2017-03-30","201703300MTL"
"MTL",0,3,0,3,0,6,0,0,1,1,0,2,"H","N","2017-03-30","201703300MTL"
"NSH",0,0,0,1,0,1,0,1,1,1,0,3,"H","N","2017-03-30","201703300NSH"
"TOR",0,1,1,1,0,3,0,0,0,1,0,1,"A","N","2017-03-30","201703300NSH"
"NYI",0,0,1,2,0,3,0,5,0,1,0,6,"A","N","2017-03-30","201703300PHI"
"PHI",0,5,0,1,0,6,0,0,1,2,0,3,"H","N","2017-03-30","201703300PHI"
"DET",0,1,1,1,0,3,0,1,3,1,0,5,"A","N","2017-03-30","201703300TBL"
"TBL",0,1,3,1,0,5,0,1,1,1,0,3,"H","N","2017-03-30","201703300TBL"
"ANA",0,2,1,0,0,3,1,1,0,2,0,4,"A","N","2017-03-30","201703300WPG"
"WPG",1,1,0,2,0,4,0,2,1,0,0,3,"H","N","2017-03-30","201703300WPG"
"ARI",0,3,2,1,0,6,0,0,2,1,0,3,"H","N","2017-03-31","201703310ARI"
"WSH",0,0,2,1,0,3,0,3,2,1,0,6,"A","N","2017-03-31","201703310ARI"
"CGY",0,1,3,1,0,5,0,0,1,1,0,2,"H","N","2017-03-31","201703310CGY"
"SJS",0,0,1,1,0,2,0,1,3,1,0,5,"A","N","2017-03-31","201703310CGY"
"CBJ",0,1,0,0,0,1,0,2,0,1,0,3,"A","N","2017-03-31","201703310CHI"
"CHI",0,2,0,1,0,3,0,1,0,0,0,1,"H","N","2017-03-31","201703310CHI"
"COL",0,0,1,0,1,2,0,1,0,0,0,1,"H","Y","2017-03-31","201703310COL"
"STL",0,1,0,0,0,1,0,0,1,0,1,2,"A","Y","2017-03-31","201703310COL"
"NJD",0,0,0,1,0,1,0,1,1,0,0,2,"A","N","2017-03-31","201703310NYI"
"NYI",0,1,1,0,0,2,0,0,0,1,0,1,"H","N","2017-03-31","201703310NYI"
"NYR",0,0,1,2,0,3,0,0,2,1,1,4,"H","Y","2017-03-31","201703310NYR"
"PIT",0,0,2,1,1,4,0,0,1,2,0,3,"A","Y","2017-03-31","201703310NYR"
"LAK",0,0,2,0,0,2,0,0,0,0,0,0,"A","N","2017-03-31","201703310VAN"
"VAN",0,0,0,0,0,0,0,0,2,0,0,2,"H","N","2017-03-31","201703310VAN"
"BOS",0,1,2,2,0,5,0,0,2,0,0,2,"H","N","2017-04-01","201704010BOS"
"FLA",0,0,2,0,0,2,0,1,2,2,0,5,"A","N","2017-04-01","201704010BOS"
"CAR",0,0,0,0,0,0,0,0,1,2,0,3,"H","N","2017-04-01","201704010CAR"
"DAL",0,0,1,2,0,3,0,0,0,0,0,0,"A","N","2017-04-01","201704010CAR"
"DET",0,1,1,2,0,4,0,0,3,2,0,5,"H","N","2017-04-01","201704010DET"
"TOR",0,0,3,2,0,5,0,1,1,2,0,4,"A","N","2017-04-01","201704010DET"
"ANA",0,0,1,1,0,2,1,1,0,1,0,3,"A","N","2017-04-01","201704010EDM"
"EDM",1,1,0,1,0,3,0,0,1,1,0,2,"H","N","2017-04-01","201704010EDM"
"MIN",0,0,0,0,0,0,0,0,2,1,0,3,"A","N","2017-04-01","201704010NSH"
"NSH",0,0,2,1,0,3,0,0,0,0,0,0,"H","N","2017-04-01","201704010NSH"
"NJD",0,0,0,0,0,0,0,2,1,0,0,3,"A","N","2017-04-01","201704010PHI"
"PHI",0,2,1,0,0,3,0,0,0,0,0,0,"H","N","2017-04-01","201704010PHI"
"MTL",1,0,1,0,0,2,0,0,0,1,0,1,"A","N","2017-04-01","201704010TBL"
"TBL",0,0,0,1,0,1,1,0,1,0,0,2,"H","N","2017-04-01","201704010TBL"
"OTT",0,1,1,0,0,2,0,0,2,2,0,4,"A","N","2017-04-01","201704010WPG"
"WPG",0,0,2,2,0,4,0,1,1,0,0,2,"H","N","2017-04-01","201704010WPG"
"BUF",0,0,1,1,0,2,0,1,1,2,0,4,"H","N","2017-04-02","201704020BUF"
"NYI",0,1,1,2,0,4,0,0,1,1,0,2,"A","N","2017-04-02","201704020BUF"
"CBJ",0,0,0,2,0,2,0,0,3,0,0,3,"H","N","2017-04-02","201704020CBJ"
"WSH",0,0,3,0,0,3,0,0,0,2,0,2,"A","N","2017-04-02","201704020CBJ"
"ANA",0,2,1,1,0,4,0,0,2,1,0,3,"A","N","2017-04-02","201704020CGY"
"CGY",0,0,2,1,0,3,0,2,1,1,0,4,"H","N","2017-04-02","201704020CGY"
"BOS",0,2,0,1,0,3,0,0,1,1,0,2,"A","N","2017-04-02","201704020CHI"
"CHI",0,0,1,1,0,2,0,2,0,1,0,3,"H","N","2017-04-02","201704020CHI"
"ARI",0,1,1,0,0,2,0,0,0,1,0,1,"A","N","2017-04-02","201704020LAK"
"LAK",0,0,0,1,0,1,0,1,1,0,0,2,"H","N","2017-04-02","201704020LAK"
"COL",0,1,1,0,0,2,0,3,2,0,0,5,"A","N","2017-04-02","201704020MIN"
"MIN",0,3,2,0,0,5,0,1,1,0,0,2,"H","N","2017-04-02","201704020MIN"
"NYR",0,0,2,2,0,4,0,0,1,2,0,3,"H","N","2017-04-02","201704020NYR"
"PHI",0,0,1,2,0,3,0,0,2,2,0,4,"A","N","2017-04-02","201704020NYR"
"CAR",0,1,0,1,0,2,0,1,1,1,0,3,"A","N","2017-04-02","201704020PIT"
"PIT",0,1,1,1,0,3,0,1,0,1,0,2,"H","N","2017-04-02","201704020PIT"
"NSH",0,1,0,0,0,1,0,1,2,1,0,4,"A","N","2017-04-02","201704020STL"
"STL",0,1,2,1,0,4,0,1,0,0,0,1,"H","N","2017-04-02","201704020STL"
"DAL",0,0,2,1,0,3,0,1,1,4,0,6,"A","N","2017-04-02","201704020TBL"
"TBL",0,1,1,4,0,6,0,0,2,1,0,3,"H","N","2017-04-02","201704020TBL"
"SJS",0,2,0,1,0,3,0,0,0,1,0,1,"A","N","2017-04-02","201704020VAN"
"VAN",0,0,0,1,0,1,0,2,0,1,0,3,"H","N","2017-04-02","201704020VAN"
"BUF",0,0,1,1,0,2,0,3,0,1,0,4,"H","N","2017-04-03","201704030BUF"
"TOR",0,3,0,1,0,4,0,0,1,1,0,2,"A","N","2017-04-03","201704030BUF"
"DET",0,0,2,2,1,5,0,0,1,3,0,4,"H","Y","2017-04-03","201704030DET"
"OTT",0,0,1,3,0,4,0,0,2,2,1,5,"A","Y","2017-04-03","201704030DET"
"FLA",0,0,1,0,0,1,0,1,0,3,0,4,"H","N","2017-04-03","201704030FLA"
"MTL",0,1,0,3,0,4,0,0,1,0,0,1,"A","N","2017-04-03","201704030FLA"
"ANA",0,0,2,1,0,3,0,1,0,0,0,1,"H","N","2017-04-04","201704040ANA"
"CGY",0,1,0,0,0,1,0,0,2,1,0,3,"A","N","2017-04-04","201704040ANA"
"BOS",0,0,2,2,0,4,0,0,0,0,0,0,"H","N","2017-04-04","201704040BOS"
"TBL",0,0,0,0,0,0,0,0,2,2,0,4,"A","N","2017-04-04","201704040BOS"
"CHI",0,0,3,0,0,3,1,0,2,1,0,4,"A","N","2017-04-04","201704040COL"
"COL",1,0,2,1,0,4,0,0,3,0,0,3,"H","N","2017-04-04","201704040COL"
"ARI",0,1,0,1,0,2,1,2,0,0,0,3,"A","N","2017-04-04","201704040DAL"
"DAL",1,2,0,0,0,3,0,1,0,1,0,2,"H","N","2017-04-04","201704040DAL"
"EDM",0,2,1,1,0,4,0,0,3,3,0,6,"A","N","2017-04-04","201704040LAK"
"LAK",0,0,3,3,0,6,0,2,1,1,0,4,"H","N","2017-04-04","201704040LAK"
"CAR",0,3,0,0,0,3,0,3,1,1,0,5,"A","N","2017-04-04","201704040MIN"
"MIN",0,3,1,1,0,5,0,3,0,0,0,3,"H","N","2017-04-04","201704040MIN"
"NJD",1,0,0,0,0,1,0,0,0,0,0,0,"H","N","2017-04-04","201704040NJD"
"PHI",0,0,0,0,0,0,1,0,0,0,0,1,"A","N","2017-04-04","201704040NJD"
"NSH",0,0,1,0,0,1,1,0,0,1,0,2,"H","N","2017-04-04","201704040NSH"
"NYI",1,0,0,1,0,2,0,0,1,0,0,1,"A","N","2017-04-04","201704040NSH"
"DET",0,0,0,0,0,0,0,1,1,0,0,2,"A","N","2017-04-04","201704040OTT"
"OTT",0,1,1,0,0,2,0,0,0,0,0,0,"H","N","2017-04-04","201704040OTT"
"CBJ",0,0,0,1,0,1,0,1,2,1,0,4,"A","N","2017-04-04","201704040PIT"
"PIT",0,1,2,1,0,4,0,0,0,1,0,1,"H","N","2017-04-04","201704040PIT"
"SJS",0,2,0,1,0,3,0,0,0,1,0,1,"H","N","2017-04-04","201704040SJS"
"VAN",0,0,0,1,0,1,0,2,0,1,0,3,"A","N","2017-04-04","201704040SJS"
"STL",0,1,1,0,0,2,0,0,3,2,0,5,"H","N","2017-04-04","201704040STL"
"WPG",0,0,3,2,0,5,0,1,1,0,0,2,"A","N","2017-04-04","201704040STL"
"TOR",0,0,0,1,0,1,0,1,1,2,0,4,"H","N","2017-04-04","201704040TOR"
"WSH",0,1,1,2,0,4,0,0,0,1,0,1,"A","N","2017-04-04","201704040TOR"
"BUF",0,1,1,0,0,2,0,0,0,1,0,1,"H","N","2017-04-05","201704050BUF"
"MTL",0,0,0,1,0,1,0,1,1,0,0,2,"A","N","2017-04-05","201704050BUF"
"NYR",0,0,0,0,0,0,0,0,1,1,0,2,"A","N","2017-04-05","201704050WSH"
"WSH",0,0,1,1,0,2,0,0,0,0,0,0,"H","N","2017-04-05","201704050WSH"
"ANA",0,1,1,2,0,4,0,0,0,0,0,0,"H","N","2017-04-06","201704060ANA"
"CHI",0,0,0,0,0,0,0,1,1,2,0,4,"A","N","2017-04-06","201704060ANA"
"ARI",0,1,3,0,0,4,0,1,0,2,0,3,"H","N","2017-04-06","201704060ARI"
"VAN",0,1,0,2,0,3,0,1,3,0,0,4,"A","N","2017-04-06","201704060ARI"
"BOS",0,1,0,0,0,1,0,0,1,0,1,2,"H","Y","2017-04-06","201704060BOS"
"OTT",0,0,1,0,1,2,0,1,0,0,0,1,"A","Y","2017-04-06","201704060BOS"
"CAR",0,0,0,0,0,0,0,2,1,0,0,3,"H","N","2017-04-06","201704060CAR"
"NYI",0,2,1,0,0,3,0,0,0,0,0,0,"A","N","2017-04-06","201704060CAR"
"CBJ",0,1,2,1,0,4,0,2,1,2,0,5,"H","N","2017-04-06","201704060CBJ"
"WPG",0,2,1,2,0,5,0,1,2,1,0,4,"A","N","2017-04-06","201704060CBJ"
"COL",0,0,2,1,0,3,0,2,0,2,0,4,"H","N","2017-04-06","201704060COL"
"MIN",0,2,0,2,0,4,0,0,2,1,0,3,"A","N","2017-04-06","201704060COL"
"DAL",0,0,3,0,0,3,0,4,2,1,0,7,"H","N","2017-04-06","201704060DAL"
"NSH",0,4,2,1,0,7,0,0,3,0,0,3,"A","N","2017-04-06","201704060DAL"
"FLA",0,0,1,2,0,3,0,1,1,4,0,6,"H","N","2017-04-06","201704060FLA"
"STL",0,1,1,4,0,6,0,0,1,2,0,3,"A","N","2017-04-06","201704060FLA"
"CGY",0,1,3,0,0,4,0,1,0,0,0,1,"A","N","2017-04-06","201704060LAK"
"LAK",0,1,0,0,0,1,0,1,3,0,0,4,"H","N","2017-04-06","201704060LAK"
"NJD",0,1,3,0,0,4,0,2,3,2,0,7,"H","N","2017-04-06","201704060NJD"
"PIT",0,2,3,2,0,7,0,1,3,0,0,4,"A","N","2017-04-06","201704060NJD"
"EDM",0,0,1,3,0,4,0,1,1,0,0,2,"A","N","2017-04-06","201704060SJS"
"SJS",0,1,1,0,0,2,0,0,1,3,0,4,"H","N","2017-04-06","201704060SJS"
"TBL",0,0,2,2,0,4,0,0,1,0,0,1,"A","N","2017-04-06","201704060TOR"
"TOR",0,0,1,0,0,1,0,0,2,2,0,4,"H","N","2017-04-06","201704060TOR"
"MTL",0,0,1,1,0,2,0,2,1,1,0,4,"H","N","2017-04-07","201704070MTL"
"TBL",0,2,1,1,0,4,0,0,1,1,0,2,"A","N","2017-04-07","201704070MTL"
"ARI",0,0,0,1,0,1,0,2,0,1,0,3,"H","N","2017-04-08","201704080ARI"
"MIN",0,2,0,1,0,3,0,0,0,1,0,1,"A","N","2017-04-08","201704080ARI"
"BOS",0,0,1,0,0,1,0,1,2,0,0,3,"H","N","2017-04-08","201704080BOS"
"WSH",0,1,2,0,0,3,0,0,1,0,0,1,"A","N","2017-04-08","201704080BOS"
"CAR",0,2,1,1,0,4,0,1,2,1,1,5,"H","Y","2017-04-08","201704080CAR"
"STL",0,1,2,1,1,5,0,2,1,1,0,4,"A","Y","2017-04-08","201704080CAR"
"COL",0,0,1,2,0,3,0,1,1,1,1,4,"A","Y","2017-04-08","201704080DAL"
"DAL",0,1,1,1,1,4,0,0,1,2,0,3,"H","Y","2017-04-08","201704080DAL"
"DET",0,1,1,0,0,2,1,0,2,0,0,3,"H","N","2017-04-08","201704080DET"
"MTL",1,0,2,0,0,3,0,1,1,0,0,2,"A","N","2017-04-08","201704080DET"
"BUF",0,0,0,0,0,0,0,0,2,1,0,3,"A","N","2017-04-08","201704080FLA"
"FLA",0,0,2,1,0,3,0,0,0,0,0,0,"H","N","2017-04-08","201704080FLA"
"CHI",0,1,0,1,0,2,1,0,0,2,0,3,"A","N","2017-04-08","201704080LAK"
"LAK",1,0,0,2,0,3,0,1,0,1,0,2,"H","N","2017-04-08","201704080LAK"
"NJD",0,0,0,2,0,2,0,0,2,2,0,4,"H","N","2017-04-08","201704080NJD"
"NYI",0,0,2,2,0,4,0,0,0,2,0,2,"A","N","2017-04-08","201704080NJD"
"NYR",0,0,0,1,0,1,0,0,2,1,0,3,"A","N","2017-04-08","201704080OTT"
"OTT",0,0,2,1,0,3,0,0,0,1,0,1,"H","N","2017-04-08","201704080OTT"
"CBJ",0,0,2,0,0,2,0,2,2,0,0,4,"A","N","2017-04-08","201704080PHI"
"PHI",0,2,2,0,0,4,0,0,2,0,0,2,"H","N","2017-04-08","201704080PHI"
"CGY",0,0,1,0,0,1,0,0,2,1,0,3,"A","N","2017-04-08","201704080SJS"
"SJS",0,0,2,1,0,3,0,0,1,0,0,1,"H","N","2017-04-08","201704080SJS"
"PIT",0,1,1,1,0,3,0,1,1,3,0,5,"A","N","2017-04-08","201704080TOR"
"TOR",0,1,1,3,0,5,0,1,1,1,0,3,"H","N","2017-04-08","201704080TOR"
"EDM",0,0,1,2,0,3,0,0,1,1,0,2,"A","N","2017-04-08","201704080VAN"
"VAN",0,0,1,1,0,2,0,0,1,2,0,3,"H","N","2017-04-08","201704080VAN"
"NSH",0,0,1,0,0,1,0,0,0,2,0,2,"A","N","2017-04-08","201704080WPG"
"WPG",0,0,0,2,0,2,0,0,1,0,0,1,"H","N","2017-04-08","201704080WPG"
"ANA",1,1,1,1,0,4,0,1,1,1,0,3,"H","N","2017-04-09","201704090ANA"
"LAK",0,1,1,1,0,3,1,1,1,1,0,4,"A","N","2017-04-09","201704090ANA"
"DET",0,2,1,1,0,4,0,0,0,1,0,1,"H","N","2017-04-09","201704090DET"
"NJD",0,0,0,1,0,1,0,2,1,1,0,4,"A","N","2017-04-09","201704090DET"
"EDM",0,1,2,2,0,5,0,0,1,1,0,2,"H","N","2017-04-09","201704090EDM"
"VAN",0,0,1,1,0,2,0,1,2,2,0,5,"A","N","2017-04-09","201704090EDM"
"NYI",0,1,2,1,0,4,0,0,1,1,0,2,"H","N","2017-04-09","201704090NYI"
"OTT",0,0,1,1,0,2,0,1,2,1,0,4,"A","N","2017-04-09","201704090NYI"
"NYR",0,2,0,1,0,3,0,1,1,0,0,2,"H","N","2017-04-09","201704090NYR"
"PIT",0,1,1,0,0,2,0,2,0,1,0,3,"A","N","2017-04-09","201704090NYR"
"CAR",0,1,0,2,1,4,0,0,1,2,0,3,"A","Y","2017-04-09","201704090PHI"
"PHI",0,0,1,2,0,3,0,1,0,2,1,4,"H","Y","2017-04-09","201704090PHI"
"COL",0,0,2,0,0,2,0,1,0,2,0,3,"A","N","2017-04-09","201704090STL"
"STL",0,1,0,2,0,3,0,0,2,0,0,2,"H","N","2017-04-09","201704090STL"
"BUF",0,1,0,1,0,2,0,0,2,2,0,4,"A","N","2017-04-09","201704090TBL"
"TBL",0,0,2,2,0,4,0,1,0,1,0,2,"H","N","2017-04-09","201704090TBL"
"CBJ",0,0,3,0,0,3,0,0,2,0,0,2,"A","N","2017-04-09","201704090TOR"
"TOR",0,0,2,0,0,2,0,0,3,0,0,3,"H","N","2017-04-09","201704090TOR"
"FLA",0,0,1,1,0,2,0,0,0,0,0,0,"A","N","2017-04-09","201704090WSH"
"WSH",0,0,0,0,0,0,0,0,1,1,0,2,"H","N","2017-04-09","201704090WSH"
"EDM",0,2,0,0,0,2,1,0,1,1,0,3,"H","N","2017-04-12","201704120EDM"
"SJS",1,0,1,1,0,3,0,2,0,0,0,2,"A","N","2017-04-12","201704120EDM"
"MIN",0,0,0,1,0,1,1,0,1,0,0,2,"H","N","2017-04-12","201704120MIN"
"STL",1,0,1,0,0,2,0,0,0,1,0,1,"A","N","2017-04-12","201704120MIN"
"MTL",0,0,0,0,0,0,0,1,0,1,0,2,"H","N","2017-04-12","201704120MTL"
"NYR",0,1,0,1,0,2,0,0,0,0,0,0,"A","N","2017-04-12","201704120MTL"
"BOS",0,0,0,2,0,2,0,0,1,0,0,1,"A","N","2017-04-12","201704120OTT"
"OTT",0,0,1,0,0,1,0,0,0,2,0,2,"H","N","2017-04-12","201704120OTT"
"CBJ",0,0,0,1,0,1,0,0,3,0,0,3,"A","N","2017-04-12","201704120PIT"
"PIT",0,0,3,0,0,3,0,0,0,1,0,1,"H","N","2017-04-12","201704120PIT"
"ANA",0,1,2,0,0,3,0,1,1,0,0,2,"H","N","2017-04-13","201704130ANA"
"CGY",0,1,1,0,0,2,0,1,2,0,0,3,"A","N","2017-04-13","201704130ANA"
"CHI",0,0,0,0,0,0,0,1,0,0,0,1,"H","N","2017-04-13","201704130CHI"
"NSH",0,1,0,0,0,1,0,0,0,0,0,0,"A","N","2017-04-13","201704130CHI"
"TOR",0,2,0,0,0,2,1,1,1,0,0,3,"A","N","2017-04-13","201704130WSH"
"WSH",1,1,1,0,0,3,0,2,0,0,0,2,"H","N","2017-04-13","201704130WSH"
"EDM",0,0,1,1,0,2,0,0,0,0,0,0,"H","N","2017-04-14","201704140EDM"
"SJS",0,0,0,0,0,0,0,0,1,1,0,2,"A","N","2017-04-14","201704140EDM"
"MIN",0,0,1,0,0,1,0,0,1,1,0,2,"H","N","2017-04-14","201704140MIN"
"STL",0,0,1,1,0,2,0,0,1,0,0,1,"A","N","2017-04-14","201704140MIN"
"MTL",1,2,0,1,0,4,0,1,2,0,0,3,"H","N","2017-04-14","201704140MTL"
"NYR",0,1,2,0,0,3,1,2,0,1,0,4,"A","N","2017-04-14","201704140MTL"
"CBJ",0,0,1,0,0,1,0,1,1,2,0,4,"A","N","2017-04-14","201704140PIT"
"PIT",0,1,1,2,0,4,0,0,1,0,0,1,"H","N","2017-04-14","201704140PIT"
"ANA",0,2,0,1,0,3,0,1,1,0,0,2,"H","N","2017-04-15","201704150ANA"
"CGY",0,1,1,0,0,2,0,2,0,1,0,3,"A","N","2017-04-15","201704150ANA"
"CHI",0,0,0,0,0,0,0,1,2,2,0,5,"H","N","2017-04-15","201704150CHI"
"NSH",0,1,2,2,0,5,0,0,0,0,0,0,"A","N","2017-04-15","201704150CHI"
"BOS",0,0,3,0,0,3,1,0,1,2,0,4,"A","N","2017-04-15","201704150OTT"
"OTT",1,0,1,2,0,4,0,0,3,0,0,3,"H","N","2017-04-15","201704150OTT"
"TOR",1,1,2,0,0,4,0,0,2,1,0,3,"A","N","2017-04-15","201704150WSH"
"WSH",0,0,2,1,0,3,1,1,2,0,0,4,"H","N","2017-04-15","201704150WSH"
"CBJ",0,3,0,1,0,4,1,1,2,1,0,5,"H","N","2017-04-16","201704160CBJ"
"PIT",1,1,2,1,0,5,0,3,0,1,0,4,"A","N","2017-04-16","201704160CBJ"
"MTL",0,0,1,2,0,3,0,0,0,1,0,1,"A","N","2017-04-16","201704160NYR"
"NYR",0,0,0,1,0,1,0,0,1,2,0,3,"H","N","2017-04-16","201704160NYR"
"EDM",0,0,0,1,0,1,0,0,0,0,0,0,"A","N","2017-04-16","201704160SJS"
"SJS",0,0,0,0,0,0,0,0,0,1,0,1,"H","N","2017-04-16","201704160SJS"
"MIN",0,0,1,0,0,1,0,1,1,1,0,3,"A","N","2017-04-16","201704160STL"
"STL",0,1,1,1,0,3,0,0,1,0,0,1,"H","N","2017-04-16","201704160STL"
"BOS",0,0,3,0,0,3,1,2,1,0,0,4,"H","N","2017-04-17","201704170BOS"
"OTT",1,2,1,0,0,4,0,0,3,0,0,3,"A","N","2017-04-17","201704170BOS"
"ANA",1,1,1,2,0,5,0,2,2,0,0,4,"A","N","2017-04-17","201704170CGY"
"CGY",0,2,2,0,0,4,1,1,1,2,0,5,"H","N","2017-04-17","201704170CGY"
"CHI",0,0,2,0,0,2,1,0,0,2,0,3,"A","N","2017-04-17","201704170NSH"
"NSH",1,0,0,2,0,3,0,0,2,0,0,2,"H","N","2017-04-17","201704170NSH"
"TOR",1,1,2,0,0,4,0,2,1,0,0,3,"H","N","2017-04-17","201704170TOR"
"WSH",0,2,1,0,0,3,1,1,2,0,0,4,"A","N","2017-04-17","201704170TOR"
"CBJ",0,2,1,2,0,5,0,0,2,2,0,4,"H","N","2017-04-18","201704180CBJ"
"PIT",0,0,2,2,0,4,0,2,1,2,0,5,"A","N","2017-04-18","201704180CBJ"
"MTL",0,1,0,0,0,1,0,1,1,0,0,2,"A","N","2017-04-18","201704180NYR"
"NYR",0,1,1,0,0,2,0,1,0,0,0,1,"H","N","2017-04-18","201704180NYR"
"EDM",0,0,0,0,0,0,0,2,4,1,0,7,"A","N","2017-04-18","201704180SJS"
"SJS",0,2,4,1,0,7,0,0,0,0,0,0,"H","N","2017-04-18","201704180SJS"
"BOS",0,0,0,0,0,0,0,0,0,1,0,1,"H","N","2017-04-19","201704190BOS"
"OTT",0,0,0,1,0,1,0,0,0,0,0,0,"A","N","2017-04-19","201704190BOS"
"ANA",0,2,0,1,0,3,0,0,1,0,0,1,"A","N","2017-04-19","201704190CGY"
"CGY",0,0,1,0,0,1,0,2,0,1,0,3,"H","N","2017-04-19","201704190CGY"
"MIN",0,1,1,0,0,2,0,0,0,0,0,0,"A","N","2017-04-19","201704190STL"
"STL",0,0,0,0,0,0,0,1,1,0,0,2,"H","N","2017-04-19","201704190STL"
"TOR",0,1,1,2,0,4,0,4,0,1,0,5,"H","N","2017-04-19","201704190TOR"
"WSH",0,4,0,1,0,5,0,1,1,2,0,4,"A","N","2017-04-19","201704190TOR"
"EDM",1,1,1,1,0,4,0,2,1,0,0,3,"H","N","2017-04-20","201704200EDM"
"SJS",0,2,1,0,0,3,1,1,1,1,0,4,"A","N","2017-04-20","201704200EDM"
"MTL",0,2,0,0,0,2,1,1,1,0,0,3,"H","N","2017-04-20","201704200MTL"
"NYR",1,1,1,0,0,3,0,2,0,0,0,2,"A","N","2017-04-20","201704200MTL"
"CHI",0,0,0,1,0,1,0,0,1,3,0,4,"A","N","2017-04-20","201704200NSH"
"NSH",0,0,1,3,0,4,0,0,0,1,0,1,"H","N","2017-04-20","201704200NSH"
"CBJ",0,0,2,0,0,2,0,1,2,2,0,5,"A","N","2017-04-20","201704200PIT"
"PIT",0,1,2,2,0,5,0,0,2,0,0,2,"H","N","2017-04-20","201704200PIT"
"BOS",1,0,2,0,0,3,0,1,1,0,0,2,"A","N","2017-04-21","201704210OTT"
"OTT",0,1,1,0,0,2,1,0,2,0,0,3,"H","N","2017-04-21","201704210OTT"
"TOR",0,0,1,0,0,1,1,1,0,0,0,2,"A","N","2017-04-21","201704210WSH"
"WSH",1,1,0,0,0,2,0,0,1,0,0,1,"H","N","2017-04-21","201704210WSH"
"MIN",0,1,0,2,0,3,1,2,0,1,0,4,"H","N","2017-04-22","201704220MIN"
"STL",1,2,0,1,0,4,0,1,0,2,0,3,"A","N","2017-04-22","201704220MIN"
"MTL",0,1,0,0,0,1,0,0,2,1,0,3,"A","N","2017-04-22","201704220NYR"
"NYR",0,0,2,1,0,3,0,1,0,0,0,1,"H","N","2017-04-22","201704220NYR"
"EDM",0,0,2,1,0,3,0,0,0,1,0,1,"A","N","2017-04-22","201704220SJS"
"SJS",0,0,0,1,0,1,0,0,2,1,0,3,"H","N","2017-04-22","201704220SJS"
"BOS",0,1,0,1,0,2,1,0,2,0,0,3,"H","N","2017-04-23","201704230BOS"
"OTT",1,0,2,0,0,3,0,1,0,1,0,2,"A","N","2017-04-23","201704230BOS"
"TOR",0,0,0,1,0,1,1,0,0,1,0,2,"H","N","2017-04-23","201704230TOR"
"WSH",1,0,0,1,0,2,0,0,0,1,0,1,"A","N","2017-04-23","201704230TOR"
"ANA",0,0,1,2,0,3,0,0,1,4,0,5,"H","N","2017-04-26","201704260ANA"
"EDM",0,0,1,4,0,5,0,0,1,2,0,3,"A","N","2017-04-26","201704260ANA"
"NSH",0,1,2,1,0,4,0,0,1,2,0,3,"A","N","2017-04-26","201704260STL"
"STL",0,0,1,2,0,3,0,1,2,1,0,4,"H","N","2017-04-26","201704260STL"
"NYR",0,0,1,0,0,1,0,0,1,1,0,2,"A","N","2017-04-27","201704270OTT"
"OTT",0,0,1,1,0,2,0,0,1,0,0,1,"H","N","2017-04-27","201704270OTT"
"PIT",0,0,2,1,0,3,0,0,1,1,0,2,"A","N","2017-04-27","201704270WSH"
"WSH",0,0,1,1,0,2,0,0,2,1,0,3,"H","N","2017-04-27","201704270WSH"
"ANA",0,0,1,0,0,1,0,1,1,0,0,2,"H","N","2017-04-28","201704280ANA"
"EDM",0,1,1,0,0,2,0,0,1,0,0,1,"A","N","2017-04-28","201704280ANA"
"NSH",0,1,0,1,0,2,0,1,0,2,0,3,"A","N","2017-04-28","201704280STL"
"STL",0,1,0,2,0,3,0,1,0,1,0,2,"H","N","2017-04-28","201704280STL"
"NYR",0,1,3,1,0,5,1,1,1,3,0,6,"A","N","2017-04-29","201704290OTT"
"OTT",1,1,1,3,0,6,0,1,3,1,0,5,"H","N","2017-04-29","201704290OTT"
"PIT",0,0,3,3,0,6,0,0,1,1,0,2,"A","N","2017-04-29","201704290WSH"
"WSH",0,0,1,1,0,2,0,0,3,3,0,6,"H","N","2017-04-29","201704290WSH"
"ANA",0,3,1,2,0,6,0,1,2,0,0,3,"A","N","2017-04-30","201704300EDM"
"EDM",0,1,2,0,0,3,0,3,1,2,0,6,"H","N","2017-04-30","201704300EDM"
"NSH",0,1,1,1,0,3,0,0,1,0,0,1,"H","N","2017-04-30","201704300NSH"
"STL",0,0,1,0,0,1,0,1,1,1,0,3,"A","N","2017-04-30","201704300NSH"
"PIT",0,0,0,2,0,2,1,1,0,1,0,3,"H","N","2017-05-01","201705010PIT"
"WSH",1,1,0,1,0,3,0,0,0,2,0,2,"A","N","2017-05-01","201705010PIT"
"NSH",0,0,0,2,0,2,0,0,0,1,0,1,"H","N","2017-05-02","201705020NSH"
"STL",0,0,0,1,0,1,0,0,0,2,0,2,"A","N","2017-05-02","201705020NSH"
"NYR",0,2,2,0,0,4,0,0,1,0,0,1,"H","N","2017-05-02","201705020NYR"
"OTT",0,0,1,0,0,1,0,2,2,0,0,4,"A","N","2017-05-02","201705020NYR"
"ANA",1,0,3,0,0,4,0,2,0,1,0,3,"A","N","2017-05-03","201705030EDM"
"EDM",0,2,0,1,0,3,1,0,3,0,0,4,"H","N","2017-05-03","201705030EDM"
"PIT",0,1,2,0,0,3,0,0,2,0,0,2,"H","N","2017-05-03","201705030PIT"
"WSH",0,0,2,0,0,2,0,1,2,0,0,3,"A","N","2017-05-03","201705030PIT"
"NYR",0,1,2,1,0,4,0,0,0,1,0,1,"H","N","2017-05-04","201705040NYR"
"OTT",0,0,0,1,0,1,0,1,2,1,0,4,"A","N","2017-05-04","201705040NYR"
"ANA",1,0,0,3,0,4,0,0,3,0,0,3,"H","N","2017-05-05","201705050ANA"
"EDM",0,0,3,0,0,3,1,0,0,3,0,4,"A","N","2017-05-05","201705050ANA"
"NSH",0,0,1,0,0,1,0,0,1,1,0,2,"A","N","2017-05-05","201705050STL"
"STL",0,0,1,1,0,2,0,0,1,0,0,1,"H","N","2017-05-05","201705050STL"
"NYR",0,2,1,1,0,4,1,1,2,1,0,5,"A","N","2017-05-06","201705060OTT"
"OTT",1,1,2,1,0,5,0,2,1,1,0,4,"H","N","2017-05-06","201705060OTT"
"PIT",0,1,1,0,0,2,0,1,0,3,0,4,"A","N","2017-05-06","201705060WSH"
"WSH",0,1,0,3,0,4,0,1,1,0,0,2,"H","N","2017-05-06","201705060WSH"
"ANA",0,0,1,0,0,1,0,5,2,0,0,7,"A","N","2017-05-07","201705070EDM"
"EDM",0,5,2,0,0,7,0,0,1,0,0,1,"H","N","2017-05-07","201705070EDM"
"NSH",0,0,1,2,0,3,0,1,0,0,0,1,"H","N","2017-05-07","201705070NSH"
"STL",0,1,0,0,0,1,0,0,1,2,0,3,"A","N","2017-05-07","201705070NSH"
"PIT",0,0,0,2,0,2,0,1,1,3,0,5,"H","N","2017-05-08","201705080PIT"
"WSH",0,1,1,3,0,5,0,0,0,2,0,2,"A","N","2017-05-08","201705080PIT"
"NYR",0,0,1,1,0,2,0,2,1,1,0,4,"H","N","2017-05-09","201705090NYR"
"OTT",0,2,1,1,0,4,0,0,1,1,0,2,"A","N","2017-05-09","201705090NYR"
"ANA",0,0,1,1,0,2,0,1,0,0,0,1,"H","N","2017-05-10","201705100ANA"
"EDM",0,1,0,0,0,1,0,0,1,1,0,2,"A","N","2017-05-10","201705100ANA"
"PIT",0,0,1,1,0,2,0,0,0,0,0,0,"A","N","2017-05-10","201705100WSH"
"WSH",0,0,0,0,0,0,0,0,1,1,0,2,"H","N","2017-05-10","201705100WSH"
"ANA",0,1,0,1,0,2,1,1,1,0,0,3,"H","N","2017-05-12","201705120ANA"
"NSH",1,1,1,0,0,3,0,1,0,1,0,2,"A","N","2017-05-12","201705120ANA"
"OTT",1,1,0,0,0,2,0,0,0,1,0,1,"A","N","2017-05-13","201705130PIT"
"PIT",0,0,0,1,0,1,1,1,0,0,0,2,"H","N","2017-05-13","201705130PIT"
"ANA",0,1,3,1,0,5,0,2,1,0,0,3,"H","N","2017-05-14","201705140ANA"
"NSH",0,2,1,0,0,3,0,1,3,1,0,5,"A","N","2017-05-14","201705140ANA"
"OTT",0,0,0,0,0,0,0,0,0,1,0,1,"A","N","2017-05-15","201705150PIT"
"PIT",0,0,0,1,0,1,0,0,0,0,0,0,"H","N","2017-05-15","201705150PIT"
"ANA",0,0,1,0,0,1,0,0,0,2,0,2,"A","N","2017-05-16","201705160NSH"
"NSH",0,0,0,2,0,2,0,0,1,0,0,1,"H","N","2017-05-16","201705160NSH"
"OTT",0,4,1,0,0,5,0,0,0,1,0,1,"H","N","2017-05-17","201705170OTT"
"PIT",0,0,0,1,0,1,0,4,1,0,0,5,"A","N","2017-05-17","201705170OTT"
"ANA",1,1,1,0,0,3,0,0,0,2,0,2,"A","N","2017-05-18","201705180NSH"
"NSH",0,0,0,2,0,2,1,1,1,0,0,3,"H","N","2017-05-18","201705180NSH"
"OTT",0,0,1,1,0,2,0,1,2,0,0,3,"H","N","2017-05-19","201705190OTT"
"PIT",0,1,2,0,0,3,0,0,1,1,0,2,"A","N","2017-05-19","201705190OTT"
"ANA",0,0,1,0,0,1,0,0,1,2,0,3,"H","N","2017-05-20","201705200ANA"
"NSH",0,0,1,2,0,3,0,0,1,0,0,1,"A","N","2017-05-20","201705200ANA"
"OTT",0,0,0,0,0,0,0,4,1,2,0,7,"A","N","2017-05-21","201705210PIT"
"PIT",0,4,1,2,0,7,0,0,0,0,0,0,"H","N","2017-05-21","201705210PIT"
"ANA",0,0,1,2,0,3,0,2,0,4,0,6,"A","N","2017-05-22","201705220NSH"
"NSH",0,2,0,4,0,6,0,0,1,2,0,3,"H","N","2017-05-22","201705220NSH"
"OTT",0,0,1,1,0,2,0,0,1,0,0,1,"H","N","2017-05-23","201705230OTT"
"PIT",0,0,1,0,0,1,0,0,1,1,0,2,"A","N","2017-05-23","201705230OTT"
"OTT",0,0,1,1,0,2,1,0,1,1,0,3,"A","N","2017-05-25","201705250PIT"
"PIT",1,0,1,1,0,3,0,0,1,1,0,2,"H","N","2017-05-25","201705250PIT"
"NSH",0,0,1,2,0,3,0,3,0,2,0,5,"A","N","2017-05-29","201705290PIT"
"PIT",0,3,0,2,0,5,0,0,1,2,0,3,"H","N","2017-05-29","201705290PIT"
"NSH",0,1,0,0,0,1,0,1,0,3,0,4,"A","N","2017-05-31","201705310PIT"
"PIT",0,1,0,3,0,4,0,1,0,0,0,1,"H","N","2017-05-31","201705310PIT"
"NSH",0,0,3,2,0,5,0,1,0,0,0,1,"H","N","2017-06-03","201706030NSH"
"PIT",0,1,0,0,0,1,0,0,3,2,0,5,"A","N","2017-06-03","201706030NSH"
"NSH",0,1,2,1,0,4,0,1,0,0,0,1,"H","N","2017-06-05","201706050NSH"
"PIT",0,1,0,0,0,1,0,1,2,1,0,4,"A","N","2017-06-05","201706050NSH"
"NSH",0,0,0,0,0,0,0,3,3,0,0,6,"A","N","2017-06-08","201706080PIT"
"PIT",0,3,3,0,0,6,0,0,0,0,0,0,"H","N","2017-06-08","201706080PIT"
"NSH",0,0,0,0,0,0,0,0,0,2,0,2,"H","N","2017-06-11","201706110NSH"
"PIT",0,0,0,2,0,2,0,0,0,0,0,0,"A","N","2017-06-11","201706110NSH"
"CGY",0,0,0,0,0,0,0,1,0,2,0,3,"A","N","2017-10-04","201710040EDM"
"EDM",0,1,0,2,0,3,0,0,0,0,0,0,"H","N","2017-10-04","201710040EDM"
"PIT",0,1,1,2,0,4,1,2,1,1,0,5,"H","N","2017-10-04","201710040PIT"
"STL",1,2,1,1,0,5,0,1,1,2,0,4,"A","N","2017-10-04","201710040PIT"
"PHI",0,2,1,2,0,5,0,2,0,1,0,3,"A","N","2017-10-04","201710040SJS"
"SJS",0,2,0,1,0,3,0,2,1,2,0,5,"H","N","2017-10-04","201710040SJS"
"TOR",0,3,1,3,0,7,0,0,0,2,0,2,"A","N","2017-10-04","201710040WPG"
"WPG",0,0,0,2,0,2,0,3,1,3,0,7,"H","N","2017-10-04","201710040WPG"
"ANA",0,1,2,2,0,5,0,2,2,0,0,4,"H","N","2017-10-05","201710050ANA"
"ARI",0,2,2,0,0,4,0,1,2,2,0,5,"A","N","2017-10-05","201710050ANA"
"BOS",0,1,2,1,0,4,0,1,0,2,0,3,"H","N","2017-10-05","201710050BOS"
"NSH",0,1,0,2,0,3,0,1,2,1,0,4,"A","N","2017-10-05","201710050BOS"
"BUF",0,1,1,0,0,2,0,1,0,1,1,3,"H","Y","2017-10-05","201710050BUF"
"MTL",0,1,0,1,1,3,0,1,1,0,0,2,"A","Y","2017-10-05","201710050BUF"
"CHI",0,5,3,2,0,10,0,0,1,0,0,1,"H","N","2017-10-05","201710050CHI"
"PIT",0,0,1,0,0,1,0,5,3,2,0,10,"A","N","2017-10-05","201710050CHI"
"DET",0,0,2,2,0,4,0,0,0,2,0,2,"H","N","2017-10-05","201710050DET"
"MIN",0,0,0,2,0,2,0,0,2,2,0,4,"A","N","2017-10-05","201710050DET"
"LAK",0,0,1,1,0,2,0,0,0,0,0,0,"H","N","2017-10-05","201710050LAK"
"PHI",0,0,0,0,0,0,0,0,1,1,0,2,"A","N","2017-10-05","201710050LAK"
"COL",0,2,1,1,0,4,0,2,0,0,0,2,"A","N","2017-10-05","201710050NYR"
"NYR",0,2,0,0,0,2,0,2,1,1,0,4,"H","N","2017-10-05","201710050NYR"
"OTT",0,1,1,2,0,4,0,1,0,3,1,5,"H","Y","2017-10-05","201710050OTT"
"WSH",0,1,0,3,1,5,0,1,1,2,0,4,"A","Y","2017-10-05","201710050OTT"
"CBJ",0,2,3,0,0,5,0,0,0,0,0,0,"H","N","2017-10-06","201710060CBJ"
"NYI",0,0,0,0,0,0,0,2,3,0,0,5,"A","N","2017-10-06","201710060CBJ"
"DAL",0,0,1,0,0,1,0,0,0,2,0,2,"H","N","2017-10-06","201710060DAL"
"VEG",0,0,0,2,0,2,0,0,1,0,0,1,"A","N","2017-10-06","201710060DAL"
"FLA",0,0,2,1,0,3,0,1,1,3,0,5,"A","N","2017-10-06","201710060TBL"
"TBL",0,1,1,3,0,5,0,0,2,1,0,3,"H","N","2017-10-06","201710060TBL"
"ANA",0,1,0,1,0,2,1,1,1,0,0,3,"H","N","2017-10-07","201710070ANA"
"PHI",1,1,1,0,0,3,0,1,0,1,0,2,"A","N","2017-10-07","201710070ANA"
"ARI",0,1,0,0,0,1,1,0,0,1,0,2,"H","N","2017-10-07","201710070ARI"
"VEG",1,0,0,1,0,2,0,1,0,0,0,1,"A","N","2017-10-07","201710070ARI"
"CAR",0,1,1,2,1,5,0,2,1,1,0,4,"H","Y","2017-10-07","201710070CAR"
"MIN",0,2,1,1,0,4,0,1,1,2,1,5,"A","Y","2017-10-07","201710070CAR"
"CGY",0,1,4,1,0,6,0,3,0,0,0,3,"H","N","2017-10-07","201710070CGY"
"WPG",0,3,0,0,0,3,0,1,4,1,0,6,"A","N","2017-10-07","201710070CGY"
"CBJ",0,0,1,0,0,1,0,2,2,1,0,5,"A","N","2017-10-07","201710070CHI"
"CHI",0,2,2,1,0,5,0,0,1,0,0,1,"H","N","2017-10-07","201710070CHI"
"FLA",0,1,1,3,0,5,0,2,1,1,0,4,"H","N","2017-10-07","201710070FLA"
"TBL",0,2,1,1,0,4,0,1,1,3,0,5,"A","N","2017-10-07","201710070FLA"
"COL",0,0,1,0,0,1,0,1,2,1,0,4,"A","N","2017-10-07","201710070NJD"
"NJD",0,1,2,1,0,4,0,0,1,0,0,1,"H","N","2017-10-07","201710070NJD"
"BUF",0,0,2,1,0,3,0,1,3,2,0,6,"A","N","2017-10-07","201710070NYI"
"NYI",0,1,3,2,0,6,0,0,2,1,0,3,"H","N","2017-10-07","201710070NYI"
"DET",0,0,0,1,1,2,0,0,0,1,0,1,"A","Y","2017-10-07","201710070OTT"
"OTT",0,0,0,1,0,1,0,0,0,1,1,2,"H","Y","2017-10-07","201710070OTT"
"NSH",0,0,0,0,0,0,0,2,1,1,0,4,"A","N","2017-10-07","201710070PIT"
"PIT",0,2,1,1,0,4,0,0,0,0,0,0,"H","N","2017-10-07","201710070PIT"
"LAK",0,2,2,0,0,4,0,1,0,0,0,1,"A","N","2017-10-07","201710070SJS"
"SJS",0,1,0,0,0,1,0,2,2,0,0,4,"H","N","2017-10-07","201710070SJS"
"DAL",0,0,0,2,0,2,0,3,0,1,0,4,"A","N","2017-10-07","201710070STL"
"STL",0,3,0,1,0,4,0,0,0,2,0,2,"H","N","2017-10-07","201710070STL"
"NYR",0,2,3,0,0,5,0,5,0,3,0,8,"A","N","2017-10-07","201710070TOR"
"TOR",0,5,0,3,0,8,0,2,3,0,0,5,"H","N","2017-10-07","201710070TOR"
"EDM",0,1,0,1,0,2,0,2,1,0,0,3,"A","N","2017-10-07","201710070VAN"
"VAN",0,2,1,0,0,3,0,1,0,1,0,2,"H","N","2017-10-07","201710070VAN"
"MTL",0,0,1,0,0,1,0,4,2,0,0,6,"A","N","2017-10-07","201710070WSH"
"WSH",0,4,2,0,0,6,0,0,1,0,0,1,"H","N","2017-10-07","201710070WSH"
"MTL",0,0,0,0,0,0,0,1,0,1,0,2,"A","N","2017-10-08","201710080NYR"
"NYR",0,1,0,1,0,2,0,0,0,0,0,0,"H","N","2017-10-08","201710080NYR"
"ANA",0,0,0,0,0,0,0,0,1,1,0,2,"H","N","2017-10-09","201710090ANA"
"CGY",0,0,1,1,0,2,0,0,0,0,0,0,"A","N","2017-10-09","201710090ANA"
"BOS",0,0,0,0,0,0,0,2,0,2,0,4,"H","N","2017-10-09","201710090BOS"
"COL",0,2,0,2,0,4,0,0,0,0,0,0,"A","N","2017-10-09","201710090BOS"
"BUF",0,0,1,1,0,2,0,2,4,0,0,6,"H","N","2017-10-09","201710090BUF"
"NJD",0,2,4,0,0,6,0,0,1,1,0,2,"A","N","2017-10-09","201710090BUF"
"EDM",0,0,2,0,0,2,0,2,2,1,0,5,"H","N","2017-10-09","201710090EDM"
"WPG",0,2,2,1,0,5,0,0,2,0,0,2,"A","N","2017-10-09","201710090EDM"
"NYI",0,0,0,2,0,2,0,0,2,0,1,3,"H","Y","2017-10-09","201710090NYI"
"STL",0,0,2,0,1,3,0,0,0,2,0,2,"A","Y","2017-10-09","201710090NYI"
"TBL",1,0,2,1,0,4,0,2,1,0,0,3,"H","N","2017-10-09","201710090TBL"
"WSH",0,2,1,0,0,3,1,0,2,1,0,4,"A","N","2017-10-09","201710090TBL"
"CHI",0,2,0,1,0,3,1,0,1,2,0,4,"A","N","2017-10-09","201710090TOR"
"TOR",1,0,1,2,0,4,0,2,0,1,0,3,"H","N","2017-10-09","201710090TOR"
"CAR",0,0,0,1,0,1,1,0,0,1,0,2,"H","N","2017-10-10","201710100CAR"
"CBJ",1,0,0,1,0,2,0,0,0,1,0,1,"A","N","2017-10-10","201710100CAR"
"DAL",0,2,1,1,0,4,0,0,1,1,0,2,"H","N","2017-10-10","201710100DAL"
"DET",0,0,1,1,0,2,0,2,1,1,0,4,"A","N","2017-10-10","201710100DAL"
"CHI",0,2,1,0,0,3,0,1,0,0,0,1,"A","N","2017-10-10","201710100MTL"
"MTL",0,1,0,0,0,1,0,2,1,0,0,3,"H","N","2017-10-10","201710100MTL"
"NSH",0,1,2,3,0,6,0,0,3,2,0,5,"H","N","2017-10-10","201710100NSH"
"PHI",0,0,3,2,0,5,0,1,2,3,0,6,"A","N","2017-10-10","201710100NSH"
"NYR",0,1,0,0,0,1,0,2,0,1,0,3,"H","N","2017-10-10","201710100NYR"
"STL",0,2,0,1,0,3,0,1,0,0,0,1,"A","N","2017-10-10","201710100NYR"
"OTT",0,1,0,1,1,3,0,1,1,0,0,2,"A","Y","2017-10-10","201710100VAN"
"VAN",0,1,1,0,0,2,0,1,0,1,1,3,"H","Y","2017-10-10","201710100VAN"
"ARI",0,1,0,1,0,2,0,4,1,0,0,5,"A","N","2017-10-10","201710100VEG"
"VEG",0,4,1,0,0,5,0,1,0,1,0,2,"H","N","2017-10-10","201710100VEG"
"ANA",0,1,1,1,0,3,0,1,0,1,0,2,"H","N","2017-10-11","201710110ANA"
"NYI",0,1,0,1,0,2,0,1,1,1,0,3,"A","N","2017-10-11","201710110ANA"
"BOS",0,1,0,2,0,3,0,1,3,2,0,6,"A","N","2017-10-11","201710110COL"
"COL",0,1,3,2,0,6,0,1,0,2,0,3,"H","N","2017-10-11","201710110COL"
"CGY",1,2,0,1,0,4,0,0,1,2,0,3,"A","N","2017-10-11","201710110LAK"
"LAK",0,0,1,2,0,3,1,2,0,1,0,4,"H","N","2017-10-11","201710110LAK"
"NJD",0,2,2,2,0,6,0,2,0,1,0,3,"A","N","2017-10-11","201710110TOR"
"TOR",0,2,0,1,0,3,0,2,2,2,0,6,"H","N","2017-10-11","201710110TOR"
"PIT",0,1,1,1,0,3,0,0,1,1,0,2,"A","N","2017-10-11","201710110WSH"
"WSH",0,0,1,1,0,2,0,1,1,1,0,3,"H","N","2017-10-11","201710110WSH"
"ARI",0,0,2,0,0,2,0,0,2,2,0,4,"H","N","2017-10-12","201710120ARI"
"DET",0,0,2,2,0,4,0,0,2,0,0,2,"A","N","2017-10-12","201710120ARI"
"CHI",0,0,0,2,0,2,0,0,1,4,0,5,"H","N","2017-10-12","201710120CHI"
"MIN",0,0,1,4,0,5,0,0,0,2,0,2,"A","N","2017-10-12","201710120CHI"
"FLA",0,0,3,2,0,5,0,0,1,1,0,2,"H","N","2017-10-12","201710120FLA"
"STL",0,0,1,1,0,2,0,0,3,2,0,5,"A","N","2017-10-12","201710120FLA"
"DAL",0,1,0,0,0,1,0,0,2,2,0,4,"A","N","2017-10-12","201710120NSH"
"NSH",0,0,2,2,0,4,0,1,0,0,0,1,"H","N","2017-10-12","201710120NSH"
"BUF",0,1,1,0,0,2,0,2,1,0,0,3,"A","N","2017-10-12","201710120SJS"
"SJS",0,2,1,0,0,3,0,1,1,0,0,2,"H","N","2017-10-12","201710120SJS"
"PIT",0,1,2,1,0,4,0,2,3,0,0,5,"A","N","2017-10-12","201710120TBL"
"TBL",0,2,3,0,0,5,0,1,2,1,0,4,"H","N","2017-10-12","201710120TBL"
"VAN",0,1,0,1,0,2,0,1,2,1,0,4,"H","N","2017-10-12","201710120VAN"
"WPG",0,1,2,1,0,4,0,1,0,1,0,2,"A","N","2017-10-12","201710120VAN"
"CBJ",0,0,1,2,0,3,0,1,0,0,0,1,"H","N","2017-10-13","201710130CBJ"
"NYR",0,1,0,0,0,1,0,0,1,2,0,3,"A","N","2017-10-13","201710130CBJ"
"CGY",0,0,0,0,0,0,0,1,1,4,0,6,"H","N","2017-10-13","201710130CGY"
"OTT",0,1,1,4,0,6,0,0,0,0,0,0,"A","N","2017-10-13","201710130CGY"
"ANA",0,0,0,1,0,1,0,1,0,2,0,3,"A","N","2017-10-13","201710130COL"
"COL",0,1,0,2,0,3,0,0,0,1,0,1,"H","N","2017-10-13","201710130COL"
"NJD",0,0,1,1,0,2,0,1,2,2,0,5,"H","N","2017-10-13","201710130NJD"
"WSH",0,1,2,2,0,5,0,0,1,1,0,2,"A","N","2017-10-13","201710130NJD"
"DET",0,1,1,4,0,6,0,0,3,0,0,3,"A","N","2017-10-13","201710130VEG"
"VEG",0,0,3,0,0,3,0,1,1,4,0,6,"H","N","2017-10-13","201710130VEG"
"ARI",0,1,0,1,0,2,0,1,3,2,0,6,"H","N","2017-10-14","201710140ARI"
"BOS",0,1,3,2,0,6,0,1,0,1,0,2,"A","N","2017-10-14","201710140ARI"
"CHI",1,0,0,1,0,2,0,0,1,0,0,1,"H","N","2017-10-14","201710140CHI"
"NSH",0,0,1,0,0,1,1,0,0,1,0,2,"A","N","2017-10-14","201710140CHI"
"COL",0,0,0,1,0,1,0,0,2,1,0,3,"A","N","2017-10-14","201710140DAL"
"DAL",0,0,2,1,0,3,0,0,0,1,0,1,"H","N","2017-10-14","201710140DAL"
"EDM",0,0,0,1,0,1,0,2,1,3,0,6,"H","N","2017-10-14","201710140EDM"
"OTT",0,2,1,3,0,6,0,0,0,1,0,1,"A","N","2017-10-14","201710140EDM"
"BUF",0,1,0,1,0,2,0,0,1,3,0,4,"A","N","2017-10-14","201710140LAK"
"LAK",0,0,1,3,0,4,0,1,0,1,0,2,"H","N","2017-10-14","201710140LAK"
"CBJ",1,1,1,2,0,5,0,1,2,1,0,4,"A","N","2017-10-14","201710140MIN"
"MIN",0,1,2,1,0,4,1,1,1,2,0,5,"H","N","2017-10-14","201710140MIN"
"MTL",0,2,1,0,0,3,1,2,1,0,0,4,"H","N","2017-10-14","201710140MTL"
"TOR",1,2,1,0,0,4,0,2,1,0,0,3,"A","N","2017-10-14","201710140MTL"
"NJD",0,0,2,1,0,3,0,0,1,1,0,2,"A","N","2017-10-14","201710140NYR"
"NYR",0,0,1,1,0,2,0,0,2,1,0,3,"H","N","2017-10-14","201710140NYR"
"PHI",0,2,3,3,0,8,0,1,1,0,0,2,"H","N","2017-10-14","201710140PHI"
"WSH",0,1,1,0,0,2,0,2,3,3,0,8,"A","N","2017-10-14","201710140PHI"
"FLA",0,0,2,1,0,3,0,1,2,1,0,4,"A","N","2017-10-14","201710140PIT"
"PIT",0,1,2,1,0,4,0,0,2,1,0,3,"H","N","2017-10-14","201710140PIT"
"NYI",0,1,1,1,0,3,0,1,0,0,0,1,"A","N","2017-10-14","201710140SJS"
"SJS",0,1,0,0,0,1,0,1,1,1,0,3,"H","N","2017-10-14","201710140SJS"
"STL",0,0,0,1,0,1,0,0,1,1,0,2,"A","N","2017-10-14","201710140TBL"
"TBL",0,0,1,1,0,2,0,0,0,1,0,1,"H","N","2017-10-14","201710140TBL"
"CGY",0,1,2,2,0,5,0,1,0,1,0,2,"A","N","2017-10-14","201710140VAN"
"VAN",0,1,0,1,0,2,0,1,2,2,0,5,"H","N","2017-10-14","201710140VAN"
"CAR",0,1,0,0,0,1,0,1,0,1,0,2,"A","N","2017-10-14","201710140WPG"
"WPG",0,1,0,1,0,2,0,1,0,0,0,1,"H","N","2017-10-14","201710140WPG"
"ANA",0,0,1,0,0,1,0,1,1,1,0,3,"H","N","2017-10-15","201710150ANA"
"BUF",0,1,1,1,0,3,0,0,1,0,0,1,"A","N","2017-10-15","201710150ANA"
"LAK",0,1,1,1,0,3,0,0,1,1,0,2,"H","N","2017-10-15","201710150LAK"
"NYI",0,0,1,1,0,2,0,1,1,1,0,3,"A","N","2017-10-15","201710150LAK"
"BOS",0,0,0,1,0,1,0,0,2,1,0,3,"A","N","2017-10-15","201710150VEG"
"VEG",0,0,2,1,0,3,0,0,0,1,0,1,"H","N","2017-10-15","201710150VEG"
"DET",0,0,2,0,0,2,0,2,0,1,0,3,"H","N","2017-10-16","201710160DET"
"TBL",0,2,0,1,0,3,0,0,2,0,0,2,"A","N","2017-10-16","201710160DET"
"ARI",0,0,1,0,0,1,0,1,1,1,0,3,"A","N","2017-10-17","201710170DAL"
"DAL",0,1,1,1,0,3,0,0,1,0,0,1,"H","N","2017-10-17","201710170DAL"
"CAR",0,3,0,2,0,5,0,0,1,2,0,3,"A","N","2017-10-17","201710170EDM"
"EDM",0,0,1,2,0,3,0,3,0,2,0,5,"H","N","2017-10-17","201710170EDM"
"NJD",0,3,0,1,1,5,0,2,2,0,0,4,"H","Y","2017-10-17","201710170NJD"
"TBL",0,2,2,0,0,4,0,3,0,1,1,5,"A","Y","2017-10-17","201710170NJD"
"COL",0,0,1,0,0,1,0,0,3,1,0,4,"A","N","2017-10-17","201710170NSH"
"NSH",0,0,3,1,0,4,0,0,1,0,0,1,"H","N","2017-10-17","201710170NSH"
"NYR",0,0,3,1,0,4,1,2,1,1,0,5,"H","N","2017-10-17","201710170NYR"
"PIT",1,2,1,1,0,5,0,0,3,1,0,4,"A","N","2017-10-17","201710170NYR"
"OTT",0,0,0,0,0,0,0,1,1,1,0,3,"H","N","2017-10-17","201710170OTT"
"VAN",0,1,1,1,0,3,0,0,0,0,0,0,"A","N","2017-10-17","201710170OTT"
"FLA",0,0,0,1,0,1,0,0,4,1,0,5,"A","N","2017-10-17","201710170PHI"
"PHI",0,0,4,1,0,5,0,0,0,1,0,1,"H","N","2017-10-17","201710170PHI"
"MTL",0,1,1,0,0,2,0,1,3,1,0,5,"A","N","2017-10-17","201710170SJS"
"SJS",0,1,3,1,0,5,0,1,1,0,0,2,"H","N","2017-10-17","201710170SJS"
"BUF",0,1,0,3,0,4,1,1,2,1,0,5,"A","N","2017-10-17","201710170VEG"
"VEG",1,1,2,1,0,5,0,1,0,3,0,4,"H","N","2017-10-17","201710170VEG"
"CBJ",0,0,4,1,0,5,0,0,1,1,0,2,"A","N","2017-10-17","201710170WPG"
"WPG",0,0,1,1,0,2,0,0,4,1,0,5,"H","N","2017-10-17","201710170WPG"
"TOR",0,0,0,2,0,2,0,0,0,0,0,0,"A","N","2017-10-17","201710170WSH"
"WSH",0,0,0,0,0,0,0,0,0,2,0,2,"H","N","2017-10-17","201710170WSH"
"LAK",0,1,0,4,0,5,0,1,0,0,0,1,"H","N","2017-10-18","201710180LAK"
"MTL",0,1,0,0,0,1,0,1,0,4,0,5,"A","N","2017-10-18","201710180LAK"
"CHI",0,0,0,2,0,2,0,1,2,2,0,5,"A","N","2017-10-18","201710180STL"
"STL",0,1,2,2,0,5,0,0,0,2,0,2,"H","N","2017-10-18","201710180STL"
"DET",0,1,2,0,0,3,0,4,1,1,0,6,"A","N","2017-10-18","201710180TOR"
"TOR",0,4,1,1,0,6,0,1,2,0,0,3,"H","N","2017-10-18","201710180TOR"
"ARI",0,1,1,2,0,4,0,2,0,3,0,5,"H","N","2017-10-19","201710190ARI"
"DAL",0,2,0,3,0,5,0,1,1,2,0,4,"A","N","2017-10-19","201710190ARI"
"BOS",0,4,1,1,0,6,0,1,2,0,0,3,"H","N","2017-10-19","201710190BOS"
"VAN",0,1,2,0,0,3,0,4,1,1,0,6,"A","N","2017-10-19","201710190BOS"
"CBJ",0,0,0,0,0,0,0,1,1,0,0,2,"H","N","2017-10-19","201710190CBJ"
"TBL",0,1,1,0,0,2,0,0,0,0,0,0,"A","N","2017-10-19","201710190CBJ"
"CAR",0,0,1,1,0,2,0,0,0,1,0,1,"A","N","2017-10-19","201710190CGY"
"CGY",0,0,0,1,0,1,0,0,1,1,0,2,"H","N","2017-10-19","201710190CGY"
"CHI",0,1,0,0,0,1,1,1,0,0,0,2,"H","N","2017-10-19","201710190CHI"
"EDM",1,1,0,0,0,2,0,1,0,0,0,1,"A","N","2017-10-19","201710190CHI"
"COL",0,1,0,2,0,3,0,0,3,1,0,4,"H","N","2017-10-19","201710190COL"
"STL",0,0,3,1,0,4,0,1,0,2,0,3,"A","N","2017-10-19","201710190COL"
"NYI",0,2,1,0,1,4,0,1,0,2,0,3,"A","Y","2017-10-19","201710190NYR"
"NYR",0,1,0,2,0,3,0,2,1,0,1,4,"H","Y","2017-10-19","201710190NYR"
"NJD",1,2,0,2,0,5,0,1,3,0,0,4,"A","N","2017-10-19","201710190OTT"
"OTT",0,1,3,0,0,4,1,2,0,2,0,5,"H","N","2017-10-19","201710190OTT"
"NSH",0,0,0,1,0,1,0,0,0,0,0,0,"A","N","2017-10-19","201710190PHI"
"PHI",0,0,0,0,0,0,0,0,0,1,0,1,"H","N","2017-10-19","201710190PHI"
"ANA",0,3,0,3,0,6,0,0,2,0,0,2,"H","N","2017-10-20","201710200ANA"
"MTL",0,0,2,0,0,2,0,3,0,3,0,6,"A","N","2017-10-20","201710200ANA"
"BUF",0,2,0,0,0,2,0,1,2,1,0,4,"H","N","2017-10-20","201710200BUF"
"VAN",0,1,2,1,0,4,0,2,0,0,0,2,"A","N","2017-10-20","201710200BUF"
"DET",0,0,1,2,0,3,1,0,1,2,0,4,"H","N","2017-10-20","201710200DET"
"WSH",1,0,1,2,0,4,0,0,1,2,0,3,"A","N","2017-10-20","201710200DET"
"FLA",0,2,0,1,0,3,0,0,3,1,0,4,"H","N","2017-10-20","201710200FLA"
"PIT",0,0,3,1,0,4,0,2,0,1,0,3,"A","N","2017-10-20","201710200FLA"
"NJD",0,0,0,0,0,0,0,1,2,0,0,3,"H","N","2017-10-20","201710200NJD"
"SJS",0,1,2,0,0,3,0,0,0,0,0,0,"A","N","2017-10-20","201710200NJD"
"MIN",0,1,2,0,0,3,0,2,1,1,0,4,"A","N","2017-10-20","201710200WPG"
"WPG",0,2,1,1,0,4,0,1,2,0,0,3,"H","N","2017-10-20","201710200WPG"
"ARI",0,1,1,0,0,2,0,1,1,2,0,4,"H","N","2017-10-21","201710210ARI"
"CHI",0,1,1,2,0,4,0,1,1,0,0,2,"A","N","2017-10-21","201710210ARI"
"BOS",0,2,2,0,0,4,1,0,2,2,0,5,"H","N","2017-10-21","201710210BOS"
"BUF",1,0,2,2,0,5,0,2,2,0,0,4,"A","N","2017-10-21","201710210BOS"
"CBJ",0,3,1,0,0,4,0,2,2,2,0,6,"H","N","2017-10-21","201710210CBJ"
"LAK",0,2,2,2,0,6,0,3,1,0,0,4,"A","N","2017-10-21","201710210CBJ"
"CGY",0,0,1,1,0,2,0,0,1,3,0,4,"H","N","2017-10-21","201710210CGY"
"MIN",0,0,1,3,0,4,0,0,1,1,0,2,"A","N","2017-10-21","201710210CGY"
"CAR",0,0,1,2,0,3,0,2,2,0,0,4,"A","N","2017-10-21","201710210DAL"
"DAL",0,2,2,0,0,4,0,0,1,2,0,3,"H","N","2017-10-21","201710210DAL"
"NYI",0,0,2,3,0,5,0,0,2,1,0,3,"H","N","2017-10-21","201710210NYI"
"SJS",0,0,2,1,0,3,0,0,2,3,0,5,"A","N","2017-10-21","201710210NYI"
"NSH",0,0,2,0,0,2,0,2,1,1,0,4,"A","N","2017-10-21","201710210NYR"
"NYR",0,2,1,1,0,4,0,0,2,0,0,2,"H","N","2017-10-21","201710210NYR"
"OTT",0,1,2,3,0,6,0,0,0,3,0,3,"H","N","2017-10-21","201710210OTT"
"TOR",0,0,0,3,0,3,0,1,2,3,0,6,"A","N","2017-10-21","201710210OTT"
"EDM",0,0,1,0,0,1,0,1,0,1,0,2,"A","N","2017-10-21","201710210PHI"
"PHI",0,1,0,1,0,2,0,0,1,0,0,1,"H","N","2017-10-21","201710210PHI"
"PIT",0,0,0,1,0,1,0,3,3,1,0,7,"A","N","2017-10-21","201710210TBL"
"TBL",0,3,3,1,0,7,0,0,0,1,0,1,"H","N","2017-10-21","201710210TBL"
"STL",0,1,0,1,0,2,1,0,2,0,0,3,"A","N","2017-10-21","201710210VEG"
"VEG",1,0,2,0,0,3,0,1,0,1,0,2,"H","N","2017-10-21","201710210VEG"
"FLA",0,2,1,1,0,4,0,0,1,0,0,1,"A","N","2017-10-21","201710210WSH"
"WSH",0,0,1,0,0,1,0,2,1,1,0,4,"H","N","2017-10-21","201710210WSH"
"DET",0,1,0,0,0,1,0,1,3,0,0,4,"H","N","2017-10-22","201710220DET"
"VAN",0,1,3,0,0,4,0,1,0,0,0,1,"A","N","2017-10-22","201710220DET"
"NYR",0,0,0,1,0,1,0,2,1,1,0,4,"H","N","2017-10-23","201710230NYR"
"SJS",0,2,1,1,0,4,0,0,0,1,0,1,"A","N","2017-10-23","201710230NYR"
"LAK",0,0,1,1,0,2,0,1,1,1,0,3,"A","N","2017-10-23","201710230TOR"
"TOR",0,1,1,1,0,3,0,0,1,1,0,2,"H","N","2017-10-23","201710230TOR"
"BUF",0,0,1,0,0,1,0,0,0,0,0,0,"H","N","2017-10-24","201710240BUF"
"DET",0,0,0,0,0,0,0,0,1,0,0,1,"A","N","2017-10-24","201710240BUF"
"CAR",0,0,0,1,0,1,0,1,1,3,0,5,"H","N","2017-10-24","201710240CAR"
"TBL",0,1,1,3,0,5,0,0,0,1,0,1,"A","N","2017-10-24","201710240CAR"
"COL",0,1,3,1,0,5,0,1,1,1,0,3,"H","N","2017-10-24","201710240COL"
"DAL",0,1,1,1,0,3,0,1,3,1,0,5,"A","N","2017-10-24","201710240COL"
"MIN",0,0,0,0,0,0,0,0,0,1,0,1,"H","N","2017-10-24","201710240MIN"
"VAN",0,0,0,1,0,1,0,0,0,0,0,0,"A","N","2017-10-24","201710240MIN"
"FLA",0,0,1,0,0,1,0,0,3,2,0,5,"A","N","2017-10-24","201710240MTL"
"MTL",0,0,3,2,0,5,0,0,1,0,0,1,"H","N","2017-10-24","201710240MTL"
"CGY",0,0,0,2,1,3,0,2,0,0,0,2,"A","Y","2017-10-24","201710240NSH"
"NSH",0,2,0,0,0,2,0,0,0,2,1,3,"H","Y","2017-10-24","201710240NSH"
"ARI",0,1,0,2,0,3,0,0,2,3,0,5,"A","N","2017-10-24","201710240NYI"
"NYI",0,0,2,3,0,5,0,1,0,2,0,3,"H","N","2017-10-24","201710240NYI"
"LAK",0,1,0,1,1,3,0,1,0,1,0,2,"A","Y","2017-10-24","201710240OTT"
"OTT",0,1,0,1,0,2,0,1,0,1,1,3,"H","Y","2017-10-24","201710240OTT"
"ANA",0,1,3,2,0,6,0,1,0,1,0,2,"A","N","2017-10-24","201710240PHI"
"PHI",0,1,0,1,0,2,0,1,3,2,0,6,"H","N","2017-10-24","201710240PHI"
"EDM",0,0,0,1,0,1,1,0,0,1,0,2,"A","N","2017-10-24","201710240PIT"
"PIT",1,0,0,1,0,2,0,0,0,1,0,1,"H","N","2017-10-24","201710240PIT"
"CHI",0,1,0,1,0,2,0,2,1,1,0,4,"A","N","2017-10-24","201710240VEG"
"VEG",0,2,1,1,0,4,0,1,0,1,0,2,"H","N","2017-10-24","201710240VEG"
"BUF",0,0,0,1,0,1,0,1,3,1,0,5,"A","N","2017-10-25","201710250CBJ"
"CBJ",0,1,3,1,0,5,0,0,0,1,0,1,"H","N","2017-10-25","201710250CBJ"
"CGY",0,1,1,0,0,2,0,1,2,2,0,5,"A","N","2017-10-25","201710250STL"
"STL",0,1,2,2,0,5,0,1,1,0,0,2,"H","N","2017-10-25","201710250STL"
"BOS",0,1,1,0,0,2,0,0,1,0,0,1,"H","N","2017-10-26","201710260BOS"
"SJS",0,0,1,0,0,1,0,1,1,0,0,2,"A","N","2017-10-26","201710260BOS"
"DAL",0,1,2,1,0,4,0,2,1,2,0,5,"A","N","2017-10-26","201710260EDM"
"EDM",0,2,1,2,0,5,0,1,2,1,0,4,"H","N","2017-10-26","201710260EDM"
"ANA",0,1,0,2,0,3,0,3,3,2,0,8,"A","N","2017-10-26","201710260FLA"
"FLA",0,3,3,2,0,8,0,1,0,2,0,3,"H","N","2017-10-26","201710260FLA"
"MIN",0,3,1,2,0,6,0,1,1,2,0,4,"H","N","2017-10-26","201710260MIN"
"NYI",0,1,1,2,0,4,0,3,1,2,0,6,"A","N","2017-10-26","201710260MIN"
"LAK",0,2,1,1,0,4,0,0,0,0,0,0,"A","N","2017-10-26","201710260MTL"
"MTL",0,0,0,0,0,0,0,2,1,1,0,4,"H","N","2017-10-26","201710260MTL"
"ARI",0,0,1,1,0,2,0,2,2,1,0,5,"A","N","2017-10-26","201710260NYR"
"NYR",0,2,2,1,0,5,0,0,1,1,0,2,"H","N","2017-10-26","201710260NYR"
"OTT",0,3,1,1,0,5,0,0,2,2,0,4,"H","N","2017-10-26","201710260OTT"
"PHI",0,0,2,2,0,4,0,3,1,1,0,5,"A","N","2017-10-26","201710260OTT"
"PIT",1,1,0,0,0,2,0,1,0,0,0,1,"H","N","2017-10-26","201710260PIT"
"WPG",0,1,0,0,0,1,1,1,0,0,0,2,"A","N","2017-10-26","201710260PIT"
"DET",0,1,0,1,0,2,0,1,0,2,0,3,"A","N","2017-10-26","201710260TBL"
"TBL",0,1,0,2,0,3,0,1,0,1,0,2,"H","N","2017-10-26","201710260TBL"
"CAR",0,3,1,2,0,6,0,1,2,0,0,3,"A","N","2017-10-26","201710260TOR"
"TOR",0,1,2,0,0,3,0,3,1,2,0,6,"H","N","2017-10-26","201710260TOR"
"VAN",0,3,2,1,0,6,0,0,1,1,0,2,"H","N","2017-10-26","201710260VAN"
"WSH",0,0,1,1,0,2,0,3,2,1,0,6,"A","N","2017-10-26","201710260VAN"
"CAR",0,0,1,0,0,1,0,0,1,1,0,2,"H","N","2017-10-27","201710270CAR"
"STL",0,0,1,1,0,2,0,0,1,0,0,1,"A","N","2017-10-27","201710270CAR"
"CBJ",1,0,0,1,0,2,0,1,0,0,0,1,"H","N","2017-10-27","201710270CBJ"
"WPG",0,1,0,0,0,1,1,0,0,1,0,2,"A","N","2017-10-27","201710270CBJ"
"CGY",0,0,1,0,0,1,0,0,1,1,0,2,"H","N","2017-10-27","201710270CGY"
"DAL",0,0,1,1,0,2,0,0,1,0,0,1,"A","N","2017-10-27","201710270CGY"
"CHI",0,1,0,0,0,1,0,0,2,0,0,2,"H","N","2017-10-27","201710270CHI"
"NSH",0,0,2,0,0,2,0,1,0,0,0,1,"A","N","2017-10-27","201710270CHI"
"NJD",0,1,2,1,1,5,0,2,0,2,0,4,"H","Y","2017-10-27","201710270NJD"
"OTT",0,2,0,2,0,4,0,1,2,1,1,5,"A","Y","2017-10-27","201710270NJD"
"COL",0,0,0,0,0,0,0,0,4,3,0,7,"A","N","2017-10-27","201710270VEG"
"VEG",0,0,4,3,0,7,0,0,0,0,0,0,"H","N","2017-10-27","201710270VEG"
"BOS",0,1,0,0,0,1,1,1,0,0,0,2,"H","N","2017-10-28","201710280BOS"
"LAK",1,1,0,0,0,2,0,1,0,0,0,1,"A","N","2017-10-28","201710280BOS"
"BUF",0,0,2,0,0,2,0,1,1,1,0,3,"H","N","2017-10-28","201710280BUF"
"SJS",0,1,1,1,0,3,0,0,2,0,0,2,"A","N","2017-10-28","201710280BUF"
"CHI",0,0,2,1,0,3,0,3,2,1,0,6,"A","N","2017-10-28","201710280COL"
"COL",0,3,2,1,0,6,0,0,2,1,0,3,"H","N","2017-10-28","201710280COL"
"EDM",0,2,0,0,0,2,0,1,1,3,0,5,"H","N","2017-10-28","201710280EDM"
"WSH",0,1,1,3,0,5,0,2,0,0,0,2,"A","N","2017-10-28","201710280EDM"
"DET",0,1,1,0,1,3,0,0,2,0,0,2,"A","Y","2017-10-28","201710280FLA"
"FLA",0,0,2,0,0,2,0,1,1,0,1,3,"H","Y","2017-10-28","201710280FLA"
"MIN",0,1,0,1,0,2,0,1,0,0,0,1,"H","N","2017-10-28","201710280MIN"
"PIT",0,1,0,0,0,1,0,1,0,1,0,2,"A","N","2017-10-28","201710280MIN"
"MTL",0,3,1,1,0,5,0,0,2,2,0,4,"H","N","2017-10-28","201710280MTL"
"NYR",0,0,2,2,0,4,0,3,1,1,0,5,"A","N","2017-10-28","201710280MTL"
"ARI",0,1,2,0,0,3,0,1,1,2,0,4,"A","N","2017-10-28","201710280NJD"
"NJD",0,1,1,2,0,4,0,1,2,0,0,3,"H","N","2017-10-28","201710280NJD"
"NSH",0,0,1,1,0,2,0,1,2,3,0,6,"H","N","2017-10-28","201710280NSH"
"NYI",0,1,2,3,0,6,0,0,1,1,0,2,"A","N","2017-10-28","201710280NSH"
"CBJ",0,0,0,1,0,1,0,1,1,2,0,4,"A","N","2017-10-28","201710280STL"
"STL",0,1,1,2,0,4,0,0,0,1,0,1,"H","N","2017-10-28","201710280STL"
"ANA",0,0,3,1,0,4,0,0,1,0,0,1,"A","N","2017-10-28","201710280TBL"
"TBL",0,0,1,0,0,1,0,0,3,1,0,4,"H","N","2017-10-28","201710280TBL"
"PHI",0,2,2,0,0,4,0,1,1,0,0,2,"A","N","2017-10-28","201710280TOR"
"TOR",0,1,1,0,0,2,0,2,2,0,0,4,"H","N","2017-10-28","201710280TOR"
"ANA",0,2,0,1,1,4,0,1,2,0,0,3,"A","Y","2017-10-29","201710290CAR"
"CAR",0,1,2,0,0,3,0,2,0,1,1,4,"H","Y","2017-10-29","201710290CAR"
"CGY",0,0,1,1,0,2,0,0,0,1,0,1,"H","N","2017-10-29","201710290CGY"
"WSH",0,0,0,1,0,1,0,0,1,1,0,2,"A","N","2017-10-29","201710290CGY"
"PIT",0,0,1,0,0,1,0,5,0,2,0,7,"A","N","2017-10-29","201710290WPG"
"WPG",0,5,0,2,0,7,0,0,1,0,0,1,"H","N","2017-10-29","201710290WPG"
"BOS",0,0,1,2,0,3,0,2,1,0,1,4,"A","Y","2017-10-30","201710300CBJ"
"CBJ",0,2,1,0,1,4,0,0,1,2,0,3,"H","Y","2017-10-30","201710300CBJ"
"FLA",0,2,1,2,0,5,0,3,3,2,0,8,"H","N","2017-10-30","201710300FLA"
"TBL",0,3,3,2,0,8,0,2,1,2,0,5,"A","N","2017-10-30","201710300FLA"
"NYI",0,1,2,3,0,6,0,2,0,1,0,3,"H","N","2017-10-30","201710300NYI"
"VEG",0,2,0,1,0,3,0,1,2,3,0,6,"A","N","2017-10-30","201710300NYI"
"MTL",0,4,2,2,0,8,0,2,1,0,0,3,"A","N","2017-10-30","201710300OTT"
"OTT",0,2,1,0,0,3,0,4,2,2,0,8,"H","N","2017-10-30","201710300OTT"
"ARI",1,2,0,1,0,4,0,0,0,3,0,3,"A","N","2017-10-30","201710300PHI"
"PHI",0,0,0,3,0,3,1,2,0,1,0,4,"H","N","2017-10-30","201710300PHI"
"SJS",0,0,1,2,0,3,0,1,0,1,0,2,"H","N","2017-10-30","201710300SJS"
"TOR",0,1,0,1,0,2,0,0,1,2,0,3,"A","N","2017-10-30","201710300SJS"
"LAK",0,0,2,0,0,2,0,0,3,1,0,4,"A","N","2017-10-30","201710300STL"
"STL",0,0,3,1,0,4,0,0,2,0,0,2,"H","N","2017-10-30","201710300STL"
"DAL",1,0,1,0,0,2,0,0,0,1,0,1,"A","N","2017-10-30","201710300VAN"
"VAN",0,0,0,1,0,1,1,0,1,0,0,2,"H","N","2017-10-30","201710300VAN"
"ARI",0,0,1,2,0,3,0,2,2,1,0,5,"A","N","2017-10-31","201710310DET"
"DET",0,2,2,1,0,5,0,0,1,2,0,3,"H","N","2017-10-31","201710310DET"
"MIN",0,0,0,1,0,1,0,1,0,1,0,2,"H","N","2017-10-31","201710310MIN"
"WPG",0,1,0,1,0,2,0,0,0,1,0,1,"A","N","2017-10-31","201710310MIN"
"NYR",0,1,1,4,0,6,0,2,2,0,0,4,"H","N","2017-10-31","201710310NYR"
"VEG",0,2,2,0,0,4,0,1,1,4,0,6,"A","N","2017-10-31","201710310NYR"
"ANA",0,1,0,0,0,1,0,1,0,2,0,3,"H","N","2017-11-01","201711010ANA"
"TOR",0,1,0,2,0,3,0,1,0,0,0,1,"A","N","2017-11-01","201711010ANA"
"CHI",0,0,2,1,0,3,0,0,0,0,0,0,"H","N","2017-11-01","201711010CHI"
"PHI",0,0,0,0,0,0,0,0,2,1,0,3,"A","N","2017-11-01","201711010CHI"
"EDM",0,0,2,0,0,2,0,0,2,1,0,3,"H","N","2017-11-01","201711010EDM"
"PIT",0,0,2,1,0,3,0,0,2,0,0,2,"A","N","2017-11-01","201711010EDM"
"NSH",0,0,1,0,0,1,0,1,2,1,0,4,"A","N","2017-11-01","201711010SJS"
"SJS",0,1,2,1,0,4,0,0,1,0,0,1,"H","N","2017-11-01","201711010SJS"
"NJD",0,0,1,1,0,2,0,0,0,0,0,0,"A","N","2017-11-01","201711010VAN"
"VAN",0,0,0,0,0,0,0,0,1,1,0,2,"H","N","2017-11-01","201711010VAN"
"ARI",0,1,0,3,0,4,0,1,2,2,0,5,"H","N","2017-11-02","201711020ARI"
"BUF",0,1,2,2,0,5,0,1,0,3,0,4,"A","N","2017-11-02","201711020ARI"
"BOS",0,0,1,1,0,2,0,0,1,0,0,1,"H","N","2017-11-02","201711020BOS"
"VEG",0,0,1,0,0,1,0,0,1,1,0,2,"A","N","2017-11-02","201711020BOS"
"CGY",1,0,0,1,0,2,0,0,0,1,0,1,"H","N","2017-11-02","201711020CGY"
"PIT",0,0,0,1,0,1,1,0,0,1,0,2,"A","N","2017-11-02","201711020CGY"
"CAR",0,2,1,0,0,3,0,2,3,0,0,5,"A","N","2017-11-02","201711020COL"
"COL",0,2,3,0,0,5,0,2,1,0,0,3,"H","N","2017-11-02","201711020COL"
"CBJ",0,2,3,2,0,7,0,1,2,0,0,3,"A","N","2017-11-02","201711020FLA"
"FLA",0,1,2,0,0,3,0,2,3,2,0,7,"H","N","2017-11-02","201711020FLA"
"LAK",0,3,2,0,0,5,0,0,2,1,0,3,"H","N","2017-11-02","201711020LAK"
"TOR",0,0,2,1,0,3,0,3,2,0,0,5,"A","N","2017-11-02","201711020LAK"
"MIN",0,3,1,2,0,6,0,0,1,2,0,3,"H","N","2017-11-02","201711020MIN"
"MTL",0,0,1,2,0,3,0,3,1,2,0,6,"A","N","2017-11-02","201711020MIN"
"DET",0,0,0,1,0,1,0,1,1,1,0,3,"A","N","2017-11-02","201711020OTT"
"OTT",0,1,1,1,0,3,0,0,0,1,0,1,"H","N","2017-11-02","201711020OTT"
"PHI",0,0,1,1,0,2,0,0,0,0,0,0,"A","N","2017-11-02","201711020STL"
"STL",0,0,0,0,0,0,0,0,1,1,0,2,"H","N","2017-11-02","201711020STL"
"NYR",1,1,0,0,0,2,0,0,1,0,0,1,"A","N","2017-11-02","201711020TBL"
"TBL",0,0,1,0,0,1,1,1,0,0,0,2,"H","N","2017-11-02","201711020TBL"
"DAL",0,1,1,0,0,2,0,3,0,2,0,5,"A","N","2017-11-02","201711020WPG"
"WPG",0,3,0,2,0,5,0,1,1,0,0,2,"H","N","2017-11-02","201711020WPG"
"NYI",0,1,1,1,0,3,0,2,1,1,0,4,"A","N","2017-11-02","201711020WSH"
"WSH",0,2,1,1,0,4,0,1,1,1,0,3,"H","N","2017-11-02","201711020WSH"
"ANA",0,0,2,1,0,3,0,2,2,1,0,5,"H","N","2017-11-03","201711030ANA"
"NSH",0,2,2,1,0,5,0,0,2,1,0,3,"A","N","2017-11-03","201711030ANA"
"EDM",0,2,2,2,0,6,0,1,1,1,0,3,"H","N","2017-11-03","201711030EDM"
"NJD",0,1,1,1,0,3,0,2,2,2,0,6,"A","N","2017-11-03","201711030EDM"
"ARI",0,0,1,0,1,2,0,0,0,1,0,1,"H","Y","2017-11-04","201711040ARI"
"CAR",0,0,0,1,0,1,0,0,1,0,1,2,"A","Y","2017-11-04","201711040ARI"
"BOS",0,0,1,1,0,2,0,2,1,0,0,3,"H","N","2017-11-04","201711040BOS"
"WSH",0,2,1,0,0,3,0,0,1,1,0,2,"A","N","2017-11-04","201711040BOS"
"BUF",0,0,1,0,0,1,0,4,1,0,0,5,"A","N","2017-11-04","201711040DAL"
"DAL",0,4,1,0,0,5,0,0,1,0,0,1,"H","N","2017-11-04","201711040DAL"
"FLA",0,0,2,2,0,4,1,0,2,2,0,5,"H","N","2017-11-04","201711040FLA"
"NYR",1,0,2,2,0,5,0,0,2,2,0,4,"A","N","2017-11-04","201711040FLA"
"LAK",0,0,0,3,0,3,1,2,1,0,0,4,"H","N","2017-11-04","201711040LAK"
"NSH",1,2,1,0,0,4,0,0,0,3,0,3,"A","N","2017-11-04","201711040LAK"
"CHI",0,0,0,2,0,2,0,0,0,0,0,0,"A","N","2017-11-04","201711040MIN"
"MIN",0,0,0,0,0,0,0,0,0,2,0,2,"H","N","2017-11-04","201711040MIN"
"OTT",0,0,2,2,0,4,0,1,2,2,0,5,"H","N","2017-11-04","201711040OTT"
"VEG",0,1,2,2,0,5,0,0,2,2,0,4,"A","N","2017-11-04","201711040OTT"
"COL",0,1,2,1,1,5,0,0,2,2,0,4,"A","Y","2017-11-04","201711040PHI"
"PHI",0,0,2,2,0,4,0,1,2,1,1,5,"H","Y","2017-11-04","201711040PHI"
"ANA",0,1,0,0,0,1,0,0,0,1,1,2,"A","Y","2017-11-04","201711040SJS"
"SJS",0,0,0,1,1,2,0,1,0,0,0,1,"H","Y","2017-11-04","201711040SJS"
"STL",0,0,3,3,0,6,0,1,0,3,0,4,"H","N","2017-11-04","201711040STL"
"TOR",0,1,0,3,0,4,0,0,3,3,0,6,"A","N","2017-11-04","201711040STL"
"CBJ",0,2,0,2,0,4,0,2,2,0,1,5,"A","Y","2017-11-04","201711040TBL"
"TBL",0,2,2,0,1,5,0,2,0,2,0,4,"H","Y","2017-11-04","201711040TBL"
"PIT",0,1,0,1,0,2,0,1,1,2,0,4,"A","N","2017-11-04","201711040VAN"
"VAN",0,1,1,2,0,4,0,1,0,1,0,2,"H","N","2017-11-04","201711040VAN"
"MTL",1,1,1,2,0,5,0,1,1,2,0,4,"A","N","2017-11-04","201711040WPG"
"WPG",0,1,1,2,0,4,1,1,1,2,0,5,"H","N","2017-11-04","201711040WPG"
"CGY",0,1,2,1,1,5,0,1,2,1,0,4,"H","Y","2017-11-05","201711050CGY"
"NJD",0,1,2,1,0,4,0,1,2,1,1,5,"A","Y","2017-11-05","201711050CGY"
"CHI",0,0,0,0,0,0,0,0,0,2,0,2,"H","N","2017-11-05","201711050CHI"
"MTL",0,0,0,2,0,2,0,0,0,0,0,0,"A","N","2017-11-05","201711050CHI"
"DET",0,2,1,1,0,4,0,0,0,0,0,0,"A","N","2017-11-05","201711050EDM"
"EDM",0,0,0,0,0,0,0,2,1,1,0,4,"H","N","2017-11-05","201711050EDM"
"COL",0,0,2,2,0,4,0,2,3,1,0,6,"A","N","2017-11-05","201711050NYI"
"NYI",0,2,3,1,0,6,0,0,2,2,0,4,"H","N","2017-11-05","201711050NYI"
"BOS",0,2,2,1,0,5,0,1,0,2,0,3,"H","N","2017-11-06","201711060BOS"
"MIN",0,1,0,2,0,3,0,2,2,1,0,5,"A","N","2017-11-06","201711060BOS"
"DAL",0,0,1,0,0,1,0,3,0,1,0,4,"H","N","2017-11-06","201711060DAL"
"WPG",0,3,0,1,0,4,0,0,1,0,0,1,"A","N","2017-11-06","201711060DAL"
"CBJ",0,0,2,1,0,3,0,0,1,4,0,5,"A","N","2017-11-06","201711060NYR"
"NYR",0,0,1,4,0,5,0,0,2,1,0,3,"H","N","2017-11-06","201711060NYR"
"TOR",0,3,0,0,1,4,0,1,1,1,0,3,"H","Y","2017-11-06","201711060TOR"
"VEG",0,1,1,1,0,3,0,3,0,0,1,4,"A","Y","2017-11-06","201711060TOR"
"DET",0,1,1,1,0,3,0,0,0,2,0,2,"A","N","2017-11-06","201711060VAN"
"VAN",0,0,0,2,0,2,0,1,1,1,0,3,"H","N","2017-11-06","201711060VAN"
"ARI",0,2,0,0,0,2,1,1,1,0,0,3,"A","N","2017-11-06","201711060WSH"
"WSH",1,1,1,0,0,3,0,2,0,0,0,2,"H","N","2017-11-06","201711060WSH"
"ANA",0,2,1,0,0,3,1,1,1,1,0,4,"H","N","2017-11-07","201711070ANA"
"LAK",1,1,1,1,0,4,0,2,1,0,0,3,"A","N","2017-11-07","201711070ANA"
"BUF",0,0,1,2,0,3,0,0,1,0,0,1,"H","N","2017-11-07","201711070BUF"
"WSH",0,0,1,0,0,1,0,0,1,2,0,3,"A","N","2017-11-07","201711070BUF"
"CAR",0,0,1,2,0,3,0,0,1,0,0,1,"H","N","2017-11-07","201711070CAR"
"FLA",0,0,1,0,0,1,0,0,1,2,0,3,"A","N","2017-11-07","201711070CAR"
"CBJ",0,0,0,1,0,1,0,0,1,2,0,3,"H","N","2017-11-07","201711070CBJ"
"NSH",0,0,1,2,0,3,0,0,0,1,0,1,"A","N","2017-11-07","201711070CBJ"
"CGY",0,1,2,0,0,3,0,1,2,2,0,5,"H","N","2017-11-07","201711070CGY"
"VAN",0,1,2,2,0,5,0,1,2,0,0,3,"A","N","2017-11-07","201711070CGY"
"MTL",0,2,1,0,0,3,0,1,0,1,0,2,"H","N","2017-11-07","201711070MTL"
"VEG",0,1,0,1,0,2,0,2,1,0,0,3,"A","N","2017-11-07","201711070MTL"
"NJD",0,1,0,0,0,1,0,0,1,2,0,3,"H","N","2017-11-07","201711070NJD"
"STL",0,0,1,2,0,3,0,1,0,0,0,1,"A","N","2017-11-07","201711070NJD"
"EDM",1,0,1,0,0,2,0,0,1,0,0,1,"A","N","2017-11-07","201711070NYI"
"NYI",0,0,1,0,0,1,1,0,1,0,0,2,"H","N","2017-11-07","201711070NYI"
"ARI",0,0,0,1,0,1,0,2,0,1,0,3,"A","N","2017-11-07","201711070PIT"
"PIT",0,2,0,1,0,3,0,0,0,1,0,1,"H","N","2017-11-07","201711070PIT"
"BOS",0,1,0,1,0,2,0,3,0,1,0,4,"A","N","2017-11-08","201711080NYR"
"NYR",0,3,0,1,0,4,0,1,0,1,0,2,"H","N","2017-11-08","201711080NYR"
"SJS",0,1,0,0,0,1,0,1,3,1,0,5,"H","N","2017-11-08","201711080SJS"
"TBL",0,1,3,1,0,5,0,1,0,0,0,1,"A","N","2017-11-08","201711080SJS"
"MIN",0,1,0,1,0,2,0,1,1,2,0,4,"A","N","2017-11-08","201711080TOR"
"TOR",0,1,1,2,0,4,0,1,0,1,0,2,"H","N","2017-11-08","201711080TOR"
"ANA",0,1,1,2,0,4,0,1,0,0,0,1,"H","N","2017-11-09","201711090ANA"
"VAN",0,1,0,0,0,1,0,1,1,2,0,4,"A","N","2017-11-09","201711090ANA"
"CGY",0,2,3,1,0,6,0,0,3,0,0,3,"H","N","2017-11-09","201711090CGY"
"DET",0,0,3,0,0,3,0,2,3,1,0,6,"A","N","2017-11-09","201711090CGY"
"LAK",0,0,1,1,0,2,0,4,0,1,0,5,"H","N","2017-11-09","201711090LAK"
"TBL",0,4,0,1,0,5,0,0,1,1,0,2,"A","N","2017-11-09","201711090LAK"
"MIN",0,0,0,3,0,3,0,0,0,0,0,0,"A","N","2017-11-09","201711090MTL"
"MTL",0,0,0,0,0,0,0,0,0,3,0,3,"H","N","2017-11-09","201711090MTL"
"EDM",1,0,1,1,0,3,0,1,1,0,0,2,"A","N","2017-11-09","201711090NJD"
"NJD",0,1,1,0,0,2,1,0,1,1,0,3,"H","N","2017-11-09","201711090NJD"
"CHI",0,0,1,0,0,1,0,2,1,0,0,3,"A","N","2017-11-09","201711090PHI"
"PHI",0,2,1,0,0,3,0,0,1,0,0,1,"H","N","2017-11-09","201711090PHI"
"ARI",0,0,2,0,0,2,0,0,1,1,1,3,"A","Y","2017-11-09","201711090STL"
"STL",0,0,1,1,1,3,0,0,2,0,0,2,"H","Y","2017-11-09","201711090STL"
"BUF",0,1,0,0,0,1,0,0,1,3,0,4,"H","N","2017-11-10","201711100BUF"
"FLA",0,0,1,3,0,4,0,1,0,0,0,1,"A","N","2017-11-10","201711100BUF"
"CAR",0,0,1,2,0,3,0,1,0,0,0,1,"A","N","2017-11-10","201711100CBJ"
"CBJ",0,1,0,0,0,1,0,0,1,2,0,3,"H","N","2017-11-10","201711100CBJ"
"COL",0,1,1,1,0,3,1,2,1,0,0,4,"H","N","2017-11-10","201711100COL"
"OTT",1,2,1,0,0,4,0,1,1,1,0,3,"A","N","2017-11-10","201711100COL"
"DAL",0,3,2,0,0,5,0,0,0,0,0,0,"H","N","2017-11-10","201711100DAL"
"NYI",0,0,0,0,0,0,0,3,2,0,0,5,"A","N","2017-11-10","201711100DAL"
"BOS",0,0,1,1,0,2,1,0,1,1,0,3,"A","N","2017-11-10","201711100TOR"
"TOR",1,0,1,1,0,3,0,0,1,1,0,2,"H","N","2017-11-10","201711100TOR"
"VEG",0,2,3,0,0,5,0,1,1,0,0,2,"H","N","2017-11-10","201711100VEG"
"WPG",0,1,1,0,0,2,0,2,3,0,0,5,"A","N","2017-11-10","201711100VEG"
"PIT",0,0,1,0,0,1,0,1,1,2,0,4,"A","N","2017-11-10","201711100WSH"
"WSH",0,1,1,2,0,4,0,0,1,0,0,1,"H","N","2017-11-10","201711100WSH"
"ARI",0,1,0,0,0,1,0,0,1,3,0,4,"H","N","2017-11-11","201711110ARI"
"WPG",0,0,1,3,0,4,0,1,0,0,0,1,"A","N","2017-11-11","201711110ARI"
"BOS",0,1,0,0,0,1,0,2,0,2,0,4,"H","N","2017-11-11","201711110BOS"
"TOR",0,2,0,2,0,4,0,1,0,0,0,1,"A","N","2017-11-11","201711110BOS"
"CAR",0,2,1,0,0,3,1,0,1,2,0,4,"H","N","2017-11-11","201711110CAR"
"CHI",1,0,1,2,0,4,0,2,1,0,0,3,"A","N","2017-11-11","201711110CAR"
"CBJ",0,1,0,0,1,2,0,0,0,1,0,1,"A","Y","2017-11-11","201711110DET"
"DET",0,0,0,1,0,1,0,1,0,0,1,2,"H","Y","2017-11-11","201711110DET"
"BUF",0,1,0,0,0,1,1,0,0,1,0,2,"A","N","2017-11-11","201711110MTL"
"MTL",1,0,0,1,0,2,0,1,0,0,0,1,"H","N","2017-11-11","201711110MTL"
"FLA",0,0,1,0,0,1,0,1,1,0,0,2,"A","N","2017-11-11","201711110NJD"
"NJD",0,1,1,0,0,2,0,0,1,0,0,1,"H","N","2017-11-11","201711110NJD"
"NSH",0,0,3,1,1,5,0,1,1,2,0,4,"H","Y","2017-11-11","201711110NSH"
"PIT",0,1,1,2,0,4,0,0,3,1,1,5,"A","Y","2017-11-11","201711110NSH"
"EDM",0,1,1,0,0,2,0,1,2,1,0,4,"A","N","2017-11-11","201711110NYR"
"NYR",0,1,2,1,0,4,0,1,1,0,0,2,"H","N","2017-11-11","201711110NYR"
"COL",0,1,2,0,0,3,0,0,2,2,0,4,"A","N","2017-11-11","201711110OTT"
"OTT",0,0,2,2,0,4,0,1,2,0,0,3,"H","N","2017-11-11","201711110OTT"
"MIN",0,0,0,1,0,1,0,0,0,0,0,0,"A","N","2017-11-11","201711110PHI"
"PHI",0,0,0,0,0,0,0,0,0,1,0,1,"H","N","2017-11-11","201711110PHI"
"SJS",0,1,1,3,0,5,0,0,0,0,0,0,"H","N","2017-11-11","201711110SJS"
"VAN",0,0,0,0,0,0,0,1,1,3,0,5,"A","N","2017-11-11","201711110SJS"
"NYI",0,3,1,1,0,5,0,0,1,1,0,2,"A","N","2017-11-11","201711110STL"
"STL",0,0,1,1,0,2,0,3,1,1,0,5,"H","N","2017-11-11","201711110STL"
"ANA",0,0,0,1,0,1,0,0,1,1,0,2,"H","N","2017-11-12","201711120ANA"
"TBL",0,0,1,1,0,2,0,0,0,1,0,1,"A","N","2017-11-12","201711120ANA"
"CHI",0,4,1,0,0,5,0,2,4,1,0,7,"H","N","2017-11-12","201711120CHI"
"NJD",0,2,4,1,0,7,0,4,1,0,0,5,"A","N","2017-11-12","201711120CHI"
"LAK",0,1,0,0,0,1,0,0,0,2,0,2,"H","N","2017-11-12","201711120LAK"
"SJS",0,0,0,2,0,2,0,1,0,0,0,1,"A","N","2017-11-12","201711120LAK"
"EDM",0,0,0,1,0,1,0,0,0,1,1,2,"A","Y","2017-11-12","201711120WSH"
"WSH",0,0,0,1,1,2,0,0,0,1,0,1,"H","Y","2017-11-12","201711120WSH"
"CAR",0,1,0,4,0,5,0,0,1,0,0,1,"H","N","2017-11-13","201711130CAR"
"DAL",0,0,1,0,0,1,0,1,0,4,0,5,"A","N","2017-11-13","201711130CAR"
"CGY",0,2,0,5,0,7,0,2,0,2,0,4,"H","N","2017-11-13","201711130CGY"
"STL",0,2,0,2,0,4,0,2,0,5,0,7,"A","N","2017-11-13","201711130CGY"
"EDM",0,3,1,4,0,8,0,0,1,1,0,2,"H","N","2017-11-14","201711140EDM"
"VEG",0,0,1,1,0,2,0,3,1,4,0,8,"A","N","2017-11-14","201711140EDM"
"DAL",0,1,2,0,0,3,0,2,0,1,1,4,"A","Y","2017-11-14","201711140FLA"
"FLA",0,2,0,1,1,4,0,1,2,0,0,3,"H","Y","2017-11-14","201711140FLA"
"LAK",0,2,0,0,0,2,0,0,2,1,0,3,"H","N","2017-11-14","201711140LAK"
"VAN",0,0,2,1,0,3,0,2,0,0,0,2,"A","N","2017-11-14","201711140LAK"
"MIN",0,1,0,2,0,3,0,0,0,0,0,0,"H","N","2017-11-14","201711140MIN"
"PHI",0,0,0,0,0,0,0,1,0,2,0,3,"A","N","2017-11-14","201711140MIN"
"CBJ",1,1,0,0,0,2,0,0,0,1,0,1,"A","N","2017-11-14","201711140MTL"
"MTL",0,0,0,1,0,1,1,1,0,0,0,2,"H","N","2017-11-14","201711140MTL"
"NSH",0,2,4,0,0,6,0,0,3,0,0,3,"H","N","2017-11-14","201711140NSH"
"WSH",0,0,3,0,0,3,0,2,4,0,0,6,"A","N","2017-11-14","201711140NSH"
"BUF",0,2,2,0,0,4,1,1,2,1,0,5,"A","N","2017-11-14","201711140PIT"
"PIT",1,1,2,1,0,5,0,2,2,0,0,4,"H","N","2017-11-14","201711140PIT"
"ARI",0,0,0,1,0,1,0,1,3,0,0,4,"A","N","2017-11-14","201711140WPG"
"WPG",0,1,3,0,0,4,0,0,0,1,0,1,"H","N","2017-11-14","201711140WPG"
"ANA",0,1,2,1,0,4,0,0,1,1,0,2,"H","N","2017-11-15","201711150ANA"
"BOS",0,0,1,1,0,2,0,1,2,1,0,4,"A","N","2017-11-15","201711150ANA"
"CHI",0,0,1,5,0,6,0,1,0,2,0,3,"H","N","2017-11-15","201711150CHI"
"NYR",0,1,0,2,0,3,0,0,1,5,0,6,"A","N","2017-11-15","201711150CHI"
"CGY",0,1,1,0,0,2,0,4,2,2,0,8,"A","N","2017-11-15","201711150DET"
"DET",0,4,2,2,0,8,0,1,1,0,0,2,"H","N","2017-11-15","201711150DET"
"COL",0,2,1,3,0,6,0,0,1,1,0,2,"H","N","2017-11-16","201711160COL"
"WSH",0,0,1,1,0,2,0,2,1,3,0,6,"A","N","2017-11-16","201711160COL"
"EDM",0,1,0,0,0,1,0,1,1,2,0,4,"H","N","2017-11-16","201711160EDM"
"STL",0,1,1,2,0,4,0,1,0,0,0,1,"A","N","2017-11-16","201711160EDM"
"BOS",0,1,1,0,0,2,0,0,1,0,0,1,"A","N","2017-11-16","201711160LAK"
"LAK",0,0,1,0,0,1,0,1,1,0,0,2,"H","N","2017-11-16","201711160LAK"
"MIN",0,0,2,4,0,6,0,1,2,1,0,4,"H","N","2017-11-16","201711160MIN"
"NSH",0,1,2,1,0,4,0,0,2,4,0,6,"A","N","2017-11-16","201711160MIN"
"ARI",0,0,3,2,0,5,0,2,2,0,0,4,"A","N","2017-11-16","201711160MTL"
"MTL",0,2,2,0,0,4,0,0,3,2,0,5,"H","N","2017-11-16","201711160MTL"
"CAR",0,1,3,0,0,4,0,3,0,3,0,6,"A","N","2017-11-16","201711160NYI"
"NYI",0,3,0,3,0,6,0,1,3,0,0,4,"H","N","2017-11-16","201711160NYI"
"OTT",0,0,0,1,0,1,0,0,2,1,0,3,"H","N","2017-11-16","201711160OTT"
"PIT",0,0,2,1,0,3,0,0,0,1,0,1,"A","N","2017-11-16","201711160OTT"
"FLA",0,0,1,1,0,2,0,0,0,0,0,0,"A","N","2017-11-16","201711160SJS"
"SJS",0,0,0,0,0,0,0,0,1,1,0,2,"H","N","2017-11-16","201711160SJS"
"DAL",0,0,1,0,0,1,0,0,3,3,0,6,"A","N","2017-11-16","201711160TBL"
"TBL",0,0,3,3,0,6,0,0,1,0,0,1,"H","N","2017-11-16","201711160TBL"
"NJD",0,0,0,0,0,0,1,0,0,0,0,1,"A","N","2017-11-16","201711160TOR"
"TOR",1,0,0,0,0,1,0,0,0,0,0,0,"H","N","2017-11-16","201711160TOR"
"VAN",0,0,2,0,0,2,0,2,0,3,0,5,"H","N","2017-11-16","201711160VAN"
"VEG",0,2,0,3,0,5,0,0,2,0,0,2,"A","N","2017-11-16","201711160VAN"
"PHI",0,2,0,0,0,2,0,0,1,1,1,3,"A","Y","2017-11-16","201711160WPG"
"WPG",0,0,1,1,1,3,0,2,0,0,0,2,"H","Y","2017-11-16","201711160WPG"
"CBJ",0,0,1,1,0,2,0,0,0,0,0,0,"H","N","2017-11-17","201711170CBJ"
"NYR",0,0,0,0,0,0,0,0,1,1,0,2,"A","N","2017-11-17","201711170CBJ"
"BUF",0,0,0,1,0,1,0,0,1,2,0,3,"A","N","2017-11-17","201711170DET"
"DET",0,0,1,2,0,3,0,0,0,1,0,1,"H","N","2017-11-17","201711170DET"
"BUF",0,0,0,1,0,1,0,0,1,2,0,3,"H","N","2017-11-18","201711180BUF"
"CAR",0,0,1,2,0,3,0,0,0,1,0,1,"A","N","2017-11-18","201711180BUF"
"DAL",0,2,2,2,0,6,0,2,1,0,0,3,"H","N","2017-11-18","201711180DAL"
"EDM",0,2,1,0,0,3,0,2,2,2,0,6,"A","N","2017-11-18","201711180DAL"
"FLA",0,0,0,0,0,0,0,1,0,3,0,4,"A","N","2017-11-18","201711180LAK"
"LAK",0,1,0,3,0,4,0,0,0,0,0,0,"H","N","2017-11-18","201711180LAK"
"MTL",0,0,0,0,0,0,0,0,2,4,0,6,"H","N","2017-11-18","201711180MTL"
"TOR",0,0,2,4,0,6,0,0,0,0,0,0,"A","N","2017-11-18","201711180MTL"
"COL",0,0,0,2,0,2,0,1,2,2,0,5,"A","N","2017-11-18","201711180NSH"
"NSH",0,1,2,2,0,5,0,0,0,2,0,2,"H","N","2017-11-18","201711180NSH"
"ARI",1,1,0,1,0,3,0,1,1,0,0,2,"A","N","2017-11-18","201711180OTT"
"OTT",0,1,1,0,0,2,1,1,0,1,0,3,"H","N","2017-11-18","201711180OTT"
"CGY",1,1,3,0,0,5,0,3,1,0,0,4,"A","N","2017-11-18","201711180PHI"
"PHI",0,3,1,0,0,4,1,1,3,0,0,5,"H","N","2017-11-18","201711180PHI"
"CHI",0,1,0,1,0,2,0,0,0,1,0,1,"A","N","2017-11-18","201711180PIT"
"PIT",0,0,0,1,0,1,0,1,0,1,0,2,"H","N","2017-11-18","201711180PIT"
"BOS",0,2,0,1,0,3,0,1,0,0,0,1,"A","N","2017-11-18","201711180SJS"
"SJS",0,1,0,0,0,1,0,2,0,1,0,3,"H","N","2017-11-18","201711180SJS"
"NYI",0,2,1,2,0,5,0,0,0,3,0,3,"A","N","2017-11-18","201711180TBL"
"TBL",0,0,0,3,0,3,0,2,1,2,0,5,"H","N","2017-11-18","201711180TBL"
"STL",1,1,1,1,0,4,0,1,2,0,0,3,"A","N","2017-11-18","201711180VAN"
"VAN",0,1,2,0,0,3,1,1,1,1,0,4,"H","N","2017-11-18","201711180VAN"
"NJD",0,0,1,1,0,2,0,0,5,0,0,5,"A","N","2017-11-18","201711180WPG"
"WPG",0,0,5,0,0,5,0,0,1,1,0,2,"H","N","2017-11-18","201711180WPG"
"MIN",0,1,0,0,0,1,0,2,0,1,0,3,"A","N","2017-11-18","201711180WSH"
"WSH",0,2,0,1,0,3,0,1,0,0,0,1,"H","N","2017-11-18","201711180WSH"
"ANA",0,1,1,1,0,3,0,0,1,1,0,2,"H","N","2017-11-19","201711190ANA"
"FLA",0,0,1,1,0,2,0,1,1,1,0,3,"A","N","2017-11-19","201711190ANA"
"CAR",0,3,1,0,0,4,0,1,0,1,0,2,"H","N","2017-11-19","201711190CAR"
"NYI",0,1,0,1,0,2,0,3,1,0,0,4,"A","N","2017-11-19","201711190CAR"
"COL",1,1,0,2,0,4,0,1,1,1,0,3,"A","N","2017-11-19","201711190DET"
"DET",0,1,1,1,0,3,1,1,0,2,0,4,"H","N","2017-11-19","201711190DET"
"NYR",0,0,1,2,0,3,0,0,0,0,0,0,"H","N","2017-11-19","201711190NYR"
"OTT",0,0,0,0,0,0,0,0,1,2,0,3,"A","N","2017-11-19","201711190NYR"
"LAK",0,0,1,1,0,2,0,3,0,1,0,4,"A","N","2017-11-19","201711190VEG"
"VEG",0,3,0,1,0,4,0,0,1,1,0,2,"H","N","2017-11-19","201711190VEG"
"BUF",0,0,0,2,0,2,0,0,1,2,0,3,"H","N","2017-11-20","201711200BUF"
"CBJ",0,0,1,2,0,3,0,0,0,2,0,2,"A","N","2017-11-20","201711200BUF"
"MIN",0,0,1,2,0,3,1,1,1,1,0,4,"H","N","2017-11-20","201711200MIN"
"NJD",1,1,1,1,0,4,0,0,1,2,0,3,"A","N","2017-11-20","201711200MIN"
"NSH",0,1,3,1,0,5,0,1,0,2,0,3,"H","N","2017-11-20","201711200NSH"
"WPG",0,1,0,2,0,3,0,1,3,1,0,5,"A","N","2017-11-20","201711200NSH"
"ANA",0,0,2,0,1,3,0,1,0,1,0,2,"A","Y","2017-11-20","201711200SJS"
"SJS",0,1,0,1,0,2,0,0,2,0,1,3,"H","Y","2017-11-20","201711200SJS"
"ARI",0,1,1,2,0,4,0,0,1,0,0,1,"A","N","2017-11-20","201711200TOR"
"TOR",0,0,1,0,0,1,0,1,1,2,0,4,"H","N","2017-11-20","201711200TOR"
"CGY",0,1,1,2,0,4,0,1,0,0,0,1,"A","N","2017-11-20","201711200WSH"
"WSH",0,1,0,0,0,1,0,1,1,2,0,4,"H","N","2017-11-20","201711200WSH"
"DAL",0,0,2,1,0,3,0,0,1,0,0,1,"H","N","2017-11-21","201711210DAL"
"MTL",0,0,1,0,0,1,0,0,2,1,0,3,"A","N","2017-11-21","201711210DAL"
"PHI",0,1,0,1,0,2,0,2,2,1,0,5,"H","N","2017-11-21","201711210PHI"
"VAN",0,2,2,1,0,5,0,1,0,1,0,2,"A","N","2017-11-21","201711210PHI"
"EDM",0,0,0,3,0,3,0,2,2,4,0,8,"A","N","2017-11-21","201711210STL"
"STL",0,2,2,4,0,8,0,0,0,3,0,3,"H","N","2017-11-21","201711210STL"
"ANA",0,1,1,0,0,2,0,0,1,3,0,4,"H","N","2017-11-22","201711220ANA"
"VEG",0,0,1,3,0,4,0,1,1,0,0,2,"A","N","2017-11-22","201711220ANA"
"ARI",0,0,0,1,0,1,0,1,1,1,0,3,"H","N","2017-11-22","201711220ARI"
"SJS",0,1,1,1,0,3,0,0,0,1,0,1,"A","N","2017-11-22","201711220ARI"
"BUF",0,1,2,1,0,4,0,3,2,0,0,5,"H","N","2017-11-22","201711220BUF"
"MIN",0,3,2,0,0,5,0,1,2,1,0,4,"A","N","2017-11-22","201711220BUF"
"CAR",0,1,0,0,0,1,0,3,0,3,0,6,"H","N","2017-11-22","201711220CAR"
"NYR",0,3,0,3,0,6,0,1,0,0,0,1,"A","N","2017-11-22","201711220CAR"
"CBJ",1,0,0,0,0,1,0,0,0,0,0,0,"H","N","2017-11-22","201711220CBJ"
"CGY",0,0,0,0,0,0,1,0,0,0,0,1,"A","N","2017-11-22","201711220CBJ"
"COL",0,0,2,1,0,3,0,0,0,0,0,0,"H","N","2017-11-22","201711220COL"
"DAL",0,0,0,0,0,0,0,0,2,1,0,3,"A","N","2017-11-22","201711220COL"
"DET",0,2,0,0,0,2,0,2,3,1,0,6,"H","N","2017-11-22","201711220DET"
"EDM",0,2,3,1,0,6,0,2,0,0,0,2,"A","N","2017-11-22","201711220DET"
"FLA",0,0,1,0,1,2,0,0,0,1,0,1,"H","Y","2017-11-22","201711220FLA"
"TOR",0,0,0,1,0,1,0,0,1,0,1,2,"A","Y","2017-11-22","201711220FLA"
"LAK",0,0,0,1,0,1,0,1,1,0,0,2,"H","N","2017-11-22","201711220LAK"
"WPG",0,1,1,0,0,2,0,0,0,1,0,1,"A","N","2017-11-22","201711220LAK"
"BOS",0,2,0,0,1,3,0,1,0,1,0,2,"A","Y","2017-11-22","201711220NJD"
"NJD",0,1,0,1,0,2,0,2,0,0,1,3,"H","Y","2017-11-22","201711220NJD"
"MTL",0,1,0,1,0,2,0,1,0,1,1,3,"A","Y","2017-11-22","201711220NSH"
"NSH",0,1,0,1,1,3,0,1,0,1,0,2,"H","Y","2017-11-22","201711220NSH"
"NYI",1,1,2,0,0,4,0,1,2,0,0,3,"H","N","2017-11-22","201711220NYI"
"PHI",0,1,2,0,0,3,1,1,2,0,0,4,"A","N","2017-11-22","201711220NYI"
"PIT",0,1,0,1,0,2,0,2,2,1,0,5,"H","N","2017-11-22","201711220PIT"
"VAN",0,2,2,1,0,5,0,1,0,1,0,2,"A","N","2017-11-22","201711220PIT"
"CHI",0,2,0,0,0,2,1,0,1,1,0,3,"A","N","2017-11-22","201711220TBL"
"TBL",1,0,1,1,0,3,0,2,0,0,0,2,"H","N","2017-11-22","201711220TBL"
"OTT",0,0,1,1,0,2,0,2,2,1,0,5,"A","N","2017-11-22","201711220WSH"
"WSH",0,2,2,1,0,5,0,0,1,1,0,2,"H","N","2017-11-22","201711220WSH"
"ANA",0,0,1,0,0,1,0,2,1,1,0,4,"H","N","2017-11-24","201711240ANA"
"WPG",0,2,1,1,0,4,0,0,1,0,0,1,"A","N","2017-11-24","201711240ANA"
"ARI",1,1,1,0,0,3,0,0,1,1,0,2,"H","N","2017-11-24","201711240ARI"
"LAK",0,0,1,1,0,2,1,1,1,0,0,3,"A","N","2017-11-24","201711240ARI"
"BOS",0,2,1,1,0,4,0,0,3,0,0,3,"H","N","2017-11-24","201711240BOS"
"PIT",0,0,3,0,0,3,0,2,1,1,0,4,"A","N","2017-11-24","201711240BOS"
"BUF",0,0,1,2,0,3,0,0,0,1,0,1,"H","N","2017-11-24","201711240BUF"
"EDM",0,0,0,1,0,1,0,0,1,2,0,3,"A","N","2017-11-24","201711240BUF"
"CAR",0,0,1,3,0,4,0,0,4,1,0,5,"H","N","2017-11-24","201711240CAR"
"TOR",0,0,4,1,0,5,0,0,1,3,0,4,"A","N","2017-11-24","201711240CAR"
"CBJ",0,1,1,3,0,5,0,1,1,0,0,2,"H","N","2017-11-24","201711240CBJ"
"OTT",0,1,1,0,0,2,0,1,1,3,0,5,"A","N","2017-11-24","201711240CBJ"
"CGY",0,0,3,1,0,4,0,1,2,3,0,6,"A","N","2017-11-24","201711240DAL"
"DAL",0,1,2,3,0,6,0,0,3,1,0,4,"H","N","2017-11-24","201711240DAL"
"COL",0,2,0,0,0,2,0,1,1,0,1,3,"A","Y","2017-11-24","201711240MIN"
"MIN",0,1,1,0,1,3,0,2,0,0,0,2,"H","Y","2017-11-24","201711240MIN"
"NJD",0,0,3,0,0,3,0,0,1,1,0,2,"H","N","2017-11-24","201711240NJD"
"VAN",0,0,1,1,0,2,0,0,3,0,0,3,"A","N","2017-11-24","201711240NJD"
"DET",0,0,0,1,0,1,1,0,0,1,0,2,"A","N","2017-11-24","201711240NYR"
"NYR",1,0,0,1,0,2,0,0,0,1,0,1,"H","N","2017-11-24","201711240NYR"
"NYI",1,1,1,2,0,5,0,0,4,0,0,4,"A","N","2017-11-24","201711240PHI"
"PHI",0,0,4,0,0,4,1,1,1,2,0,5,"H","N","2017-11-24","201711240PHI"
"NSH",0,1,0,1,0,2,0,0,0,0,0,0,"A","N","2017-11-24","201711240STL"
"STL",0,0,0,0,0,0,0,1,0,1,0,2,"H","N","2017-11-24","201711240STL"
"SJS",0,1,3,0,0,4,1,2,2,0,0,5,"A","N","2017-11-24","201711240VEG"
"VEG",1,2,2,0,0,5,0,1,3,0,0,4,"H","N","2017-11-24","201711240VEG"
"TBL",0,1,0,0,0,1,0,1,1,1,0,3,"A","N","2017-11-24","201711240WSH"
"WSH",0,1,1,1,0,3,0,1,0,0,0,1,"H","N","2017-11-24","201711240WSH"
"ARI",0,0,0,2,0,2,0,0,3,1,0,4,"H","N","2017-11-25","201711250ARI"
"VEG",0,0,3,1,0,4,0,0,0,2,0,2,"A","N","2017-11-25","201711250ARI"
"CGY",0,1,2,0,0,3,0,0,1,1,0,2,"A","N","2017-11-25","201711250COL"
"COL",0,0,1,1,0,2,0,1,2,0,0,3,"H","N","2017-11-25","201711250COL"
"DET",0,1,0,2,0,3,1,2,0,1,0,4,"H","N","2017-11-25","201711250DET"
"NJD",1,2,0,1,0,4,0,1,0,2,0,3,"A","N","2017-11-25","201711250DET"
"CHI",0,2,2,0,0,4,0,0,1,0,0,1,"A","N","2017-11-25","201711250FLA"
"FLA",0,0,1,0,0,1,0,2,2,0,0,4,"H","N","2017-11-25","201711250FLA"
"ANA",0,1,0,0,0,1,0,0,0,1,1,2,"A","Y","2017-11-25","201711250LAK"
"LAK",0,0,0,1,1,2,0,1,0,0,0,1,"H","Y","2017-11-25","201711250LAK"
"BUF",0,0,0,0,0,0,0,1,1,1,0,3,"A","N","2017-11-25","201711250MTL"
"MTL",0,1,1,1,0,3,0,0,0,0,0,0,"H","N","2017-11-25","201711250MTL"
"NYI",0,0,1,1,0,2,0,0,0,1,0,1,"A","N","2017-11-25","201711250OTT"
"OTT",0,0,0,1,0,1,0,0,1,1,0,2,"H","N","2017-11-25","201711250OTT"
"PIT",0,3,1,1,0,5,0,0,1,1,0,2,"H","N","2017-11-25","201711250PIT"
"TBL",0,0,1,1,0,2,0,3,1,1,0,5,"A","N","2017-11-25","201711250PIT"
"SJS",0,2,1,1,0,4,0,0,0,0,0,0,"H","N","2017-11-25","201711250SJS"
"WPG",0,0,0,0,0,0,0,2,1,1,0,4,"A","N","2017-11-25","201711250SJS"
"MIN",0,0,1,2,0,3,0,3,0,3,0,6,"A","N","2017-11-25","201711250STL"
"STL",0,3,0,3,0,6,0,0,1,2,0,3,"H","N","2017-11-25","201711250STL"
"TOR",0,0,0,2,0,2,0,2,1,1,0,4,"H","N","2017-11-25","201711250TOR"
"WSH",0,2,1,1,0,4,0,0,0,2,0,2,"A","N","2017-11-25","201711250TOR"
"BOS",0,1,1,0,0,2,0,0,2,2,0,4,"H","N","2017-11-26","201711260BOS"
"EDM",0,0,2,2,0,4,0,1,1,0,0,2,"A","N","2017-11-26","201711260BOS"
"CAR",0,1,1,1,1,4,0,1,1,1,0,3,"H","Y","2017-11-26","201711260CAR"
"NSH",0,1,1,1,0,3,0,1,1,1,1,4,"A","Y","2017-11-26","201711260CAR"
"NYR",0,0,1,2,1,4,0,1,1,1,0,3,"H","Y","2017-11-26","201711260NYR"
"VAN",0,1,1,1,0,3,0,0,1,2,1,4,"A","Y","2017-11-26","201711260NYR"
"ANA",0,0,2,1,0,3,0,3,3,1,0,7,"A","N","2017-11-27","201711270CHI"
"CHI",0,3,3,1,0,7,0,0,2,1,0,3,"H","N","2017-11-27","201711270CHI"
"CBJ",0,0,1,0,0,1,0,2,0,1,0,3,"A","N","2017-11-27","201711270MTL"
"MTL",0,2,0,1,0,3,0,0,1,0,0,1,"H","N","2017-11-27","201711270MTL"
"FLA",0,0,1,2,0,3,0,0,0,2,0,2,"A","N","2017-11-27","201711270NJD"
"NJD",0,0,0,2,0,2,0,0,1,2,0,3,"H","N","2017-11-27","201711270NJD"
"PHI",0,0,3,1,0,4,1,1,0,3,0,5,"A","N","2017-11-27","201711270PIT"
"PIT",1,1,0,3,0,5,0,0,3,1,0,4,"H","N","2017-11-27","201711270PIT"
"MIN",0,2,0,0,0,2,0,2,2,3,0,7,"A","N","2017-11-27","201711270WPG"
"WPG",0,2,2,3,0,7,0,2,0,0,0,2,"H","N","2017-11-27","201711270WPG"
"BUF",0,0,0,0,0,0,0,1,1,0,0,2,"H","N","2017-11-28","201711280BUF"
"TBL",0,1,1,0,0,2,0,0,0,0,0,0,"A","N","2017-11-28","201711280BUF"
"CAR",0,1,0,1,0,2,0,1,1,0,1,3,"A","Y","2017-11-28","201711280CBJ"
"CBJ",0,1,1,0,1,3,0,1,0,1,0,2,"H","Y","2017-11-28","201711280CBJ"
"CGY",0,0,0,1,0,1,0,1,1,2,0,4,"H","N","2017-11-28","201711280CGY"
"TOR",0,1,1,2,0,4,0,0,0,1,0,1,"A","N","2017-11-28","201711280CGY"
"DET",0,1,0,0,0,1,0,0,2,2,0,4,"H","N","2017-11-28","201711280DET"
"LAK",0,0,2,2,0,4,0,1,0,0,0,1,"A","N","2017-11-28","201711280DET"
"ARI",0,1,1,0,0,2,1,1,0,1,0,3,"A","N","2017-11-28","201711280EDM"
"EDM",1,1,0,1,0,3,0,1,1,0,0,2,"H","N","2017-11-28","201711280EDM"
"CHI",0,1,0,1,0,2,0,1,1,1,0,3,"A","N","2017-11-28","201711280NSH"
"NSH",0,1,1,1,0,3,0,1,0,1,0,2,"H","N","2017-11-28","201711280NSH"
"NYI",0,3,1,1,0,5,0,1,1,0,0,2,"H","N","2017-11-28","201711280NYI"
"VAN",0,1,1,0,0,2,0,3,1,1,0,5,"A","N","2017-11-28","201711280NYI"
"FLA",0,3,1,1,0,5,0,0,3,1,0,4,"A","N","2017-11-28","201711280NYR"
"NYR",0,0,3,1,0,4,0,3,1,1,0,5,"H","N","2017-11-28","201711280NYR"
"PHI",0,1,0,0,0,1,0,2,1,0,0,3,"H","N","2017-11-28","201711280PHI"
"SJS",0,2,1,0,0,3,0,1,0,0,0,1,"A","N","2017-11-28","201711280PHI"
"DAL",0,0,3,0,0,3,0,0,0,0,0,0,"A","N","2017-11-28","201711280VEG"
"VEG",0,0,0,0,0,0,0,0,3,0,0,3,"H","N","2017-11-28","201711280VEG"
"BOS",0,2,1,0,0,3,0,0,1,1,0,2,"H","N","2017-11-29","201711290BOS"
"TBL",0,0,1,1,0,2,0,2,1,0,0,3,"A","N","2017-11-29","201711290BOS"
"COL",1,1,0,1,0,3,0,1,0,1,0,2,"H","N","2017-11-29","201711290COL"
"WPG",0,1,0,1,0,2,1,1,0,1,0,3,"A","N","2017-11-29","201711290COL"
"MTL",0,0,2,0,0,2,0,1,0,0,0,1,"H","N","2017-11-29","201711290MTL"
"OTT",0,1,0,0,0,1,0,0,2,0,0,2,"A","N","2017-11-29","201711290MTL"
"ANA",0,1,2,0,0,3,0,0,0,2,0,2,"A","N","2017-11-29","201711290STL"
"STL",0,0,0,2,0,2,0,1,2,0,0,3,"H","N","2017-11-29","201711290STL"
"ARI",0,0,0,0,0,0,0,0,1,2,0,3,"A","N","2017-11-30","201711300CGY"
"CGY",0,0,1,2,0,3,0,0,0,0,0,0,"H","N","2017-11-30","201711300CGY"
"CHI",0,1,1,1,0,3,1,2,1,0,0,4,"H","N","2017-11-30","201711300CHI"
"DAL",1,2,1,0,0,4,0,1,1,1,0,3,"A","N","2017-11-30","201711300CHI"
"DET",0,2,0,1,0,3,0,1,3,2,0,6,"H","N","2017-11-30","201711300DET"
"MTL",0,1,3,2,0,6,0,2,0,1,0,3,"A","N","2017-11-30","201711300DET"
"EDM",0,1,2,1,0,4,0,3,1,2,0,6,"H","N","2017-11-30","201711300EDM"
"TOR",0,3,1,2,0,6,0,1,2,1,0,4,"A","N","2017-11-30","201711300EDM"
"MIN",0,0,1,3,0,4,0,0,0,2,0,2,"H","N","2017-11-30","201711300MIN"
"VEG",0,0,0,2,0,2,0,0,1,3,0,4,"A","N","2017-11-30","201711300MIN"
"NSH",0,0,3,0,0,3,0,0,2,3,0,5,"H","N","2017-11-30","201711300NSH"
"VAN",0,0,2,3,0,5,0,0,3,0,0,3,"A","N","2017-11-30","201711300NSH"
"LAK",0,1,2,2,0,5,0,1,1,0,0,2,"A","N","2017-11-30","201711300WSH"
"WSH",0,1,1,0,0,2,0,1,2,2,0,5,"H","N","2017-11-30","201711300WSH"
"BUF",0,0,0,0,0,0,0,3,1,0,0,4,"H","N","2017-12-01","201712010BUF"
"PIT",0,3,1,0,0,4,0,0,0,0,0,0,"A","N","2017-12-01","201712010BUF"
"ANA",0,1,1,0,0,2,0,1,1,2,0,4,"A","N","2017-12-01","201712010CBJ"
"CBJ",0,1,1,2,0,4,0,1,1,0,0,2,"H","N","2017-12-01","201712010CBJ"
"COL",0,0,1,0,0,1,0,0,1,1,0,2,"H","N","2017-12-01","201712010COL"
"NJD",0,0,1,1,0,2,0,0,1,0,0,1,"A","N","2017-12-01","201712010COL"
"FLA",0,1,0,0,0,1,0,0,1,1,0,2,"H","N","2017-12-01","201712010FLA"
"SJS",0,0,1,1,0,2,0,1,0,0,0,1,"A","N","2017-12-01","201712010FLA"
"NYI",0,2,3,0,0,5,0,3,2,1,0,6,"H","N","2017-12-01","201712010NYI"
"OTT",0,3,2,1,0,6,0,2,3,0,0,5,"A","N","2017-12-01","201712010NYI"
"CAR",0,1,0,0,0,1,0,0,2,3,0,5,"A","N","2017-12-01","201712010NYR"
"NYR",0,0,2,3,0,5,0,1,0,0,0,1,"H","N","2017-12-01","201712010NYR"
"LAK",0,2,1,1,0,4,0,0,1,0,0,1,"A","N","2017-12-01","201712010STL"
"STL",0,0,1,0,0,1,0,2,1,1,0,4,"H","N","2017-12-01","201712010STL"
"VEG",0,2,0,2,0,4,0,1,1,5,0,7,"A","N","2017-12-01","201712010WPG"
"WPG",0,1,1,5,0,7,0,2,0,2,0,4,"H","N","2017-12-01","201712010WPG"
"ARI",0,2,1,2,0,5,0,0,0,0,0,0,"H","N","2017-12-02","201712020ARI"
"NJD",0,0,0,0,0,0,0,2,1,2,0,5,"A","N","2017-12-02","201712020ARI"
"CAR",1,1,0,1,0,3,0,0,0,2,0,2,"H","N","2017-12-02","201712020CAR"
"FLA",0,0,0,2,0,2,1,1,0,1,0,3,"A","N","2017-12-02","201712020CAR"
"CGY",0,1,0,4,0,5,0,3,2,2,0,7,"H","N","2017-12-02","201712020CGY"
"EDM",0,3,2,2,0,7,0,1,0,4,0,5,"A","N","2017-12-02","201712020CGY"
"CHI",0,1,1,0,0,2,0,1,1,0,1,3,"A","Y","2017-12-02","201712020DAL"
"DAL",0,1,1,0,1,3,0,1,1,0,0,2,"H","Y","2017-12-02","201712020DAL"
"MIN",1,1,0,0,0,2,0,0,1,0,0,1,"H","N","2017-12-02","201712020MIN"
"STL",0,0,1,0,0,1,1,1,0,0,0,2,"A","N","2017-12-02","201712020MIN"
"DET",0,0,0,1,0,1,0,2,4,4,0,10,"A","N","2017-12-02","201712020MTL"
"MTL",0,2,4,4,0,10,0,0,0,1,0,1,"H","N","2017-12-02","201712020MTL"
"ANA",0,0,1,1,0,2,0,0,1,1,1,3,"A","Y","2017-12-02","201712020NSH"
"NSH",0,0,1,1,1,3,0,0,1,1,0,2,"H","Y","2017-12-02","201712020NSH"
"BOS",0,1,2,0,0,3,0,0,0,0,0,0,"A","N","2017-12-02","201712020PHI"
"PHI",0,0,0,0,0,0,0,1,2,0,0,3,"H","N","2017-12-02","201712020PHI"
"BUF",0,0,0,1,0,1,0,1,2,2,0,5,"A","N","2017-12-02","201712020PIT"
"PIT",0,1,2,2,0,5,0,0,0,1,0,1,"H","N","2017-12-02","201712020PIT"
"SJS",0,1,0,1,0,2,0,0,1,4,0,5,"A","N","2017-12-02","201712020TBL"
"TBL",0,0,1,4,0,5,0,1,0,1,0,2,"H","N","2017-12-02","201712020TBL"
"TOR",0,0,0,1,0,1,0,2,0,0,0,2,"A","N","2017-12-02","201712020VAN"
"VAN",0,2,0,0,0,2,0,0,0,1,0,1,"H","N","2017-12-02","201712020VAN"
"CBJ",0,0,2,1,0,3,0,2,1,1,0,4,"A","N","2017-12-02","201712020WSH"
"WSH",0,2,1,1,0,4,0,0,2,1,0,3,"H","N","2017-12-02","201712020WSH"
"CHI",0,0,0,1,0,1,0,0,0,3,0,3,"H","N","2017-12-03","201712030CHI"
"LAK",0,0,0,3,0,3,0,0,0,1,0,1,"A","N","2017-12-03","201712030CHI"
"COL",0,0,2,0,0,2,0,2,2,3,0,7,"H","N","2017-12-03","201712030COL"
"DAL",0,2,2,3,0,7,0,0,2,0,0,2,"A","N","2017-12-03","201712030COL"
"ARI",0,0,1,1,0,2,1,0,1,1,0,3,"A","N","2017-12-03","201712030VEG"
"VEG",1,0,1,1,0,3,0,0,1,1,0,2,"H","N","2017-12-03","201712030VEG"
"OTT",0,0,0,0,0,0,0,2,3,0,0,5,"A","N","2017-12-03","201712030WPG"
"WPG",0,2,3,0,0,5,0,0,0,0,0,0,"H","N","2017-12-03","201712030WPG"
"CGY",0,1,1,0,0,2,0,1,3,1,0,5,"H","N","2017-12-04","201712040CGY"
"PHI",0,1,3,1,0,5,0,1,1,0,0,2,"A","N","2017-12-04","201712040CGY"
"FLA",0,1,2,1,0,4,0,1,3,0,1,5,"H","Y","2017-12-04","201712040FLA"
"NYI",0,1,3,0,1,5,0,1,2,1,0,4,"A","Y","2017-12-04","201712040FLA"
"BOS",0,0,1,2,0,3,0,2,2,1,0,5,"A","N","2017-12-04","201712040NSH"
"NSH",0,2,2,1,0,5,0,0,1,2,0,3,"H","N","2017-12-04","201712040NSH"
"SJS",0,0,1,0,0,1,0,1,2,1,0,4,"A","N","2017-12-04","201712040WSH"
"WSH",0,1,2,1,0,4,0,0,1,0,0,1,"H","N","2017-12-04","201712040WSH"
"CBJ",0,1,0,0,0,1,0,1,2,1,0,4,"H","N","2017-12-05","201712050CBJ"
"NJD",0,1,2,1,0,4,0,1,0,0,0,1,"A","N","2017-12-05","201712050CBJ"
"BUF",0,0,2,2,0,4,0,0,1,1,0,2,"A","N","2017-12-05","201712050COL"
"COL",0,0,1,1,0,2,0,0,2,2,0,4,"H","N","2017-12-05","201712050COL"
"DAL",0,0,0,2,0,2,0,1,4,0,0,5,"H","N","2017-12-05","201712050DAL"
"NSH",0,1,4,0,0,5,0,0,0,2,0,2,"A","N","2017-12-05","201712050DAL"
"DET",0,2,0,3,0,5,0,0,1,0,0,1,"H","N","2017-12-05","201712050DET"
"WPG",0,0,1,0,0,1,0,2,0,3,0,5,"A","N","2017-12-05","201712050DET"
"LAK",0,0,1,4,0,5,0,0,2,0,0,2,"H","N","2017-12-05","201712050LAK"
"MIN",0,0,2,0,0,2,0,0,1,4,0,5,"A","N","2017-12-05","201712050LAK"
"MTL",0,1,1,1,0,3,0,1,2,1,0,4,"H","N","2017-12-05","201712050MTL"
"STL",0,1,2,1,0,4,0,1,1,1,0,3,"A","N","2017-12-05","201712050MTL"
"NYR",0,1,2,1,0,4,0,1,1,1,0,3,"A","N","2017-12-05","201712050PIT"
"PIT",0,1,1,1,0,3,0,1,2,1,0,4,"H","N","2017-12-05","201712050PIT"
"NYI",0,0,2,0,0,2,0,2,3,1,0,6,"A","N","2017-12-05","201712050TBL"
"TBL",0,2,3,1,0,6,0,0,2,0,0,2,"H","N","2017-12-05","201712050TBL"
"CAR",0,0,0,0,0,0,0,0,2,1,0,3,"A","N","2017-12-05","201712050VAN"
"VAN",0,0,2,1,0,3,0,0,0,0,0,0,"H","N","2017-12-05","201712050VAN"
"ANA",0,0,3,0,0,3,0,2,0,1,1,4,"A","Y","2017-12-05","201712050VEG"
"VEG",0,2,0,1,1,4,0,0,3,0,0,3,"H","Y","2017-12-05","201712050VEG"
"ANA",0,0,2,1,0,3,0,0,0,0,0,0,"H","N","2017-12-06","201712060ANA"
"OTT",0,0,0,0,0,0,0,0,2,1,0,3,"A","N","2017-12-06","201712060ANA"
"EDM",0,0,1,1,0,2,0,0,2,2,0,4,"H","N","2017-12-06","201712060EDM"
"PHI",0,0,2,2,0,4,0,0,1,1,0,2,"A","N","2017-12-06","201712060EDM"
"CGY",0,1,0,0,0,1,0,0,1,0,1,2,"A","Y","2017-12-06","201712060TOR"
"TOR",0,0,1,0,1,2,0,1,0,0,0,1,"H","Y","2017-12-06","201712060TOR"
"CHI",0,1,0,1,0,2,0,3,1,2,0,6,"A","N","2017-12-06","201712060WSH"
"WSH",0,3,1,2,0,6,0,1,0,1,0,2,"H","N","2017-12-06","201712060WSH"
"ARI",0,1,0,0,0,1,0,1,2,3,0,6,"A","N","2017-12-07","201712070BOS"
"BOS",0,1,2,3,0,6,0,1,0,0,0,1,"H","N","2017-12-07","201712070BOS"
"FLA",0,2,1,3,0,6,0,2,1,1,0,4,"H","N","2017-12-07","201712070FLA"
"WPG",0,2,1,1,0,4,0,2,1,3,0,6,"A","N","2017-12-07","201712070FLA"
"LAK",1,1,1,1,0,4,0,1,1,1,0,3,"H","N","2017-12-07","201712070LAK"
"OTT",0,1,1,1,0,3,1,1,1,1,0,4,"A","N","2017-12-07","201712070LAK"
"CGY",1,1,0,1,0,3,0,1,1,0,0,2,"A","N","2017-12-07","201712070MTL"
"MTL",0,1,1,0,0,2,1,1,0,1,0,3,"H","N","2017-12-07","201712070MTL"
"NYI",0,0,1,2,0,3,1,1,0,2,0,4,"A","N","2017-12-07","201712070PIT"
"PIT",1,1,0,2,0,4,0,0,1,2,0,3,"H","N","2017-12-07","201712070PIT"
"CAR",0,3,1,0,0,4,1,0,2,2,0,5,"A","N","2017-12-07","201712070SJS"
"SJS",1,0,2,2,0,5,0,3,1,0,0,4,"H","N","2017-12-07","201712070SJS"
"DAL",0,0,0,0,0,0,0,1,0,2,0,3,"A","N","2017-12-07","201712070STL"
"STL",0,1,0,2,0,3,0,0,0,0,0,0,"H","N","2017-12-07","201712070STL"
"COL",0,2,0,0,0,2,0,2,1,2,0,5,"A","N","2017-12-07","201712070TBL"
"TBL",0,2,1,2,0,5,0,2,0,0,0,2,"H","N","2017-12-07","201712070TBL"
"PHI",0,1,2,1,0,4,0,0,1,0,0,1,"A","N","2017-12-07","201712070VAN"
"VAN",0,0,1,0,0,1,0,1,2,1,0,4,"H","N","2017-12-07","201712070VAN"
"ANA",0,1,0,1,0,2,1,0,2,0,0,3,"H","N","2017-12-08","201712080ANA"
"MIN",1,0,2,0,0,3,0,1,0,1,0,2,"A","N","2017-12-08","201712080ANA"
"BUF",0,1,1,0,0,2,1,0,1,1,0,3,"A","N","2017-12-08","201712080CHI"
"CHI",1,0,1,1,0,3,0,1,1,0,0,2,"H","N","2017-12-08","201712080CHI"
"CBJ",0,0,3,2,0,5,0,2,1,0,0,3,"A","N","2017-12-08","201712080NJD"
"NJD",0,2,1,0,0,3,0,0,3,2,0,5,"H","N","2017-12-08","201712080NJD"
"NSH",0,0,1,2,0,3,0,1,1,1,1,4,"H","Y","2017-12-08","201712080NSH"
"VEG",0,1,1,1,1,4,0,0,1,2,0,3,"A","Y","2017-12-08","201712080NSH"
"NYR",0,0,1,1,0,2,0,1,1,2,0,4,"A","N","2017-12-08","201712080WSH"
"WSH",0,1,1,2,0,4,0,0,1,1,0,2,"H","N","2017-12-08","201712080WSH"
"BOS",0,0,1,2,0,3,0,0,0,1,0,1,"H","N","2017-12-09","201712090BOS"
"NYI",0,0,0,1,0,1,0,0,1,2,0,3,"A","N","2017-12-09","201712090BOS"
"ARI",0,0,0,0,0,0,0,1,0,0,0,1,"A","N","2017-12-09","201712090CBJ"
"CBJ",0,1,0,0,0,1,0,0,0,0,0,0,"H","N","2017-12-09","201712090CBJ"
"CGY",0,1,0,3,0,4,0,1,1,0,0,2,"H","N","2017-12-09","201712090CGY"
"VAN",0,1,1,0,0,2,0,1,0,3,0,4,"A","N","2017-12-09","201712090CGY"
"DAL",0,1,1,1,0,3,0,1,3,1,0,5,"H","N","2017-12-09","201712090DAL"
"VEG",0,1,3,1,0,5,0,1,1,1,0,3,"A","N","2017-12-09","201712090DAL"
"DET",0,0,0,1,0,1,0,1,3,2,0,6,"H","N","2017-12-09","201712090DET"
"STL",0,1,3,2,0,6,0,0,0,1,0,1,"A","N","2017-12-09","201712090DET"
"COL",0,1,2,4,0,7,0,1,1,1,0,3,"A","N","2017-12-09","201712090FLA"
"FLA",0,1,1,1,0,3,0,1,2,4,0,7,"H","N","2017-12-09","201712090FLA"
"CAR",0,0,0,2,0,2,1,0,2,0,0,3,"A","N","2017-12-09","201712090LAK"
"LAK",1,0,2,0,0,3,0,0,0,2,0,2,"H","N","2017-12-09","201712090LAK"
"EDM",0,2,2,2,0,6,0,0,1,1,0,2,"A","N","2017-12-09","201712090MTL"
"MTL",0,0,1,1,0,2,0,2,2,2,0,6,"H","N","2017-12-09","201712090MTL"
"NJD",0,0,1,1,0,2,0,1,2,2,0,5,"A","N","2017-12-09","201712090NYR"
"NYR",0,1,2,2,0,5,0,0,1,1,0,2,"H","N","2017-12-09","201712090NYR"
"PIT",0,0,2,1,0,3,0,3,1,0,0,4,"H","N","2017-12-09","201712090PIT"
"TOR",0,3,1,0,0,4,0,0,2,1,0,3,"A","N","2017-12-09","201712090PIT"
"OTT",0,0,0,0,0,0,0,1,2,2,0,5,"A","N","2017-12-09","201712090SJS"
"SJS",0,1,2,2,0,5,0,0,0,0,0,0,"H","N","2017-12-09","201712090SJS"
"TBL",1,1,1,1,0,4,0,1,1,1,0,3,"H","N","2017-12-09","201712090TBL"
"WPG",0,1,1,1,0,3,1,1,1,1,0,4,"A","N","2017-12-09","201712090TBL"
"ARI",0,0,0,1,0,1,0,0,0,3,0,3,"A","N","2017-12-10","201712100CHI"
"CHI",0,0,0,3,0,3,0,0,0,1,0,1,"H","N","2017-12-10","201712100CHI"
"MIN",1,2,1,0,0,4,0,0,1,2,0,3,"A","N","2017-12-10","201712100SJS"
"SJS",0,0,1,2,0,3,1,2,1,0,0,4,"H","N","2017-12-10","201712100SJS"
"BUF",0,0,0,2,0,2,1,1,1,0,0,3,"A","N","2017-12-10","201712100STL"
"STL",1,1,1,0,0,3,0,0,0,2,0,2,"H","N","2017-12-10","201712100STL"
"EDM",0,0,0,0,0,0,0,1,0,0,0,1,"A","N","2017-12-10","201712100TOR"
"TOR",0,1,0,0,0,1,0,0,0,0,0,0,"H","N","2017-12-10","201712100TOR"
"ANA",0,1,1,1,0,3,0,1,0,1,0,2,"H","N","2017-12-11","201712110ANA"
"CAR",0,1,0,1,0,2,0,1,1,1,0,3,"A","N","2017-12-11","201712110ANA"
"DET",0,1,0,0,0,1,1,0,0,1,0,2,"H","N","2017-12-11","201712110DET"
"FLA",1,0,0,1,0,2,0,1,0,0,0,1,"A","N","2017-12-11","201712110DET"
"NYI",0,1,2,0,0,3,0,0,0,1,0,1,"H","N","2017-12-11","201712110NYI"
"WSH",0,0,0,1,0,1,0,1,2,0,0,3,"A","N","2017-12-11","201712110NYI"
"DAL",0,0,1,0,1,2,0,0,0,1,0,1,"A","Y","2017-12-11","201712110NYR"
"NYR",0,0,0,1,0,1,0,0,1,0,1,2,"H","Y","2017-12-11","201712110NYR"
"COL",0,0,0,2,0,2,0,0,0,1,0,1,"A","N","2017-12-11","201712110PIT"
"PIT",0,0,0,1,0,1,0,0,0,2,0,2,"H","N","2017-12-11","201712110PIT"
"VAN",0,1,0,0,0,1,0,1,2,2,0,5,"A","N","2017-12-11","201712110WPG"
"WPG",0,1,2,2,0,5,0,1,0,0,0,1,"H","N","2017-12-11","201712110WPG"
"BUF",0,0,3,0,0,3,0,0,0,2,0,2,"H","N","2017-12-12","201712120BUF"
"OTT",0,0,0,2,0,2,0,0,3,0,0,3,"A","N","2017-12-12","201712120BUF"
"CBJ",0,0,0,2,0,2,0,1,4,2,0,7,"H","N","2017-12-12","201712120CBJ"
"EDM",0,1,4,2,0,7,0,0,0,2,0,2,"A","N","2017-12-12","201712120CBJ"
"CHI",1,1,0,1,0,3,0,0,1,1,0,2,"H","N","2017-12-12","201712120CHI"
"FLA",0,0,1,1,0,2,1,1,0,1,0,3,"A","N","2017-12-12","201712120CHI"
"CGY",0,0,1,0,0,1,0,1,0,0,1,2,"A","Y","2017-12-12","201712120MIN"
"MIN",0,1,0,0,1,2,0,0,1,0,0,1,"H","Y","2017-12-12","201712120MIN"
"LAK",0,0,0,1,0,1,0,2,2,1,0,5,"A","N","2017-12-12","201712120NJD"
"NJD",0,2,2,1,0,5,0,0,0,1,0,1,"H","N","2017-12-12","201712120NJD"
"PHI",0,1,0,3,0,4,0,1,1,0,0,2,"H","N","2017-12-12","201712120PHI"
"TOR",0,1,1,0,0,2,0,1,0,3,0,4,"A","N","2017-12-12","201712120PHI"
"STL",0,0,0,0,0,0,0,1,0,2,0,3,"H","N","2017-12-12","201712120STL"
"TBL",0,1,0,2,0,3,0,0,0,0,0,0,"A","N","2017-12-12","201712120STL"
"CAR",0,1,1,0,1,3,0,0,2,0,0,2,"A","Y","2017-12-12","201712120VEG"
"VEG",0,0,2,0,0,2,0,1,1,0,1,3,"H","Y","2017-12-12","201712120VEG"
"COL",0,0,1,1,0,2,0,1,1,3,0,5,"A","N","2017-12-12","201712120WSH"
"WSH",0,1,1,3,0,5,0,0,1,1,0,2,"H","N","2017-12-12","201712120WSH"
"BOS",1,0,0,2,0,3,0,0,1,1,0,2,"A","N","2017-12-13","201712130DET"
"DET",0,0,1,1,0,2,1,0,0,2,0,3,"H","N","2017-12-13","201712130DET"
"DAL",0,2,2,1,0,5,0,0,0,2,0,2,"A","N","2017-12-13","201712130NYI"
"NYI",0,0,0,2,0,2,0,2,2,1,0,5,"H","N","2017-12-13","201712130NYI"
"NYR",0,0,1,1,0,2,0,1,1,1,0,3,"A","N","2017-12-13","201712130OTT"
"OTT",0,1,1,1,0,3,0,0,1,1,0,2,"H","N","2017-12-13","201712130OTT"
"NSH",0,2,2,3,0,7,0,0,1,0,0,1,"A","N","2017-12-13","201712130VAN"
"VAN",0,0,1,0,0,1,0,2,2,3,0,7,"H","N","2017-12-13","201712130VAN"
"ARI",0,0,1,0,0,1,0,2,1,1,0,4,"H","N","2017-12-14","201712140ARI"
"TBL",0,2,1,1,0,4,0,0,1,0,0,1,"A","N","2017-12-14","201712140ARI"
"BOS",0,0,1,2,0,3,0,1,1,3,0,5,"H","N","2017-12-14","201712140BOS"
"WSH",0,1,1,3,0,5,0,0,1,2,0,3,"A","N","2017-12-14","201712140BOS"
"CBJ",0,3,2,1,0,6,0,0,3,1,0,4,"H","N","2017-12-14","201712140CBJ"
"NYI",0,0,3,1,0,4,0,3,2,1,0,6,"A","N","2017-12-14","201712140CBJ"
"CGY",0,1,0,1,0,2,0,1,1,1,0,3,"H","N","2017-12-14","201712140CGY"
"SJS",0,1,1,1,0,3,0,1,0,1,0,2,"A","N","2017-12-14","201712140CGY"
"COL",0,0,1,1,0,2,0,0,1,0,0,1,"H","N","2017-12-14","201712140COL"
"FLA",0,0,1,0,0,1,0,0,1,1,0,2,"A","N","2017-12-14","201712140COL"
"EDM",0,0,0,0,0,0,0,0,4,0,0,4,"H","N","2017-12-14","201712140EDM"
"NSH",0,0,4,0,0,4,0,0,0,0,0,0,"A","N","2017-12-14","201712140EDM"
"MIN",0,1,0,1,0,2,0,0,0,0,0,0,"H","N","2017-12-14","201712140MIN"
"TOR",0,0,0,0,0,0,0,1,0,1,0,2,"A","N","2017-12-14","201712140MIN"
"MTL",1,1,0,0,0,2,0,1,0,0,0,1,"H","N","2017-12-14","201712140MTL"
"NJD",0,1,0,0,0,1,1,1,0,0,0,2,"A","N","2017-12-14","201712140MTL"
"BUF",0,1,0,0,0,1,0,1,1,0,0,2,"A","N","2017-12-14","201712140PHI"
"PHI",0,1,1,0,0,2,0,1,0,0,0,1,"H","N","2017-12-14","201712140PHI"
"ANA",0,0,1,2,0,3,0,0,0,1,0,1,"A","N","2017-12-14","201712140STL"
"STL",0,0,0,1,0,1,0,0,1,2,0,3,"H","N","2017-12-14","201712140STL"
"PIT",0,1,0,0,0,1,0,1,0,1,0,2,"A","N","2017-12-14","201712140VEG"
"VEG",0,1,0,1,0,2,0,1,0,0,0,1,"H","N","2017-12-14","201712140VEG"
"CHI",0,3,1,1,0,5,0,0,0,1,0,1,"A","N","2017-12-14","201712140WPG"
"WPG",0,0,0,1,0,1,0,3,1,1,0,5,"H","N","2017-12-14","201712140WPG"
"BUF",0,0,1,3,0,4,1,0,1,3,0,5,"H","N","2017-12-15","201712150BUF"
"CAR",1,0,1,3,0,5,0,0,1,3,0,4,"A","N","2017-12-15","201712150BUF"
"DET",0,0,2,1,0,3,0,1,0,0,0,1,"H","N","2017-12-15","201712150DET"
"TOR",0,1,0,0,0,1,0,0,2,1,0,3,"A","N","2017-12-15","201712150DET"
"DAL",0,1,1,0,0,2,0,2,1,2,0,5,"A","N","2017-12-15","201712150NJD"
"NJD",0,2,1,2,0,5,0,1,1,0,0,2,"H","N","2017-12-15","201712150NJD"
"LAK",0,0,1,1,0,2,0,1,1,2,0,4,"A","N","2017-12-15","201712150NYR"
"NYR",0,1,1,2,0,4,0,0,1,1,0,2,"H","N","2017-12-15","201712150NYR"
"SJS",0,1,1,1,0,3,1,2,1,0,0,4,"A","N","2017-12-15","201712150VAN"
"VAN",1,2,1,0,0,4,0,1,1,1,0,3,"H","N","2017-12-15","201712150VAN"
"ARI",0,0,1,1,0,2,0,0,2,2,0,4,"H","N","2017-12-16","201712160ARI"
"PIT",0,0,2,2,0,4,0,0,1,1,0,2,"A","N","2017-12-16","201712160ARI"
"BOS",0,0,1,1,0,2,1,1,1,0,0,3,"H","N","2017-12-16","201712160BOS"
"NYR",1,1,1,0,0,3,0,0,1,1,0,2,"A","N","2017-12-16","201712160BOS"
"CAR",0,1,1,0,0,2,0,1,0,0,0,1,"H","N","2017-12-16","201712160CAR"
"CBJ",0,1,0,0,0,1,0,1,1,0,0,2,"A","N","2017-12-16","201712160CAR"
"CGY",0,0,0,0,0,0,0,0,2,0,0,2,"H","N","2017-12-16","201712160CGY"
"NSH",0,0,2,0,0,2,0,0,0,0,0,0,"A","N","2017-12-16","201712160CGY"
"COL",0,0,1,4,0,5,0,0,4,2,0,6,"H","N","2017-12-16","201712160COL"
"TBL",0,0,4,2,0,6,0,0,1,4,0,5,"A","N","2017-12-16","201712160COL"
"EDM",0,0,2,1,0,3,0,0,1,1,0,2,"A","N","2017-12-16","201712160MIN"
"MIN",0,0,1,1,0,2,0,0,2,1,0,3,"H","N","2017-12-16","201712160MIN"
"LAK",0,2,0,1,0,3,1,1,0,2,0,4,"A","N","2017-12-16","201712160NYI"
"NYI",1,1,0,2,0,4,0,2,0,1,0,3,"H","N","2017-12-16","201712160NYI"
"MTL",0,0,0,0,0,0,0,0,1,2,0,3,"A","N","2017-12-16","201712160OTT"
"OTT",0,0,1,2,0,3,0,0,0,0,0,0,"H","N","2017-12-16","201712160OTT"
"DAL",0,1,0,0,0,1,1,0,1,0,0,2,"A","N","2017-12-16","201712160PHI"
"PHI",1,0,1,0,0,2,0,1,0,0,0,1,"H","N","2017-12-16","201712160PHI"
"STL",0,1,0,1,0,2,0,0,0,0,0,0,"H","N","2017-12-16","201712160STL"
"WPG",0,0,0,0,0,0,0,1,0,1,0,2,"A","N","2017-12-16","201712160STL"
"ANA",0,1,1,0,0,2,1,0,0,2,0,3,"A","N","2017-12-16","201712160WSH"
"WSH",1,0,0,2,0,3,0,1,1,0,0,2,"H","N","2017-12-16","201712160WSH"
"CHI",0,1,1,2,0,4,0,0,0,1,0,1,"H","N","2017-12-17","201712170CHI"
"MIN",0,0,0,1,0,1,0,1,1,2,0,4,"A","N","2017-12-17","201712170CHI"
"CGY",0,1,4,1,0,6,0,0,0,1,0,1,"A","N","2017-12-17","201712170VAN"
"VAN",0,0,0,1,0,1,0,1,4,1,0,6,"H","N","2017-12-17","201712170VAN"
"FLA",0,2,0,0,0,2,0,2,0,3,0,5,"A","N","2017-12-17","201712170VEG"
"VEG",0,2,0,3,0,5,0,2,0,0,0,2,"H","N","2017-12-17","201712170VEG"
"STL",0,0,0,0,0,0,0,0,2,2,0,4,"A","N","2017-12-17","201712170WPG"
"WPG",0,0,2,2,0,4,0,0,0,0,0,0,"H","N","2017-12-17","201712170WPG"
"BOS",0,1,2,4,0,7,0,0,0,2,0,2,"H","N","2017-12-18","201712180BOS"
"CBJ",0,0,0,2,0,2,0,1,2,4,0,7,"A","N","2017-12-18","201712180BOS"
"COL",0,1,2,1,0,4,0,1,0,1,0,2,"H","N","2017-12-18","201712180COL"
"PIT",0,1,0,1,0,2,0,1,2,1,0,4,"A","N","2017-12-18","201712180COL"
"EDM",0,2,1,2,0,5,0,1,1,1,0,3,"H","N","2017-12-18","201712180EDM"
"SJS",0,1,1,1,0,3,0,2,1,2,0,5,"A","N","2017-12-18","201712180EDM"
"ANA",0,2,1,0,0,3,0,0,2,3,0,5,"A","N","2017-12-18","201712180NJD"
"NJD",0,0,2,3,0,5,0,2,1,0,0,3,"H","N","2017-12-18","201712180NJD"
"LAK",0,2,0,2,0,4,0,1,0,0,0,1,"A","N","2017-12-18","201712180PHI"
"PHI",0,1,0,0,0,1,0,2,0,2,0,4,"H","N","2017-12-18","201712180PHI"
"ARI",0,1,1,0,0,2,0,0,1,2,0,3,"H","N","2017-12-19","201712190ARI"
"FLA",0,0,1,2,0,3,0,1,1,0,0,2,"A","N","2017-12-19","201712190ARI"
"BOS",0,0,1,2,0,3,0,0,0,0,0,0,"A","N","2017-12-19","201712190BUF"
"BUF",0,0,0,0,0,0,0,0,1,2,0,3,"H","N","2017-12-19","201712190BUF"
"DAL",0,1,1,1,0,3,1,1,1,1,0,4,"H","N","2017-12-19","201712190DAL"
"WSH",1,1,1,1,0,4,0,1,1,1,0,3,"A","N","2017-12-19","201712190DAL"
"NSH",0,2,1,1,0,4,0,1,3,2,0,6,"H","N","2017-12-19","201712190NSH"
"WPG",0,1,3,2,0,6,0,2,1,1,0,4,"A","N","2017-12-19","201712190NSH"
"DET",0,2,1,3,0,6,0,1,2,0,0,3,"A","N","2017-12-19","201712190NYI"
"NYI",0,1,2,0,0,3,0,2,1,3,0,6,"H","N","2017-12-19","201712190NYI"
"ANA",0,0,0,1,0,1,0,1,2,1,0,4,"A","N","2017-12-19","201712190NYR"
"NYR",0,1,2,1,0,4,0,0,0,1,0,1,"H","N","2017-12-19","201712190NYR"
"MIN",0,1,2,3,0,6,0,1,2,1,0,4,"A","N","2017-12-19","201712190OTT"
"OTT",0,1,2,1,0,4,0,1,2,3,0,6,"H","N","2017-12-19","201712190OTT"
"CAR",0,1,0,0,0,1,0,4,0,4,0,8,"A","N","2017-12-19","201712190TOR"
"TOR",0,4,0,4,0,8,0,1,0,0,0,1,"H","N","2017-12-19","201712190TOR"
"MTL",0,1,3,3,0,7,0,1,2,2,0,5,"A","N","2017-12-19","201712190VAN"
"VAN",0,1,2,2,0,5,0,1,3,3,0,7,"H","N","2017-12-19","201712190VAN"
"TBL",0,2,0,1,0,3,0,0,2,2,0,4,"A","N","2017-12-19","201712190VEG"
"VEG",0,0,2,2,0,4,0,2,0,1,0,3,"H","N","2017-12-19","201712190VEG"
"CBJ",0,2,1,1,0,4,0,0,1,1,0,2,"H","N","2017-12-20","201712200CBJ"
"TOR",0,0,1,1,0,2,0,2,1,1,0,4,"A","N","2017-12-20","201712200CBJ"
"CGY",0,1,0,1,0,2,0,0,1,0,0,1,"H","N","2017-12-20","201712200CGY"
"STL",0,0,1,0,0,1,0,1,0,1,0,2,"A","N","2017-12-20","201712200CGY"
"DET",0,1,2,0,0,3,0,1,2,1,0,4,"A","N","2017-12-20","201712200PHI"
"PHI",0,1,2,1,0,4,0,1,2,0,0,3,"H","N","2017-12-20","201712200PHI"
"BOS",0,0,0,1,1,2,0,0,0,1,0,1,"H","Y","2017-12-21","201712210BOS"
"WPG",0,0,0,1,0,1,0,0,0,1,1,2,"A","Y","2017-12-21","201712210BOS"
"CHI",0,0,0,0,0,0,0,1,3,0,0,4,"A","N","2017-12-21","201712210DAL"
"DAL",0,1,3,0,0,4,0,0,0,0,0,0,"H","N","2017-12-21","201712210DAL"
"EDM",0,0,0,3,0,3,0,0,0,2,0,2,"H","N","2017-12-21","201712210EDM"
"STL",0,0,0,2,0,2,0,0,0,3,0,3,"A","N","2017-12-21","201712210EDM"
"COL",0,0,1,0,0,1,1,0,0,1,0,2,"A","N","2017-12-21","201712210LAK"
"LAK",1,0,0,1,0,2,0,0,1,0,0,1,"H","N","2017-12-21","201712210LAK"
"NJD",0,1,1,1,1,4,0,2,0,1,0,3,"H","Y","2017-12-21","201712210NJD"
"NYR",0,2,0,1,0,3,0,1,1,1,1,4,"A","Y","2017-12-21","201712210NJD"
"CAR",0,4,0,0,0,4,0,1,0,0,0,1,"A","N","2017-12-21","201712210NSH"
"NSH",0,1,0,0,0,1,0,4,0,0,0,4,"H","N","2017-12-21","201712210NSH"
"ANA",1,2,1,1,0,5,0,0,2,2,0,4,"A","N","2017-12-21","201712210NYI"
"NYI",0,0,2,2,0,4,1,2,1,1,0,5,"H","N","2017-12-21","201712210NYI"
"CBJ",0,0,1,1,0,2,0,0,0,2,1,3,"A","Y","2017-12-21","201712210PIT"
"PIT",0,0,0,2,1,3,0,0,1,1,0,2,"H","Y","2017-12-21","201712210PIT"
"SJS",1,1,3,0,0,5,0,1,2,1,0,4,"H","N","2017-12-21","201712210SJS"
"VAN",0,1,2,1,0,4,1,1,3,0,0,5,"A","N","2017-12-21","201712210SJS"
"OTT",0,1,1,1,0,3,0,0,2,1,1,4,"A","Y","2017-12-21","201712210TBL"
"TBL",0,0,2,1,1,4,0,1,1,1,0,3,"H","Y","2017-12-21","201712210TBL"
"ARI",1,0,0,2,0,3,0,0,1,1,0,2,"H","N","2017-12-22","201712220ARI"
"WSH",0,0,1,1,0,2,1,0,0,2,0,3,"A","N","2017-12-22","201712220ARI"
"BUF",0,0,0,4,0,4,0,0,0,2,0,2,"H","N","2017-12-22","201712220BUF"
"PHI",0,0,0,2,0,2,0,0,0,4,0,4,"A","N","2017-12-22","201712220BUF"
"CGY",0,0,0,2,0,2,0,1,1,1,0,3,"H","N","2017-12-22","201712220CGY"
"MTL",0,1,1,1,0,3,0,0,0,2,0,2,"A","N","2017-12-22","201712220CGY"
"FLA",0,1,0,3,0,4,0,1,1,0,0,2,"H","N","2017-12-22","201712220FLA"
"MIN",0,1,1,0,0,2,0,1,0,3,0,4,"A","N","2017-12-22","201712220FLA"
"ARI",0,0,1,1,0,2,0,0,4,2,0,6,"H","N","2017-12-23","201712230ARI"
"COL",0,0,4,2,0,6,0,0,1,1,0,2,"A","N","2017-12-23","201712230ARI"
"BOS",0,1,0,2,0,3,0,1,0,0,0,1,"H","N","2017-12-23","201712230BOS"
"DET",0,1,0,0,0,1,0,1,0,2,0,3,"A","N","2017-12-23","201712230BOS"
"BUF",0,0,2,0,0,2,0,1,3,0,0,4,"A","N","2017-12-23","201712230CAR"
"CAR",0,1,3,0,0,4,0,0,2,0,0,2,"H","N","2017-12-23","201712230CAR"
"CBJ",0,1,0,0,1,2,0,0,1,0,0,1,"H","Y","2017-12-23","201712230CBJ"
"PHI",0,0,1,0,0,1,0,1,0,0,1,2,"A","Y","2017-12-23","201712230CBJ"
"DAL",0,1,2,0,1,4,0,2,0,1,0,3,"H","Y","2017-12-23","201712230DAL"
"NSH",0,2,0,1,0,3,0,1,2,0,1,4,"A","Y","2017-12-23","201712230DAL"
"EDM",0,2,1,1,0,4,0,0,1,0,0,1,"H","N","2017-12-23","201712230EDM"
"MTL",0,0,1,0,0,1,0,2,1,1,0,4,"A","N","2017-12-23","201712230EDM"
"FLA",0,0,1,0,0,1,0,0,0,0,0,0,"H","N","2017-12-23","201712230FLA"
"OTT",0,0,0,0,0,0,0,0,1,0,0,1,"A","N","2017-12-23","201712230FLA"
"CHI",0,0,1,0,0,1,0,3,0,1,0,4,"A","N","2017-12-23","201712230NJD"
"NJD",0,3,0,1,0,4,0,0,1,0,0,1,"H","N","2017-12-23","201712230NJD"
"NYI",0,3,0,2,0,5,0,1,0,1,0,2,"H","N","2017-12-23","201712230NYI"
"WPG",0,1,0,1,0,2,0,3,0,2,0,5,"A","N","2017-12-23","201712230NYI"
"NYR",0,0,1,1,0,2,0,1,2,0,0,3,"H","N","2017-12-23","201712230NYR"
"TOR",0,1,2,0,0,3,0,0,1,1,0,2,"A","N","2017-12-23","201712230NYR"
"ANA",0,2,2,0,0,4,0,0,0,0,0,0,"A","N","2017-12-23","201712230PIT"
"PIT",0,0,0,0,0,0,0,2,2,0,0,4,"H","N","2017-12-23","201712230PIT"
"LAK",0,0,0,0,0,0,0,0,1,1,0,2,"A","N","2017-12-23","201712230SJS"
"SJS",0,0,1,1,0,2,0,0,0,0,0,0,"H","N","2017-12-23","201712230SJS"
"MIN",0,0,0,0,0,0,0,0,0,3,0,3,"A","N","2017-12-23","201712230TBL"
"TBL",0,0,0,3,0,3,0,0,0,0,0,0,"H","N","2017-12-23","201712230TBL"
"STL",0,1,1,1,0,3,0,0,1,0,0,1,"A","N","2017-12-23","201712230VAN"
"VAN",0,0,1,0,0,1,0,1,1,1,0,3,"H","N","2017-12-23","201712230VAN"
"VEG",0,3,0,0,0,3,0,0,0,0,0,0,"H","N","2017-12-23","201712230VEG"
"WSH",0,0,0,0,0,0,0,3,0,0,0,3,"A","N","2017-12-23","201712230VEG"
"ANA",0,1,0,0,0,1,0,1,1,2,0,4,"H","N","2017-12-27","201712270ANA"
"VEG",0,1,1,2,0,4,0,1,0,0,0,1,"A","N","2017-12-27","201712270ANA"
"BOS",0,2,2,1,0,5,0,0,1,0,0,1,"H","N","2017-12-27","201712270BOS"
"OTT",0,0,1,0,0,1,0,2,2,1,0,5,"A","N","2017-12-27","201712270BOS"
"CAR",0,1,0,2,0,3,0,0,1,0,0,1,"H","N","2017-12-27","201712270CAR"
"MTL",0,0,1,0,0,1,0,1,0,2,0,3,"A","N","2017-12-27","201712270CAR"
"ARI",0,1,1,1,0,3,0,1,0,0,0,1,"A","N","2017-12-27","201712270COL"
"COL",0,1,0,0,0,1,0,1,1,1,0,3,"H","N","2017-12-27","201712270COL"
"DAL",0,1,1,0,0,2,0,1,2,1,0,4,"A","N","2017-12-27","201712270MIN"
"MIN",0,1,2,1,0,4,0,1,1,0,0,2,"H","N","2017-12-27","201712270MIN"
"DET",0,0,1,0,0,1,0,2,0,1,0,3,"A","N","2017-12-27","201712270NJD"
"NJD",0,2,0,1,0,3,0,0,1,0,0,1,"H","N","2017-12-27","201712270NJD"
"BUF",0,0,1,1,0,2,1,0,1,1,0,3,"A","N","2017-12-27","201712270NYI"
"NYI",1,0,1,1,0,3,0,0,1,1,0,2,"H","N","2017-12-27","201712270NYI"
"NYR",0,0,0,0,1,1,0,0,0,0,0,0,"H","Y","2017-12-27","201712270NYR"
"WSH",0,0,0,0,0,0,0,0,0,0,1,1,"A","Y","2017-12-27","201712270NYR"
"CBJ",0,2,1,1,0,4,0,0,1,3,1,5,"A","Y","2017-12-27","201712270PIT"
"PIT",0,0,1,3,1,5,0,2,1,1,0,4,"H","Y","2017-12-27","201712270PIT"
"NSH",0,1,1,0,0,2,0,0,0,1,0,1,"A","N","2017-12-27","201712270STL"
"STL",0,0,0,1,0,1,0,1,1,0,0,2,"H","N","2017-12-27","201712270STL"
"EDM",0,2,1,0,0,3,0,2,2,0,0,4,"A","N","2017-12-27","201712270WPG"
"WPG",0,2,2,0,0,4,0,2,1,0,0,3,"H","N","2017-12-27","201712270WPG"
"ARI",0,2,1,1,0,4,0,3,3,1,0,7,"H","N","2017-12-28","201712280ARI"
"TOR",0,3,3,1,0,7,0,2,1,1,0,4,"A","N","2017-12-28","201712280ARI"
"FLA",0,1,2,0,0,3,0,0,0,2,0,2,"H","N","2017-12-28","201712280FLA"
"PHI",0,0,0,2,0,2,0,1,2,0,0,3,"A","N","2017-12-28","201712280FLA"
"LAK",0,1,0,1,0,2,1,0,1,1,0,3,"H","N","2017-12-28","201712280LAK"
"VEG",1,0,1,1,0,3,0,1,0,1,0,2,"A","N","2017-12-28","201712280LAK"
"CGY",0,2,0,0,0,2,0,1,0,1,1,3,"A","Y","2017-12-28","201712280SJS"
"SJS",0,1,0,1,1,3,0,2,0,0,0,2,"H","Y","2017-12-28","201712280SJS"
"MTL",0,0,1,0,0,1,0,0,1,2,0,3,"A","N","2017-12-28","201712280TBL"
"TBL",0,0,1,2,0,3,0,0,1,0,0,1,"H","N","2017-12-28","201712280TBL"
"CHI",0,1,0,1,0,2,0,1,1,3,0,5,"A","N","2017-12-28","201712280VAN"
"VAN",0,1,1,3,0,5,0,1,0,1,0,2,"H","N","2017-12-28","201712280VAN"
"BOS",0,2,0,1,0,3,0,0,2,1,1,4,"A","Y","2017-12-28","201712280WSH"
"WSH",0,0,2,1,1,4,0,2,0,1,0,3,"H","Y","2017-12-28","201712280WSH"
"ANA",0,1,0,1,0,2,0,0,1,0,0,1,"H","N","2017-12-29","201712290ANA"
"CGY",0,0,1,0,0,1,0,1,0,1,0,2,"A","N","2017-12-29","201712290ANA"
"CAR",0,0,2,0,0,2,0,1,0,0,0,1,"H","N","2017-12-29","201712290CAR"
"PIT",0,1,0,0,0,1,0,0,2,0,0,2,"A","N","2017-12-29","201712290CAR"
"COL",1,1,1,1,0,4,0,1,1,1,0,3,"H","N","2017-12-29","201712290COL"
"TOR",0,1,1,1,0,3,1,1,1,1,0,4,"A","N","2017-12-29","201712290COL"
"DAL",0,0,1,3,0,4,0,0,0,2,0,2,"H","N","2017-12-29","201712290DAL"
"STL",0,0,0,2,0,2,0,0,1,3,0,4,"A","N","2017-12-29","201712290DAL"
"DET",0,0,1,1,1,3,0,1,0,1,0,2,"H","Y","2017-12-29","201712290DET"
"NYR",0,1,0,1,0,2,0,0,1,1,1,3,"A","Y","2017-12-29","201712290DET"
"CHI",1,1,1,1,0,4,0,1,0,2,0,3,"A","N","2017-12-29","201712290EDM"
"EDM",0,1,0,2,0,3,1,1,1,1,0,4,"H","N","2017-12-29","201712290EDM"
"MIN",0,2,1,1,0,4,0,1,0,1,0,2,"H","N","2017-12-29","201712290MIN"
"NSH",0,1,0,1,0,2,0,2,1,1,0,4,"A","N","2017-12-29","201712290MIN"
"BUF",1,0,2,1,0,4,0,1,2,0,0,3,"A","N","2017-12-29","201712290NJD"
"NJD",0,1,2,0,0,3,1,0,2,1,0,4,"H","N","2017-12-29","201712290NJD"
"CBJ",0,0,3,1,0,4,0,0,3,2,0,5,"A","N","2017-12-29","201712290OTT"
"OTT",0,0,3,2,0,5,0,0,3,1,0,4,"H","N","2017-12-29","201712290OTT"
"PHI",0,0,3,2,0,5,0,1,1,1,0,3,"A","N","2017-12-29","201712290TBL"
"TBL",0,1,1,1,0,3,0,0,3,2,0,5,"H","N","2017-12-29","201712290TBL"
"NYI",0,0,1,1,0,2,0,2,0,2,0,4,"A","N","2017-12-29","201712290WPG"
"WPG",0,2,0,2,0,4,0,0,1,1,0,2,"H","N","2017-12-29","201712290WPG"
"FLA",0,0,1,1,0,2,0,0,0,0,0,0,"H","N","2017-12-30","201712300FLA"
"MTL",0,0,0,0,0,0,0,0,1,1,0,2,"A","N","2017-12-30","201712300FLA"
"MIN",0,0,0,0,0,0,0,0,0,3,0,3,"A","N","2017-12-30","201712300NSH"
"NSH",0,0,0,3,0,3,0,0,0,0,0,0,"H","N","2017-12-30","201712300NSH"
"BOS",0,1,3,1,0,5,0,0,0,0,0,0,"A","N","2017-12-30","201712300OTT"
"OTT",0,0,0,0,0,0,0,1,3,1,0,5,"H","N","2017-12-30","201712300OTT"
"CAR",0,0,2,0,0,2,0,1,1,1,0,3,"A","N","2017-12-30","201712300STL"
"STL",0,1,1,1,0,3,0,0,2,0,0,2,"H","N","2017-12-30","201712300STL"
"LAK",0,2,0,2,0,4,0,1,1,1,0,3,"A","N","2017-12-30","201712300VAN"
"VAN",0,1,1,1,0,3,0,2,0,2,0,4,"H","N","2017-12-30","201712300VAN"
"NJD",0,1,0,1,0,2,0,2,1,2,0,5,"A","N","2017-12-30","201712300WSH"
"WSH",0,2,1,2,0,5,0,1,0,1,0,2,"H","N","2017-12-30","201712300WSH"
"ANA",0,2,0,3,0,5,0,1,0,1,0,2,"H","N","2017-12-31","201712310ANA"
"ARI",0,1,0,1,0,2,0,2,0,3,0,5,"A","N","2017-12-31","201712310ANA"
"CBJ",0,0,0,0,0,0,0,0,4,1,0,5,"H","N","2017-12-31","201712310CBJ"
"TBL",0,0,4,1,0,5,0,0,0,0,0,0,"A","N","2017-12-31","201712310CBJ"
"CGY",1,1,2,0,0,4,0,0,2,1,0,3,"H","N","2017-12-31","201712310CGY"
"CHI",0,0,2,1,0,3,1,1,2,0,0,4,"A","N","2017-12-31","201712310CGY"
"COL",0,1,4,1,0,6,0,0,0,1,0,1,"H","N","2017-12-31","201712310COL"
"NYI",0,0,0,1,0,1,0,1,4,1,0,6,"A","N","2017-12-31","201712310COL"
"DAL",0,2,2,2,0,6,0,0,0,0,0,0,"H","N","2017-12-31","201712310DAL"
"SJS",0,0,0,0,0,0,0,2,2,2,0,6,"A","N","2017-12-31","201712310DAL"
"DET",0,1,2,1,0,4,0,0,1,0,0,1,"H","N","2017-12-31","201712310DET"
"PIT",0,0,1,0,0,1,0,1,2,1,0,4,"A","N","2017-12-31","201712310DET"
"EDM",0,0,0,0,0,0,0,2,2,1,0,5,"H","N","2017-12-31","201712310EDM"
"WPG",0,2,2,1,0,5,0,0,0,0,0,0,"A","N","2017-12-31","201712310EDM"
"TOR",0,0,2,1,0,3,0,3,1,2,0,6,"A","N","2017-12-31","201712310VEG"
"VEG",0,3,1,2,0,6,0,0,2,1,0,3,"H","N","2017-12-31","201712310VEG"
"BUF",0,0,1,1,0,2,1,2,0,0,0,3,"H","N","2018-01-01","201801010BUF"
"NYR",1,2,0,0,0,3,0,0,1,1,0,2,"A","N","2018-01-01","201801010BUF"
"CAR",0,1,1,2,0,4,1,2,1,1,0,5,"H","N","2018-01-02","201801020CAR"
"WSH",1,2,1,1,0,5,0,1,1,2,0,4,"A","N","2018-01-02","201801020CAR"
"COL",1,0,2,0,0,3,0,0,0,2,0,2,"H","N","2018-01-02","201801020COL"
"WPG",0,0,0,2,0,2,1,0,2,0,0,3,"A","N","2018-01-02","201801020COL"
"CBJ",0,0,0,2,0,2,0,0,0,1,0,1,"A","N","2018-01-02","201801020DAL"
"DAL",0,0,0,1,0,1,0,0,0,2,0,2,"H","N","2018-01-02","201801020DAL"
"EDM",0,0,0,0,0,0,0,0,1,4,0,5,"H","N","2018-01-02","201801020EDM"
"LAK",0,0,1,4,0,5,0,0,0,0,0,0,"A","N","2018-01-02","201801020EDM"
"FLA",0,0,0,1,0,1,0,1,3,1,0,5,"A","N","2018-01-02","201801020MIN"
"MIN",0,1,3,1,0,5,0,0,0,1,0,1,"H","N","2018-01-02","201801020MIN"
"MTL",0,0,1,0,0,1,0,1,2,1,0,4,"H","N","2018-01-02","201801020MTL"
"SJS",0,1,2,1,0,4,0,0,1,0,0,1,"A","N","2018-01-02","201801020MTL"
"BOS",0,1,1,3,0,5,0,1,0,0,0,1,"A","N","2018-01-02","201801020NYI"
"NYI",0,1,0,0,0,1,0,1,1,3,0,5,"H","N","2018-01-02","201801020NYI"
"PHI",0,0,1,0,0,1,0,0,4,1,0,5,"H","N","2018-01-02","201801020PHI"
"PIT",0,0,4,1,0,5,0,0,1,0,0,1,"A","N","2018-01-02","201801020PHI"
"NJD",0,0,1,1,0,2,0,1,1,0,1,3,"A","Y","2018-01-02","201801020STL"
"STL",0,1,1,0,1,3,0,0,1,1,0,2,"H","Y","2018-01-02","201801020STL"
"TBL",0,0,2,0,0,2,0,0,0,0,0,0,"A","N","2018-01-02","201801020TOR"
"TOR",0,0,0,0,0,0,0,0,2,0,0,2,"H","N","2018-01-02","201801020TOR"
"ANA",0,2,1,2,0,5,0,0,0,0,0,0,"A","N","2018-01-02","201801020VAN"
"VAN",0,0,0,0,0,0,0,2,1,2,0,5,"H","N","2018-01-02","201801020VAN"
"NSH",0,0,0,0,0,0,0,0,2,1,0,3,"A","N","2018-01-02","201801020VEG"
"VEG",0,0,2,1,0,3,0,0,0,0,0,0,"H","N","2018-01-02","201801020VEG"
"DET",1,1,0,0,0,2,0,0,0,1,0,1,"H","N","2018-01-03","201801030DET"
"OTT",0,0,0,1,0,1,1,1,0,0,0,2,"A","N","2018-01-03","201801030DET"
"CHI",0,1,1,3,0,5,0,1,1,0,0,2,"A","N","2018-01-03","201801030NYR"
"NYR",0,1,1,0,0,2,0,1,1,3,0,5,"H","N","2018-01-03","201801030NYR"
"ARI",1,0,1,1,0,3,0,0,1,1,0,2,"H","N","2018-01-04","201801040ARI"
"NSH",0,0,1,1,0,2,1,0,1,1,0,3,"A","N","2018-01-04","201801040ARI"
"CGY",0,0,4,0,0,4,0,2,0,1,0,3,"H","N","2018-01-04","201801040CGY"
"LAK",0,2,0,1,0,3,0,0,4,0,0,4,"A","N","2018-01-04","201801040CGY"
"CBJ",0,0,0,0,0,0,0,0,1,1,0,2,"A","N","2018-01-04","201801040COL"
"COL",0,0,1,1,0,2,0,0,0,0,0,0,"H","N","2018-01-04","201801040COL"
"DAL",0,0,3,1,0,4,0,1,1,1,0,3,"H","N","2018-01-04","201801040DAL"
"NJD",0,1,1,1,0,3,0,0,3,1,0,4,"A","N","2018-01-04","201801040DAL"
"ANA",0,0,0,1,0,1,0,0,1,0,1,2,"A","Y","2018-01-04","201801040EDM"
"EDM",0,0,1,0,1,2,0,0,0,1,0,1,"H","Y","2018-01-04","201801040EDM"
"BUF",0,0,0,2,0,2,0,3,3,0,0,6,"A","N","2018-01-04","201801040MIN"
"MIN",0,3,3,0,0,6,0,0,0,2,0,2,"H","N","2018-01-04","201801040MIN"
"MTL",0,0,1,0,1,2,0,0,1,0,0,1,"H","Y","2018-01-04","201801040MTL"
"TBL",0,0,1,0,0,1,0,0,1,0,1,2,"A","Y","2018-01-04","201801040MTL"
"NYI",0,1,1,2,0,4,0,1,4,1,0,6,"A","N","2018-01-04","201801040PHI"
"PHI",0,1,4,1,0,6,0,1,1,2,0,4,"H","N","2018-01-04","201801040PHI"
"CAR",0,0,2,2,0,4,0,0,0,0,0,0,"A","N","2018-01-04","201801040PIT"
"PIT",0,0,0,0,0,0,0,0,2,2,0,4,"H","N","2018-01-04","201801040PIT"
"STL",0,1,0,1,0,2,0,0,1,0,0,1,"H","N","2018-01-04","201801040STL"
"VEG",0,0,1,0,0,1,0,1,0,1,0,2,"A","N","2018-01-04","201801040STL"
"SJS",0,1,1,0,0,2,0,1,1,0,1,3,"A","Y","2018-01-04","201801040TOR"
"TOR",0,1,1,0,1,3,0,1,1,0,0,2,"H","Y","2018-01-04","201801040TOR"
"CHI",0,1,2,1,0,4,0,2,1,2,0,5,"H","N","2018-01-05","201801050CHI"
"VEG",0,2,1,2,0,5,0,1,2,1,0,4,"A","N","2018-01-05","201801050CHI"
"DET",0,1,1,2,0,4,0,0,1,1,0,2,"H","N","2018-01-05","201801050DET"
"FLA",0,0,1,1,0,2,0,1,1,2,0,4,"A","N","2018-01-05","201801050DET"
"NYI",0,0,0,0,0,0,0,0,3,1,0,4,"H","N","2018-01-05","201801050NYI"
"PIT",0,0,3,1,0,4,0,0,0,0,0,0,"A","N","2018-01-05","201801050NYI"
"OTT",1,1,1,3,0,6,0,2,3,0,0,5,"H","N","2018-01-05","201801050OTT"
"SJS",0,2,3,0,0,5,1,1,1,3,0,6,"A","N","2018-01-05","201801050OTT"
"BUF",0,1,1,1,0,3,0,2,1,1,0,4,"A","N","2018-01-05","201801050WPG"
"WPG",0,2,1,1,0,4,0,1,1,1,0,3,"H","N","2018-01-05","201801050WPG"
"ARI",0,1,0,0,0,1,0,0,1,0,1,2,"H","Y","2018-01-06","201801060ARI"
"NYR",0,0,1,0,1,2,0,1,0,0,0,1,"A","Y","2018-01-06","201801060ARI"
"BOS",0,5,2,0,0,7,0,1,0,0,0,1,"H","N","2018-01-06","201801060BOS"
"CAR",0,1,0,0,0,1,0,5,2,0,0,7,"A","N","2018-01-06","201801060BOS"
"ANA",0,0,0,2,0,2,0,2,0,1,0,3,"A","N","2018-01-06","201801060CGY"
"CGY",0,2,0,1,0,3,0,0,0,2,0,2,"H","N","2018-01-06","201801060CGY"
"COL",0,2,2,3,0,7,0,1,1,0,0,2,"H","N","2018-01-06","201801060COL"
"MIN",0,1,1,0,0,2,0,2,2,3,0,7,"A","N","2018-01-06","201801060COL"
"DAL",0,3,1,1,0,5,0,0,0,1,0,1,"H","N","2018-01-06","201801060DAL"
"EDM",0,0,0,1,0,1,0,3,1,1,0,5,"A","N","2018-01-06","201801060DAL"
"LAK",0,0,1,2,0,3,0,1,2,1,0,4,"H","N","2018-01-06","201801060LAK"
"NSH",0,1,2,1,0,4,0,0,1,2,0,3,"A","N","2018-01-06","201801060LAK"
"OTT",0,3,0,3,0,6,0,0,3,0,0,3,"H","N","2018-01-06","201801060OTT"
"TBL",0,0,3,0,0,3,0,3,0,3,0,6,"A","N","2018-01-06","201801060OTT"
"PHI",0,2,2,2,0,6,0,0,1,2,0,3,"H","N","2018-01-06","201801060PHI"
"STL",0,0,1,2,0,3,0,2,2,2,0,6,"A","N","2018-01-06","201801060PHI"
"TOR",0,0,0,2,1,3,0,0,1,1,0,2,"H","Y","2018-01-06","201801060TOR"
"VAN",0,0,1,1,0,2,0,0,0,2,1,3,"A","Y","2018-01-06","201801060TOR"
"CBJ",0,1,1,0,1,3,0,0,1,1,0,2,"H","Y","2018-01-07","201801070CBJ"
"FLA",0,0,1,1,0,2,0,1,1,0,1,3,"A","Y","2018-01-07","201801070CBJ"
"CHI",0,2,1,1,0,4,0,0,1,0,0,1,"H","N","2018-01-07","201801070CHI"
"EDM",0,0,1,0,0,1,0,2,1,1,0,4,"A","N","2018-01-07","201801070CHI"
"DET",0,0,1,1,0,2,0,2,1,2,0,5,"H","N","2018-01-07","201801070DET"
"TBL",0,2,1,2,0,5,0,0,1,1,0,2,"A","N","2018-01-07","201801070DET"
"MTL",0,1,1,3,0,5,0,0,1,1,0,2,"H","N","2018-01-07","201801070MTL"
"VAN",0,0,1,1,0,2,0,1,1,3,0,5,"A","N","2018-01-07","201801070MTL"
"NJD",0,0,2,2,0,4,0,1,1,2,1,5,"A","Y","2018-01-07","201801070NYI"
"NYI",0,1,1,2,1,5,0,0,2,2,0,4,"H","Y","2018-01-07","201801070NYI"
"BUF",0,0,1,0,0,1,0,0,2,2,0,4,"A","N","2018-01-07","201801070PHI"
"PHI",0,0,2,2,0,4,0,0,1,0,0,1,"H","N","2018-01-07","201801070PHI"
"BOS",0,1,4,0,0,5,1,3,1,1,0,6,"A","N","2018-01-07","201801070PIT"
"PIT",1,3,1,1,0,6,0,1,4,0,0,5,"H","N","2018-01-07","201801070PIT"
"NYR",0,1,0,0,0,1,0,1,0,1,0,2,"A","N","2018-01-07","201801070VEG"
"VEG",0,1,0,1,0,2,0,1,0,0,0,1,"H","N","2018-01-07","201801070VEG"
"SJS",0,0,1,0,0,1,0,1,2,1,0,4,"A","N","2018-01-07","201801070WPG"
"WPG",0,1,2,1,0,4,0,0,1,0,0,1,"H","N","2018-01-07","201801070WPG"
"STL",0,0,2,1,0,3,1,1,0,2,0,4,"A","N","2018-01-07","201801070WSH"
"WSH",1,1,0,2,0,4,0,0,2,1,0,3,"H","N","2018-01-07","201801070WSH"
"CBJ",1,0,0,2,0,3,0,0,2,0,0,2,"A","N","2018-01-08","201801080TOR"
"TOR",0,0,2,0,0,2,1,0,0,2,0,3,"H","N","2018-01-08","201801080TOR"
"BUF",0,1,1,2,0,4,0,2,3,2,0,7,"H","N","2018-01-09","201801090BUF"
"WPG",0,2,3,2,0,7,0,1,1,2,0,4,"A","N","2018-01-09","201801090BUF"
"CGY",1,1,1,0,0,3,0,0,0,2,0,2,"A","N","2018-01-09","201801090MIN"
"MIN",0,0,0,2,0,2,1,1,1,0,0,3,"H","N","2018-01-09","201801090MIN"
"EDM",0,0,1,0,0,1,0,2,0,0,0,2,"A","N","2018-01-09","201801090NSH"
"NSH",0,2,0,0,0,2,0,0,1,0,0,1,"H","N","2018-01-09","201801090NSH"
"CHI",0,1,5,2,0,8,0,0,2,0,0,2,"A","N","2018-01-09","201801090OTT"
"OTT",0,0,2,0,0,2,0,1,5,2,0,8,"H","N","2018-01-09","201801090OTT"
"FLA",0,2,3,2,0,7,0,2,1,1,0,4,"A","N","2018-01-09","201801090STL"
"STL",0,2,1,1,0,4,0,2,3,2,0,7,"H","N","2018-01-09","201801090STL"
"CAR",0,2,1,1,0,4,0,2,1,2,0,5,"A","N","2018-01-09","201801090TBL"
"TBL",0,2,1,2,0,5,0,2,1,1,0,4,"H","N","2018-01-09","201801090TBL"
"VAN",0,1,0,0,0,1,0,2,1,0,0,3,"A","N","2018-01-09","201801090WSH"
"WSH",0,2,1,0,0,3,0,1,0,0,0,1,"H","N","2018-01-09","201801090WSH"
"CHI",0,1,0,0,0,1,0,0,1,1,0,2,"H","N","2018-01-10","201801100CHI"
"MIN",0,0,1,1,0,2,0,1,0,0,0,1,"A","N","2018-01-10","201801100CHI"
"OTT",0,1,1,2,0,4,0,0,1,2,0,3,"A","N","2018-01-10","201801100TOR"
"TOR",0,0,1,2,0,3,0,1,1,2,0,4,"H","N","2018-01-10","201801100TOR"
"BUF",0,1,0,2,0,3,0,0,0,1,0,1,"H","N","2018-01-11","201801110BUF"
"CBJ",0,0,0,1,0,1,0,1,0,2,0,3,"A","N","2018-01-11","201801110BUF"
"CGY",0,1,2,2,0,5,0,0,1,0,0,1,"A","N","2018-01-11","201801110TBL"
"TBL",0,0,1,0,0,1,0,1,2,2,0,5,"H","N","2018-01-11","201801110TBL"
"CAR",0,0,1,2,0,3,0,0,1,0,0,1,"A","N","2018-01-11","201801110WSH"
"WSH",0,0,1,0,0,1,0,0,1,2,0,3,"H","N","2018-01-11","201801110WSH"
"ARI",0,2,0,0,0,2,0,2,0,2,0,4,"H","N","2018-01-12","201801120ARI"
"EDM",0,2,0,2,0,4,0,2,0,0,0,2,"A","N","2018-01-12","201801120ARI"
"CAR",0,1,1,1,0,3,0,1,1,2,0,4,"H","N","2018-01-12","201801120CAR"
"WSH",0,1,1,2,0,4,0,1,1,1,0,3,"A","N","2018-01-12","201801120CAR"
"CBJ",0,1,0,1,0,2,0,0,4,1,0,5,"H","N","2018-01-12","201801120CBJ"
"VAN",0,0,4,1,0,5,0,1,0,1,0,2,"A","N","2018-01-12","201801120CBJ"
"CHI",0,0,2,0,0,2,0,0,0,1,0,1,"H","N","2018-01-12","201801120CHI"
"WPG",0,0,0,1,0,1,0,0,2,0,0,2,"A","N","2018-01-12","201801120CHI"
"CGY",0,0,3,1,0,4,0,0,1,1,0,2,"A","N","2018-01-12","201801120FLA"
"FLA",0,0,1,1,0,2,0,0,3,1,0,4,"H","N","2018-01-12","201801120FLA"
"COL",0,1,0,3,0,4,0,0,1,0,0,1,"A","N","2018-01-13","201801130DAL"
"DAL",0,0,1,0,0,1,0,1,0,3,0,4,"H","N","2018-01-13","201801130DAL"
"ANA",0,2,0,2,0,4,0,0,0,2,0,2,"A","N","2018-01-13","201801130LAK"
"LAK",0,0,0,2,0,2,0,2,0,2,0,4,"H","N","2018-01-13","201801130LAK"
"MIN",0,1,1,2,0,4,0,0,0,1,0,1,"H","N","2018-01-13","201801130MIN"
"WPG",0,0,0,1,0,1,0,1,1,2,0,4,"A","N","2018-01-13","201801130MIN"
"BOS",0,1,2,0,1,4,0,1,2,0,0,3,"A","Y","2018-01-13","201801130MTL"
"MTL",0,1,2,0,0,3,0,1,2,0,1,4,"H","Y","2018-01-13","201801130MTL"
"NJD",0,1,1,1,0,3,0,1,2,2,0,5,"H","N","2018-01-13","201801130NJD"
"PHI",0,1,2,2,0,5,0,1,1,1,0,3,"A","N","2018-01-13","201801130NJD"
"NYI",0,2,3,2,0,7,0,1,0,1,0,2,"A","N","2018-01-13","201801130NYR"
"NYR",0,1,0,1,0,2,0,2,3,2,0,7,"H","N","2018-01-13","201801130NYR"
"DET",0,1,0,0,0,1,0,2,1,1,0,4,"A","N","2018-01-13","201801130PIT"
"PIT",0,2,1,1,0,4,0,1,0,0,0,1,"H","N","2018-01-13","201801130PIT"
"ARI",0,3,0,2,0,5,1,3,1,1,0,6,"A","N","2018-01-13","201801130SJS"
"SJS",1,3,1,1,0,6,0,3,0,2,0,5,"H","N","2018-01-13","201801130SJS"
"EDM",1,0,1,1,0,3,0,0,2,0,0,2,"A","N","2018-01-13","201801130VEG"
"VEG",0,0,2,0,0,2,1,0,1,1,0,3,"H","N","2018-01-13","201801130VEG"
"CAR",0,0,0,1,0,1,0,2,0,2,0,4,"H","N","2018-01-14","201801140CAR"
"CGY",0,2,0,2,0,4,0,0,0,1,0,1,"A","N","2018-01-14","201801140CAR"
"CHI",0,0,0,0,0,0,0,2,0,2,0,4,"H","N","2018-01-14","201801140CHI"
"DET",0,2,0,2,0,4,0,0,0,0,0,0,"A","N","2018-01-14","201801140CHI"
"MIN",0,1,0,1,0,2,1,1,0,1,0,3,"H","N","2018-01-14","201801140MIN"
"VAN",1,1,0,1,0,3,0,1,0,1,0,2,"A","N","2018-01-14","201801140MIN"
"NYR",0,2,0,0,0,2,0,1,2,2,0,5,"A","N","2018-01-14","201801140PIT"
"PIT",0,1,2,2,0,5,0,2,0,0,0,2,"H","N","2018-01-14","201801140PIT"
"BOS",0,0,1,1,0,2,1,0,2,0,0,3,"H","N","2018-01-15","201801150BOS"
"DAL",1,0,2,0,0,3,0,0,1,1,0,2,"A","N","2018-01-15","201801150BOS"
"ANA",0,0,1,0,0,1,0,1,2,0,0,3,"A","N","2018-01-15","201801150COL"
"COL",0,1,2,0,0,3,0,0,1,0,0,1,"H","N","2018-01-15","201801150COL"
"LAK",0,0,0,1,0,1,0,1,1,2,0,4,"H","N","2018-01-15","201801150LAK"
"SJS",0,1,1,2,0,4,0,0,0,1,0,1,"A","N","2018-01-15","201801150LAK"
"MTL",0,2,1,1,0,4,1,2,2,0,0,5,"H","N","2018-01-15","201801150MTL"
"NYI",1,2,2,0,0,5,0,2,1,1,0,4,"A","N","2018-01-15","201801150MTL"
"ARI",0,0,1,1,0,2,0,1,1,0,1,3,"H","Y","2018-01-16","201801160ARI"
"SJS",0,1,1,0,1,3,0,0,1,1,0,2,"A","Y","2018-01-16","201801160ARI"
"DAL",0,2,1,1,0,4,0,1,1,0,0,2,"A","N","2018-01-16","201801160DET"
"DET",0,1,1,0,0,2,0,2,1,1,0,4,"H","N","2018-01-16","201801160DET"
"NSH",0,0,0,1,0,1,0,0,0,0,0,0,"H","N","2018-01-16","201801160NSH"
"VEG",0,0,0,0,0,0,0,0,0,1,0,1,"A","N","2018-01-16","201801160NSH"
"NJD",0,1,3,0,0,4,0,1,0,0,0,1,"A","N","2018-01-16","201801160NYI"
"NYI",0,1,0,0,0,1,0,1,3,0,0,4,"H","N","2018-01-16","201801160NYI"
"NYR",0,3,2,0,0,5,0,1,0,0,0,1,"H","N","2018-01-16","201801160NYR"
"PHI",0,1,0,0,0,1,0,3,2,0,0,5,"A","N","2018-01-16","201801160NYR"
"STL",1,0,0,1,0,2,0,0,0,1,0,1,"A","N","2018-01-16","201801160TOR"
"TOR",0,0,0,1,0,1,1,0,0,1,0,2,"H","N","2018-01-16","201801160TOR"
"ANA",0,0,4,1,0,5,0,1,0,2,0,3,"H","N","2018-01-17","201801170ANA"
"PIT",0,1,0,2,0,3,0,0,4,1,0,5,"A","N","2018-01-17","201801170ANA"
"BOS",0,1,1,2,0,4,0,1,0,0,0,1,"H","N","2018-01-17","201801170BOS"
"MTL",0,1,0,0,0,1,0,1,1,2,0,4,"A","N","2018-01-17","201801170BOS"
"CBJ",0,1,0,0,1,2,0,0,0,1,0,1,"H","Y","2018-01-18","201801180CBJ"
"DAL",0,0,0,1,0,1,0,1,0,0,1,2,"A","Y","2018-01-18","201801180CBJ"
"COL",0,3,1,1,0,5,0,0,1,2,0,3,"H","N","2018-01-18","201801180COL"
"SJS",0,0,1,2,0,3,0,3,1,1,0,5,"A","N","2018-01-18","201801180COL"
"LAK",0,0,1,0,0,1,0,1,0,2,0,3,"H","N","2018-01-18","201801180LAK"
"PIT",0,1,0,2,0,3,0,0,1,0,0,1,"A","N","2018-01-18","201801180LAK"
"NJD",1,1,2,0,0,4,0,1,1,1,0,3,"H","N","2018-01-18","201801180NJD"
"WSH",0,1,1,1,0,3,1,1,2,0,0,4,"A","N","2018-01-18","201801180NJD"
"ARI",0,0,1,1,0,2,0,0,1,1,1,3,"A","Y","2018-01-18","201801180NSH"
"NSH",0,0,1,1,1,3,0,0,1,1,0,2,"H","Y","2018-01-18","201801180NSH"
"BOS",0,1,2,2,0,5,0,1,0,1,0,2,"A","N","2018-01-18","201801180NYI"
"NYI",0,1,0,1,0,2,0,1,2,2,0,5,"H","N","2018-01-18","201801180NYI"
"BUF",0,1,1,1,0,3,0,1,1,2,0,4,"A","N","2018-01-18","201801180NYR"
"NYR",0,1,1,2,0,4,0,1,1,1,0,3,"H","N","2018-01-18","201801180NYR"
"OTT",0,0,1,0,0,1,0,0,3,1,0,4,"H","N","2018-01-18","201801180OTT"
"STL",0,0,3,1,0,4,0,0,1,0,0,1,"A","N","2018-01-18","201801180OTT"
"PHI",1,0,0,2,0,3,0,0,2,0,0,2,"H","N","2018-01-18","201801180PHI"
"TOR",0,0,2,0,0,2,1,0,0,2,0,3,"A","N","2018-01-18","201801180PHI"
"TBL",0,0,1,0,0,1,0,2,1,1,0,4,"H","N","2018-01-18","201801180TBL"
"VEG",0,2,1,1,0,4,0,0,1,0,0,1,"A","N","2018-01-18","201801180TBL"
"ANA",0,0,0,2,0,2,0,0,0,1,0,1,"H","N","2018-01-19","201801190ANA"
"LAK",0,0,0,1,0,1,0,0,0,2,0,2,"A","N","2018-01-19","201801190ANA"
"FLA",1,2,0,1,0,4,0,1,1,1,0,3,"H","N","2018-01-19","201801190FLA"
"VEG",0,1,1,1,0,3,1,2,0,1,0,4,"A","N","2018-01-19","201801190FLA"
"MTL",0,0,1,2,0,3,0,0,1,1,0,2,"A","N","2018-01-19","201801190WSH"
"WSH",0,0,1,1,0,2,0,0,1,2,0,3,"H","N","2018-01-19","201801190WSH"
"BUF",0,0,1,0,0,1,0,2,4,1,0,7,"H","N","2018-01-20","201801200BUF"
"DAL",0,2,4,1,0,7,0,0,1,0,0,1,"A","N","2018-01-20","201801200BUF"
"CGY",0,1,0,0,0,1,0,0,1,0,1,2,"H","Y","2018-01-20","201801200CGY"
"WPG",0,0,1,0,1,2,0,1,0,0,0,1,"A","Y","2018-01-20","201801200CGY"
"CHI",0,1,1,1,0,3,0,3,1,3,0,7,"H","N","2018-01-20","201801200CHI"
"NYI",0,3,1,3,0,7,0,1,1,1,0,3,"A","N","2018-01-20","201801200CHI"
"COL",0,1,1,1,0,3,0,0,1,0,0,1,"H","N","2018-01-20","201801200COL"
"NYR",0,0,1,0,0,1,0,1,1,1,0,3,"A","N","2018-01-20","201801200COL"
"CAR",0,1,0,2,0,3,0,1,0,0,0,1,"A","N","2018-01-20","201801200DET"
"DET",0,1,0,0,0,1,0,1,0,2,0,3,"H","N","2018-01-20","201801200DET"
"EDM",0,2,1,2,0,5,0,0,2,0,0,2,"H","N","2018-01-20","201801200EDM"
"VAN",0,0,2,0,0,2,0,2,1,2,0,5,"A","N","2018-01-20","201801200EDM"
"MIN",0,2,1,2,0,5,0,0,1,1,0,2,"H","N","2018-01-20","201801200MIN"
"TBL",0,0,1,1,0,2,0,2,1,2,0,5,"A","N","2018-01-20","201801200MIN"
"BOS",0,0,2,2,0,4,0,0,1,0,0,1,"A","N","2018-01-20","201801200MTL"
"MTL",0,0,1,0,0,1,0,0,2,2,0,4,"H","N","2018-01-20","201801200MTL"
"FLA",0,2,0,1,0,3,0,1,3,0,0,4,"A","N","2018-01-20","201801200NSH"
"NSH",0,1,3,0,0,4,0,2,0,1,0,3,"H","N","2018-01-20","201801200NSH"
"OTT",0,0,3,0,0,3,0,1,0,3,0,4,"H","N","2018-01-20","201801200OTT"
"TOR",0,1,0,3,0,4,0,0,3,0,0,3,"A","N","2018-01-20","201801200OTT"
"NJD",0,0,1,0,0,1,0,3,0,0,0,3,"A","N","2018-01-20","201801200PHI"
"PHI",0,3,0,0,0,3,0,0,1,0,0,1,"H","N","2018-01-20","201801200PHI"
"PIT",0,1,0,0,0,1,0,1,0,1,0,2,"A","N","2018-01-20","201801200SJS"
"SJS",0,1,0,1,0,2,0,1,0,0,0,1,"H","N","2018-01-20","201801200SJS"
"ARI",0,4,1,0,0,5,0,0,1,1,0,2,"A","N","2018-01-20","201801200STL"
"STL",0,0,1,1,0,2,0,4,1,0,0,5,"H","N","2018-01-20","201801200STL"
"ANA",0,0,1,1,0,2,0,1,2,3,0,6,"H","N","2018-01-21","201801210ANA"
"SJS",0,1,2,3,0,6,0,0,1,1,0,2,"A","N","2018-01-21","201801210ANA"
"CAR",0,1,0,0,0,1,0,3,1,1,0,5,"H","N","2018-01-21","201801210CAR"
"VEG",0,3,1,1,0,5,0,1,0,0,0,1,"A","N","2018-01-21","201801210CAR"
"LAK",0,0,3,1,0,4,0,2,0,0,0,2,"H","N","2018-01-21","201801210LAK"
"NYR",0,2,0,0,0,2,0,0,3,1,0,4,"A","N","2018-01-21","201801210LAK"
"VAN",0,0,0,0,0,0,0,1,0,0,0,1,"A","N","2018-01-21","201801210WPG"
"WPG",0,1,0,0,0,1,0,0,0,0,0,0,"H","N","2018-01-21","201801210WPG"
"PHI",1,0,1,0,0,2,0,0,1,0,0,1,"A","N","2018-01-21","201801210WSH"
"WSH",0,0,1,0,0,1,1,0,1,0,0,2,"H","N","2018-01-21","201801210WSH"
"ARI",1,1,1,0,0,3,0,0,1,1,0,2,"H","N","2018-01-22","201801220ARI"
"NYI",0,0,1,1,0,2,1,1,1,0,0,3,"A","N","2018-01-22","201801220ARI"
"BUF",1,1,0,0,0,2,0,1,0,0,0,1,"A","N","2018-01-22","201801220CGY"
"CGY",0,1,0,0,0,1,1,1,0,0,0,2,"H","N","2018-01-22","201801220CGY"
"CHI",0,0,0,0,0,0,0,0,1,1,0,2,"H","N","2018-01-22","201801220CHI"
"TBL",0,0,1,1,0,2,0,0,0,0,0,0,"A","N","2018-01-22","201801220CHI"
"MIN",0,1,0,2,0,3,0,0,1,0,0,1,"H","N","2018-01-22","201801220MIN"
"OTT",0,0,1,0,0,1,0,1,0,2,0,3,"A","N","2018-01-22","201801220MIN"
"DET",0,1,1,1,0,3,0,0,0,0,0,0,"A","N","2018-01-22","201801220NJD"
"NJD",0,0,0,0,0,0,0,1,1,1,0,3,"H","N","2018-01-22","201801220NJD"
"COL",0,1,1,2,0,4,0,0,2,0,0,2,"A","N","2018-01-22","201801220TOR"
"TOR",0,0,2,0,0,2,0,1,1,2,0,4,"H","N","2018-01-22","201801220TOR"
"ANA",0,4,0,2,0,6,0,2,1,0,0,3,"H","N","2018-01-23","201801230ANA"
"NYR",0,2,1,0,0,3,0,4,0,2,0,6,"A","N","2018-01-23","201801230ANA"
"BOS",0,0,3,0,0,3,0,0,2,0,0,2,"H","N","2018-01-23","201801230BOS"
"NJD",0,0,2,0,0,2,0,0,3,0,0,3,"A","N","2018-01-23","201801230BOS"
"DAL",0,1,2,3,0,6,0,0,1,0,0,1,"H","N","2018-01-23","201801230DAL"
"FLA",0,0,1,0,0,1,0,1,2,3,0,6,"A","N","2018-01-23","201801230DAL"
"DET",0,1,0,1,0,2,1,0,2,0,0,3,"H","N","2018-01-23","201801230DET"
"PHI",1,0,2,0,0,3,0,1,0,1,0,2,"A","N","2018-01-23","201801230DET"
"BUF",0,1,4,0,0,5,0,0,0,0,0,0,"A","N","2018-01-23","201801230EDM"
"EDM",0,0,0,0,0,0,0,1,4,0,0,5,"H","N","2018-01-23","201801230EDM"
"COL",0,0,0,2,0,2,0,0,2,2,0,4,"A","N","2018-01-23","201801230MTL"
"MTL",0,0,2,2,0,4,0,0,0,2,0,2,"H","N","2018-01-23","201801230MTL"
"NSH",0,2,1,0,0,3,1,2,0,1,0,4,"H","N","2018-01-23","201801230NSH"
"TBL",1,2,0,1,0,4,0,2,1,0,0,3,"A","N","2018-01-23","201801230NSH"
"CAR",0,0,1,0,0,1,0,0,2,1,0,3,"A","N","2018-01-23","201801230PIT"
"PIT",0,0,2,1,0,3,0,0,1,0,0,1,"H","N","2018-01-23","201801230PIT"
"SJS",0,1,2,1,0,4,1,3,0,1,0,5,"H","N","2018-01-23","201801230SJS"
"WPG",1,3,0,1,0,5,0,1,2,1,0,4,"A","N","2018-01-23","201801230SJS"
"OTT",0,0,0,0,0,0,0,1,0,2,0,3,"A","N","2018-01-23","201801230STL"
"STL",0,1,0,2,0,3,0,0,0,0,0,0,"H","N","2018-01-23","201801230STL"
"LAK",0,1,1,0,0,2,0,4,2,0,0,6,"A","N","2018-01-23","201801230VAN"
"VAN",0,4,2,0,0,6,0,1,1,0,0,2,"H","N","2018-01-23","201801230VAN"
"CBJ",0,1,1,1,0,3,0,1,3,2,0,6,"A","N","2018-01-23","201801230VEG"
"VEG",0,1,3,2,0,6,0,1,1,1,0,3,"H","N","2018-01-23","201801230VEG"
"CGY",0,1,0,0,0,1,1,0,0,1,0,2,"H","N","2018-01-24","201801240CGY"
"LAK",1,0,0,1,0,2,0,1,0,0,0,1,"A","N","2018-01-24","201801240CGY"
"CHI",0,1,0,1,0,2,1,1,0,1,0,3,"H","N","2018-01-24","201801240CHI"
"TOR",1,1,0,1,0,3,0,1,0,1,0,2,"A","N","2018-01-24","201801240CHI"
"ANA",0,1,1,1,1,4,0,1,1,1,0,3,"H","Y","2018-01-25","201801250ANA"
"WPG",0,1,1,1,0,3,0,1,1,1,1,4,"A","Y","2018-01-25","201801250ANA"
"ARI",0,0,0,1,0,1,0,0,0,2,0,2,"H","N","2018-01-25","201801250ARI"
"CBJ",0,0,0,2,0,2,0,0,0,1,0,1,"A","N","2018-01-25","201801250ARI"
"DAL",0,0,1,0,0,1,0,1,2,1,0,4,"H","N","2018-01-25","201801250DAL"
"TOR",0,1,2,1,0,4,0,0,1,0,0,1,"A","N","2018-01-25","201801250DAL"
"CHI",0,3,1,1,0,5,0,0,0,1,0,1,"A","N","2018-01-25","201801250DET"
"DET",0,0,0,1,0,1,0,3,1,1,0,5,"H","N","2018-01-25","201801250DET"
"CGY",0,2,0,1,0,3,0,0,2,1,1,4,"A","Y","2018-01-25","201801250EDM"
"EDM",0,0,2,1,1,4,0,2,0,1,0,3,"H","Y","2018-01-25","201801250EDM"
"FLA",0,1,1,0,0,2,0,1,2,1,0,4,"H","N","2018-01-25","201801250FLA"
"WSH",0,1,2,1,0,4,0,1,1,0,0,2,"A","N","2018-01-25","201801250FLA"
"CAR",0,2,3,1,0,6,0,0,4,1,0,5,"A","N","2018-01-25","201801250MTL"
"MTL",0,0,4,1,0,5,0,2,3,1,0,6,"H","N","2018-01-25","201801250MTL"
"NJD",0,0,0,0,0,0,0,0,1,2,0,3,"H","N","2018-01-25","201801250NJD"
"NSH",0,0,1,2,0,3,0,0,0,0,0,0,"A","N","2018-01-25","201801250NJD"
"BOS",0,0,1,2,0,3,0,1,0,1,0,2,"A","N","2018-01-25","201801250OTT"
"OTT",0,1,0,1,0,2,0,0,1,2,0,3,"H","N","2018-01-25","201801250OTT"
"PHI",0,0,0,1,0,1,0,0,3,2,0,5,"H","N","2018-01-25","201801250PHI"
"TBL",0,0,3,2,0,5,0,0,0,1,0,1,"A","N","2018-01-25","201801250PHI"
"MIN",0,0,0,3,0,3,0,2,2,2,0,6,"A","N","2018-01-25","201801250PIT"
"PIT",0,2,2,2,0,6,0,0,0,3,0,3,"H","N","2018-01-25","201801250PIT"
"NYR",0,2,3,1,0,6,0,2,1,2,0,5,"A","N","2018-01-25","201801250SJS"
"SJS",0,2,1,2,0,5,0,2,3,1,0,6,"H","N","2018-01-25","201801250SJS"
"COL",0,0,1,0,0,1,0,1,1,1,0,3,"A","N","2018-01-25","201801250STL"
"STL",0,1,1,1,0,3,0,0,1,0,0,1,"H","N","2018-01-25","201801250STL"
"BUF",0,1,1,2,0,4,0,0,0,0,0,0,"A","N","2018-01-25","201801250VAN"
"VAN",0,0,0,0,0,0,0,1,1,2,0,4,"H","N","2018-01-25","201801250VAN"
"NYI",0,0,1,1,0,2,0,0,0,1,0,1,"A","N","2018-01-25","201801250VEG"
"VEG",0,0,0,1,0,1,0,0,1,1,0,2,"H","N","2018-01-25","201801250VEG"
"ANA",0,2,0,1,0,3,0,0,0,1,0,1,"A","N","2018-01-30","201801300BOS"
"BOS",0,0,0,1,0,1,0,2,0,1,0,3,"H","N","2018-01-30","201801300BOS"
"BUF",0,0,0,1,0,1,0,0,1,2,0,3,"H","N","2018-01-30","201801300BUF"
"NJD",0,0,1,2,0,3,0,0,0,1,0,1,"A","N","2018-01-30","201801300BUF"
"CAR",0,0,0,2,0,2,0,0,1,0,0,1,"H","N","2018-01-30","201801300CAR"
"OTT",0,0,1,0,0,1,0,0,0,2,0,2,"A","N","2018-01-30","201801300CAR"
"CBJ",0,1,0,1,0,2,0,0,1,1,1,3,"H","Y","2018-01-30","201801300CBJ"
"MIN",0,0,1,1,1,3,0,1,0,1,0,2,"A","Y","2018-01-30","201801300CBJ"
"CGY",0,0,2,0,0,2,0,1,0,3,0,4,"H","N","2018-01-30","201801300CGY"
"VEG",0,1,0,3,0,4,0,0,2,0,0,2,"A","N","2018-01-30","201801300CGY"
"DAL",0,0,0,0,0,0,0,1,1,1,0,3,"H","N","2018-01-30","201801300DAL"
"LAK",0,1,1,1,0,3,0,0,0,0,0,0,"A","N","2018-01-30","201801300DAL"
"CHI",0,1,1,0,0,2,0,0,1,0,0,1,"A","N","2018-01-30","201801300NSH"
"NSH",0,0,1,0,0,1,0,1,1,0,0,2,"H","N","2018-01-30","201801300NSH"
"FLA",0,1,1,2,0,4,0,0,0,1,0,1,"A","N","2018-01-30","201801300NYI"
"NYI",0,0,0,1,0,1,0,1,1,2,0,4,"H","N","2018-01-30","201801300NYI"
"PIT",0,1,1,3,0,5,0,0,2,0,0,2,"H","N","2018-01-30","201801300PIT"
"SJS",0,0,2,0,0,2,0,1,1,3,0,5,"A","N","2018-01-30","201801300PIT"
"MTL",0,0,0,1,0,1,0,0,1,2,0,3,"A","N","2018-01-30","201801300STL"
"STL",0,0,1,2,0,3,0,0,0,1,0,1,"H","N","2018-01-30","201801300STL"
"COL",0,0,3,0,0,3,1,2,0,1,0,4,"A","N","2018-01-30","201801300VAN"
"VAN",1,2,0,1,0,4,0,0,3,0,0,3,"H","N","2018-01-30","201801300VAN"
"TBL",0,1,0,0,0,1,0,0,2,1,0,3,"A","N","2018-01-30","201801300WPG"
"WPG",0,0,2,1,0,3,0,1,0,0,0,1,"H","N","2018-01-30","201801300WPG"
"DET",0,0,0,1,1,2,0,0,0,1,0,1,"H","Y","2018-01-31","201801310DET"
"SJS",0,0,0,1,0,1,0,0,0,1,1,2,"A","Y","2018-01-31","201801310DET"
"NYI",0,0,0,0,0,0,0,2,2,1,0,5,"A","N","2018-01-31","201801310TOR"
"TOR",0,2,2,1,0,5,0,0,0,0,0,0,"H","N","2018-01-31","201801310TOR"
"PHI",0,2,0,1,0,3,0,0,3,2,0,5,"A","N","2018-01-31","201801310WSH"
"WSH",0,0,3,2,0,5,0,2,0,1,0,3,"H","N","2018-01-31","201801310WSH"
"ARI",0,1,0,0,0,1,0,0,3,1,0,4,"H","N","2018-02-01","201802010ARI"
"DAL",0,0,3,1,0,4,0,1,0,0,0,1,"A","N","2018-02-01","201802010ARI"
"BOS",0,1,0,2,0,3,0,0,0,1,0,1,"H","N","2018-02-01","201802010BOS"
"STL",0,0,0,1,0,1,0,1,0,2,0,3,"A","N","2018-02-01","201802010BOS"
"BUF",0,1,1,0,0,2,0,3,0,1,0,4,"H","N","2018-02-01","201802010BUF"
"FLA",0,3,0,1,0,4,0,1,1,0,0,2,"A","N","2018-02-01","201802010BUF"
"CAR",0,0,1,1,0,2,0,0,0,0,0,0,"H","N","2018-02-01","201802010CAR"
"MTL",0,0,0,0,0,0,0,0,1,1,0,2,"A","N","2018-02-01","201802010CAR"
"CGY",0,1,3,0,0,4,0,1,2,4,0,7,"H","N","2018-02-01","201802010CGY"
"TBL",0,1,2,4,0,7,0,1,3,0,0,4,"A","N","2018-02-01","201802010CGY"
"COL",1,0,3,0,0,4,0,0,1,2,0,3,"A","N","2018-02-01","201802010EDM"
"EDM",0,0,1,2,0,3,1,0,3,0,0,4,"H","N","2018-02-01","201802010EDM"
"NJD",0,2,0,2,0,4,0,2,1,0,0,3,"H","N","2018-02-01","201802010NJD"
"PHI",0,2,1,0,0,3,0,2,0,2,0,4,"A","N","2018-02-01","201802010NJD"
"LAK",0,0,0,0,0,0,0,3,1,1,0,5,"A","N","2018-02-01","201802010NSH"
"NSH",0,3,1,1,0,5,0,0,0,0,0,0,"H","N","2018-02-01","201802010NSH"
"NYR",0,0,0,0,0,0,0,2,2,0,0,4,"H","N","2018-02-01","201802010NYR"
"TOR",0,2,2,0,0,4,0,0,0,0,0,0,"A","N","2018-02-01","201802010NYR"
"ANA",0,0,0,1,0,1,1,0,0,1,0,2,"A","N","2018-02-01","201802010OTT"
"OTT",1,0,0,1,0,2,0,0,0,1,0,1,"H","N","2018-02-01","201802010OTT"
"CHI",0,1,0,1,0,2,0,0,2,2,0,4,"A","N","2018-02-01","201802010VAN"
"VAN",0,0,2,2,0,4,0,1,0,1,0,2,"H","N","2018-02-01","201802010VAN"
"VEG",1,0,2,0,0,3,0,1,0,1,0,2,"A","N","2018-02-01","201802010WPG"
"WPG",0,1,0,1,0,2,1,0,2,0,0,3,"H","N","2018-02-01","201802010WPG"
"CAR",0,1,0,0,0,1,0,1,1,2,0,4,"H","N","2018-02-02","201802020CAR"
"DET",0,1,1,2,0,4,0,1,0,0,0,1,"A","N","2018-02-02","201802020CAR"
"CBJ",0,0,1,0,0,1,0,1,1,1,0,3,"H","N","2018-02-02","201802020CBJ"
"SJS",0,1,1,1,0,3,0,0,1,0,0,1,"A","N","2018-02-02","201802020CBJ"
"MIN",0,2,2,1,0,5,0,0,1,1,0,2,"H","N","2018-02-02","201802020MIN"
"VEG",0,0,1,1,0,2,0,2,2,1,0,5,"A","N","2018-02-02","201802020MIN"
"PIT",0,2,1,4,0,7,0,1,2,1,0,4,"H","N","2018-02-02","201802020PIT"
"WSH",0,1,2,1,0,4,0,2,1,4,0,7,"A","N","2018-02-02","201802020PIT"
"BOS",0,1,2,1,0,4,0,1,0,0,0,1,"H","N","2018-02-03","201802030BOS"
"TOR",0,1,0,0,0,1,0,1,2,1,0,4,"A","N","2018-02-03","201802030BOS"
"BUF",0,0,0,0,0,0,0,0,0,1,0,1,"H","N","2018-02-03","201802030BUF"
"STL",0,0,0,1,0,1,0,0,0,0,0,0,"A","N","2018-02-03","201802030BUF"
"CGY",1,0,2,1,0,4,0,1,2,0,0,3,"H","N","2018-02-03","201802030CGY"
"CHI",0,1,2,0,0,3,1,0,2,1,0,4,"A","N","2018-02-03","201802030CGY"
"DAL",0,0,4,2,0,6,0,0,0,1,0,1,"H","N","2018-02-03","201802030DAL"
"MIN",0,0,0,1,0,1,0,0,4,2,0,6,"A","N","2018-02-03","201802030DAL"
"DET",0,0,1,1,0,2,0,1,1,1,0,3,"A","N","2018-02-03","201802030FLA"
"FLA",0,1,1,1,0,3,0,0,1,1,0,2,"H","N","2018-02-03","201802030FLA"
"ARI",0,0,0,0,0,0,0,1,3,2,0,6,"A","N","2018-02-03","201802030LAK"
"LAK",0,1,3,2,0,6,0,0,0,0,0,0,"H","N","2018-02-03","201802030LAK"
"ANA",0,0,2,0,0,2,0,3,1,1,0,5,"A","N","2018-02-03","201802030MTL"
"MTL",0,3,1,1,0,5,0,0,2,0,0,2,"H","N","2018-02-03","201802030MTL"
"NJD",0,0,2,1,0,3,0,0,0,1,0,1,"H","N","2018-02-03","201802030NJD"
"PIT",0,0,0,1,0,1,0,0,2,1,0,3,"A","N","2018-02-03","201802030NJD"
"NSH",0,0,2,3,0,5,0,0,0,2,0,2,"H","N","2018-02-03","201802030NSH"
"NYR",0,0,0,2,0,2,0,0,2,3,0,5,"A","N","2018-02-03","201802030NSH"
"CBJ",0,1,2,0,0,3,0,1,1,2,0,4,"A","N","2018-02-03","201802030NYI"
"NYI",0,1,1,2,0,4,0,1,2,0,0,3,"H","N","2018-02-03","201802030NYI"
"OTT",0,2,1,0,1,4,0,0,1,2,0,3,"A","Y","2018-02-03","201802030PHI"
"PHI",0,0,1,2,0,3,0,2,1,0,1,4,"H","Y","2018-02-03","201802030PHI"
"TBL",0,2,1,1,0,4,0,0,0,2,0,2,"A","N","2018-02-03","201802030VAN"
"VAN",0,0,0,2,0,2,0,2,1,1,0,4,"H","N","2018-02-03","201802030VAN"
"COL",0,0,0,0,0,0,0,1,0,2,0,3,"A","N","2018-02-03","201802030WPG"
"WPG",0,1,0,2,0,3,0,0,0,0,0,0,"H","N","2018-02-03","201802030WPG"
"CAR",0,1,0,0,0,1,0,2,1,0,0,3,"H","N","2018-02-04","201802040CAR"
"SJS",0,2,1,0,0,3,0,1,0,0,0,1,"A","N","2018-02-04","201802040CAR"
"MTL",0,0,3,1,0,4,0,0,1,0,0,1,"H","N","2018-02-04","201802040MTL"
"OTT",0,0,1,0,0,1,0,0,3,1,0,4,"A","N","2018-02-04","201802040MTL"
"VEG",0,1,1,2,0,4,0,1,1,1,0,3,"A","N","2018-02-04","201802040WSH"
"WSH",0,1,1,1,0,3,0,1,1,2,0,4,"H","N","2018-02-04","201802040WSH"
"DAL",0,0,1,1,0,2,0,1,0,0,0,1,"H","N","2018-02-05","201802050DAL"
"NYR",0,1,0,0,0,1,0,0,1,1,0,2,"A","N","2018-02-05","201802050DAL"
"EDM",0,2,2,2,0,6,0,1,0,1,0,2,"H","N","2018-02-05","201802050EDM"
"TBL",0,1,0,1,0,2,0,2,2,2,0,6,"A","N","2018-02-05","201802050EDM"
"NSH",1,2,1,1,0,5,0,3,1,0,0,4,"A","N","2018-02-05","201802050NYI"
"NYI",0,3,1,0,0,4,1,2,1,1,0,5,"H","N","2018-02-05","201802050NYI"
"ANA",0,0,3,1,0,4,0,1,3,3,0,7,"A","N","2018-02-05","201802050TOR"
"TOR",0,1,3,3,0,7,0,0,3,1,0,4,"H","N","2018-02-05","201802050TOR"
"ANA",1,0,2,1,0,4,0,1,1,1,0,3,"A","N","2018-02-06","201802060BUF"
"BUF",0,1,1,1,0,3,1,0,2,1,0,4,"H","N","2018-02-06","201802060BUF"
"CAR",0,1,0,0,0,1,1,0,1,0,0,2,"H","N","2018-02-06","201802060CAR"
"PHI",1,0,1,0,0,2,0,1,0,0,0,1,"A","N","2018-02-06","201802060CAR"
"CBJ",0,1,0,1,0,2,0,1,1,1,0,3,"H","N","2018-02-06","201802060CBJ"
"WSH",0,1,1,1,0,3,0,1,0,1,0,2,"A","N","2018-02-06","201802060CBJ"
"CGY",0,0,1,2,0,3,0,1,0,1,0,2,"A","N","2018-02-06","201802060CHI"
"CHI",0,1,0,1,0,2,0,0,1,2,0,3,"H","N","2018-02-06","201802060CHI"
"COL",0,0,2,1,0,3,0,0,1,0,0,1,"H","N","2018-02-06","201802060COL"
"SJS",0,0,1,0,0,1,0,0,2,1,0,3,"A","N","2018-02-06","201802060COL"
"BOS",0,0,2,1,0,3,0,0,1,1,0,2,"A","N","2018-02-06","201802060DET"
"DET",0,0,1,1,0,2,0,0,2,1,0,3,"H","N","2018-02-06","201802060DET"
"FLA",0,1,1,1,0,3,0,0,1,0,0,1,"H","N","2018-02-06","201802060FLA"
"VAN",0,0,1,0,0,1,0,1,1,1,0,3,"A","N","2018-02-06","201802060FLA"
"NJD",0,1,1,1,0,3,0,3,2,0,0,5,"A","N","2018-02-06","201802060OTT"
"OTT",0,3,2,0,0,5,0,1,1,1,0,3,"H","N","2018-02-06","201802060OTT"
"PIT",0,0,3,2,0,5,0,1,1,2,0,4,"H","N","2018-02-06","201802060PIT"
"VEG",0,1,1,2,0,4,0,0,3,2,0,5,"A","N","2018-02-06","201802060PIT"
"MIN",0,3,2,1,0,6,0,1,0,1,0,2,"A","N","2018-02-06","201802060STL"
"STL",0,1,0,1,0,2,0,3,2,1,0,6,"H","N","2018-02-06","201802060STL"
"ARI",0,2,0,1,0,3,0,3,1,0,0,4,"A","N","2018-02-06","201802060WPG"
"WPG",0,3,1,0,0,4,0,2,0,1,0,3,"H","N","2018-02-06","201802060WPG"
"EDM",0,0,2,0,0,2,0,1,1,3,0,5,"A","N","2018-02-07","201802070LAK"
"LAK",0,1,1,3,0,5,0,0,2,0,0,2,"H","N","2018-02-07","201802070LAK"
"BOS",0,2,3,1,0,6,0,1,0,0,0,1,"A","N","2018-02-07","201802070NYR"
"NYR",0,1,0,0,0,1,0,2,3,1,0,6,"H","N","2018-02-07","201802070NYR"
"NSH",0,0,1,1,0,2,0,1,1,0,1,3,"A","Y","2018-02-07","201802070TOR"
"TOR",0,1,1,0,1,3,0,0,1,1,0,2,"H","Y","2018-02-07","201802070TOR"
"BUF",0,2,1,1,0,4,0,0,1,2,0,3,"H","N","2018-02-08","201802080BUF"
"NYI",0,0,1,2,0,3,0,2,1,1,0,4,"A","N","2018-02-08","201802080BUF"
"CHI",0,1,1,0,0,2,0,0,3,1,0,4,"H","N","2018-02-08","201802080CHI"
"DAL",0,0,3,1,0,4,0,1,1,0,0,2,"A","N","2018-02-08","201802080CHI"
"ARI",1,0,1,2,0,4,0,1,2,0,0,3,"A","N","2018-02-08","201802080MIN"
"MIN",0,1,2,0,0,3,1,0,1,2,0,4,"H","N","2018-02-08","201802080MIN"
"CGY",0,0,3,0,0,3,0,0,1,1,0,2,"A","N","2018-02-08","201802080NJD"
"NJD",0,0,1,1,0,2,0,0,3,0,0,3,"H","N","2018-02-08","201802080NJD"
"NSH",0,2,0,1,0,3,1,1,2,0,0,4,"A","N","2018-02-08","201802080OTT"
"OTT",1,1,2,0,0,4,0,2,0,1,0,3,"H","N","2018-02-08","201802080OTT"
"MTL",0,0,2,1,0,3,0,0,2,3,0,5,"A","N","2018-02-08","201802080PHI"
"PHI",0,0,2,3,0,5,0,0,2,1,0,3,"H","N","2018-02-08","201802080PHI"
"SJS",0,1,1,1,0,3,0,1,1,3,0,5,"H","N","2018-02-08","201802080SJS"
"VEG",0,1,1,3,0,5,0,1,1,1,0,3,"A","N","2018-02-08","201802080SJS"
"COL",0,0,1,0,0,1,0,1,4,1,0,6,"A","N","2018-02-08","201802080STL"
"STL",0,1,4,1,0,6,0,0,1,0,0,1,"H","N","2018-02-08","201802080STL"
"TBL",0,1,3,1,0,5,0,0,0,2,0,2,"H","N","2018-02-08","201802080TBL"
"VAN",0,0,0,2,0,2,0,1,3,1,0,5,"A","N","2018-02-08","201802080TBL"
"ANA",0,1,1,1,0,3,0,0,1,1,0,2,"H","N","2018-02-09","201802090ANA"
"EDM",0,0,1,1,0,2,0,1,1,1,0,3,"A","N","2018-02-09","201802090ANA"
"CAR",0,3,0,1,0,4,0,0,1,0,0,1,"H","N","2018-02-09","201802090CAR"
"VAN",0,0,1,0,0,1,0,3,0,1,0,4,"A","N","2018-02-09","201802090CAR"
"DAL",0,1,0,2,1,4,0,2,0,1,0,3,"H","Y","2018-02-09","201802090DAL"
"PIT",0,2,0,1,0,3,0,1,0,2,1,4,"A","Y","2018-02-09","201802090DAL"
"FLA",0,1,0,0,0,1,0,0,2,1,0,3,"H","N","2018-02-09","201802090FLA"
"LAK",0,0,2,1,0,3,0,1,0,0,0,1,"A","N","2018-02-09","201802090FLA"
"DET",0,3,0,3,0,6,1,0,1,5,0,7,"A","N","2018-02-09","201802090NYI"
"NYI",1,0,1,5,0,7,0,3,0,3,0,6,"H","N","2018-02-09","201802090NYI"
"CGY",0,1,2,0,0,3,0,1,1,2,0,4,"A","N","2018-02-09","201802090NYR"
"NYR",0,1,1,2,0,4,0,1,2,0,0,3,"H","N","2018-02-09","201802090NYR"
"STL",0,0,3,2,0,5,0,0,1,1,0,2,"A","N","2018-02-09","201802090WPG"
"WPG",0,0,1,1,0,2,0,0,3,2,0,5,"H","N","2018-02-09","201802090WPG"
"CBJ",0,1,1,0,0,2,0,2,2,0,0,4,"A","N","2018-02-09","201802090WSH"
"WSH",0,2,2,0,0,4,0,1,1,0,0,2,"H","N","2018-02-09","201802090WSH"
"ARI",0,1,1,1,0,3,0,2,1,0,1,4,"H","Y","2018-02-10","201802100ARI"
"PHI",0,2,1,0,1,4,0,1,1,1,0,3,"A","Y","2018-02-10","201802100ARI"
"BOS",0,0,1,1,0,2,0,0,3,1,0,4,"H","N","2018-02-10","201802100BOS"
"BUF",0,0,3,1,0,4,0,0,1,1,0,2,"A","N","2018-02-10","201802100BOS"
"CAR",0,1,0,2,0,3,0,1,0,0,0,1,"H","N","2018-02-10","201802100CAR"
"COL",0,1,0,0,0,1,0,1,0,2,0,3,"A","N","2018-02-10","201802100CAR"
"CBJ",0,1,3,2,0,6,0,0,0,1,0,1,"H","N","2018-02-10","201802100CBJ"
"NJD",0,0,0,1,0,1,0,1,3,2,0,6,"A","N","2018-02-10","201802100CBJ"
"CHI",0,0,0,0,0,0,0,2,1,0,0,3,"A","N","2018-02-10","201802100MIN"
"MIN",0,2,1,0,0,3,0,0,0,0,0,0,"H","N","2018-02-10","201802100MIN"
"MTL",0,0,1,1,0,2,0,0,1,1,1,3,"H","Y","2018-02-10","201802100MTL"
"NSH",0,0,1,1,1,3,0,0,1,1,0,2,"A","Y","2018-02-10","201802100MTL"
"EDM",0,0,3,1,0,4,0,2,1,3,0,6,"A","N","2018-02-10","201802100SJS"
"SJS",0,2,1,3,0,6,0,0,3,1,0,4,"H","N","2018-02-10","201802100SJS"
"LAK",0,1,0,2,0,3,0,2,2,0,0,4,"A","N","2018-02-10","201802100TBL"
"TBL",0,2,2,0,0,4,0,1,0,2,0,3,"H","N","2018-02-10","201802100TBL"
"OTT",0,0,1,2,0,3,0,3,1,2,0,6,"A","N","2018-02-10","201802100TOR"
"TOR",0,3,1,2,0,6,0,0,1,2,0,3,"H","N","2018-02-10","201802100TOR"
"ANA",0,1,0,1,0,2,0,0,0,2,1,3,"H","Y","2018-02-11","201802110ANA"
"SJS",0,0,0,2,1,3,0,1,0,1,0,2,"A","Y","2018-02-11","201802110ANA"
"BUF",0,1,1,2,0,4,0,2,1,2,0,5,"H","N","2018-02-11","201802110BUF"
"COL",0,2,1,2,0,5,0,1,1,2,0,4,"A","N","2018-02-11","201802110BUF"
"DAL",0,0,0,0,0,0,0,3,2,1,0,6,"H","N","2018-02-11","201802110DAL"
"VAN",0,3,2,1,0,6,0,0,0,0,0,0,"A","N","2018-02-11","201802110DAL"
"BOS",0,2,1,2,0,5,0,1,2,0,0,3,"A","N","2018-02-11","201802110NJD"
"NJD",0,1,2,0,0,3,0,2,1,2,0,5,"H","N","2018-02-11","201802110NJD"
"CGY",0,0,1,2,0,3,0,1,1,0,0,2,"A","N","2018-02-11","201802110NYI"
"NYI",0,1,1,0,0,2,0,0,1,2,0,3,"H","N","2018-02-11","201802110NYI"
"PIT",0,0,1,3,0,4,0,0,1,0,0,1,"A","N","2018-02-11","201802110STL"
"STL",0,0,1,0,0,1,0,0,1,3,0,4,"H","N","2018-02-11","201802110STL"
"PHI",0,1,2,1,0,4,0,1,0,0,0,1,"A","N","2018-02-11","201802110VEG"
"VEG",0,1,0,0,0,1,0,1,2,1,0,4,"H","N","2018-02-11","201802110VEG"
"NYR",0,1,0,2,0,3,0,1,0,0,0,1,"A","N","2018-02-11","201802110WPG"
"WPG",0,1,0,0,0,1,0,1,0,2,0,3,"H","N","2018-02-11","201802110WPG"
"DET",1,1,3,0,0,5,0,1,0,3,0,4,"A","N","2018-02-11","201802110WSH"
"WSH",0,1,0,3,0,4,1,1,3,0,0,5,"H","N","2018-02-11","201802110WSH"
"ARI",0,2,2,2,0,6,0,0,1,0,0,1,"H","N","2018-02-12","201802120ARI"
"CHI",0,0,1,0,0,1,0,2,2,2,0,6,"A","N","2018-02-12","201802120ARI"
"EDM",0,1,2,2,0,5,0,1,2,4,0,7,"H","N","2018-02-12","201802120EDM"
"FLA",0,1,2,4,0,7,0,1,2,2,0,5,"A","N","2018-02-12","201802120EDM"
"TBL",0,0,1,2,0,3,0,1,2,1,0,4,"A","N","2018-02-12","201802120TOR"
"TOR",0,1,2,1,0,4,0,0,1,2,0,3,"H","N","2018-02-12","201802120TOR"
"BOS",0,1,1,3,0,5,0,2,0,0,0,2,"H","N","2018-02-13","201802130BOS"
"CGY",0,2,0,0,0,2,0,1,1,3,0,5,"A","N","2018-02-13","201802130BOS"
"BUF",0,1,2,2,0,5,0,1,1,1,0,3,"H","N","2018-02-13","201802130BUF"
"TBL",0,1,1,1,0,3,0,1,2,2,0,5,"A","N","2018-02-13","201802130BUF"
"CAR",0,3,2,2,0,7,0,0,2,1,0,3,"H","N","2018-02-13","201802130CAR"
"LAK",0,0,2,1,0,3,0,3,2,2,0,7,"A","N","2018-02-13","201802130CAR"
"ANA",0,0,0,1,0,1,0,1,1,0,0,2,"A","N","2018-02-13","201802130DET"
"DET",0,1,1,0,0,2,0,0,0,1,0,1,"H","N","2018-02-13","201802130DET"
"MIN",0,3,0,0,0,3,0,1,1,0,0,2,"H","N","2018-02-13","201802130MIN"
"NYR",0,1,1,0,0,2,0,3,0,0,0,3,"A","N","2018-02-13","201802130MIN"
"NSH",1,0,0,3,0,4,0,1,2,0,0,3,"H","N","2018-02-13","201802130NSH"
"STL",0,1,2,0,0,3,1,0,0,3,0,4,"A","N","2018-02-13","201802130NSH"
"CBJ",0,0,2,2,0,4,0,1,0,0,0,1,"A","N","2018-02-13","201802130NYI"
"NYI",0,1,0,0,0,1,0,0,2,2,0,4,"H","N","2018-02-13","201802130NYI"
"NJD",0,0,3,1,1,5,0,1,3,0,0,4,"A","Y","2018-02-13","201802130PHI"
"PHI",0,1,3,0,0,4,0,0,3,1,1,5,"H","Y","2018-02-13","201802130PHI"
"OTT",0,0,2,1,0,3,0,1,3,2,0,6,"A","N","2018-02-13","201802130PIT"
"PIT",0,1,3,2,0,6,0,0,2,1,0,3,"H","N","2018-02-13","201802130PIT"
"ARI",0,1,1,0,0,2,0,1,0,0,0,1,"A","N","2018-02-13","201802130SJS"
"SJS",0,1,0,0,0,1,0,1,1,0,0,2,"H","N","2018-02-13","201802130SJS"
"CHI",0,1,1,0,0,2,0,1,0,4,0,5,"A","N","2018-02-13","201802130VEG"
"VEG",0,1,0,4,0,5,0,1,1,0,0,2,"H","N","2018-02-13","201802130VEG"
"WPG",1,1,0,2,0,4,0,1,1,1,0,3,"H","N","2018-02-13","201802130WPG"
"WSH",0,1,1,1,0,3,1,1,0,2,0,4,"A","N","2018-02-13","201802130WPG"
"COL",0,0,1,1,0,2,0,0,0,0,0,0,"H","N","2018-02-14","201802140COL"
"MTL",0,0,0,0,0,0,0,0,1,1,0,2,"A","N","2018-02-14","201802140COL"
"CBJ",0,1,2,0,0,3,0,2,2,2,0,6,"A","N","2018-02-14","201802140TOR"
"TOR",0,2,2,2,0,6,0,1,2,0,0,3,"H","N","2018-02-14","201802140TOR"
"FLA",0,4,0,0,0,4,0,2,1,0,0,3,"A","N","2018-02-14","201802140VAN"
"VAN",0,2,1,0,0,3,0,4,0,0,0,4,"H","N","2018-02-14","201802140VAN"
"ARI",0,1,2,2,0,5,0,0,0,2,0,2,"H","N","2018-02-15","201802150ARI"
"MTL",0,0,0,2,0,2,0,1,2,2,0,5,"A","N","2018-02-15","201802150ARI"
"ANA",0,0,2,1,0,3,0,0,2,0,0,2,"A","N","2018-02-15","201802150CHI"
"CHI",0,0,2,0,0,2,0,0,2,1,0,3,"H","N","2018-02-15","201802150CHI"
"MIN",0,0,0,2,0,2,0,0,2,3,0,5,"H","N","2018-02-15","201802150MIN"
"WSH",0,0,2,3,0,5,0,0,0,2,0,2,"A","N","2018-02-15","201802150MIN"
"CAR",0,1,1,0,0,2,0,1,2,2,0,5,"A","N","2018-02-15","201802150NJD"
"NJD",0,1,2,2,0,5,0,1,1,0,0,2,"H","N","2018-02-15","201802150NJD"
"CGY",0,1,1,2,0,4,0,1,1,1,0,3,"A","N","2018-02-15","201802150NSH"
"NSH",0,1,1,1,0,3,0,1,1,2,0,4,"H","N","2018-02-15","201802150NSH"
"NYI",0,1,1,1,0,3,0,0,0,0,0,0,"H","N","2018-02-15","201802150NYI"
"NYR",0,0,0,0,0,0,0,1,1,1,0,3,"A","N","2018-02-15","201802150NYI"
"BUF",0,1,0,1,0,2,1,0,0,2,0,3,"A","N","2018-02-15","201802150OTT"
"OTT",1,0,0,2,0,3,0,1,0,1,0,2,"H","N","2018-02-15","201802150OTT"
"LAK",0,0,1,0,0,1,0,0,1,2,0,3,"A","N","2018-02-15","201802150PIT"
"PIT",0,0,1,2,0,3,0,0,1,0,0,1,"H","N","2018-02-15","201802150PIT"
"SJS",0,1,1,2,0,4,0,0,0,1,0,1,"H","N","2018-02-15","201802150SJS"
"VAN",0,0,0,1,0,1,0,1,1,2,0,4,"A","N","2018-02-15","201802150SJS"
"DET",0,0,1,0,0,1,0,2,1,1,0,4,"A","N","2018-02-15","201802150TBL"
"TBL",0,2,1,1,0,4,0,0,1,0,0,1,"H","N","2018-02-15","201802150TBL"
"EDM",0,0,0,1,0,1,0,1,2,1,0,4,"A","N","2018-02-15","201802150VEG"
"VEG",0,1,2,1,0,4,0,0,0,1,0,1,"H","N","2018-02-15","201802150VEG"
"CAR",0,0,0,0,0,0,0,0,1,2,0,3,"H","N","2018-02-16","201802160CAR"
"NYI",0,0,1,2,0,3,0,0,0,0,0,0,"A","N","2018-02-16","201802160CAR"
"CBJ",0,0,0,1,0,1,1,0,1,0,0,2,"H","N","2018-02-16","201802160CBJ"
"PHI",1,0,1,0,0,2,0,0,0,1,0,1,"A","N","2018-02-16","201802160CBJ"
"DAL",0,0,1,1,0,2,0,0,0,1,0,1,"H","N","2018-02-16","201802160DAL"
"STL",0,0,0,1,0,1,0,0,1,1,0,2,"A","N","2018-02-16","201802160DAL"
"COL",0,0,0,1,0,1,0,1,3,2,0,6,"A","N","2018-02-16","201802160WPG"
"WPG",0,1,3,2,0,6,0,0,0,1,0,1,"H","N","2018-02-16","201802160WPG"
"ARI",0,1,0,0,0,1,0,0,0,0,0,0,"H","N","2018-02-17","201802170ARI"
"EDM",0,0,0,0,0,0,0,1,0,0,0,1,"A","N","2018-02-17","201802170ARI"
"BUF",0,0,0,2,0,2,0,1,3,0,0,4,"H","N","2018-02-17","201802170BUF"
"LAK",0,1,3,0,0,4,0,0,0,2,0,2,"A","N","2018-02-17","201802170BUF"
"CGY",0,1,1,1,0,3,0,1,3,2,0,6,"H","N","2018-02-17","201802170CGY"
"FLA",0,1,3,2,0,6,0,1,1,1,0,3,"A","N","2018-02-17","201802170CGY"
"CHI",0,3,3,1,0,7,0,1,0,0,0,1,"H","N","2018-02-17","201802170CHI"
"WSH",0,1,0,0,0,1,0,3,3,1,0,7,"A","N","2018-02-17","201802170CHI"
"ANA",0,1,0,1,1,3,0,1,1,0,0,2,"A","Y","2018-02-17","201802170MIN"
"MIN",0,1,1,0,0,2,0,1,0,1,1,3,"H","Y","2018-02-17","201802170MIN"
"DET",0,2,0,1,0,3,0,0,0,1,0,1,"A","N","2018-02-17","201802170NSH"
"NSH",0,0,0,1,0,1,0,2,0,1,0,3,"H","N","2018-02-17","201802170NSH"
"NYR",0,1,1,1,0,3,0,2,2,2,0,6,"A","N","2018-02-17","201802170OTT"
"OTT",0,2,2,2,0,6,0,1,1,1,0,3,"H","N","2018-02-17","201802170OTT"
"PIT",0,2,1,2,0,5,0,2,1,0,0,3,"H","N","2018-02-17","201802170PIT"
"TOR",0,2,1,0,0,3,0,2,1,2,0,5,"A","N","2018-02-17","201802170PIT"
"NJD",0,1,2,1,0,4,0,1,1,1,0,3,"A","N","2018-02-17","201802170TBL"
"TBL",0,1,1,1,0,3,0,1,2,1,0,4,"H","N","2018-02-17","201802170TBL"
"BOS",0,0,0,1,0,1,0,4,1,1,0,6,"A","N","2018-02-17","201802170VAN"
"VAN",0,4,1,1,0,6,0,0,0,1,0,1,"H","N","2018-02-17","201802170VAN"
"MTL",0,2,0,1,0,3,0,3,2,1,0,6,"A","N","2018-02-17","201802170VEG"
"VEG",0,3,2,1,0,6,0,2,0,1,0,3,"H","N","2018-02-17","201802170VEG"
"CAR",0,0,1,1,0,2,1,1,1,0,0,3,"H","N","2018-02-18","201802180CAR"
"NJD",1,1,1,0,0,3,0,0,1,1,0,2,"A","N","2018-02-18","201802180CAR"
"CBJ",0,1,0,1,0,2,0,3,1,1,0,5,"H","N","2018-02-18","201802180CBJ"
"PIT",0,3,1,1,0,5,0,1,0,1,0,2,"A","N","2018-02-18","201802180CBJ"
"COL",0,1,1,0,0,2,0,0,1,3,0,4,"H","N","2018-02-18","201802180COL"
"EDM",0,0,1,3,0,4,0,1,1,0,0,2,"A","N","2018-02-18","201802180COL"
"DET",0,0,1,1,0,2,0,0,2,1,0,3,"H","N","2018-02-18","201802180DET"
"TOR",0,0,2,1,0,3,0,0,1,1,0,2,"A","N","2018-02-18","201802180DET"
"NYR",0,3,1,0,0,4,0,3,2,2,0,7,"H","N","2018-02-18","201802180NYR"
"PHI",0,3,2,2,0,7,0,3,1,0,0,4,"A","N","2018-02-18","201802180NYR"
"DAL",0,0,0,2,0,2,0,4,1,0,0,5,"A","N","2018-02-18","201802180SJS"
"SJS",0,4,1,0,0,5,0,0,0,2,0,2,"H","N","2018-02-18","201802180SJS"
"FLA",0,1,1,0,0,2,0,1,2,4,0,7,"A","N","2018-02-18","201802180WPG"
"WPG",0,1,2,4,0,7,0,1,1,0,0,2,"H","N","2018-02-18","201802180WPG"
"BUF",0,0,0,2,0,2,0,0,2,1,0,3,"H","N","2018-02-19","201802190BUF"
"WSH",0,0,2,1,0,3,0,0,0,2,0,2,"A","N","2018-02-19","201802190BUF"
"BOS",1,1,0,0,0,2,0,0,1,0,0,1,"A","N","2018-02-19","201802190CGY"
"CGY",0,0,1,0,0,1,1,1,0,0,0,2,"H","N","2018-02-19","201802190CGY"
"CHI",0,0,0,1,0,1,0,2,1,0,0,3,"H","N","2018-02-19","201802190CHI"
"LAK",0,2,1,0,0,3,0,0,0,1,0,1,"A","N","2018-02-19","201802190CHI"
"NSH",0,2,2,1,0,5,0,1,1,0,0,2,"H","N","2018-02-19","201802190NSH"
"OTT",0,1,1,0,0,2,0,2,2,1,0,5,"A","N","2018-02-19","201802190NSH"
"MIN",0,1,3,1,0,5,0,1,2,0,0,3,"A","N","2018-02-19","201802190NYI"
"NYI",0,1,2,0,0,3,0,1,3,1,0,5,"H","N","2018-02-19","201802190NYI"
"ANA",0,1,0,1,0,2,0,0,0,0,0,0,"A","N","2018-02-19","201802190VEG"
"VEG",0,0,0,0,0,0,0,1,0,1,0,2,"H","N","2018-02-19","201802190VEG"
"DET",0,0,1,1,0,2,0,2,0,1,0,3,"H","N","2018-02-20","201802200DET"
"NSH",0,2,0,1,0,3,0,0,1,1,0,2,"A","N","2018-02-20","201802200DET"
"BOS",0,0,0,3,0,3,0,1,1,0,0,2,"A","N","2018-02-20","201802200EDM"
"EDM",0,1,1,0,0,2,0,0,0,3,0,3,"H","N","2018-02-20","201802200EDM"
"CBJ",0,1,1,0,0,2,0,0,1,0,0,1,"A","N","2018-02-20","201802200NJD"
"NJD",0,0,1,0,0,1,0,1,1,0,0,2,"H","N","2018-02-20","201802200NJD"
"MTL",0,1,0,1,0,2,1,0,1,1,0,3,"A","N","2018-02-20","201802200PHI"
"PHI",1,0,1,1,0,3,0,1,0,1,0,2,"H","N","2018-02-20","201802200PHI"
"SJS",0,0,3,0,0,3,0,0,2,0,0,2,"A","N","2018-02-20","201802200STL"
"STL",0,0,2,0,0,2,0,0,3,0,0,3,"H","N","2018-02-20","201802200STL"
"FLA",0,0,0,0,0,0,0,1,0,0,0,1,"A","N","2018-02-20","201802200TOR"
"TOR",0,1,0,0,0,1,0,0,0,0,0,0,"H","N","2018-02-20","201802200TOR"
"COL",1,0,3,1,0,5,0,0,4,0,0,4,"A","N","2018-02-20","201802200VAN"
"VAN",0,0,4,0,0,4,1,0,3,1,0,5,"H","N","2018-02-20","201802200VAN"
"LAK",0,0,2,2,0,4,0,1,1,1,0,3,"A","N","2018-02-20","201802200WPG"
"WPG",0,1,1,1,0,3,0,0,2,2,0,4,"H","N","2018-02-20","201802200WPG"
"TBL",0,3,0,1,0,4,0,0,1,1,0,2,"A","N","2018-02-20","201802200WSH"
"WSH",0,0,1,1,0,2,0,3,0,1,0,4,"H","N","2018-02-20","201802200WSH"
"ANA",0,1,0,1,0,2,0,0,0,0,0,0,"H","N","2018-02-21","201802210ANA"
"DAL",0,0,0,0,0,0,0,1,0,1,0,2,"A","N","2018-02-21","201802210ANA"
"CHI",0,1,1,0,1,3,0,1,1,0,0,2,"H","Y","2018-02-21","201802210CHI"
"OTT",0,1,1,0,0,2,0,1,1,0,1,3,"A","Y","2018-02-21","201802210CHI"
"CGY",0,1,2,0,0,3,0,2,2,3,0,7,"A","N","2018-02-21","201802210VEG"
"VEG",0,2,2,3,0,7,0,1,2,0,0,3,"H","N","2018-02-21","201802210VEG"
"ARI",0,1,0,1,0,2,0,2,1,2,0,5,"H","N","2018-02-22","201802220ARI"
"CGY",0,2,1,2,0,5,0,1,0,1,0,2,"A","N","2018-02-22","201802220ARI"
"BUF",1,1,1,0,0,3,0,0,1,1,0,2,"A","N","2018-02-22","201802220DET"
"DET",0,0,1,1,0,2,1,1,1,0,0,3,"H","N","2018-02-22","201802220DET"
"COL",0,0,1,1,0,2,1,0,2,0,0,3,"A","N","2018-02-22","201802220EDM"
"EDM",1,0,2,0,0,3,0,0,1,1,0,2,"H","N","2018-02-22","201802220EDM"
"FLA",0,1,0,2,0,3,0,1,1,0,0,2,"H","N","2018-02-22","201802220FLA"
"WSH",0,1,1,0,0,2,0,1,0,2,0,3,"A","N","2018-02-22","201802220FLA"
"DAL",0,0,0,2,0,2,0,0,0,0,0,0,"A","N","2018-02-22","201802220LAK"
"LAK",0,0,0,0,0,0,0,0,0,2,0,2,"H","N","2018-02-22","201802220LAK"
"MTL",0,1,1,1,0,3,0,0,0,1,0,1,"H","N","2018-02-22","201802220MTL"
"NYR",0,0,0,1,0,1,0,1,1,1,0,3,"A","N","2018-02-22","201802220MTL"
"MIN",0,0,3,1,0,4,0,1,1,0,0,2,"A","N","2018-02-22","201802220NJD"
"NJD",0,1,1,0,0,2,0,0,3,1,0,4,"H","N","2018-02-22","201802220NJD"
"NSH",0,2,1,4,0,7,0,0,1,0,0,1,"H","N","2018-02-22","201802220NSH"
"SJS",0,0,1,0,0,1,0,2,1,4,0,7,"A","N","2018-02-22","201802220NSH"
"OTT",0,1,0,2,0,3,0,2,2,0,0,4,"H","N","2018-02-22","201802220OTT"
"TBL",0,2,2,0,0,4,0,1,0,2,0,3,"A","N","2018-02-22","201802220OTT"
"CBJ",0,0,1,0,0,1,0,0,0,2,0,2,"A","N","2018-02-22","201802220PHI"
"PHI",0,0,0,2,0,2,0,0,1,0,0,1,"H","N","2018-02-22","201802220PHI"
"NYI",0,2,0,1,0,3,0,1,0,2,1,4,"A","Y","2018-02-22","201802220TOR"
"TOR",0,1,0,2,1,4,0,2,0,1,0,3,"H","Y","2018-02-22","201802220TOR"
"CAR",0,0,1,0,0,1,0,1,3,2,0,6,"H","N","2018-02-23","201802230CAR"
"PIT",0,1,3,2,0,6,0,0,1,0,0,1,"A","N","2018-02-23","201802230CAR"
"CHI",0,0,1,2,0,3,0,0,0,1,0,1,"H","N","2018-02-23","201802230CHI"
"SJS",0,0,0,1,0,1,0,0,1,2,0,3,"A","N","2018-02-23","201802230CHI"
"MIN",0,2,0,2,0,4,0,0,1,0,0,1,"A","N","2018-02-23","201802230NYR"
"NYR",0,0,1,0,0,1,0,2,0,2,0,4,"H","N","2018-02-23","201802230NYR"
"STL",0,0,0,0,0,0,0,3,1,0,0,4,"H","N","2018-02-23","201802230STL"
"WPG",0,3,1,0,0,4,0,0,0,0,0,0,"A","N","2018-02-23","201802230STL"
"VAN",0,2,0,1,0,3,0,2,3,1,0,6,"A","N","2018-02-23","201802230VEG"
"VEG",0,2,3,1,0,6,0,2,0,1,0,3,"H","N","2018-02-23","201802230VEG"
"ANA",0,0,0,0,0,0,0,1,0,1,0,2,"A","N","2018-02-24","201802240ARI"
"ARI",0,1,0,1,0,2,0,0,0,0,0,0,"H","N","2018-02-24","201802240ARI"
"CBJ",0,1,1,1,0,3,0,1,1,0,0,2,"H","N","2018-02-24","201802240CBJ"
"CHI",0,1,1,0,0,2,0,1,1,1,0,3,"A","N","2018-02-24","201802240CBJ"
"CGY",0,2,1,2,0,5,0,1,0,0,0,1,"H","N","2018-02-24","201802240CGY"
"COL",0,1,0,0,0,1,0,2,1,2,0,5,"A","N","2018-02-24","201802240CGY"
"DAL",0,1,1,1,0,3,0,0,5,0,0,5,"H","N","2018-02-24","201802240DAL"
"WPG",0,0,5,0,0,5,0,1,1,1,0,3,"A","N","2018-02-24","201802240DAL"
"CAR",0,0,1,0,0,1,0,1,2,0,0,3,"A","N","2018-02-24","201802240DET"
"DET",0,1,2,0,0,3,0,0,1,0,0,1,"H","N","2018-02-24","201802240DET"
"FLA",0,2,2,2,0,6,0,1,1,3,0,5,"H","N","2018-02-24","201802240FLA"
"PIT",0,1,1,3,0,5,0,2,2,2,0,6,"A","N","2018-02-24","201802240FLA"
"EDM",0,1,2,1,0,4,0,0,1,2,0,3,"A","N","2018-02-24","201802240LAK"
"LAK",0,0,1,2,0,3,0,1,2,1,0,4,"H","N","2018-02-24","201802240LAK"
"MTL",0,1,2,0,0,3,0,1,1,1,1,4,"H","Y","2018-02-24","201802240MTL"
"TBL",0,1,1,1,1,4,0,1,2,0,0,3,"A","Y","2018-02-24","201802240MTL"
"NJD",0,0,0,2,0,2,0,0,1,0,0,1,"H","N","2018-02-24","201802240NJD"
"NYI",0,0,1,0,0,1,0,0,0,2,0,2,"A","N","2018-02-24","201802240NJD"
"OTT",0,1,0,2,0,3,0,2,0,3,0,5,"H","N","2018-02-24","201802240OTT"
"PHI",0,2,0,3,0,5,0,1,0,2,0,3,"A","N","2018-02-24","201802240OTT"
"BOS",0,2,1,0,0,3,0,2,1,1,0,4,"A","N","2018-02-24","201802240TOR"
"TOR",0,2,1,1,0,4,0,2,1,0,0,3,"H","N","2018-02-24","201802240TOR"
"BUF",0,0,0,1,0,1,0,1,1,3,0,5,"A","N","2018-02-24","201802240WSH"
"WSH",0,1,1,3,0,5,0,0,0,1,0,1,"H","N","2018-02-24","201802240WSH"
"ANA",0,1,1,3,0,5,0,2,1,2,1,6,"H","Y","2018-02-25","201802250ANA"
"EDM",0,2,1,2,1,6,0,1,1,3,0,5,"A","Y","2018-02-25","201802250ANA"
"ARI",0,0,0,1,0,1,0,1,0,2,0,3,"H","N","2018-02-25","201802250ARI"
"VAN",0,1,0,2,0,3,0,0,0,1,0,1,"A","N","2018-02-25","201802250ARI"
"BOS",0,0,1,0,0,1,0,2,1,1,0,4,"A","N","2018-02-25","201802250BUF"
"BUF",0,2,1,1,0,4,0,0,1,0,0,1,"H","N","2018-02-25","201802250BUF"
"MIN",1,0,1,1,0,3,0,1,1,0,0,2,"H","N","2018-02-25","201802250MIN"
"SJS",0,1,1,0,0,2,1,0,1,1,0,3,"A","N","2018-02-25","201802250MIN"
"NSH",0,2,2,0,0,4,0,0,0,0,0,0,"H","N","2018-02-25","201802250NSH"
"STL",0,0,0,0,0,0,0,2,2,0,0,4,"A","N","2018-02-25","201802250NSH"
"DET",1,1,1,0,0,3,0,0,1,1,0,2,"A","N","2018-02-25","201802250NYR"
"NYR",0,0,1,1,0,2,1,1,1,0,0,3,"H","N","2018-02-25","201802250NYR"
"CBJ",0,4,0,1,0,5,0,1,0,0,0,1,"H","N","2018-02-26","201802260CBJ"
"WSH",0,1,0,0,0,1,0,4,0,1,0,5,"A","N","2018-02-26","201802260CBJ"
"COL",0,1,0,2,0,3,0,0,0,1,0,1,"H","N","2018-02-26","201802260COL"
"VAN",0,0,0,1,0,1,0,1,0,2,0,3,"A","N","2018-02-26","201802260COL"
"LAK",1,0,0,2,0,3,0,1,0,1,0,2,"H","N","2018-02-26","201802260LAK"
"VEG",0,1,0,1,0,2,1,0,0,2,0,3,"A","N","2018-02-26","201802260LAK"
"MTL",0,0,0,0,0,0,0,0,0,0,1,1,"H","Y","2018-02-26","201802260MTL"
"PHI",0,0,0,0,1,1,0,0,0,0,0,0,"A","Y","2018-02-26","201802260MTL"
"TBL",0,1,2,0,1,4,0,2,0,1,0,3,"H","Y","2018-02-26","201802260TBL"
"TOR",0,2,0,1,0,3,0,1,2,0,1,4,"A","Y","2018-02-26","201802260TBL"
"BOS",1,2,1,0,0,4,0,3,0,0,0,3,"H","N","2018-02-27","201802270BOS"
"CAR",0,3,0,0,0,3,1,2,1,0,0,4,"A","N","2018-02-27","201802270BOS"
"CGY",0,0,0,0,0,0,0,1,1,0,0,2,"A","N","2018-02-27","201802270DAL"
"DAL",0,1,1,0,0,2,0,0,0,0,0,0,"H","N","2018-02-27","201802270DAL"
"FLA",1,1,1,0,0,3,0,0,2,0,0,2,"H","N","2018-02-27","201802270FLA"
"TOR",0,0,2,0,0,2,1,1,1,0,0,3,"A","N","2018-02-27","201802270FLA"
"MIN",0,3,3,2,0,8,0,1,2,0,0,3,"H","N","2018-02-27","201802270MIN"
"STL",0,1,2,0,0,3,0,3,3,2,0,8,"A","N","2018-02-27","201802270MIN"
"NJD",0,1,1,1,0,3,0,1,1,0,0,2,"A","N","2018-02-27","201802270PIT"
"PIT",0,1,1,0,0,2,0,1,1,1,0,3,"H","N","2018-02-27","201802270PIT"
"EDM",0,1,0,1,0,2,0,0,4,1,0,5,"A","N","2018-02-27","201802270SJS"
"SJS",0,0,4,1,0,5,0,1,0,1,0,2,"H","N","2018-02-27","201802270SJS"
"LAK",0,1,2,1,0,4,0,1,0,0,0,1,"A","N","2018-02-27","201802270VEG"
"VEG",0,1,0,0,0,1,0,1,2,1,0,4,"H","N","2018-02-27","201802270VEG"
"NSH",0,0,3,3,0,6,0,0,4,1,0,5,"A","N","2018-02-27","201802270WPG"
"WPG",0,0,4,1,0,5,0,0,3,3,0,6,"H","N","2018-02-27","201802270WPG"
"OTT",0,0,1,1,0,2,0,1,2,0,0,3,"A","N","2018-02-27","201802270WSH"
"WSH",0,1,2,0,0,3,0,0,1,1,0,2,"H","N","2018-02-27","201802270WSH"
"CGY",0,1,1,0,0,2,0,0,4,1,0,5,"A","N","2018-02-28","201802280COL"
"COL",0,0,4,1,0,5,0,1,1,0,0,2,"H","N","2018-02-28","201802280COL"
"MTL",0,1,2,0,0,3,0,1,0,0,0,1,"H","N","2018-02-28","201802280MTL"
"NYI",0,1,0,0,0,1,0,1,2,0,0,3,"A","N","2018-02-28","201802280MTL"
"DET",0,0,0,1,0,1,0,0,1,1,0,2,"A","N","2018-02-28","201802280STL"
"STL",0,0,1,1,0,2,0,0,0,1,0,1,"H","N","2018-02-28","201802280STL"
"BUF",1,0,0,1,0,2,0,1,0,0,0,1,"A","N","2018-02-28","201802280TBL"
"TBL",0,1,0,0,0,1,1,0,0,1,0,2,"H","N","2018-02-28","201802280TBL"
"NYR",1,3,1,1,0,6,0,2,1,2,0,5,"A","N","2018-02-28","201802280VAN"
"VAN",0,2,1,2,0,5,1,3,1,1,0,6,"H","N","2018-02-28","201802280VAN"
"ARI",0,0,1,4,0,5,0,1,0,2,0,3,"H","N","2018-03-01","201803010ARI"
"MIN",0,1,0,2,0,3,0,0,1,4,0,5,"A","N","2018-03-01","201803010ARI"
"BOS",0,5,3,0,0,8,0,3,0,1,0,4,"H","N","2018-03-01","201803010BOS"
"PIT",0,3,0,1,0,4,0,5,3,0,0,8,"A","N","2018-03-01","201803010BOS"
"DAL",0,1,1,2,0,4,1,1,3,0,0,5,"H","N","2018-03-01","201803010DAL"
"TBL",1,1,3,0,0,5,0,1,1,2,0,4,"A","N","2018-03-01","201803010DAL"
"EDM",0,2,0,0,0,2,0,0,2,2,0,4,"H","N","2018-03-01","201803010EDM"
"NSH",0,0,2,2,0,4,0,2,0,0,0,2,"A","N","2018-03-01","201803010EDM"
"FLA",0,1,0,2,0,3,0,0,1,1,0,2,"H","N","2018-03-01","201803010FLA"
"NJD",0,0,1,1,0,2,0,1,0,2,0,3,"A","N","2018-03-01","201803010FLA"
"CBJ",0,2,0,0,0,2,0,0,3,2,0,5,"A","N","2018-03-01","201803010LAK"
"LAK",0,0,3,2,0,5,0,2,0,0,0,2,"H","N","2018-03-01","201803010LAK"
"CAR",0,1,2,1,0,4,0,0,0,1,0,1,"A","N","2018-03-01","201803010PHI"
"PHI",0,0,0,1,0,1,0,1,2,1,0,4,"H","N","2018-03-01","201803010PHI"
"CHI",0,1,0,1,0,2,0,2,4,1,0,7,"A","N","2018-03-01","201803010SJS"
"SJS",0,2,4,1,0,7,0,1,0,1,0,2,"H","N","2018-03-01","201803010SJS"
"ANA",0,1,2,1,0,4,0,1,0,1,0,2,"H","N","2018-03-02","201803020ANA"
"CBJ",0,1,0,1,0,2,0,1,2,1,0,4,"A","N","2018-03-02","201803020ANA"
"CAR",0,0,1,2,0,3,0,0,1,0,0,1,"H","N","2018-03-02","201803020CAR"
"NJD",0,0,1,0,0,1,0,0,1,2,0,3,"A","N","2018-03-02","201803020CAR"
"CGY",0,1,0,0,0,1,0,1,2,0,0,3,"H","N","2018-03-02","201803020CGY"
"NYR",0,1,2,0,0,3,0,1,0,0,0,1,"A","N","2018-03-02","201803020CGY"
"COL",0,2,4,1,0,7,0,0,1,0,0,1,"H","N","2018-03-02","201803020COL"
"MIN",0,0,1,0,0,1,0,2,4,1,0,7,"A","N","2018-03-02","201803020COL"
"BUF",0,1,0,0,0,1,0,2,2,0,0,4,"A","N","2018-03-02","201803020FLA"
"FLA",0,2,2,0,0,4,0,1,0,0,0,1,"H","N","2018-03-02","201803020FLA"
"MTL",0,1,2,3,0,6,0,1,2,0,0,3,"A","N","2018-03-02","201803020NYI"
"NYI",0,1,2,0,0,3,0,1,2,3,0,6,"H","N","2018-03-02","201803020NYI"
"NSH",1,0,1,2,0,4,0,1,1,1,0,3,"A","N","2018-03-02","201803020VAN"
"VAN",0,1,1,1,0,3,1,0,1,2,0,4,"H","N","2018-03-02","201803020VAN"
"OTT",0,1,3,1,0,5,0,2,0,2,0,4,"A","N","2018-03-02","201803020VEG"
"VEG",0,2,0,2,0,4,0,1,3,1,0,5,"H","N","2018-03-02","201803020VEG"
"DET",0,1,1,1,0,3,0,2,2,0,0,4,"A","N","2018-03-02","201803020WPG"
"WPG",0,2,2,0,0,4,0,1,1,1,0,3,"H","N","2018-03-02","201803020WPG"
"ARI",0,1,1,0,0,2,0,1,0,0,0,1,"H","N","2018-03-03","201803030ARI"
"OTT",0,1,0,0,0,1,0,1,1,0,0,2,"A","N","2018-03-03","201803030ARI"
"BOS",1,0,0,1,0,2,0,1,0,0,0,1,"H","N","2018-03-03","201803030BOS"
"MTL",0,1,0,0,0,1,1,0,0,1,0,2,"A","N","2018-03-03","201803030BOS"
"DAL",1,0,1,1,0,3,0,0,1,1,0,2,"H","N","2018-03-03","201803030DAL"
"STL",0,0,1,1,0,2,1,0,1,1,0,3,"A","N","2018-03-03","201803030DAL"
"EDM",0,0,2,0,0,2,0,1,2,0,0,3,"H","N","2018-03-03","201803030EDM"
"NYR",0,1,2,0,0,3,0,0,2,0,0,2,"A","N","2018-03-03","201803030EDM"
"CHI",0,1,0,4,0,5,0,0,3,0,0,3,"A","N","2018-03-03","201803030LAK"
"LAK",0,0,3,0,0,3,0,1,0,4,0,5,"H","N","2018-03-03","201803030LAK"
"NYI",0,1,0,1,0,2,1,0,1,1,0,3,"A","N","2018-03-03","201803030PIT"
"PIT",1,0,1,1,0,3,0,1,0,1,0,2,"H","N","2018-03-03","201803030PIT"
"PHI",0,3,1,2,0,6,0,1,2,3,1,7,"A","Y","2018-03-03","201803030TBL"
"TBL",0,1,2,3,1,7,0,3,1,2,0,6,"H","Y","2018-03-03","201803030TBL"
"TOR",0,1,1,0,0,2,0,3,2,0,0,5,"A","N","2018-03-03","201803030WSH"
"WSH",0,3,2,0,0,5,0,1,1,0,0,2,"H","N","2018-03-03","201803030WSH"
"ANA",0,2,2,2,0,6,0,0,1,2,0,3,"H","N","2018-03-04","201803040ANA"
"CHI",0,0,1,2,0,3,0,2,2,2,0,6,"A","N","2018-03-04","201803040ANA"
"CAR",0,1,0,1,0,2,0,1,1,1,0,3,"H","N","2018-03-04","201803040CAR"
"WPG",0,1,1,1,0,3,0,1,0,1,0,2,"A","N","2018-03-04","201803040CAR"
"COL",0,1,0,2,0,3,1,1,1,1,0,4,"H","N","2018-03-04","201803040COL"
"NSH",1,1,1,1,0,4,0,1,0,2,0,3,"A","N","2018-03-04","201803040COL"
"FLA",0,2,1,1,0,4,0,0,0,1,0,1,"H","N","2018-03-04","201803040FLA"
"PHI",0,0,0,1,0,1,0,2,1,1,0,4,"A","N","2018-03-04","201803040FLA"
"DET",0,1,0,0,0,1,0,0,2,2,0,4,"A","N","2018-03-04","201803040MIN"
"MIN",0,0,2,2,0,4,0,1,0,0,0,1,"H","N","2018-03-04","201803040MIN"
"NJD",0,0,2,0,0,2,0,0,3,0,0,3,"H","N","2018-03-04","201803040NJD"
"VEG",0,0,3,0,0,3,0,0,2,0,0,2,"A","N","2018-03-04","201803040NJD"
"CBJ",0,2,1,1,0,4,0,0,1,1,0,2,"A","N","2018-03-04","201803040SJS"
"SJS",0,0,1,1,0,2,0,2,1,1,0,4,"H","N","2018-03-04","201803040SJS"
"BUF",0,2,2,1,0,5,0,1,1,1,0,3,"H","N","2018-03-05","201803050BUF"
"TOR",0,1,1,1,0,3,0,2,2,1,0,5,"A","N","2018-03-05","201803050BUF"
"DAL",0,1,0,1,0,2,1,0,1,1,0,3,"H","N","2018-03-05","201803050DAL"
"OTT",1,0,1,1,0,3,0,1,0,1,0,2,"A","N","2018-03-05","201803050DAL"
"ARI",0,1,0,2,0,3,1,3,0,0,0,4,"A","N","2018-03-05","201803050EDM"
"EDM",1,3,0,0,0,4,0,1,0,2,0,3,"H","N","2018-03-05","201803050EDM"
"CGY",0,2,1,0,0,3,1,2,1,0,0,4,"A","N","2018-03-05","201803050PIT"
"PIT",1,2,1,0,0,4,0,2,1,0,0,3,"H","N","2018-03-05","201803050PIT"
"NYI",0,1,1,1,0,3,1,0,2,1,0,4,"A","N","2018-03-05","201803050VAN"
"VAN",1,0,2,1,0,4,0,1,1,1,0,3,"H","N","2018-03-05","201803050VAN"
"ANA",0,2,1,1,0,4,0,0,0,0,0,0,"H","N","2018-03-06","201803060ANA"
"WSH",0,0,0,0,0,0,0,2,1,1,0,4,"A","N","2018-03-06","201803060ANA"
"BOS",1,3,2,0,0,6,0,2,2,1,0,5,"H","N","2018-03-06","201803060BOS"
"DET",0,2,2,1,0,5,1,3,2,0,0,6,"A","N","2018-03-06","201803060BOS"
"CBJ",0,1,2,1,0,4,0,0,1,0,0,1,"H","N","2018-03-06","201803060CBJ"
"VEG",0,0,1,0,0,1,0,1,2,1,0,4,"A","N","2018-03-06","201803060CBJ"
"CHI",1,1,0,0,0,2,0,0,1,0,0,1,"H","N","2018-03-06","201803060CHI"
"COL",0,0,1,0,0,1,1,1,0,0,0,2,"A","N","2018-03-06","201803060CHI"
"CAR",0,0,0,2,0,2,0,1,4,1,0,6,"A","N","2018-03-06","201803060MIN"
"MIN",0,1,4,1,0,6,0,0,0,2,0,2,"H","N","2018-03-06","201803060MIN"
"MTL",0,0,2,2,0,4,0,4,2,0,0,6,"A","N","2018-03-06","201803060NJD"
"NJD",0,4,2,0,0,6,0,0,2,2,0,4,"H","N","2018-03-06","201803060NJD"
"DAL",0,0,0,0,0,0,0,0,0,2,0,2,"A","N","2018-03-06","201803060NSH"
"NSH",0,0,0,2,0,2,0,0,0,0,0,0,"H","N","2018-03-06","201803060NSH"
"NYR",0,0,0,0,0,0,0,1,1,1,0,3,"H","N","2018-03-06","201803060NYR"
"WPG",0,1,1,1,0,3,0,0,0,0,0,0,"A","N","2018-03-06","201803060NYR"
"FLA",0,1,1,2,0,4,1,2,2,0,0,5,"A","N","2018-03-06","201803060TBL"
"TBL",1,2,2,0,0,5,0,1,1,2,0,4,"H","N","2018-03-06","201803060TBL"
"BUF",0,0,0,1,0,1,0,2,3,0,0,5,"H","N","2018-03-07","201803070BUF"
"CGY",0,2,3,0,0,5,0,0,0,1,0,1,"A","N","2018-03-07","201803070BUF"
"PHI",0,0,2,0,0,2,0,1,3,1,0,5,"H","N","2018-03-07","201803070PHI"
"PIT",0,1,3,1,0,5,0,0,2,0,0,2,"A","N","2018-03-07","201803070PHI"
"ARI",0,1,0,1,0,2,0,1,0,0,0,1,"A","N","2018-03-07","201803070VAN"
"VAN",0,1,0,0,0,1,0,1,0,1,0,2,"H","N","2018-03-07","201803070VAN"
"BOS",0,2,0,1,0,3,0,1,1,0,0,2,"H","N","2018-03-08","201803080BOS"
"PHI",0,1,1,0,0,2,0,2,0,1,0,3,"A","N","2018-03-08","201803080BOS"
"CBJ",1,1,3,0,0,5,0,2,0,2,0,4,"H","N","2018-03-08","201803080CBJ"
"COL",0,2,0,2,0,4,1,1,3,0,0,5,"A","N","2018-03-08","201803080CBJ"
"CAR",0,1,1,1,0,3,0,2,0,0,0,2,"A","N","2018-03-08","201803080CHI"
"CHI",0,2,0,0,0,2,0,1,1,1,0,3,"H","N","2018-03-08","201803080CHI"
"DET",0,0,0,0,0,0,0,1,3,0,0,4,"H","N","2018-03-08","201803080DET"
"VEG",0,1,3,0,0,4,0,0,0,0,0,0,"A","N","2018-03-08","201803080DET"
"EDM",0,0,0,1,1,2,0,0,0,1,0,1,"H","Y","2018-03-08","201803080EDM"
"NYI",0,0,0,1,0,1,0,0,0,1,1,2,"A","Y","2018-03-08","201803080EDM"
"FLA",0,1,2,2,0,5,0,0,0,0,0,0,"H","N","2018-03-08","201803080FLA"
"MTL",0,0,0,0,0,0,0,1,2,2,0,5,"A","N","2018-03-08","201803080FLA"
"LAK",0,1,1,1,0,3,0,0,1,0,0,1,"H","N","2018-03-08","201803080LAK"
"WSH",0,0,1,0,0,1,0,1,1,1,0,3,"A","N","2018-03-08","201803080LAK"
"NJD",0,0,1,1,0,2,0,1,1,1,0,3,"H","N","2018-03-08","201803080NJD"
"WPG",0,1,1,1,0,3,0,0,1,1,0,2,"A","N","2018-03-08","201803080NJD"
"ANA",0,0,0,2,0,2,0,2,1,1,0,4,"A","N","2018-03-08","201803080NSH"
"NSH",0,2,1,1,0,4,0,0,0,2,0,2,"H","N","2018-03-08","201803080NSH"
"BUF",0,1,1,1,1,4,0,0,3,0,0,3,"A","Y","2018-03-08","201803080OTT"
"OTT",0,0,3,0,0,3,0,1,1,1,1,4,"H","Y","2018-03-08","201803080OTT"
"SJS",0,0,0,2,0,2,0,0,0,0,0,0,"H","N","2018-03-08","201803080SJS"
"STL",0,0,0,0,0,0,0,0,0,2,0,2,"A","N","2018-03-08","201803080SJS"
"NYR",0,0,1,2,0,3,0,2,3,0,0,5,"A","N","2018-03-08","201803080TBL"
"TBL",0,2,3,0,0,5,0,0,1,2,0,3,"H","N","2018-03-08","201803080TBL"
"CBJ",0,1,2,0,0,3,0,1,0,1,0,2,"H","N","2018-03-09","201803090CBJ"
"DET",0,1,0,1,0,2,0,1,2,0,0,3,"A","N","2018-03-09","201803090CBJ"
"ANA",0,1,0,0,0,1,0,0,0,2,0,2,"A","N","2018-03-09","201803090DAL"
"DAL",0,0,0,2,0,2,0,1,0,0,0,1,"H","N","2018-03-09","201803090DAL"
"CGY",0,1,0,1,0,2,0,0,0,1,0,1,"A","N","2018-03-09","201803090OTT"
"OTT",0,0,0,1,0,1,0,1,0,1,0,2,"H","N","2018-03-09","201803090OTT"
"MIN",0,1,2,2,0,5,0,1,1,0,0,2,"A","N","2018-03-09","201803090VAN"
"VAN",0,1,1,0,0,2,0,1,2,2,0,5,"H","N","2018-03-09","201803090VAN"
"BOS",0,2,1,4,0,7,0,2,2,0,0,4,"H","N","2018-03-10","201803100BOS"
"CHI",0,2,2,0,0,4,0,2,1,4,0,7,"A","N","2018-03-10","201803100BOS"
"BUF",0,0,0,1,0,1,0,0,0,1,1,2,"H","Y","2018-03-10","201803100BUF"
"VEG",0,0,0,1,1,2,0,0,0,1,0,1,"A","Y","2018-03-10","201803100BUF"
"ARI",0,1,1,0,0,2,0,3,0,2,0,5,"A","N","2018-03-10","201803100COL"
"COL",0,3,0,2,0,5,0,1,1,0,0,2,"H","N","2018-03-10","201803100COL"
"EDM",0,0,2,2,0,4,0,0,0,1,0,1,"H","N","2018-03-10","201803100EDM"
"MIN",0,0,0,1,0,1,0,0,2,2,0,4,"A","N","2018-03-10","201803100EDM"
"FLA",0,1,1,1,1,4,0,0,1,2,0,3,"H","Y","2018-03-10","201803100FLA"
"NYR",0,0,1,2,0,3,0,1,1,1,1,4,"A","Y","2018-03-10","201803100FLA"
"LAK",0,0,1,1,0,2,0,2,2,3,0,7,"H","N","2018-03-10","201803100LAK"
"STL",0,2,2,3,0,7,0,0,1,1,0,2,"A","N","2018-03-10","201803100LAK"
"NJD",0,1,1,0,1,3,0,1,0,1,0,2,"A","Y","2018-03-10","201803100NSH"
"NSH",0,1,0,1,0,2,0,1,1,0,1,3,"H","Y","2018-03-10","201803100NSH"
"PHI",0,0,2,0,0,2,0,0,0,1,0,1,"H","N","2018-03-10","201803100PHI"
"WPG",0,0,0,1,0,1,0,0,2,0,0,2,"A","N","2018-03-10","201803100PHI"
"SJS",0,0,0,0,0,0,0,0,1,1,0,2,"H","N","2018-03-10","201803100SJS"
"WSH",0,0,1,1,0,2,0,0,0,0,0,0,"A","N","2018-03-10","201803100SJS"
"MTL",0,1,1,0,0,2,0,1,0,1,1,3,"A","Y","2018-03-10","201803100TBL"
"TBL",0,1,0,1,1,3,0,1,1,0,0,2,"H","Y","2018-03-10","201803100TBL"
"PIT",0,0,0,2,0,2,0,2,2,1,0,5,"A","N","2018-03-10","201803100TOR"
"TOR",0,2,2,1,0,5,0,0,0,2,0,2,"H","N","2018-03-10","201803100TOR"
"ARI",0,0,1,0,0,1,0,0,0,0,0,0,"H","N","2018-03-11","201803110ARI"
"VAN",0,0,0,0,0,0,0,0,1,0,0,1,"A","N","2018-03-11","201803110ARI"
"CGY",0,1,0,1,0,2,0,3,1,1,0,5,"H","N","2018-03-11","201803110CGY"
"NYI",0,3,1,1,0,5,0,1,0,1,0,2,"A","N","2018-03-11","201803110CGY"
"BOS",0,0,0,1,0,1,0,1,0,2,0,3,"A","N","2018-03-11","201803110CHI"
"CHI",0,1,0,2,0,3,0,0,0,1,0,1,"H","N","2018-03-11","201803110CHI"
"DAL",0,0,1,0,0,1,0,2,0,1,0,3,"A","N","2018-03-11","201803110PIT"
"PIT",0,2,0,1,0,3,0,0,1,0,0,1,"H","N","2018-03-11","201803110PIT"
"ANA",0,0,1,1,0,2,0,1,2,1,0,4,"H","N","2018-03-12","201803120ANA"
"STL",0,1,2,1,0,4,0,0,1,1,0,2,"A","N","2018-03-12","201803120ANA"
"CBJ",0,3,1,1,0,5,0,1,1,0,0,2,"H","N","2018-03-12","201803120CBJ"
"MTL",0,1,1,0,0,2,0,3,1,1,0,5,"A","N","2018-03-12","201803120CBJ"
"FLA",0,0,2,1,0,3,0,2,0,3,0,5,"H","N","2018-03-12","201803120FLA"
"OTT",0,2,0,3,0,5,0,0,2,1,0,3,"A","N","2018-03-12","201803120FLA"
"LAK",0,0,2,1,0,3,0,0,0,0,0,0,"H","N","2018-03-12","201803120LAK"
"VAN",0,0,0,0,0,0,0,0,2,1,0,3,"A","N","2018-03-12","201803120LAK"
"CAR",0,1,1,1,0,3,0,1,2,3,0,6,"A","N","2018-03-12","201803120NYR"
"NYR",0,1,2,3,0,6,0,1,1,1,0,3,"H","N","2018-03-12","201803120NYR"
"PHI",0,0,1,1,0,2,0,1,0,2,0,3,"H","N","2018-03-12","201803120PHI"
"VEG",0,1,0,2,0,3,0,0,1,1,0,2,"A","N","2018-03-12","201803120PHI"
"DET",0,1,1,1,0,3,0,2,1,2,0,5,"A","N","2018-03-12","201803120SJS"
"SJS",0,2,1,2,0,5,0,1,1,1,0,3,"H","N","2018-03-12","201803120SJS"
"WPG",0,1,0,1,0,2,1,1,1,0,0,3,"A","N","2018-03-12","201803120WSH"
"WSH",1,1,1,0,0,3,0,1,0,1,0,2,"H","N","2018-03-12","201803120WSH"
"ARI",0,2,1,0,1,4,0,0,1,2,0,3,"H","Y","2018-03-13","201803130ARI"
"LAK",0,0,1,2,0,3,0,2,1,0,1,4,"A","Y","2018-03-13","201803130ARI"
"BOS",0,1,0,5,0,6,0,0,3,1,0,4,"A","N","2018-03-13","201803130CAR"
"CAR",0,0,3,1,0,4,0,1,0,5,0,6,"H","N","2018-03-13","201803130CAR"
"CGY",0,0,1,0,0,1,0,0,0,0,0,0,"H","N","2018-03-13","201803130CGY"
"EDM",0,0,0,0,0,0,0,0,1,0,0,1,"A","N","2018-03-13","201803130CGY"
"COL",0,1,1,3,0,5,0,0,1,0,0,1,"A","N","2018-03-13","201803130MIN"
"MIN",0,0,1,0,0,1,0,1,1,3,0,5,"H","N","2018-03-13","201803130MIN"
"DAL",0,1,1,0,0,2,0,1,2,1,0,4,"A","N","2018-03-13","201803130MTL"
"MTL",0,1,2,1,0,4,0,1,1,0,0,2,"H","N","2018-03-13","201803130MTL"
"NSH",0,3,0,0,0,3,0,0,0,1,0,1,"H","N","2018-03-13","201803130NSH"
"WPG",0,0,0,1,0,1,0,3,0,0,0,3,"A","N","2018-03-13","201803130NSH"
"OTT",0,3,3,1,0,7,0,1,2,1,0,4,"A","N","2018-03-13","201803130TBL"
"TBL",0,1,2,1,0,4,0,3,3,1,0,7,"H","N","2018-03-13","201803130TBL"
"ANA",0,1,1,1,0,3,0,0,0,0,0,0,"H","N","2018-03-14","201803140ANA"
"VAN",0,0,0,0,0,0,0,1,1,1,0,3,"A","N","2018-03-14","201803140ANA"
"EDM",0,1,1,1,0,3,1,1,1,1,0,4,"H","N","2018-03-14","201803140EDM"
"SJS",1,1,1,1,0,4,0,1,1,1,0,3,"A","N","2018-03-14","201803140EDM"
"NYR",1,0,0,3,0,4,0,0,2,1,0,3,"H","N","2018-03-14","201803140NYR"
"PIT",0,0,2,1,0,3,1,0,0,3,0,4,"A","N","2018-03-14","201803140NYR"
"DAL",0,2,2,1,0,5,0,2,0,3,1,6,"A","Y","2018-03-14","201803140TOR"
"TOR",0,2,0,3,1,6,0,2,2,1,0,5,"H","Y","2018-03-14","201803140TOR"
"NJD",0,2,2,4,0,8,0,0,2,1,0,3,"A","N","2018-03-14","201803140VEG"
"VEG",0,0,2,1,0,3,0,2,2,4,0,8,"H","N","2018-03-14","201803140VEG"
"ARI",0,0,2,0,0,2,0,0,1,2,0,3,"H","N","2018-03-15","201803150ARI"
"NSH",0,0,1,2,0,3,0,0,2,0,0,2,"A","N","2018-03-15","201803150ARI"
"BUF",0,1,1,0,0,2,0,2,2,1,0,5,"H","N","2018-03-15","201803150BUF"
"TOR",0,2,2,1,0,5,0,1,1,0,0,2,"A","N","2018-03-15","201803150BUF"
"BOS",0,0,0,0,0,0,0,2,1,0,0,3,"A","N","2018-03-15","201803150FLA"
"FLA",0,2,1,0,0,3,0,0,0,0,0,0,"H","N","2018-03-15","201803150FLA"
"DET",0,0,0,1,0,1,0,1,0,3,0,4,"A","N","2018-03-15","201803150LAK"
"LAK",0,1,0,3,0,4,0,0,0,1,0,1,"H","N","2018-03-15","201803150LAK"
"MTL",0,2,1,0,0,3,0,2,1,2,0,5,"H","N","2018-03-15","201803150MTL"
"PIT",0,2,1,2,0,5,0,2,1,0,0,3,"A","N","2018-03-15","201803150MTL"
"NYI",0,2,0,1,0,3,0,3,2,2,0,7,"H","N","2018-03-15","201803150NYI"
"WSH",0,3,2,2,0,7,0,2,0,1,0,3,"A","N","2018-03-15","201803150NYI"
"CBJ",0,3,1,1,0,5,0,1,2,0,0,3,"A","N","2018-03-15","201803150PHI"
"PHI",0,1,2,0,0,3,0,3,1,1,0,5,"H","N","2018-03-15","201803150PHI"
"COL",0,2,1,1,0,4,0,0,1,0,0,1,"A","N","2018-03-15","201803150STL"
"STL",0,0,1,0,0,1,0,2,1,1,0,4,"H","N","2018-03-15","201803150STL"
"CHI",0,1,1,0,0,2,0,5,0,1,0,6,"A","N","2018-03-15","201803150WPG"
"WPG",0,5,0,1,0,6,0,1,1,0,0,2,"H","N","2018-03-15","201803150WPG"
"ANA",0,1,2,1,0,4,0,1,1,0,0,2,"H","N","2018-03-16","201803160ANA"
"DET",0,1,1,0,0,2,0,1,2,1,0,4,"A","N","2018-03-16","201803160ANA"
"CGY",0,1,2,1,0,4,0,1,4,2,0,7,"H","N","2018-03-16","201803160CGY"
"SJS",0,1,4,2,0,7,0,1,2,1,0,4,"A","N","2018-03-16","201803160CGY"
"COL",0,1,1,0,0,2,0,1,2,1,0,4,"H","N","2018-03-16","201803160COL"
"NSH",0,1,2,1,0,4,0,1,1,0,0,2,"A","N","2018-03-16","201803160COL"
"DAL",0,1,0,1,0,2,1,0,0,2,0,3,"A","N","2018-03-16","201803160OTT"
"OTT",1,0,0,2,0,3,0,1,0,1,0,2,"H","N","2018-03-16","201803160OTT"
"MIN",0,1,2,1,0,4,0,0,0,2,0,2,"A","N","2018-03-16","201803160VEG"
"VEG",0,0,0,2,0,2,0,1,2,1,0,4,"H","N","2018-03-16","201803160VEG"
"NYI",0,0,1,2,0,3,0,1,2,3,0,6,"A","N","2018-03-16","201803160WSH"
"WSH",0,1,2,3,0,6,0,0,1,2,0,3,"H","N","2018-03-16","201803160WSH"
"ARI",0,0,1,0,0,1,0,1,0,2,0,3,"H","N","2018-03-17","201803170ARI"
"MIN",0,1,0,2,0,3,0,0,1,0,0,1,"A","N","2018-03-17","201803170ARI"
"BUF",0,1,1,3,0,5,0,0,2,1,0,3,"H","N","2018-03-17","201803170BUF"
"CHI",0,0,2,1,0,3,0,1,1,3,0,5,"A","N","2018-03-17","201803170BUF"
"CAR",0,1,0,1,0,2,0,0,0,4,0,4,"H","N","2018-03-17","201803170CAR"
"PHI",0,0,0,4,0,4,0,1,0,1,0,2,"A","N","2018-03-17","201803170CAR"
"CBJ",0,1,1,0,0,2,0,1,0,0,0,1,"H","N","2018-03-17","201803170CBJ"
"OTT",0,1,0,0,0,1,0,1,1,0,0,2,"A","N","2018-03-17","201803170CBJ"
"EDM",0,0,1,3,0,4,0,0,2,0,0,2,"A","N","2018-03-17","201803170FLA"
"FLA",0,0,2,0,0,2,0,0,1,3,0,4,"H","N","2018-03-17","201803170FLA"
"LAK",0,0,0,0,0,0,0,2,0,1,0,3,"H","N","2018-03-17","201803170LAK"
"NJD",0,2,0,1,0,3,0,0,0,0,0,0,"A","N","2018-03-17","201803170LAK"
"NYR",0,0,3,0,0,3,1,1,1,1,0,4,"A","N","2018-03-17","201803170STL"
"STL",1,1,1,1,0,4,0,0,3,0,0,3,"H","N","2018-03-17","201803170STL"
"BOS",0,2,1,0,0,3,0,0,0,0,0,0,"A","N","2018-03-17","201803170TBL"
"TBL",0,0,0,0,0,0,0,2,1,0,0,3,"H","N","2018-03-17","201803170TBL"
"MTL",0,0,0,0,0,0,0,1,2,1,0,4,"A","N","2018-03-17","201803170TOR"
"TOR",0,1,2,1,0,4,0,0,0,0,0,0,"H","N","2018-03-17","201803170TOR"
"SJS",0,2,1,2,0,5,0,1,2,0,0,3,"A","N","2018-03-17","201803170VAN"
"VAN",0,1,2,0,0,3,0,2,1,2,0,5,"H","N","2018-03-17","201803170VAN"
"ANA",0,2,0,2,0,4,0,0,1,1,0,2,"H","N","2018-03-18","201803180ANA"
"NJD",0,0,1,1,0,2,0,2,0,2,0,4,"A","N","2018-03-18","201803180ANA"
"CHI",0,2,1,1,0,4,1,0,2,2,0,5,"H","N","2018-03-18","201803180CHI"
"STL",1,0,2,2,0,5,0,2,1,1,0,4,"A","N","2018-03-18","201803180CHI"
"COL",0,2,1,2,0,5,0,0,1,0,0,1,"H","N","2018-03-18","201803180COL"
"DET",0,0,1,0,0,1,0,2,1,2,0,5,"A","N","2018-03-18","201803180COL"
"CAR",0,2,1,1,0,4,0,0,2,1,0,3,"A","N","2018-03-18","201803180NYI"
"NYI",0,0,2,1,0,3,0,2,1,1,0,4,"H","N","2018-03-18","201803180NYI"
"PHI",0,0,3,3,0,6,0,0,1,2,0,3,"H","N","2018-03-18","201803180PHI"
"WSH",0,0,1,2,0,3,0,0,3,3,0,6,"A","N","2018-03-18","201803180PHI"
"EDM",0,1,0,0,0,1,0,1,1,1,0,3,"A","N","2018-03-18","201803180TBL"
"TBL",0,1,1,1,0,3,0,1,0,0,0,1,"H","N","2018-03-18","201803180TBL"
"CGY",0,0,0,0,0,0,0,0,4,0,0,4,"A","N","2018-03-18","201803180VEG"
"VEG",0,0,4,0,0,4,0,0,0,0,0,0,"H","N","2018-03-18","201803180VEG"
"DAL",0,0,2,0,0,2,0,1,2,1,0,4,"A","N","2018-03-18","201803180WPG"
"WPG",0,1,2,1,0,4,0,0,2,0,0,2,"H","N","2018-03-18","201803180WPG"
"ARI",0,0,2,3,0,5,0,0,2,0,0,2,"H","N","2018-03-19","201803190ARI"
"CGY",0,0,2,0,0,2,0,0,2,3,0,5,"A","N","2018-03-19","201803190ARI"
"BOS",0,0,3,1,0,4,1,1,1,2,0,5,"H","N","2018-03-19","201803190BOS"
"CBJ",1,1,1,2,0,5,0,0,3,1,0,4,"A","N","2018-03-19","201803190BOS"
"BUF",0,0,0,0,0,0,0,0,2,2,0,4,"H","N","2018-03-19","201803190BUF"
"NSH",0,0,2,2,0,4,0,0,0,0,0,0,"A","N","2018-03-19","201803190BUF"
"LAK",1,1,1,1,0,4,0,0,2,1,0,3,"A","N","2018-03-19","201803190MIN"
"MIN",0,0,2,1,0,3,1,1,1,1,0,4,"H","N","2018-03-19","201803190MIN"
"FLA",0,1,0,1,0,2,0,0,0,0,0,0,"A","N","2018-03-19","201803190MTL"
"MTL",0,0,0,0,0,0,0,1,0,1,0,2,"H","N","2018-03-19","201803190MTL"
"CAR",0,2,1,0,0,3,0,3,3,1,0,7,"H","N","2018-03-20","201803200CAR"
"EDM",0,3,3,1,0,7,0,2,1,0,0,3,"A","N","2018-03-20","201803200CAR"
"CHI",0,1,0,0,0,1,0,0,3,2,0,5,"H","N","2018-03-20","201803200CHI"
"COL",0,0,3,2,0,5,0,1,0,0,0,1,"A","N","2018-03-20","201803200CHI"
"DET",0,0,3,1,1,5,0,0,1,3,0,4,"H","Y","2018-03-20","201803200DET"
"PHI",0,0,1,3,0,4,0,0,3,1,1,5,"A","Y","2018-03-20","201803200DET"
"NYI",0,2,0,2,0,4,0,0,1,0,0,1,"H","N","2018-03-20","201803200NYI"
"PIT",0,0,1,0,0,1,0,2,0,2,0,4,"A","N","2018-03-20","201803200NYI"
"CBJ",0,1,1,3,0,5,0,0,1,2,0,3,"A","N","2018-03-20","201803200NYR"
"NYR",0,0,1,2,0,3,0,1,1,3,0,5,"H","N","2018-03-20","201803200NYR"
"FLA",0,2,4,1,0,7,0,1,1,0,0,2,"A","N","2018-03-20","201803200OTT"
"OTT",0,1,1,0,0,2,0,2,4,1,0,7,"H","N","2018-03-20","201803200OTT"
"NJD",0,1,0,1,0,2,0,3,3,0,0,6,"A","N","2018-03-20","201803200SJS"
"SJS",0,3,3,0,0,6,0,1,0,1,0,2,"H","N","2018-03-20","201803200SJS"
"TBL",0,0,1,3,0,4,0,1,2,0,0,3,"H","N","2018-03-20","201803200TBL"
"TOR",0,1,2,0,0,3,0,0,1,3,0,4,"A","N","2018-03-20","201803200TBL"
"VAN",0,0,0,1,0,1,0,3,1,0,0,4,"A","N","2018-03-20","201803200VEG"
"VEG",0,3,1,0,0,4,0,0,0,1,0,1,"H","N","2018-03-20","201803200VEG"
"LAK",0,0,1,0,0,1,1,0,1,0,0,2,"A","N","2018-03-20","201803200WPG"
"WPG",1,0,1,0,0,2,0,0,1,0,0,1,"H","N","2018-03-20","201803200WPG"
"DAL",0,1,2,0,0,3,0,0,3,1,0,4,"A","N","2018-03-20","201803200WSH"
"WSH",0,0,3,1,0,4,0,1,2,0,0,3,"H","N","2018-03-20","201803200WSH"
"ARI",0,2,0,2,0,4,0,1,0,0,0,1,"A","N","2018-03-21","201803210BUF"
"BUF",0,1,0,0,0,1,0,2,0,2,0,4,"H","N","2018-03-21","201803210BUF"
"ANA",0,1,2,1,0,4,0,0,0,0,0,0,"A","N","2018-03-21","201803210CGY"
"CGY",0,0,0,0,0,0,0,1,2,1,0,4,"H","N","2018-03-21","201803210CGY"
"MTL",0,1,2,0,0,3,0,2,1,2,0,5,"A","N","2018-03-21","201803210PIT"
"PIT",0,2,1,2,0,5,0,1,2,0,0,3,"H","N","2018-03-21","201803210PIT"
"BOS",0,1,0,0,0,1,1,0,0,1,0,2,"A","N","2018-03-21","201803210STL"
"STL",1,0,0,1,0,2,0,1,0,0,0,1,"H","N","2018-03-21","201803210STL"
"ARI",0,2,3,0,0,5,0,2,2,2,0,6,"A","N","2018-03-22","201803220CAR"
"CAR",0,2,2,2,0,6,0,2,3,0,0,5,"H","N","2018-03-22","201803220CAR"
"CBJ",0,0,3,1,0,4,0,0,0,0,0,0,"H","N","2018-03-22","201803220CBJ"
"FLA",0,0,0,0,0,0,0,0,3,1,0,4,"A","N","2018-03-22","201803220CBJ"
"CHI",0,1,0,1,0,2,0,2,2,1,0,5,"H","N","2018-03-22","201803220CHI"
"VAN",0,2,2,1,0,5,0,1,0,1,0,2,"A","N","2018-03-22","201803220CHI"
"COL",0,1,0,0,0,1,0,3,2,2,0,7,"H","N","2018-03-22","201803220COL"
"LAK",0,3,2,2,0,7,0,1,0,0,0,1,"A","N","2018-03-22","201803220COL"
"DET",0,0,0,0,0,0,0,0,0,1,0,1,"H","N","2018-03-22","201803220DET"
"WSH",0,0,0,1,0,1,0,0,0,0,0,0,"A","N","2018-03-22","201803220DET"
"NSH",0,0,1,1,0,2,0,1,2,2,0,5,"H","N","2018-03-22","201803220NSH"
"TOR",0,1,2,2,0,5,0,0,1,1,0,2,"A","N","2018-03-22","201803220NSH"
"NYI",0,1,2,3,0,6,0,3,4,0,0,7,"H","N","2018-03-22","201803220NYI"
"TBL",0,3,4,0,0,7,0,1,2,3,0,6,"A","N","2018-03-22","201803220NYI"
"EDM",0,1,1,4,0,6,0,0,0,2,0,2,"A","N","2018-03-22","201803220OTT"
"OTT",0,0,0,2,0,2,0,1,1,4,0,6,"H","N","2018-03-22","201803220OTT"
"NYR",0,1,1,1,0,3,0,1,2,1,0,4,"A","N","2018-03-22","201803220PHI"
"PHI",0,1,2,1,0,4,0,1,1,1,0,3,"H","N","2018-03-22","201803220PHI"
"SJS",1,0,1,0,0,2,0,1,0,0,0,1,"H","N","2018-03-22","201803220SJS"
"VEG",0,1,0,0,0,1,1,0,1,0,0,2,"A","N","2018-03-22","201803220SJS"
"BUF",0,0,0,0,0,0,0,0,1,2,0,3,"H","N","2018-03-23","201803230BUF"
"MTL",0,0,1,2,0,3,0,0,0,0,0,0,"A","N","2018-03-23","201803230BUF"
"BOS",0,0,0,3,0,3,0,1,1,0,0,2,"A","N","2018-03-23","201803230DAL"
"DAL",0,1,1,0,0,2,0,0,0,3,0,3,"H","N","2018-03-23","201803230DAL"
"NJD",1,0,3,0,0,4,0,1,0,2,0,3,"A","N","2018-03-23","201803230PIT"
"PIT",0,1,0,2,0,3,1,0,3,0,0,4,"H","N","2018-03-23","201803230PIT"
"STL",0,1,1,2,0,4,0,0,1,0,0,1,"H","N","2018-03-23","201803230STL"
"VAN",0,0,1,0,0,1,0,1,1,2,0,4,"A","N","2018-03-23","201803230STL"
"ANA",0,1,0,1,0,2,1,1,1,0,0,3,"A","N","2018-03-23","201803230WPG"
"WPG",1,1,1,0,0,3,0,1,0,1,0,2,"H","N","2018-03-23","201803230WPG"
"CBJ",0,0,1,0,0,1,0,1,1,0,0,2,"H","N","2018-03-24","201803240CBJ"
"STL",0,1,1,0,0,2,0,0,1,0,0,1,"A","N","2018-03-24","201803240CBJ"
"COL",0,1,0,0,1,2,0,0,0,1,0,1,"H","Y","2018-03-24","201803240COL"
"VEG",0,0,0,1,0,1,0,1,0,0,1,2,"A","Y","2018-03-24","201803240COL"
"EDM",0,2,1,0,0,3,0,1,1,0,0,2,"H","N","2018-03-24","201803240EDM"
"LAK",0,1,1,0,0,2,0,2,1,0,0,3,"A","N","2018-03-24","201803240EDM"
"ARI",0,1,1,0,0,2,0,0,0,4,0,4,"A","N","2018-03-24","201803240FLA"
"FLA",0,0,0,4,0,4,0,1,1,0,0,2,"H","N","2018-03-24","201803240FLA"
"MIN",0,0,2,2,0,4,0,1,0,0,0,1,"H","N","2018-03-24","201803240MIN"
"NSH",0,1,0,0,0,1,0,0,2,2,0,4,"A","N","2018-03-24","201803240MIN"
"MTL",0,1,1,2,0,4,0,3,1,2,0,6,"H","N","2018-03-24","201803240MTL"
"WSH",0,3,1,2,0,6,0,1,1,2,0,4,"A","N","2018-03-24","201803240MTL"
"NJD",0,1,1,0,0,2,0,0,0,1,0,1,"H","N","2018-03-24","201803240NJD"
"TBL",0,0,0,1,0,1,0,1,1,0,0,2,"A","N","2018-03-24","201803240NJD"
"CHI",0,0,2,1,0,3,0,0,0,1,0,1,"A","N","2018-03-24","201803240NYI"
"NYI",0,0,0,1,0,1,0,0,2,1,0,3,"H","N","2018-03-24","201803240NYI"
"BUF",0,0,0,1,0,1,0,2,3,0,0,5,"A","N","2018-03-24","201803240NYR"
"NYR",0,2,3,0,0,5,0,0,0,1,0,1,"H","N","2018-03-24","201803240NYR"
"CAR",0,1,1,3,0,5,0,1,0,1,0,2,"A","N","2018-03-24","201803240OTT"
"OTT",0,1,0,1,0,2,0,1,1,3,0,5,"H","N","2018-03-24","201803240OTT"
"CGY",0,1,0,0,0,1,0,2,1,2,0,5,"A","N","2018-03-24","201803240SJS"
"SJS",0,2,1,2,0,5,0,1,0,0,0,1,"H","N","2018-03-24","201803240SJS"
"DET",0,0,2,1,0,3,0,1,1,2,0,4,"A","N","2018-03-24","201803240TOR"
"TOR",0,1,1,2,0,4,0,0,2,1,0,3,"H","N","2018-03-24","201803240TOR"
"DAL",0,1,0,0,0,1,0,1,1,2,0,4,"H","N","2018-03-25","201803250DAL"
"VAN",0,1,1,2,0,4,0,1,0,0,0,1,"A","N","2018-03-25","201803250DAL"
"ANA",1,0,1,3,0,5,0,0,3,1,0,4,"A","N","2018-03-25","201803250EDM"
"EDM",0,0,3,1,0,4,1,0,1,3,0,5,"H","N","2018-03-25","201803250EDM"
"BOS",1,0,1,0,0,2,0,0,0,1,0,1,"A","N","2018-03-25","201803250MIN"
"MIN",0,0,0,1,0,1,1,0,1,0,0,2,"H","N","2018-03-25","201803250MIN"
"PHI",0,2,1,1,0,4,1,1,2,1,0,5,"A","N","2018-03-25","201803250PIT"
"PIT",1,1,2,1,0,5,0,2,1,1,0,4,"H","N","2018-03-25","201803250PIT"
"NSH",0,2,2,0,0,4,0,0,3,1,1,5,"A","Y","2018-03-25","201803250WPG"
"WPG",0,0,3,1,1,5,0,2,2,0,0,4,"H","Y","2018-03-25","201803250WPG"
"CAR",0,1,2,1,0,4,0,0,1,0,0,1,"H","N","2018-03-26","201803260CAR"
"OTT",0,0,1,0,0,1,0,1,2,1,0,4,"A","N","2018-03-26","201803260CAR"
"CHI",0,2,0,1,0,3,0,1,1,1,1,4,"H","Y","2018-03-26","201803260CHI"
"SJS",0,1,1,1,1,4,0,2,0,1,0,3,"A","Y","2018-03-26","201803260CHI"
"CGY",0,0,0,0,0,0,0,0,2,1,0,3,"A","N","2018-03-26","201803260LAK"
"LAK",0,0,2,1,0,3,0,0,0,0,0,0,"H","N","2018-03-26","201803260LAK"
"DET",0,1,1,0,0,2,0,1,2,1,0,4,"A","N","2018-03-26","201803260MTL"
"MTL",0,1,2,1,0,4,0,1,1,0,0,2,"H","N","2018-03-26","201803260MTL"
"FLA",0,1,2,0,0,3,0,0,0,0,0,0,"A","N","2018-03-26","201803260NYI"
"NYI",0,0,0,0,0,0,0,1,2,0,0,3,"H","N","2018-03-26","201803260NYI"
"NYR",0,0,1,1,0,2,0,4,0,0,0,4,"H","N","2018-03-26","201803260NYR"
"WSH",0,4,0,0,0,4,0,0,1,1,0,2,"A","N","2018-03-26","201803260NYR"
"ARI",0,0,2,2,0,4,0,0,0,1,0,1,"A","N","2018-03-26","201803260TBL"
"TBL",0,0,0,1,0,1,0,0,2,2,0,4,"H","N","2018-03-26","201803260TBL"
"BUF",0,1,0,2,0,3,0,0,2,0,0,2,"A","N","2018-03-26","201803260TOR"
"TOR",0,0,2,0,0,2,0,1,0,2,0,3,"H","N","2018-03-26","201803260TOR"
"COL",0,0,1,0,0,1,0,0,2,2,0,4,"A","N","2018-03-26","201803260VEG"
"VEG",0,0,2,2,0,4,0,0,1,0,0,1,"H","N","2018-03-26","201803260VEG"
"DAL",1,1,1,0,0,3,0,1,1,0,0,2,"H","N","2018-03-27","201803270DAL"
"PHI",0,1,1,0,0,2,1,1,1,0,0,3,"A","N","2018-03-27","201803270DAL"
"DET",0,1,2,2,0,5,0,1,0,1,0,2,"H","N","2018-03-27","201803270DET"
"PIT",0,1,0,1,0,2,0,1,2,2,0,5,"A","N","2018-03-27","201803270DET"
"CBJ",0,3,3,1,0,7,0,3,0,0,0,3,"A","N","2018-03-27","201803270EDM"
"EDM",0,3,0,0,0,3,0,3,3,1,0,7,"H","N","2018-03-27","201803270EDM"
"CAR",0,2,0,1,0,3,0,1,1,2,0,4,"A","N","2018-03-27","201803270NJD"
"NJD",0,1,1,2,0,4,0,2,0,1,0,3,"H","N","2018-03-27","201803270NJD"
"MIN",0,0,0,1,0,1,0,1,0,0,1,2,"A","Y","2018-03-27","201803270NSH"
"NSH",0,1,0,0,1,2,0,0,0,1,0,1,"H","Y","2018-03-27","201803270NSH"
"NYI",0,1,2,1,0,4,0,2,0,1,0,3,"A","N","2018-03-27","201803270OTT"
"OTT",0,2,0,1,0,3,0,1,2,1,0,4,"H","N","2018-03-27","201803270OTT"
"SJS",0,1,1,0,0,2,1,1,1,0,0,3,"A","N","2018-03-27","201803270STL"
"STL",1,1,1,0,0,3,0,1,1,0,0,2,"H","N","2018-03-27","201803270STL"
"ANA",0,0,1,0,0,1,0,1,0,3,0,4,"A","N","2018-03-27","201803270VAN"
"VAN",0,1,0,3,0,4,0,0,1,0,0,1,"H","N","2018-03-27","201803270VAN"
"BOS",0,1,0,3,0,4,0,1,2,1,1,5,"A","Y","2018-03-27","201803270WPG"
"WPG",0,1,2,1,1,5,0,1,0,3,0,4,"H","Y","2018-03-27","201803270WPG"
"COL",0,0,1,0,0,1,0,2,0,0,0,2,"H","N","2018-03-28","201803280COL"
"PHI",0,2,0,0,0,2,0,0,1,0,0,1,"A","N","2018-03-28","201803280COL"
"FLA",0,1,1,1,0,3,0,3,0,1,0,4,"A","N","2018-03-28","201803280TOR"
"TOR",0,3,0,1,0,4,0,1,1,1,0,3,"H","N","2018-03-28","201803280TOR"
"ARI",0,2,1,0,0,3,0,1,1,0,0,2,"A","N","2018-03-28","201803280VEG"
"VEG",0,1,1,0,0,2,0,2,1,0,0,3,"H","N","2018-03-28","201803280VEG"
"NYR",0,1,0,1,0,2,1,1,0,1,0,3,"A","N","2018-03-28","201803280WSH"
"WSH",1,1,0,1,0,3,0,1,0,1,0,2,"H","N","2018-03-28","201803280WSH"
"BOS",0,2,0,2,0,4,0,0,1,1,0,2,"H","N","2018-03-29","201803290BOS"
"TBL",0,0,1,1,0,2,0,2,0,2,0,4,"A","N","2018-03-29","201803290BOS"
"BUF",0,2,0,1,0,3,0,1,2,3,0,6,"H","N","2018-03-29","201803290BUF"
"DET",0,1,2,3,0,6,0,2,0,1,0,3,"A","N","2018-03-29","201803290BUF"
"CBJ",0,2,1,2,0,5,0,0,0,1,0,1,"A","N","2018-03-29","201803290CGY"
"CGY",0,0,0,1,0,1,0,2,1,2,0,5,"H","N","2018-03-29","201803290CGY"
"CHI",0,2,3,1,0,6,0,0,2,0,0,2,"H","N","2018-03-29","201803290CHI"
"WPG",0,0,2,0,0,2,0,2,3,1,0,6,"A","N","2018-03-29","201803290CHI"
"ARI",0,1,1,0,0,2,0,1,1,2,0,4,"A","N","2018-03-29","201803290LAK"
"LAK",0,1,1,2,0,4,0,1,1,0,0,2,"H","N","2018-03-29","201803290LAK"
"DAL",0,1,1,0,0,2,0,1,3,1,0,5,"A","N","2018-03-29","201803290MIN"
"MIN",0,1,3,1,0,5,0,1,1,0,0,2,"H","N","2018-03-29","201803290MIN"
"NJD",0,1,1,1,0,3,1,1,1,1,0,4,"H","N","2018-03-29","201803290NJD"
"PIT",1,1,1,1,0,4,0,1,1,1,0,3,"A","N","2018-03-29","201803290NJD"
"NSH",0,2,1,2,0,5,0,2,0,1,0,3,"H","N","2018-03-29","201803290NSH"
"SJS",0,2,0,1,0,3,0,2,1,2,0,5,"A","N","2018-03-29","201803290NSH"
"FLA",0,0,2,0,0,2,1,0,1,1,0,3,"A","N","2018-03-29","201803290OTT"
"OTT",1,0,1,1,0,3,0,0,2,0,0,2,"H","N","2018-03-29","201803290OTT"
"EDM",0,1,0,0,0,1,0,0,1,1,0,2,"A","N","2018-03-29","201803290VAN"
"VAN",0,0,1,1,0,2,0,1,0,0,0,1,"H","N","2018-03-29","201803290VAN"
"ANA",1,0,1,0,0,2,0,1,0,0,0,1,"H","N","2018-03-30","201803300ANA"
"LAK",0,1,0,0,0,1,1,0,1,0,0,2,"A","N","2018-03-30","201803300ANA"
"CHI",0,0,0,0,0,0,0,1,1,3,0,5,"A","N","2018-03-30","201803300COL"
"COL",0,1,1,3,0,5,0,0,0,0,0,0,"H","N","2018-03-30","201803300COL"
"NYI",0,2,1,1,0,4,0,1,2,2,0,5,"H","N","2018-03-30","201803300NYI"
"TOR",0,1,2,2,0,5,0,2,1,1,0,4,"A","N","2018-03-30","201803300NYI"
"NYR",0,1,0,2,0,3,0,0,2,5,0,7,"H","N","2018-03-30","201803300NYR"
"TBL",0,0,2,5,0,7,0,1,0,2,0,3,"A","N","2018-03-30","201803300NYR"
"STL",0,2,0,1,0,3,1,2,1,0,0,4,"A","N","2018-03-30","201803300VEG"
"VEG",1,2,1,0,0,4,0,2,0,1,0,3,"H","N","2018-03-30","201803300VEG"
"CAR",0,0,2,2,0,4,0,0,1,0,0,1,"A","N","2018-03-30","201803300WSH"
"WSH",0,0,1,0,0,1,0,0,2,2,0,4,"H","N","2018-03-30","201803300WSH"
"ARI",0,1,3,2,0,6,0,0,0,0,0,0,"H","N","2018-03-31","201803310ARI"
"STL",0,0,0,0,0,0,0,1,3,2,0,6,"A","N","2018-03-31","201803310ARI"
"BOS",0,2,3,0,0,5,0,1,0,0,0,1,"H","N","2018-03-31","201803310BOS"
"FLA",0,1,0,0,0,1,0,2,3,0,0,5,"A","N","2018-03-31","201803310BOS"
"CAR",0,0,0,1,0,1,0,0,2,0,0,2,"H","N","2018-03-31","201803310CAR"
"NYR",0,0,2,0,0,2,0,0,0,1,0,1,"A","N","2018-03-31","201803310CAR"
"CGY",0,3,0,0,0,3,0,1,1,0,0,2,"H","N","2018-03-31","201803310CGY"
"EDM",0,1,1,0,0,2,0,3,0,0,0,3,"A","N","2018-03-31","201803310CGY"
"DAL",0,1,1,2,0,4,0,0,0,1,0,1,"H","N","2018-03-31","201803310DAL"
"MIN",0,0,0,1,0,1,0,1,1,2,0,4,"A","N","2018-03-31","201803310DAL"
"DET",0,0,1,1,0,2,0,0,0,0,0,0,"H","N","2018-03-31","201803310DET"
"OTT",0,0,0,0,0,0,0,0,1,1,0,2,"A","N","2018-03-31","201803310DET"
"NJD",0,1,3,0,0,4,0,1,1,1,0,3,"H","N","2018-03-31","201803310NJD"
"NYI",0,1,1,1,0,3,0,1,3,0,0,4,"A","N","2018-03-31","201803310NJD"
"BUF",0,1,5,1,0,7,0,2,2,0,0,4,"A","N","2018-03-31","201803310NSH"
"NSH",0,2,2,0,0,4,0,1,5,1,0,7,"H","N","2018-03-31","201803310NSH"
"MTL",0,2,0,0,0,2,0,3,0,2,0,5,"A","N","2018-03-31","201803310PIT"
"PIT",0,3,0,2,0,5,0,2,0,0,0,2,"H","N","2018-03-31","201803310PIT"
"TOR",0,0,1,0,0,1,0,0,3,0,0,3,"H","N","2018-03-31","201803310TOR"
"WPG",0,0,3,0,0,3,0,0,1,0,0,1,"A","N","2018-03-31","201803310TOR"
"CBJ",0,1,0,3,0,4,1,0,2,2,0,5,"A","N","2018-03-31","201803310VAN"
"VAN",1,0,2,2,0,5,0,1,0,3,0,4,"H","N","2018-03-31","201803310VAN"
"SJS",0,1,1,0,0,2,0,1,1,1,0,3,"A","N","2018-03-31","201803310VEG"
"VEG",0,1,1,1,0,3,0,1,1,0,0,2,"H","N","2018-03-31","201803310VEG"
"ANA",1,1,0,2,0,4,0,1,2,0,0,3,"H","N","2018-04-01","201804010ANA"
"COL",0,1,2,0,0,3,1,1,0,2,0,4,"A","N","2018-04-01","201804010ANA"
"MTL",0,1,0,0,0,1,0,0,0,2,0,2,"H","N","2018-04-01","201804010MTL"
"NJD",0,0,0,2,0,2,0,1,0,0,0,1,"A","N","2018-04-01","201804010MTL"
"BOS",0,0,1,2,0,3,1,1,1,1,0,4,"A","N","2018-04-01","201804010PHI"
"PHI",1,1,1,1,0,4,0,0,1,2,0,3,"H","N","2018-04-01","201804010PHI"
"PIT",0,0,0,1,0,1,0,1,1,1,0,3,"H","N","2018-04-01","201804010PIT"
"WSH",0,1,1,1,0,3,0,0,0,1,0,1,"A","N","2018-04-01","201804010PIT"
"NSH",0,1,1,2,0,4,0,0,1,0,0,1,"A","N","2018-04-01","201804010TBL"
"TBL",0,0,1,0,0,1,0,1,1,2,0,4,"H","N","2018-04-01","201804010TBL"
"CAR",0,1,1,0,0,2,0,2,0,1,0,3,"A","N","2018-04-02","201804020FLA"
"FLA",0,2,0,1,0,3,0,1,1,0,0,2,"H","N","2018-04-02","201804020FLA"
"COL",0,0,1,0,0,1,0,2,0,1,0,3,"A","N","2018-04-02","201804020LAK"
"LAK",0,2,0,1,0,3,0,0,1,0,0,1,"H","N","2018-04-02","201804020LAK"
"EDM",0,0,0,0,0,0,0,1,1,1,0,3,"A","N","2018-04-02","201804020MIN"
"MIN",0,1,1,1,0,3,0,0,0,0,0,0,"H","N","2018-04-02","201804020MIN"
"OTT",0,1,2,2,0,5,0,3,2,1,0,6,"H","N","2018-04-02","201804020OTT"
"WPG",0,3,2,1,0,6,0,1,2,2,0,5,"A","N","2018-04-02","201804020OTT"
"STL",0,1,1,0,0,2,0,0,3,1,0,4,"H","N","2018-04-02","201804020STL"
"WSH",0,0,3,1,0,4,0,1,1,0,0,2,"A","N","2018-04-02","201804020STL"
"BUF",0,0,1,1,0,2,0,1,3,1,0,5,"A","N","2018-04-02","201804020TOR"
"TOR",0,1,3,1,0,5,0,0,1,1,0,2,"H","N","2018-04-02","201804020TOR"
"CBJ",1,1,1,2,0,5,0,3,1,0,0,4,"H","N","2018-04-03","201804030CBJ"
"DET",0,3,1,0,0,4,1,1,1,2,0,5,"A","N","2018-04-03","201804030CBJ"
"ARI",0,2,1,1,0,4,0,0,1,0,0,1,"A","N","2018-04-03","201804030CGY"
"CGY",0,0,1,0,0,1,0,2,1,1,0,4,"H","N","2018-04-03","201804030CGY"
"FLA",0,1,0,1,0,2,0,0,0,1,0,1,"H","N","2018-04-03","201804030FLA"
"NSH",0,0,0,1,0,1,0,1,0,1,0,2,"A","N","2018-04-03","201804030FLA"
"MTL",0,0,1,3,0,4,1,2,1,1,0,5,"H","N","2018-04-03","201804030MTL"
"WPG",1,2,1,1,0,5,0,0,1,3,0,4,"A","N","2018-04-03","201804030MTL"
"NJD",0,3,2,0,0,5,0,1,0,1,0,2,"H","N","2018-04-03","201804030NJD"
"NYR",0,1,0,1,0,2,0,3,2,0,0,5,"A","N","2018-04-03","201804030NJD"
"NYI",0,1,3,1,0,5,0,1,0,3,0,4,"H","N","2018-04-03","201804030NYI"
"PHI",0,1,0,3,0,4,0,1,3,1,0,5,"A","N","2018-04-03","201804030NYI"
"DAL",0,0,1,3,0,4,0,2,0,0,0,2,"A","N","2018-04-03","201804030SJS"
"SJS",0,2,0,0,0,2,0,0,1,3,0,4,"H","N","2018-04-03","201804030SJS"
"BOS",0,0,0,0,0,0,0,0,3,1,0,4,"A","N","2018-04-03","201804030TBL"
"TBL",0,0,3,1,0,4,0,0,0,0,0,0,"H","N","2018-04-03","201804030TBL"
"VAN",0,1,0,3,0,4,0,1,2,1,1,5,"H","Y","2018-04-03","201804030VAN"
"VEG",0,1,2,1,1,5,0,1,0,3,0,4,"A","Y","2018-04-03","201804030VAN"
"ANA",0,0,1,2,0,3,0,0,1,0,0,1,"H","N","2018-04-04","201804040ANA"
"MIN",0,0,1,0,0,1,0,0,1,2,0,3,"A","N","2018-04-04","201804040ANA"
"BUF",0,1,1,0,0,2,0,2,1,1,0,4,"H","N","2018-04-04","201804040BUF"
"OTT",0,2,1,1,0,4,0,1,1,0,0,2,"A","N","2018-04-04","201804040BUF"
"CHI",0,1,1,2,0,4,0,1,2,0,0,3,"A","N","2018-04-04","201804040STL"
"STL",0,1,2,0,0,3,0,1,1,2,0,4,"H","N","2018-04-04","201804040STL"
"CBJ",0,2,1,1,0,4,1,2,0,2,0,5,"H","N","2018-04-05","201804050CBJ"
"PIT",1,2,0,2,0,5,0,2,1,1,0,4,"A","N","2018-04-05","201804050CBJ"
"DET",0,1,1,1,0,3,0,1,2,1,0,4,"H","N","2018-04-05","201804050DET"
"MTL",0,1,2,1,0,4,0,1,1,1,0,3,"A","N","2018-04-05","201804050DET"
"EDM",0,1,0,3,0,4,0,0,2,1,0,3,"H","N","2018-04-05","201804050EDM"
"VEG",0,0,2,1,0,3,0,1,0,3,0,4,"A","N","2018-04-05","201804050EDM"
"BOS",0,1,1,0,0,2,0,2,0,1,0,3,"A","N","2018-04-05","201804050FLA"
"FLA",0,2,0,1,0,3,0,1,1,0,0,2,"H","N","2018-04-05","201804050FLA"
"LAK",1,1,3,0,0,5,0,2,0,2,0,4,"H","N","2018-04-05","201804050LAK"
"MIN",0,2,0,2,0,4,1,1,3,0,0,5,"A","N","2018-04-05","201804050LAK"
"NJD",0,0,2,0,0,2,0,1,0,0,0,1,"H","N","2018-04-05","201804050NJD"
"TOR",0,1,0,0,0,1,0,0,2,0,0,2,"A","N","2018-04-05","201804050NJD"
"NYI",0,0,2,0,0,2,0,1,0,0,0,1,"H","N","2018-04-05","201804050NYI"
"NYR",0,1,0,0,0,1,0,0,2,0,0,2,"A","N","2018-04-05","201804050NYI"
"CAR",0,2,0,1,0,3,0,1,1,2,0,4,"A","N","2018-04-05","201804050PHI"
"PHI",0,1,1,2,0,4,0,2,0,1,0,3,"H","N","2018-04-05","201804050PHI"
"COL",0,0,0,2,0,2,0,1,0,3,0,4,"A","N","2018-04-05","201804050SJS"
"SJS",0,1,0,3,0,4,0,0,0,2,0,2,"H","N","2018-04-05","201804050SJS"
"ARI",0,1,2,0,0,3,1,0,1,2,0,4,"A","N","2018-04-05","201804050VAN"
"VAN",1,0,1,2,0,4,0,1,2,0,0,3,"H","N","2018-04-05","201804050VAN"
"CGY",0,0,1,0,0,1,0,1,1,0,0,2,"A","N","2018-04-05","201804050WPG"
"WPG",0,1,1,0,0,2,0,0,1,0,0,1,"H","N","2018-04-05","201804050WPG"
"NSH",0,1,1,2,0,4,0,0,2,1,0,3,"A","N","2018-04-05","201804050WSH"
"WSH",0,0,2,1,0,3,0,1,1,2,0,4,"H","N","2018-04-05","201804050WSH"
"ANA",0,3,1,1,0,5,0,1,1,1,0,3,"H","N","2018-04-06","201804060ANA"
"DAL",0,1,1,1,0,3,0,3,1,1,0,5,"A","N","2018-04-06","201804060ANA"
"CHI",0,0,0,1,0,1,0,1,0,3,0,4,"H","N","2018-04-06","201804060CHI"
"STL",0,1,0,3,0,4,0,0,0,1,0,1,"A","N","2018-04-06","201804060CHI"
"OTT",0,0,0,0,0,0,0,0,2,2,0,4,"A","N","2018-04-06","201804060PIT"
"PIT",0,0,2,2,0,4,0,0,0,0,0,0,"H","N","2018-04-06","201804060PIT"
"BUF",0,2,3,0,0,5,0,3,1,3,0,7,"A","N","2018-04-06","201804060TBL"
"TBL",0,3,1,3,0,7,0,2,3,0,0,5,"H","N","2018-04-06","201804060TBL"
"ANA",0,1,1,1,0,3,0,0,0,0,0,0,"A","N","2018-04-07","201804070ARI"
"ARI",0,0,0,0,0,0,0,1,1,1,0,3,"H","N","2018-04-07","201804070ARI"
"BOS",0,0,3,2,0,5,0,1,0,1,0,2,"H","N","2018-04-07","201804070BOS"
"OTT",0,1,0,1,0,2,0,0,3,2,0,5,"A","N","2018-04-07","201804070BOS"
"CAR",1,2,0,0,0,3,0,0,1,1,0,2,"H","N","2018-04-07","201804070CAR"
"TBL",0,0,1,1,0,2,1,2,0,0,0,3,"A","N","2018-04-07","201804070CAR"
"CGY",0,3,3,1,0,7,0,0,1,0,0,1,"H","N","2018-04-07","201804070CGY"
"VEG",0,0,1,0,0,1,0,3,3,1,0,7,"A","N","2018-04-07","201804070CGY"
"COL",0,1,2,2,0,5,0,0,1,1,0,2,"H","N","2018-04-07","201804070COL"
"STL",0,0,1,1,0,2,0,1,2,2,0,5,"A","N","2018-04-07","201804070COL"
"DET",0,1,1,1,0,3,1,0,1,2,0,4,"H","N","2018-04-07","201804070DET"
"NYI",1,0,1,2,0,4,0,1,1,1,0,3,"A","N","2018-04-07","201804070DET"
"EDM",0,1,1,0,1,3,0,1,1,0,0,2,"H","Y","2018-04-07","201804070EDM"
"VAN",0,1,1,0,0,2,0,1,1,0,1,3,"A","Y","2018-04-07","201804070EDM"
"BUF",0,0,0,3,0,3,0,3,0,1,0,4,"A","N","2018-04-07","201804070FLA"
"FLA",0,3,0,1,0,4,0,0,0,3,0,3,"H","N","2018-04-07","201804070FLA"
"DAL",0,4,0,0,0,4,0,0,2,0,0,2,"A","N","2018-04-07","201804070LAK"
"LAK",0,0,2,0,0,2,0,4,0,0,0,4,"H","N","2018-04-07","201804070LAK"
"CBJ",0,0,1,1,0,2,0,3,0,1,0,4,"A","N","2018-04-07","201804070NSH"
"NSH",0,3,0,1,0,4,0,0,1,1,0,2,"H","N","2018-04-07","201804070NSH"
"NYR",0,0,0,0,0,0,0,1,3,1,0,5,"A","N","2018-04-07","201804070PHI"
"PHI",0,1,3,1,0,5,0,0,0,0,0,0,"H","N","2018-04-07","201804070PHI"
"MIN",0,2,3,1,0,6,0,2,0,1,0,3,"A","N","2018-04-07","201804070SJS"
"SJS",0,2,0,1,0,3,0,2,3,1,0,6,"H","N","2018-04-07","201804070SJS"
"MTL",0,0,1,1,0,2,0,1,0,3,0,4,"A","N","2018-04-07","201804070TOR"
"TOR",0,1,0,3,0,4,0,0,1,1,0,2,"H","N","2018-04-07","201804070TOR"
"CHI",0,0,1,0,0,1,0,1,3,0,0,4,"A","N","2018-04-07","201804070WPG"
"WPG",0,1,3,0,0,4,0,0,1,0,0,1,"H","N","2018-04-07","201804070WPG"
"NJD",0,1,1,1,0,3,0,2,1,2,0,5,"A","N","2018-04-07","201804070WSH"
"WSH",0,2,1,2,0,5,0,1,1,1,0,3,"H","N","2018-04-07","201804070WSH"
"BOS",0,1,0,1,0,2,0,2,1,1,0,4,"H","N","2018-04-08","201804080BOS"
"FLA",0,2,1,1,0,4,0,1,0,1,0,2,"A","N","2018-04-08","201804080BOS"
"PHI",0,0,0,0,0,0,0,3,2,2,0,7,"A","N","2018-04-11","201804110PIT"
"PIT",0,3,2,2,0,7,0,0,0,0,0,0,"H","N","2018-04-11","201804110PIT"
"LAK",0,0,0,0,0,0,0,1,0,0,0,1,"A","N","2018-04-11","201804110VEG"
"VEG",0,1,0,0,0,1,0,0,0,0,0,0,"H","N","2018-04-11","201804110VEG"
"MIN",0,0,0,2,0,2,0,0,1,2,0,3,"A","N","2018-04-11","201804110WPG"
"WPG",0,0,1,2,0,3,0,0,0,2,0,2,"H","N","2018-04-11","201804110WPG"
"ANA",0,0,0,0,0,0,0,0,3,0,0,3,"H","N","2018-04-12","201804120ANA"
"SJS",0,0,3,0,0,3,0,0,0,0,0,0,"A","N","2018-04-12","201804120ANA"
"BOS",0,1,2,2,0,5,0,1,0,0,0,1,"H","N","2018-04-12","201804120BOS"
"TOR",0,1,0,0,0,1,0,1,2,2,0,5,"A","N","2018-04-12","201804120BOS"
"COL",0,1,1,0,0,2,0,0,2,3,0,5,"A","N","2018-04-12","201804120NSH"
"NSH",0,0,2,3,0,5,0,1,1,0,0,2,"H","N","2018-04-12","201804120NSH"
"NJD",0,0,1,1,0,2,0,2,1,2,0,5,"A","N","2018-04-12","201804120TBL"
"TBL",0,2,1,2,0,5,0,0,1,1,0,2,"H","N","2018-04-12","201804120TBL"
"CBJ",1,0,1,2,0,4,0,2,0,1,0,3,"A","N","2018-04-12","201804120WSH"
"WSH",0,2,0,1,0,3,1,0,1,2,0,4,"H","N","2018-04-12","201804120WSH"
"PHI",0,1,1,3,0,5,0,0,0,1,0,1,"A","N","2018-04-13","201804130PIT"
"PIT",0,0,0,1,0,1,0,1,1,3,0,5,"H","N","2018-04-13","201804130PIT"
"LAK",0,0,1,0,0,1,1,1,0,0,0,2,"A","N","2018-04-13","201804130VEG"
"VEG",1,1,0,0,0,2,0,0,1,0,0,1,"H","N","2018-04-13","201804130VEG"
"MIN",0,0,0,1,0,1,0,0,1,3,0,4,"A","N","2018-04-13","201804130WPG"
"WPG",0,0,1,3,0,4,0,0,0,1,0,1,"H","N","2018-04-13","201804130WPG"
"ANA",0,1,1,0,0,2,0,2,1,0,0,3,"H","N","2018-04-14","201804140ANA"
"SJS",0,2,1,0,0,3,0,1,1,0,0,2,"A","N","2018-04-14","201804140ANA"
"BOS",0,4,1,2,0,7,0,0,2,1,0,3,"H","N","2018-04-14","201804140BOS"
"TOR",0,0,2,1,0,3,0,4,1,2,0,7,"A","N","2018-04-14","201804140BOS"
"COL",0,1,1,2,0,4,0,0,3,2,0,5,"A","N","2018-04-14","201804140NSH"
"NSH",0,0,3,2,0,5,0,1,1,2,0,4,"H","N","2018-04-14","201804140NSH"
"NJD",0,1,1,1,0,3,0,1,4,0,0,5,"A","N","2018-04-14","201804140TBL"
"TBL",0,1,4,0,0,5,0,1,1,1,0,3,"H","N","2018-04-14","201804140TBL"
"LAK",0,1,0,1,0,2,0,0,0,3,0,3,"H","N","2018-04-15","201804150LAK"
"VEG",0,0,0,3,0,3,0,1,0,1,0,2,"A","N","2018-04-15","201804150LAK"
"MIN",0,2,4,0,0,6,0,1,1,0,0,2,"H","N","2018-04-15","201804150MIN"
"WPG",0,1,1,0,0,2,0,2,4,0,0,6,"A","N","2018-04-15","201804150MIN"
"PHI",0,0,1,0,0,1,0,1,3,1,0,5,"H","N","2018-04-15","201804150PHI"
"PIT",0,1,3,1,0,5,0,0,1,0,0,1,"A","N","2018-04-15","201804150PHI"
"CBJ",1,1,3,0,0,5,0,2,1,1,0,4,"A","N","2018-04-15","201804150WSH"
"WSH",0,2,1,1,0,4,1,1,3,0,0,5,"H","N","2018-04-15","201804150WSH"
"COL",0,3,1,1,0,5,0,0,1,2,0,3,"H","N","2018-04-16","201804160COL"
"NSH",0,0,1,2,0,3,0,3,1,1,0,5,"A","N","2018-04-16","201804160COL"
"NJD",0,0,1,4,0,5,0,0,1,1,0,2,"H","N","2018-04-16","201804160NJD"
"TBL",0,0,1,1,0,2,0,0,1,4,0,5,"A","N","2018-04-16","201804160NJD"
"ANA",0,1,0,0,0,1,0,1,4,3,0,8,"A","N","2018-04-16","201804160SJS"
"SJS",0,1,4,3,0,8,0,1,0,0,0,1,"H","N","2018-04-16","201804160SJS"
"BOS",0,0,2,0,0,2,0,1,2,1,0,4,"A","N","2018-04-16","201804160TOR"
"TOR",0,1,2,1,0,4,0,0,2,0,0,2,"H","N","2018-04-16","201804160TOR"
"CBJ",0,0,1,1,0,2,1,0,2,0,0,3,"H","N","2018-04-17","201804170CBJ"
"WSH",1,0,2,0,0,3,0,0,1,1,0,2,"A","N","2018-04-17","201804170CBJ"
"LAK",0,0,0,0,0,0,0,0,1,0,0,1,"H","N","2018-04-17","201804170LAK"
"VEG",0,0,1,0,0,1,0,0,0,0,0,0,"A","N","2018-04-17","201804170LAK"
"MIN",0,0,0,0,0,0,0,1,0,1,0,2,"H","N","2018-04-17","201804170MIN"
"WPG",0,1,0,1,0,2,0,0,0,0,0,0,"A","N","2018-04-17","201804170MIN"
"COL",0,0,0,2,0,2,0,1,2,0,0,3,"H","N","2018-04-18","201804180COL"
"NSH",0,1,2,0,0,3,0,0,0,2,0,2,"A","N","2018-04-18","201804180COL"
"NJD",0,1,0,0,0,1,0,2,0,1,0,3,"H","N","2018-04-18","201804180NJD"
"TBL",0,2,0,1,0,3,0,1,0,0,0,1,"A","N","2018-04-18","201804180NJD"
"PHI",0,0,0,0,0,0,0,2,2,1,0,5,"H","N","2018-04-18","201804180PHI"
"PIT",0,2,2,1,0,5,0,0,0,0,0,0,"A","N","2018-04-18","201804180PHI"
"ANA",0,0,0,1,0,1,0,1,0,1,0,2,"A","N","2018-04-18","201804180SJS"
"SJS",0,1,0,1,0,2,0,0,0,1,0,1,"H","N","2018-04-18","201804180SJS"
"CBJ",0,0,0,1,0,1,0,1,1,2,0,4,"H","N","2018-04-19","201804190CBJ"
"WSH",0,1,1,2,0,4,0,0,0,1,0,1,"A","N","2018-04-19","201804190CBJ"
"BOS",0,1,1,1,0,3,0,1,0,0,0,1,"A","N","2018-04-19","201804190TOR"
"TOR",0,1,0,0,0,1,0,1,1,1,0,3,"H","N","2018-04-19","201804190TOR"
"COL",0,0,0,2,0,2,0,0,0,1,0,1,"A","N","2018-04-20","201804200NSH"
"NSH",0,0,0,1,0,1,0,0,0,2,0,2,"H","N","2018-04-20","201804200NSH"
"PHI",0,1,1,2,0,4,0,0,2,0,0,2,"A","N","2018-04-20","201804200PIT"
"PIT",0,0,2,0,0,2,0,1,1,2,0,4,"H","N","2018-04-20","201804200PIT"
"MIN",0,0,0,0,0,0,0,4,0,1,0,5,"A","N","2018-04-20","201804200WPG"
"WPG",0,4,0,1,0,5,0,0,0,0,0,0,"H","N","2018-04-20","201804200WPG"
"BOS",0,0,2,1,0,3,0,2,2,0,0,4,"H","N","2018-04-21","201804210BOS"
"TOR",0,2,2,0,0,4,0,0,2,1,0,3,"A","N","2018-04-21","201804210BOS"
"NJD",0,0,0,1,0,1,0,1,0,2,0,3,"A","N","2018-04-21","201804210TBL"
"TBL",0,1,0,2,0,3,0,0,0,1,0,1,"H","N","2018-04-21","201804210TBL"
"CBJ",0,1,1,1,0,3,1,1,2,0,0,4,"A","N","2018-04-21","201804210WSH"
"WSH",1,1,2,0,0,4,0,1,1,1,0,3,"H","N","2018-04-21","201804210WSH"
"COL",0,0,0,0,0,0,0,2,2,1,0,5,"H","N","2018-04-22","201804220COL"
"NSH",0,2,2,1,0,5,0,0,0,0,0,0,"A","N","2018-04-22","201804220COL"
"PHI",0,2,2,1,0,5,0,2,2,4,0,8,"H","N","2018-04-22","201804220PHI"
"PIT",0,2,2,4,0,8,0,2,2,1,0,5,"A","N","2018-04-22","201804220PHI"
"CBJ",0,0,1,2,0,3,0,1,2,3,0,6,"H","N","2018-04-23","201804230CBJ"
"WSH",0,1,2,3,0,6,0,0,1,2,0,3,"A","N","2018-04-23","201804230CBJ"
"BOS",0,0,1,0,0,1,0,0,2,1,0,3,"A","N","2018-04-23","201804230TOR"
"TOR",0,0,2,1,0,3,0,0,1,0,0,1,"H","N","2018-04-23","201804230TOR"
"BOS",0,3,0,4,0,7,0,2,2,0,0,4,"H","N","2018-04-25","201804250BOS"
"TOR",0,2,2,0,0,4,0,3,0,4,0,7,"A","N","2018-04-25","201804250BOS"
"SJS",0,0,0,0,0,0,0,4,1,2,0,7,"A","N","2018-04-26","201804260VEG"
"VEG",0,4,1,2,0,7,0,0,0,0,0,0,"H","N","2018-04-26","201804260VEG"
"PIT",0,0,0,3,0,3,0,1,0,1,0,2,"A","N","2018-04-26","201804260WSH"
"WSH",0,1,0,1,0,2,0,0,0,3,0,3,"H","N","2018-04-26","201804260WSH"
"NSH",0,0,0,1,0,1,0,1,2,1,0,4,"H","N","2018-04-27","201804270NSH"
"WPG",0,1,2,1,0,4,0,0,0,1,0,1,"A","N","2018-04-27","201804270NSH"
"BOS",0,1,2,3,0,6,0,0,2,0,0,2,"A","N","2018-04-28","201804280TBL"
"TBL",0,0,2,0,0,2,0,1,2,3,0,6,"H","N","2018-04-28","201804280TBL"
"SJS",1,0,3,0,0,4,0,1,1,1,0,3,"A","N","2018-04-28","201804280VEG"
"VEG",0,1,1,1,0,3,1,0,3,0,0,4,"H","N","2018-04-28","201804280VEG"
"NSH",1,1,2,1,0,5,0,2,0,2,0,4,"H","N","2018-04-29","201804290NSH"
"WPG",0,2,0,2,0,4,1,1,2,1,0,5,"A","N","2018-04-29","201804290NSH"
"PIT",0,0,1,0,0,1,0,2,1,1,0,4,"A","N","2018-04-29","201804290WSH"
"WSH",0,2,1,1,0,4,0,0,1,0,0,1,"H","N","2018-04-29","201804290WSH"
"SJS",0,0,1,2,0,3,1,0,3,0,0,4,"H","N","2018-04-30","201804300SJS"
"VEG",1,0,3,0,0,4,0,0,1,2,0,3,"A","N","2018-04-30","201804300SJS"
"BOS",0,1,0,1,0,2,0,1,1,2,0,4,"A","N","2018-04-30","201804300TBL"
"TBL",0,1,1,2,0,4,0,1,0,1,0,2,"H","N","2018-04-30","201804300TBL"
"PIT",0,0,3,0,0,3,0,0,2,2,0,4,"H","N","2018-05-01","201805010PIT"
"WSH",0,0,2,2,0,4,0,0,3,0,0,3,"A","N","2018-05-01","201805010PIT"
"NSH",0,3,0,1,0,4,0,0,4,3,0,7,"A","N","2018-05-01","201805010WPG"
"WPG",0,0,4,3,0,7,0,3,0,1,0,4,"H","N","2018-05-01","201805010WPG"
"BOS",0,1,0,0,0,1,0,3,0,1,0,4,"H","N","2018-05-02","201805020BOS"
"TBL",0,3,0,1,0,4,0,1,0,0,0,1,"A","N","2018-05-02","201805020BOS"
"SJS",0,2,1,1,0,4,0,0,0,0,0,0,"H","N","2018-05-02","201805020SJS"
"VEG",0,0,0,0,0,0,0,2,1,1,0,4,"A","N","2018-05-02","201805020SJS"
"PIT",0,0,2,1,0,3,0,0,1,0,0,1,"H","N","2018-05-03","201805030PIT"
"WSH",0,0,1,0,0,1,0,0,2,1,0,3,"A","N","2018-05-03","201805030PIT"
"NSH",0,1,1,0,0,2,0,0,0,1,0,1,"A","N","2018-05-03","201805030WPG"
"WPG",0,0,0,1,0,1,0,1,1,0,0,2,"H","N","2018-05-03","201805030WPG"
"BOS",0,1,1,1,0,3,1,2,0,1,0,4,"H","N","2018-05-04","201805040BOS"
"TBL",1,2,0,1,0,4,0,1,1,1,0,3,"A","N","2018-05-04","201805040BOS"
"SJS",0,0,0,3,0,3,0,1,2,2,0,5,"A","N","2018-05-04","201805040VEG"
"VEG",0,1,2,2,0,5,0,0,0,3,0,3,"H","N","2018-05-04","201805040VEG"
"NSH",0,0,2,0,0,2,0,0,4,2,0,6,"H","N","2018-05-05","201805050NSH"
"WPG",0,0,4,2,0,6,0,0,2,0,0,2,"A","N","2018-05-05","201805050NSH"
"PIT",0,1,2,0,0,3,0,2,0,4,0,6,"A","N","2018-05-05","201805050WSH"
"WSH",0,2,0,4,0,6,0,1,2,0,0,3,"H","N","2018-05-05","201805050WSH"
"SJS",0,0,0,0,0,0,0,0,2,1,0,3,"H","N","2018-05-06","201805060SJS"
"VEG",0,0,2,1,0,3,0,0,0,0,0,0,"A","N","2018-05-06","201805060SJS"
"BOS",0,1,0,0,0,1,0,0,2,1,0,3,"A","N","2018-05-06","201805060TBL"
"TBL",0,0,2,1,0,3,0,1,0,0,0,1,"H","N","2018-05-06","201805060TBL"
"PIT",0,0,1,0,0,1,1,0,1,0,0,2,"H","N","2018-05-07","201805070PIT"
"WSH",1,0,1,0,0,2,0,0,1,0,0,1,"A","N","2018-05-07","201805070PIT"
"NSH",0,1,1,2,0,4,0,0,0,0,0,0,"A","N","2018-05-07","201805070WPG"
"WPG",0,0,0,0,0,0,0,1,1,2,0,4,"H","N","2018-05-07","201805070WPG"
"NSH",0,1,0,0,0,1,0,2,1,2,0,5,"H","N","2018-05-10","201805100NSH"
"WPG",0,2,1,2,0,5,0,1,0,0,0,1,"A","N","2018-05-10","201805100NSH"
"TBL",0,0,0,2,0,2,0,2,2,0,0,4,"H","N","2018-05-11","201805110TBL"
"WSH",0,2,2,0,0,4,0,0,0,2,0,2,"A","N","2018-05-11","201805110TBL"
"VEG",0,1,1,0,0,2,0,3,1,0,0,4,"A","N","2018-05-12","201805120WPG"
"WPG",0,3,1,0,0,4,0,1,1,0,0,2,"H","N","2018-05-12","201805120WPG"
"TBL",0,2,0,0,0,2,0,1,3,2,0,6,"H","N","2018-05-13","201805130TBL"
"WSH",0,1,3,2,0,6,0,2,0,0,0,2,"A","N","2018-05-13","201805130TBL"
"VEG",0,2,0,1,0,3,0,0,0,1,0,1,"A","N","2018-05-14","201805140WPG"
"WPG",0,0,0,1,0,1,0,2,0,1,0,3,"H","N","2018-05-14","201805140WPG"
"TBL",0,1,3,0,0,4,0,0,1,1,0,2,"A","N","2018-05-15","201805150WSH"
"WSH",0,0,1,1,0,2,0,1,3,0,0,4,"H","N","2018-05-15","201805150WSH"
"VEG",0,1,2,1,0,4,0,0,1,1,0,2,"H","N","2018-05-16","201805160VEG"
"WPG",0,0,1,1,0,2,0,1,2,1,0,4,"A","N","2018-05-16","201805160VEG"
"TBL",0,2,0,2,0,4,0,1,1,0,0,2,"A","N","2018-05-17","201805170WSH"
"WSH",0,1,1,0,0,2,0,2,0,2,0,4,"H","N","2018-05-17","201805170WSH"
"VEG",0,1,1,1,0,3,0,0,1,1,0,2,"H","N","2018-05-18","201805180VEG"
"WPG",0,0,1,1,0,2,0,1,1,1,0,3,"A","N","2018-05-18","201805180VEG"
"TBL",0,2,1,0,0,3,0,0,1,1,0,2,"H","N","2018-05-19","201805190TBL"
"WSH",0,0,1,1,0,2,0,2,1,0,0,3,"A","N","2018-05-19","201805190TBL"
"VEG",0,1,1,0,0,2,0,1,0,0,0,1,"A","N","2018-05-20","201805200WPG"
"WPG",0,1,0,0,0,1,0,1,1,0,0,2,"H","N","2018-05-20","201805200WPG"
"TBL",0,0,0,0,0,0,0,0,1,2,0,3,"A","N","2018-05-21","201805210WSH"
"WSH",0,0,1,2,0,3,0,0,0,0,0,0,"H","N","2018-05-21","201805210WSH"
"TBL",0,0,0,0,0,0,0,1,2,1,0,4,"H","N","2018-05-23","201805230TBL"
"WSH",0,1,2,1,0,4,0,0,0,0,0,0,"A","N","2018-05-23","201805230TBL"
"VEG",0,2,1,3,0,6,0,2,1,1,0,4,"H","N","2018-05-28","201805280VEG"
"WSH",0,2,1,1,0,4,0,2,1,3,0,6,"A","N","2018-05-28","201805280VEG"
"VEG",0,1,1,0,0,2,0,1,2,0,0,3,"H","N","2018-05-30","201805300VEG"
"WSH",0,1,2,0,0,3,0,1,1,0,0,2,"A","N","2018-05-30","201805300VEG"
"VEG",0,0,0,1,0,1,0,0,2,1,0,3,"A","N","2018-06-02","201806020WSH"
"WSH",0,0,2,1,0,3,0,0,0,1,0,1,"H","N","2018-06-02","201806020WSH"
"VEG",0,0,0,2,0,2,0,3,1,2,0,6,"A","N","2018-06-04","201806040WSH"
"WSH",0,3,1,2,0,6,0,0,0,2,0,2,"H","N","2018-06-04","201806040WSH"
"VEG",0,0,3,0,0,3,0,0,2,2,0,4,"H","N","2018-06-07","201806070VEG"
"WSH",0,0,2,2,0,4,0,0,3,0,0,3,"A","N","2018-06-07","201806070VEG"
"ANA",0,1,1,3,0,5,0,1,1,0,0,2,"A","N","2018-10-03","201810030SJS"
"SJS",0,1,1,0,0,2,0,1,1,3,0,5,"H","N","2018-10-03","201810030SJS"
"MTL",0,1,1,0,0,2,1,1,1,0,0,3,"A","N","2018-10-03","201810030TOR"
"TOR",1,1,1,0,0,3,0,1,1,0,0,2,"H","N","2018-10-03","201810030TOR"
"CGY",0,0,0,2,0,2,0,1,0,4,0,5,"A","N","2018-10-03","201810030VAN"
"VAN",0,1,0,4,0,5,0,0,0,2,0,2,"H","N","2018-10-03","201810030VAN"
"BOS",0,0,0,0,0,0,0,2,4,1,0,7,"A","N","2018-10-03","201810030WSH"
"WSH",0,2,4,1,0,7,0,0,0,0,0,0,"H","N","2018-10-03","201810030WSH"
"BOS",0,2,1,1,0,4,0,0,0,0,0,0,"A","N","2018-10-04","201810040BUF"
"BUF",0,0,0,0,0,0,0,2,1,1,0,4,"H","N","2018-10-04","201810040BUF"
"CAR",0,0,0,1,0,1,1,0,1,0,0,2,"H","N","2018-10-04","201810040CAR"
"NYI",1,0,1,0,0,2,0,0,0,1,0,1,"A","N","2018-10-04","201810040CAR"
"COL",0,1,1,2,0,4,0,1,0,0,0,1,"H","N","2018-10-04","201810040COL"
"MIN",0,1,0,0,0,1,0,1,1,2,0,4,"A","N","2018-10-04","201810040COL"
"ARI",0,0,0,0,0,0,0,0,3,0,0,3,"A","N","2018-10-04","201810040DAL"
"DAL",0,0,3,0,0,3,0,0,0,0,0,0,"H","N","2018-10-04","201810040DAL"
"CBJ",1,1,1,0,0,3,0,0,2,0,0,2,"A","N","2018-10-04","201810040DET"
"DET",0,0,2,0,0,2,1,1,1,0,0,3,"H","N","2018-10-04","201810040DET"
"NSH",0,0,1,2,0,3,0,0,1,1,0,2,"A","N","2018-10-04","201810040NYR"
"NYR",0,0,1,1,0,2,0,0,1,2,0,3,"H","N","2018-10-04","201810040NYR"
"CHI",1,2,0,1,0,4,0,3,0,0,0,3,"A","N","2018-10-04","201810040OTT"
"OTT",0,3,0,0,0,3,1,2,0,1,0,4,"H","N","2018-10-04","201810040OTT"
"PIT",1,2,3,1,0,7,0,3,1,2,0,6,"H","N","2018-10-04","201810040PIT"
"WSH",0,3,1,2,0,6,1,2,3,1,0,7,"A","N","2018-10-04","201810040PIT"
"STL",0,0,0,1,0,1,0,1,0,4,0,5,"H","N","2018-10-04","201810040STL"
"WPG",0,1,0,4,0,5,0,0,0,1,0,1,"A","N","2018-10-04","201810040STL"
"PHI",0,2,3,0,0,5,0,1,0,1,0,2,"A","N","2018-10-04","201810040VEG"
"VEG",0,1,0,1,0,2,0,2,3,0,0,5,"H","N","2018-10-04","201810040VEG"
"CAR",0,1,1,1,0,3,0,1,0,0,0,1,"A","N","2018-10-05","201810050CBJ"
"CBJ",0,1,0,0,0,1,0,1,1,1,0,3,"H","N","2018-10-05","201810050CBJ"
"LAK",0,1,1,0,0,2,1,2,0,0,0,3,"H","N","2018-10-05","201810050LAK"
"SJS",1,2,0,0,0,3,0,1,1,0,0,2,"A","N","2018-10-05","201810050LAK"
"ANA",0,0,1,0,0,1,0,0,0,0,0,0,"A","N","2018-10-06","201810060ARI"
"ARI",0,0,0,0,0,0,0,0,1,0,0,1,"H","N","2018-10-06","201810060ARI"
"BUF",0,1,1,1,0,3,0,0,0,1,0,1,"H","N","2018-10-06","201810060BUF"
"NYR",0,0,0,1,0,1,0,1,1,1,0,3,"A","N","2018-10-06","201810060BUF"
"CGY",0,2,1,4,0,7,0,2,2,0,0,4,"H","N","2018-10-06","201810060CGY"
"VAN",0,2,2,0,0,4,0,2,1,4,0,7,"A","N","2018-10-06","201810060CGY"
"COL",0,2,1,2,0,5,0,1,1,0,0,2,"H","N","2018-10-06","201810060COL"
"PHI",0,1,1,0,0,2,0,2,1,2,0,5,"A","N","2018-10-06","201810060COL"
"DAL",0,2,1,2,0,5,0,0,1,0,0,1,"H","N","2018-10-06","201810060DAL"
"WPG",0,0,1,0,0,1,0,2,1,2,0,5,"A","N","2018-10-06","201810060DAL"
"MIN",0,1,0,0,0,1,0,0,0,1,1,2,"H","Y","2018-10-06","201810060MIN"
"VEG",0,0,0,1,1,2,0,1,0,0,0,1,"A","Y","2018-10-06","201810060MIN"
"EDM",0,1,0,1,0,2,0,1,2,2,0,5,"A","N","2018-10-06","201810060NJD"
"NJD",0,1,2,2,0,5,0,1,0,1,0,2,"H","N","2018-10-06","201810060NJD"
"NSH",0,2,2,0,0,4,0,1,2,0,0,3,"A","N","2018-10-06","201810060NYI"
"NYI",0,1,2,0,0,3,0,2,2,0,0,4,"H","N","2018-10-06","201810060NYI"
"MTL",0,2,2,1,0,5,0,0,1,0,0,1,"A","N","2018-10-06","201810060PIT"
"PIT",0,0,1,0,0,1,0,2,2,1,0,5,"H","N","2018-10-06","201810060PIT"
"CHI",1,1,2,1,0,5,0,2,0,2,0,4,"A","N","2018-10-06","201810060STL"
"STL",0,2,0,2,0,4,1,1,2,1,0,5,"H","N","2018-10-06","201810060STL"
"FLA",0,1,0,0,0,1,0,0,0,1,1,2,"A","Y","2018-10-06","201810060TBL"
"TBL",0,0,0,1,1,2,0,1,0,0,0,1,"H","Y","2018-10-06","201810060TBL"
"OTT",0,1,2,2,0,5,0,0,3,0,0,3,"A","N","2018-10-06","201810060TOR"
"TOR",0,0,3,0,0,3,0,1,2,2,0,5,"H","N","2018-10-06","201810060TOR"
"CAR",0,2,2,4,0,8,0,2,2,1,0,5,"H","N","2018-10-07","201810070CAR"
"NYR",0,2,2,1,0,5,0,2,2,4,0,8,"A","N","2018-10-07","201810070CAR"
"CHI",0,2,1,3,0,6,1,2,2,2,0,7,"H","N","2018-10-07","201810070CHI"
"TOR",1,2,2,2,0,7,0,2,1,3,0,6,"A","N","2018-10-07","201810070CHI"
"DET",0,0,1,1,0,2,0,0,2,2,0,4,"A","N","2018-10-07","201810070LAK"
"LAK",0,0,2,2,0,4,0,0,1,1,0,2,"H","N","2018-10-07","201810070LAK"
"ANA",0,0,1,1,1,3,0,1,1,0,0,2,"H","Y","2018-10-08","201810080ANA"
"DET",0,1,1,0,0,2,0,0,1,1,1,3,"A","Y","2018-10-08","201810080ANA"
"BOS",0,2,1,3,0,6,0,0,2,1,0,3,"H","N","2018-10-08","201810080BOS"
"OTT",0,0,2,1,0,3,0,2,1,3,0,6,"A","N","2018-10-08","201810080BOS"
"BUF",0,1,3,0,0,4,0,0,1,1,0,2,"H","N","2018-10-08","201810080BUF"
"VEG",0,0,1,1,0,2,0,1,3,0,0,4,"A","N","2018-10-08","201810080BUF"
"NYI",0,0,1,3,0,4,0,0,0,0,0,0,"H","N","2018-10-08","201810080NYI"
"SJS",0,0,0,0,0,0,0,0,1,3,0,4,"A","N","2018-10-08","201810080NYI"
"CAR",0,3,1,1,0,5,0,1,2,0,0,3,"H","N","2018-10-09","201810090CAR"
"VAN",0,1,2,0,0,3,0,3,1,1,0,5,"A","N","2018-10-09","201810090CAR"
"CBJ",0,2,0,3,0,5,0,0,2,0,0,2,"H","N","2018-10-09","201810090CBJ"
"COL",0,0,2,0,0,2,0,2,0,3,0,5,"A","N","2018-10-09","201810090CBJ"
"DAL",0,1,2,1,0,4,0,2,3,2,0,7,"H","N","2018-10-09","201810090DAL"
"TOR",0,2,3,2,0,7,0,1,2,1,0,4,"A","N","2018-10-09","201810090DAL"
"CGY",0,1,1,1,0,3,0,0,0,0,0,0,"A","N","2018-10-09","201810090NSH"
"NSH",0,0,0,0,0,0,0,1,1,1,0,3,"H","N","2018-10-09","201810090NSH"
"PHI",0,0,1,1,0,2,0,4,1,3,0,8,"H","N","2018-10-09","201810090PHI"
"SJS",0,4,1,3,0,8,0,0,1,1,0,2,"A","N","2018-10-09","201810090PHI"
"LAK",0,1,0,0,0,1,0,1,1,0,0,2,"A","N","2018-10-09","201810090WPG"
"WPG",0,1,1,0,0,2,0,1,0,0,0,1,"H","N","2018-10-09","201810090WPG"
"ANA",0,1,1,0,0,2,0,1,1,0,1,3,"H","Y","2018-10-10","201810100ANA"
"ARI",0,1,1,0,1,3,0,1,1,0,0,2,"A","Y","2018-10-10","201810100ANA"
"OTT",0,1,2,1,0,4,0,1,3,3,0,7,"H","N","2018-10-10","201810100OTT"
"PHI",0,1,3,3,0,7,0,1,2,1,0,4,"A","N","2018-10-10","201810100OTT"
"VEG",0,0,1,1,0,2,0,1,1,3,0,5,"A","N","2018-10-10","201810100WSH"
"WSH",0,1,1,3,0,5,0,0,1,1,0,2,"H","N","2018-10-10","201810100WSH"
"BOS",0,3,0,1,0,4,0,1,0,0,0,1,"H","N","2018-10-11","201810110BOS"
"EDM",0,1,0,0,0,1,0,3,0,1,0,4,"A","N","2018-10-11","201810110BOS"
"BUF",0,0,1,0,0,1,0,3,1,2,0,6,"H","N","2018-10-11","201810110BUF"
"COL",0,3,1,2,0,6,0,0,1,0,0,1,"A","N","2018-10-11","201810110BUF"
"DET",0,1,0,2,0,3,0,1,2,2,0,5,"H","N","2018-10-11","201810110DET"
"TOR",0,1,2,2,0,5,0,1,0,2,0,3,"A","N","2018-10-11","201810110DET"
"CBJ",0,2,1,2,0,5,0,1,3,0,0,4,"A","N","2018-10-11","201810110FLA"
"FLA",0,1,3,0,0,4,0,2,1,2,0,5,"H","N","2018-10-11","201810110FLA"
"CHI",0,2,0,1,0,3,1,0,2,1,0,4,"A","N","2018-10-11","201810110MIN"
"MIN",1,0,2,1,0,4,0,2,0,1,0,3,"H","N","2018-10-11","201810110MIN"
"LAK",0,2,0,1,0,3,0,0,0,0,0,0,"A","N","2018-10-11","201810110MTL"
"MTL",0,0,0,0,0,0,0,2,0,1,0,3,"H","N","2018-10-11","201810110MTL"
"NJD",0,2,1,3,0,6,0,0,0,0,0,0,"H","N","2018-10-11","201810110NJD"
"WSH",0,0,0,0,0,0,0,2,1,3,0,6,"A","N","2018-10-11","201810110NJD"
"NSH",0,0,1,2,0,3,0,0,0,0,0,0,"H","N","2018-10-11","201810110NSH"
"WPG",0,0,0,0,0,0,0,0,1,2,0,3,"A","N","2018-10-11","201810110NSH"
"NYR",1,1,0,1,0,3,0,1,1,0,0,2,"H","N","2018-10-11","201810110NYR"
"SJS",0,1,1,0,0,2,1,1,0,1,0,3,"A","N","2018-10-11","201810110NYR"
"PIT",0,1,3,0,0,4,0,1,0,1,0,2,"H","N","2018-10-11","201810110PIT"
"VEG",0,1,0,1,0,2,0,1,3,0,0,4,"A","N","2018-10-11","201810110PIT"
"CGY",0,1,0,2,0,3,0,3,2,0,0,5,"A","N","2018-10-11","201810110STL"
"STL",0,3,2,0,0,5,0,1,0,2,0,3,"H","N","2018-10-11","201810110STL"
"TBL",0,1,0,0,0,1,0,0,0,4,0,4,"H","N","2018-10-11","201810110TBL"
"VAN",0,0,0,4,0,4,0,1,0,0,0,1,"A","N","2018-10-11","201810110TBL"
"ARI",0,0,0,0,0,0,0,2,0,1,0,3,"H","N","2018-10-13","201810130ARI"
"BUF",0,2,0,1,0,3,0,0,0,0,0,0,"A","N","2018-10-13","201810130ARI"
"BOS",0,1,3,4,0,8,0,0,0,2,0,2,"H","N","2018-10-13","201810130BOS"
"DET",0,0,0,2,0,2,0,1,3,4,0,8,"A","N","2018-10-13","201810130BOS"
"CHI",1,2,0,1,0,4,0,0,1,2,0,3,"H","N","2018-10-13","201810130CHI"
"STL",0,0,1,2,0,3,1,2,0,1,0,4,"A","N","2018-10-13","201810130CHI"
"CGY",1,0,1,1,0,3,0,2,0,0,0,2,"A","N","2018-10-13","201810130COL"
"COL",0,2,0,0,0,2,1,0,1,1,0,3,"H","N","2018-10-13","201810130COL"
"ANA",0,2,1,0,0,3,0,0,4,1,0,5,"A","N","2018-10-13","201810130DAL"
"DAL",0,0,4,1,0,5,0,2,1,0,0,3,"H","N","2018-10-13","201810130DAL"
"FLA",0,0,2,0,0,2,0,0,2,1,0,3,"H","N","2018-10-13","201810130FLA"
"VAN",0,0,2,1,0,3,0,0,2,0,0,2,"A","N","2018-10-13","201810130FLA"
"CAR",1,1,1,2,0,5,0,1,0,3,0,4,"A","N","2018-10-13","201810130MIN"
"MIN",0,1,0,3,0,4,1,1,1,2,0,5,"H","N","2018-10-13","201810130MIN"
"MTL",0,0,3,0,1,4,0,2,1,0,0,3,"H","Y","2018-10-13","201810130MTL"
"PIT",0,2,1,0,0,3,0,0,3,0,1,4,"A","Y","2018-10-13","201810130MTL"
"NSH",0,3,0,2,0,5,0,0,2,0,0,2,"H","N","2018-10-13","201810130NSH"
"NYI",0,0,2,0,0,2,0,3,0,2,0,5,"A","N","2018-10-13","201810130NSH"
"EDM",0,1,0,1,0,2,0,1,0,0,0,1,"A","N","2018-10-13","201810130NYR"
"NYR",0,1,0,0,0,1,0,1,0,1,0,2,"H","N","2018-10-13","201810130NYR"
"LAK",0,0,1,0,0,1,0,3,1,1,0,5,"A","N","2018-10-13","201810130OTT"
"OTT",0,3,1,1,0,5,0,0,1,0,0,1,"H","N","2018-10-13","201810130OTT"
"PHI",0,0,0,0,0,0,0,0,0,1,0,1,"H","N","2018-10-13","201810130PHI"
"VEG",0,0,0,1,0,1,0,0,0,0,0,0,"A","N","2018-10-13","201810130PHI"
"CBJ",0,0,2,0,0,2,0,3,1,4,0,8,"A","N","2018-10-13","201810130TBL"
"TBL",0,3,1,4,0,8,0,0,2,0,0,2,"H","N","2018-10-13","201810130TBL"
"TOR",0,0,2,2,0,4,0,1,1,0,0,2,"A","N","2018-10-13","201810130WSH"
"WSH",0,1,1,0,0,2,0,0,2,2,0,4,"H","N","2018-10-13","201810130WSH"
"NJD",0,0,1,2,0,3,0,0,2,0,0,2,"H","N","2018-10-14","201810140NJD"
"SJS",0,0,2,0,0,2,0,0,1,2,0,3,"A","N","2018-10-14","201810140NJD"
"ANA",0,1,0,2,0,3,0,0,2,0,0,2,"A","N","2018-10-14","201810140STL"
"STL",0,0,2,0,0,2,0,1,0,2,0,3,"H","N","2018-10-14","201810140STL"
"CAR",0,0,0,1,0,1,0,0,0,3,0,3,"A","N","2018-10-14","201810140WPG"
"WPG",0,0,0,3,0,3,0,0,0,1,0,1,"H","N","2018-10-14","201810140WPG"
"DET",0,1,0,2,0,3,0,3,3,1,0,7,"A","N","2018-10-15","201810150MTL"
"MTL",0,3,3,1,0,7,0,1,0,2,0,3,"H","N","2018-10-15","201810150MTL"
"MIN",0,1,1,0,0,2,0,1,2,1,0,4,"A","N","2018-10-15","201810150NSH"
"NSH",0,1,2,1,0,4,0,1,1,0,0,2,"H","N","2018-10-15","201810150NSH"
"DAL",0,1,0,0,0,1,0,0,1,3,0,4,"A","N","2018-10-15","201810150OTT"
"OTT",0,0,1,3,0,4,0,1,0,0,0,1,"H","N","2018-10-15","201810150OTT"
"LAK",0,0,1,0,0,1,0,2,1,1,0,4,"A","N","2018-10-15","201810150TOR"
"TOR",0,2,1,1,0,4,0,0,1,0,0,1,"H","N","2018-10-15","201810150TOR"
"ARI",0,1,0,0,0,1,0,0,1,1,0,2,"A","N","2018-10-16","201810160MIN"
"MIN",0,0,1,1,0,2,0,1,0,0,0,1,"H","N","2018-10-16","201810160MIN"
"DAL",0,0,0,0,0,0,0,1,2,0,0,3,"A","N","2018-10-16","201810160NJD"
"NJD",0,1,2,0,0,3,0,0,0,0,0,0,"H","N","2018-10-16","201810160NJD"
"COL",0,0,2,0,0,2,0,1,1,0,1,3,"A","Y","2018-10-16","201810160NYR"
"NYR",0,1,1,0,1,3,0,0,2,0,0,2,"H","Y","2018-10-16","201810160NYR"
"FLA",0,1,2,2,0,5,0,0,5,0,1,6,"A","Y","2018-10-16","201810160PHI"
"PHI",0,0,5,0,1,6,0,1,2,2,0,5,"H","Y","2018-10-16","201810160PHI"
"PIT",0,1,0,1,0,2,1,2,0,0,0,3,"H","N","2018-10-16","201810160PIT"
"VAN",1,2,0,0,0,3,0,1,0,1,0,2,"A","N","2018-10-16","201810160PIT"
"CAR",0,1,1,0,0,2,0,1,1,2,0,4,"A","N","2018-10-16","201810160TBL"
"TBL",0,1,1,2,0,4,0,1,1,0,0,2,"H","N","2018-10-16","201810160TBL"
"BUF",0,0,0,1,0,1,0,1,1,2,0,4,"A","N","2018-10-16","201810160VEG"
"VEG",0,1,1,2,0,4,0,0,0,1,0,1,"H","N","2018-10-16","201810160VEG"
"EDM",1,1,0,3,0,5,0,3,1,0,0,4,"A","N","2018-10-16","201810160WPG"
"WPG",0,3,1,0,0,4,1,1,0,3,0,5,"H","N","2018-10-16","201810160WPG"
"ANA",0,1,1,2,0,4,0,0,0,1,0,1,"H","N","2018-10-17","201810170ANA"
"NYI",0,0,0,1,0,1,0,1,1,2,0,4,"A","N","2018-10-17","201810170ANA"
"BOS",0,0,2,0,0,2,0,3,1,1,0,5,"A","N","2018-10-17","201810170CGY"
"CGY",0,3,1,1,0,5,0,0,2,0,0,2,"H","N","2018-10-17","201810170CGY"
"MTL",0,1,1,1,0,3,0,0,1,1,0,2,"H","N","2018-10-17","201810170MTL"
"STL",0,0,1,1,0,2,0,1,1,1,0,3,"A","N","2018-10-17","201810170MTL"
"NYR",0,1,1,1,0,3,1,1,2,0,0,4,"A","N","2018-10-17","201810170WSH"
"WSH",1,1,2,0,0,4,0,1,1,1,0,3,"H","N","2018-10-17","201810170WSH"
"CBJ",0,1,3,2,0,6,0,2,0,1,0,3,"H","N","2018-10-18","201810180CBJ"
"PHI",0,2,0,1,0,3,0,1,3,2,0,6,"A","N","2018-10-18","201810180CBJ"
"ARI",0,1,1,2,0,4,0,0,1,0,0,1,"A","N","2018-10-18","201810180CHI"
"CHI",0,0,1,0,0,1,0,1,1,2,0,4,"H","N","2018-10-18","201810180CHI"
"BOS",0,0,1,1,0,2,1,0,1,1,0,3,"A","N","2018-10-18","201810180EDM"
"EDM",1,0,1,1,0,3,0,0,1,1,0,2,"H","N","2018-10-18","201810180EDM"
"LAK",0,1,0,1,0,2,0,1,2,4,0,7,"H","N","2018-10-18","201810180LAK"
"NYI",0,1,2,4,0,7,0,1,0,1,0,2,"A","N","2018-10-18","201810180LAK"
"COL",0,0,2,3,0,5,0,1,1,1,0,3,"A","N","2018-10-18","201810180NJD"
"NJD",0,1,1,1,0,3,0,0,2,3,0,5,"H","N","2018-10-18","201810180NJD"
"BUF",0,0,1,0,0,1,0,2,0,3,0,5,"A","N","2018-10-18","201810180SJS"
"SJS",0,2,0,3,0,5,0,0,1,0,0,1,"H","N","2018-10-18","201810180SJS"
"DET",0,0,1,0,0,1,0,1,1,1,0,3,"A","N","2018-10-18","201810180TBL"
"TBL",0,1,1,1,0,3,0,0,1,0,0,1,"H","N","2018-10-18","201810180TBL"
"PIT",0,1,0,2,0,3,0,0,0,0,0,0,"A","N","2018-10-18","201810180TOR"
"TOR",0,0,0,0,0,0,0,1,0,2,0,3,"H","N","2018-10-18","201810180TOR"
"VAN",0,0,1,0,0,1,0,1,0,3,0,4,"A","N","2018-10-18","201810180WPG"
"WPG",0,1,0,3,0,4,0,0,1,0,0,1,"H","N","2018-10-18","201810180WPG"
"CGY",0,1,1,1,0,3,0,1,2,2,0,5,"H","N","2018-10-19","201810190CGY"
"NSH",0,1,2,2,0,5,0,1,1,1,0,3,"A","N","2018-10-19","201810190CGY"
"DAL",0,0,0,1,0,1,0,0,0,3,0,3,"H","N","2018-10-19","201810190DAL"
"MIN",0,0,0,3,0,3,0,0,0,1,0,1,"A","N","2018-10-19","201810190DAL"
"FLA",0,4,1,0,1,6,0,1,3,1,0,5,"A","Y","2018-10-19","201810190WSH"
"WSH",0,1,3,1,0,5,0,4,1,0,1,6,"H","Y","2018-10-19","201810190WSH"
"CAR",0,0,0,1,0,1,0,1,1,1,0,3,"H","N","2018-10-20","201810200CAR"
"COL",0,1,1,1,0,3,0,0,0,1,0,1,"A","N","2018-10-20","201810200CAR"
"CBJ",0,1,0,0,0,1,0,1,0,3,0,4,"H","N","2018-10-20","201810200CBJ"
"CHI",0,1,0,3,0,4,0,1,0,0,0,1,"A","N","2018-10-20","201810200CBJ"
"EDM",0,0,0,0,0,0,0,0,2,1,0,3,"H","N","2018-10-20","201810200EDM"
"NSH",0,0,2,1,0,3,0,0,0,0,0,0,"A","N","2018-10-20","201810200EDM"
"DET",1,0,3,0,0,4,0,2,0,1,0,3,"A","N","2018-10-20","201810200FLA"
"FLA",0,2,0,1,0,3,1,0,3,0,0,4,"H","N","2018-10-20","201810200FLA"
"BUF",0,1,3,1,0,5,0,0,0,1,0,1,"A","N","2018-10-20","201810200LAK"
"LAK",0,0,0,1,0,1,0,1,3,1,0,5,"H","N","2018-10-20","201810200LAK"
"MIN",1,1,1,2,0,5,0,3,0,1,0,4,"H","N","2018-10-20","201810200MIN"
"TBL",0,3,0,1,0,4,1,1,1,2,0,5,"A","N","2018-10-20","201810200MIN"
"MTL",0,3,0,0,0,3,1,1,2,0,0,4,"A","N","2018-10-20","201810200OTT"
"OTT",1,1,2,0,0,4,0,3,0,0,0,3,"H","N","2018-10-20","201810200OTT"
"NJD",0,1,0,1,0,2,0,1,1,3,0,5,"A","N","2018-10-20","201810200PHI"
"PHI",0,1,1,3,0,5,0,1,0,1,0,2,"H","N","2018-10-20","201810200PHI"
"NYI",0,1,0,0,0,1,0,1,2,1,0,4,"A","N","2018-10-20","201810200SJS"
"SJS",0,1,2,1,0,4,0,1,0,0,0,1,"H","N","2018-10-20","201810200SJS"
"STL",0,0,3,1,0,4,0,0,0,1,0,1,"A","N","2018-10-20","201810200TOR"
"TOR",0,0,0,1,0,1,0,0,3,1,0,4,"H","N","2018-10-20","201810200TOR"
"BOS",0,0,0,1,0,1,1,1,0,0,0,2,"A","N","2018-10-20","201810200VAN"
"VAN",1,1,0,0,0,2,0,0,0,1,0,1,"H","N","2018-10-20","201810200VAN"
"ANA",0,0,0,1,0,1,0,1,1,1,0,3,"A","N","2018-10-20","201810200VEG"
"VEG",0,1,1,1,0,3,0,0,0,1,0,1,"H","N","2018-10-20","201810200VEG"
"ARI",0,1,0,2,0,3,0,1,2,2,0,5,"A","N","2018-10-20","201810200WPG"
"WPG",0,1,2,2,0,5,0,1,0,2,0,3,"H","N","2018-10-20","201810200WPG"
"ANA",0,1,1,0,0,2,0,0,2,2,0,4,"H","N","2018-10-21","201810210ANA"
"BUF",0,0,2,2,0,4,0,1,1,0,0,2,"A","N","2018-10-21","201810210ANA"
"CHI",0,1,0,2,0,3,0,1,3,2,0,6,"H","N","2018-10-21","201810210CHI"
"TBL",0,1,3,2,0,6,0,1,0,2,0,3,"A","N","2018-10-21","201810210CHI"
"CGY",0,1,2,1,0,4,0,0,0,1,0,1,"A","N","2018-10-21","201810210NYR"
"NYR",0,0,0,1,0,1,0,1,2,1,0,4,"H","N","2018-10-21","201810210NYR"
"CAR",0,1,1,1,0,3,0,0,0,1,0,1,"A","N","2018-10-22","201810220DET"
"DET",0,0,0,1,0,1,0,1,1,1,0,3,"H","N","2018-10-22","201810220DET"
"COL",0,1,1,2,0,4,0,0,0,1,0,1,"A","N","2018-10-22","201810220PHI"
"PHI",0,0,0,1,0,1,0,1,1,2,0,4,"H","N","2018-10-22","201810220PHI"
"VAN",0,0,1,1,0,2,0,1,2,2,0,5,"H","N","2018-10-22","201810220VAN"
"WSH",0,1,2,2,0,5,0,0,1,1,0,2,"A","N","2018-10-22","201810220VAN"
"STL",0,2,1,1,0,4,1,1,0,3,0,5,"A","N","2018-10-22","201810220WPG"
"WPG",1,1,0,3,0,5,0,2,1,1,0,4,"H","N","2018-10-22","201810220WPG"
"ARI",0,2,1,1,0,4,0,1,0,0,0,1,"A","N","2018-10-23","201810230CBJ"
"CBJ",0,1,0,0,0,1,0,2,1,1,0,4,"H","N","2018-10-23","201810230CBJ"
"ANA",0,0,1,0,0,1,0,1,0,2,0,3,"A","N","2018-10-23","201810230CHI"
"CHI",0,1,0,2,0,3,0,0,1,0,0,1,"H","N","2018-10-23","201810230CHI"
"DAL",0,1,2,1,0,4,0,0,2,0,0,2,"H","N","2018-10-23","201810230DAL"
"LAK",0,0,2,0,0,2,0,1,2,1,0,4,"A","N","2018-10-23","201810230DAL"
"EDM",0,0,3,2,0,5,1,1,3,1,0,6,"H","N","2018-10-23","201810230EDM"
"PIT",1,1,3,1,0,6,0,0,3,2,0,5,"A","N","2018-10-23","201810230EDM"
"CGY",0,1,0,1,0,2,0,0,3,0,0,3,"A","N","2018-10-23","201810230MTL"
"MTL",0,0,3,0,0,3,0,1,0,1,0,2,"H","N","2018-10-23","201810230MTL"
"NSH",0,1,3,0,0,4,0,1,1,3,0,5,"H","N","2018-10-23","201810230NSH"
"SJS",0,1,1,3,0,5,0,1,3,0,0,4,"A","N","2018-10-23","201810230NSH"
"FLA",0,1,0,1,0,2,0,0,3,2,0,5,"A","N","2018-10-23","201810230NYR"
"NYR",0,0,3,2,0,5,0,1,0,1,0,2,"H","N","2018-10-23","201810230NYR"
"BOS",0,1,1,2,0,4,0,0,1,0,0,1,"A","N","2018-10-23","201810230OTT"
"OTT",0,0,1,0,0,1,0,1,1,2,0,4,"H","N","2018-10-23","201810230OTT"
"COL",0,0,0,0,0,0,0,0,0,1,0,1,"H","N","2018-10-24","201810240COL"
"TBL",0,0,0,1,0,1,0,0,0,0,0,0,"A","N","2018-10-24","201810240COL"
"FLA",1,0,0,2,0,3,0,1,1,0,0,2,"A","N","2018-10-24","201810240NYI"
"NYI",0,1,1,0,0,2,1,0,0,2,0,3,"H","N","2018-10-24","201810240NYI"
"VAN",0,0,2,0,1,3,0,0,2,0,0,2,"A","Y","2018-10-24","201810240VEG"
"VEG",0,0,2,0,0,2,0,0,2,0,1,3,"H","Y","2018-10-24","201810240VEG"
"TOR",0,1,2,1,0,4,0,0,0,2,0,2,"A","N","2018-10-24","201810240WPG"
"WPG",0,0,0,2,0,2,0,1,2,1,0,4,"H","N","2018-10-24","201810240WPG"
"ARI",0,0,1,3,0,4,0,0,1,0,0,1,"H","N","2018-10-25","201810250ARI"
"VAN",0,0,1,0,0,1,0,0,1,3,0,4,"A","N","2018-10-25","201810250ARI"
"BOS",0,0,2,1,0,3,0,0,0,0,0,0,"H","N","2018-10-25","201810250BOS"
"PHI",0,0,0,0,0,0,0,0,2,1,0,3,"A","N","2018-10-25","201810250BOS"
"BUF",0,0,2,2,0,4,0,1,1,1,0,3,"H","N","2018-10-25","201810250BUF"
"MTL",0,1,1,1,0,3,0,0,2,2,0,4,"A","N","2018-10-25","201810250BUF"
"CGY",0,0,0,1,0,1,0,3,4,2,0,9,"H","N","2018-10-25","201810250CGY"
"PIT",0,3,4,2,0,9,0,0,0,1,0,1,"A","N","2018-10-25","201810250CGY"
"CHI",0,1,1,2,0,4,0,1,0,0,0,1,"H","N","2018-10-25","201810250CHI"
"NYR",0,1,0,0,0,1,0,1,1,2,0,4,"A","N","2018-10-25","201810250CHI"
"ANA",0,1,1,0,0,2,0,2,3,0,0,5,"A","N","2018-10-25","201810250DAL"
"DAL",0,2,3,0,0,5,0,1,1,0,0,2,"H","N","2018-10-25","201810250DAL"
"EDM",0,1,1,2,0,4,0,0,1,0,0,1,"H","N","2018-10-25","201810250EDM"
"WSH",0,0,1,0,0,1,0,1,1,2,0,4,"A","N","2018-10-25","201810250EDM"
"LAK",0,0,0,1,0,1,0,1,1,2,0,4,"A","N","2018-10-25","201810250MIN"
"MIN",0,1,1,2,0,4,0,0,0,1,0,1,"H","N","2018-10-25","201810250MIN"
"NJD",0,2,1,0,0,3,1,1,1,1,0,4,"H","N","2018-10-25","201810250NJD"
"NSH",1,1,1,1,0,4,0,2,1,0,0,3,"A","N","2018-10-25","201810250NJD"
"CBJ",0,1,3,3,0,7,0,2,1,1,0,4,"A","N","2018-10-25","201810250STL"
"STL",0,2,1,1,0,4,0,1,3,3,0,7,"H","N","2018-10-25","201810250STL"
"CAR",0,0,3,0,1,4,0,2,1,0,0,3,"H","Y","2018-10-26","201810260CAR"
"SJS",0,2,1,0,0,3,0,0,3,0,1,4,"A","Y","2018-10-26","201810260CAR"
"COL",0,0,2,4,0,6,0,2,1,0,0,3,"H","N","2018-10-26","201810260COL"
"OTT",0,2,1,0,0,3,0,0,2,4,0,6,"A","N","2018-10-26","201810260COL"
"DET",0,1,0,0,0,1,0,0,1,1,0,2,"H","N","2018-10-26","201810260DET"
"WPG",0,0,1,1,0,2,0,1,0,0,0,1,"A","N","2018-10-26","201810260DET"
"TBL",0,2,1,0,0,3,0,1,0,1,0,2,"A","N","2018-10-26","201810260VEG"
"VEG",0,1,0,1,0,2,0,2,1,0,0,3,"H","N","2018-10-26","201810260VEG"
"ARI",0,3,2,2,0,7,0,0,0,1,0,1,"H","N","2018-10-27","201810270ARI"
"TBL",0,0,0,1,0,1,0,3,2,2,0,7,"A","N","2018-10-27","201810270ARI"
"BOS",0,0,0,0,0,0,0,2,0,1,0,3,"H","N","2018-10-27","201810270BOS"
"MTL",0,2,0,1,0,3,0,0,0,0,0,0,"A","N","2018-10-27","201810270BOS"
"BUF",0,2,0,2,0,4,1,1,3,0,0,5,"A","N","2018-10-27","201810270CBJ"
"CBJ",1,1,3,0,0,5,0,2,0,2,0,4,"H","N","2018-10-27","201810270CBJ"
"CGY",0,2,0,1,0,3,0,2,1,0,1,4,"H","Y","2018-10-27","201810270CGY"
"WSH",0,2,1,0,1,4,0,2,0,1,0,3,"A","Y","2018-10-27","201810270CGY"
"COL",0,1,0,1,0,2,0,0,1,2,0,3,"A","N","2018-10-27","201810270MIN"
"MIN",0,0,1,2,0,3,0,1,0,1,0,2,"H","N","2018-10-27","201810270MIN"
"FLA",0,0,0,2,0,2,0,1,2,0,0,3,"A","N","2018-10-27","201810270NJD"
"NJD",0,1,2,0,0,3,0,0,0,2,0,2,"H","N","2018-10-27","201810270NJD"
"EDM",0,1,2,2,0,5,0,0,1,2,0,3,"A","N","2018-10-27","201810270NSH"
"NSH",0,0,1,2,0,3,0,1,2,2,0,5,"H","N","2018-10-27","201810270NSH"
"NYI",0,2,1,3,0,6,0,0,1,0,0,1,"A","N","2018-10-27","201810270PHI"
"PHI",0,0,1,0,0,1,0,2,1,3,0,6,"H","N","2018-10-27","201810270PHI"
"CHI",0,2,1,0,0,3,0,2,2,3,0,7,"A","N","2018-10-27","201810270STL"
"STL",0,2,2,3,0,7,0,2,1,0,0,3,"H","N","2018-10-27","201810270STL"
"TOR",0,0,0,3,0,3,0,1,1,0,0,2,"H","N","2018-10-27","201810270TOR"
"WPG",0,1,1,0,0,2,0,0,0,3,0,3,"A","N","2018-10-27","201810270TOR"
"PIT",0,0,2,3,0,5,0,0,0,0,0,0,"A","N","2018-10-27","201810270VAN"
"VAN",0,0,0,0,0,0,0,0,2,3,0,5,"H","N","2018-10-27","201810270VAN"
"ANA",0,1,1,1,0,3,1,1,2,0,0,4,"H","N","2018-10-28","201810280ANA"
"SJS",1,1,2,0,0,4,0,1,1,1,0,3,"A","N","2018-10-28","201810280ANA"
"CAR",0,0,1,0,0,1,0,1,1,0,0,2,"H","N","2018-10-28","201810280CAR"
"NYI",0,1,1,0,0,2,0,0,1,0,0,1,"A","N","2018-10-28","201810280CAR"
"CHI",0,1,0,0,0,1,1,1,0,0,0,2,"H","N","2018-10-28","201810280CHI"
"EDM",1,1,0,0,0,2,0,1,0,0,0,1,"A","N","2018-10-28","201810280CHI"
"DAL",0,1,0,1,0,2,0,0,1,3,0,4,"A","N","2018-10-28","201810280DET"
"DET",0,0,1,3,0,4,0,1,0,1,0,2,"H","N","2018-10-28","201810280DET"
"LAK",0,0,2,2,0,4,0,1,1,1,0,3,"H","N","2018-10-28","201810280LAK"
"NYR",0,1,1,1,0,3,0,0,2,2,0,4,"A","N","2018-10-28","201810280LAK"
"OTT",0,1,1,1,0,3,1,0,2,1,0,4,"A","N","2018-10-28","201810280VEG"
"VEG",1,0,2,1,0,4,0,1,1,1,0,3,"H","N","2018-10-28","201810280VEG"
"CGY",0,0,0,3,0,3,0,0,0,1,0,1,"A","N","2018-10-29","201810290TOR"
"TOR",0,0,0,1,0,1,0,0,0,3,0,3,"H","N","2018-10-29","201810290TOR"
"MIN",0,1,1,0,0,2,0,1,2,2,0,5,"A","N","2018-10-29","201810290VAN"
"VAN",0,1,2,2,0,5,0,1,1,0,0,2,"H","N","2018-10-29","201810290VAN"
"ANA",0,0,1,1,0,2,0,1,1,1,0,3,"H","N","2018-10-30","201810300ANA"
"PHI",0,1,1,1,0,3,0,0,1,1,0,2,"A","N","2018-10-30","201810300ANA"
"ARI",0,3,1,1,0,5,0,0,1,0,0,1,"H","N","2018-10-30","201810300ARI"
"OTT",0,0,1,0,0,1,0,3,1,1,0,5,"A","N","2018-10-30","201810300ARI"
"BUF",0,1,0,0,0,1,1,0,0,1,0,2,"H","N","2018-10-30","201810300BUF"
"CGY",1,0,0,1,0,2,0,1,0,0,0,1,"A","N","2018-10-30","201810300BUF"
"BOS",0,0,2,1,0,3,0,1,1,0,0,2,"A","N","2018-10-30","201810300CAR"
"CAR",0,1,1,0,0,2,0,0,2,1,0,3,"H","N","2018-10-30","201810300CAR"
"CBJ",0,0,0,3,0,3,0,3,0,2,0,5,"H","N","2018-10-30","201810300CBJ"
"DET",0,3,0,2,0,5,0,0,0,3,0,3,"A","N","2018-10-30","201810300CBJ"
"EDM",0,1,2,0,0,3,0,1,2,1,0,4,"H","N","2018-10-30","201810300EDM"
"MIN",0,1,2,1,0,4,0,1,2,0,0,3,"A","N","2018-10-30","201810300EDM"
"DAL",0,0,2,2,0,4,0,0,0,1,0,1,"A","N","2018-10-30","201810300MTL"
"MTL",0,0,0,1,0,1,0,0,2,2,0,4,"H","N","2018-10-30","201810300MTL"
"NSH",0,0,2,2,0,4,0,1,0,0,0,1,"H","N","2018-10-30","201810300NSH"
"VEG",0,1,0,0,0,1,0,0,2,2,0,4,"A","N","2018-10-30","201810300NSH"
"NYI",0,2,3,1,0,6,0,2,0,1,0,3,"A","N","2018-10-30","201810300PIT"
"PIT",0,2,0,1,0,3,0,2,3,1,0,6,"H","N","2018-10-30","201810300PIT"
"NYR",0,1,0,2,1,4,0,1,0,2,0,3,"A","Y","2018-10-30","201810300SJS"
"SJS",0,1,0,2,0,3,0,1,0,2,1,4,"H","Y","2018-10-30","201810300SJS"
"NJD",0,2,1,0,0,3,0,2,3,3,0,8,"A","N","2018-10-30","201810300TBL"
"TBL",0,2,3,3,0,8,0,2,1,0,0,3,"H","N","2018-10-30","201810300TBL"
"CHI",0,1,1,0,0,2,0,1,1,2,0,4,"A","N","2018-10-31","201810310VAN"
"VAN",0,1,1,2,0,4,0,1,1,0,0,2,"H","N","2018-10-31","201810310VAN"
"ANA",0,0,1,1,0,2,0,0,2,0,1,3,"H","Y","2018-11-01","201811010ANA"
"NYR",0,0,2,0,1,3,0,0,1,1,0,2,"A","Y","2018-11-01","201811010ANA"
"CGY",0,0,1,5,0,6,0,0,4,1,0,5,"H","N","2018-11-01","201811010CGY"
"COL",0,0,4,1,0,5,0,0,1,5,0,6,"A","N","2018-11-01","201811010CGY"
"DET",0,1,0,3,0,4,0,0,1,2,0,3,"H","N","2018-11-01","201811010DET"
"NJD",0,0,1,2,0,3,0,1,0,3,0,4,"A","N","2018-11-01","201811010DET"
"CHI",0,0,0,0,0,0,0,0,2,2,0,4,"A","N","2018-11-01","201811010EDM"
"EDM",0,0,2,2,0,4,0,0,0,0,0,0,"H","N","2018-11-01","201811010EDM"
"FLA",0,0,2,0,0,2,0,1,1,2,0,4,"H","N","2018-11-01","201811010FLA"
"WPG",0,1,1,2,0,4,0,0,2,0,0,2,"A","N","2018-11-01","201811010FLA"
"LAK",0,0,2,0,0,2,0,1,2,2,0,5,"H","N","2018-11-01","201811010LAK"
"PHI",0,1,2,2,0,5,0,0,2,0,0,2,"A","N","2018-11-01","201811010LAK"
"MTL",0,1,2,3,0,6,0,1,3,0,0,4,"H","N","2018-11-01","201811010MTL"
"WSH",0,1,3,0,0,4,0,1,2,3,0,6,"A","N","2018-11-01","201811010MTL"
"NYI",0,0,1,1,1,3,0,1,0,1,0,2,"H","Y","2018-11-01","201811010NYI"
"PIT",0,1,0,1,0,2,0,0,1,1,1,3,"A","Y","2018-11-01","201811010NYI"
"BUF",0,0,0,2,0,2,0,1,2,1,0,4,"A","N","2018-11-01","201811010OTT"
"OTT",0,1,2,1,0,4,0,0,0,2,0,2,"H","N","2018-11-01","201811010OTT"
"CBJ",0,1,2,1,0,4,0,1,0,0,0,1,"A","N","2018-11-01","201811010SJS"
"SJS",0,1,0,0,0,1,0,1,2,1,0,4,"H","N","2018-11-01","201811010SJS"
"STL",0,1,3,1,0,5,0,1,1,1,0,3,"H","N","2018-11-01","201811010STL"
"VEG",0,1,1,1,0,3,0,1,3,1,0,5,"A","N","2018-11-01","201811010STL"
"NSH",0,2,0,2,0,4,0,0,1,0,0,1,"A","N","2018-11-01","201811010TBL"
"TBL",0,0,1,0,0,1,0,2,0,2,0,4,"H","N","2018-11-01","201811010TBL"
"DAL",0,0,1,1,0,2,0,0,0,1,0,1,"A","N","2018-11-01","201811010TOR"
"TOR",0,0,0,1,0,1,0,0,1,1,0,2,"H","N","2018-11-01","201811010TOR"
"ARI",1,3,0,0,0,4,0,0,1,2,0,3,"H","N","2018-11-02","201811020ARI"
"CAR",0,0,1,2,0,3,1,3,0,0,0,4,"A","N","2018-11-02","201811020ARI"
"COL",0,0,4,2,0,6,1,1,3,2,0,7,"A","N","2018-11-02","201811020VAN"
"VAN",1,1,3,2,0,7,0,0,4,2,0,6,"H","N","2018-11-02","201811020VAN"
"FLA",0,1,2,1,0,4,0,2,0,0,0,2,"A","N","2018-11-02","201811020WPG"
"WPG",0,2,0,0,0,2,0,1,2,1,0,4,"H","N","2018-11-02","201811020WPG"
"BUF",0,3,4,2,0,9,0,0,1,1,0,2,"H","N","2018-11-03","201811030BUF"
"OTT",0,0,1,1,0,2,0,3,4,2,0,9,"A","N","2018-11-03","201811030BUF"
"CGY",0,1,1,3,0,5,0,2,1,0,0,3,"H","N","2018-11-03","201811030CGY"
"CHI",0,2,1,0,0,3,0,1,1,3,0,5,"A","N","2018-11-03","201811030CGY"
"DET",0,1,1,1,0,3,0,1,2,1,0,4,"H","N","2018-11-03","201811030DET"
"EDM",0,1,2,1,0,4,0,1,1,1,0,3,"A","N","2018-11-03","201811030DET"
"CBJ",0,0,0,1,0,1,0,1,1,2,0,4,"A","N","2018-11-03","201811030LAK"
"LAK",0,1,1,2,0,4,0,0,0,1,0,1,"H","N","2018-11-03","201811030LAK"
"MTL",0,1,0,0,0,1,0,2,0,2,0,4,"H","N","2018-11-03","201811030MTL"
"TBL",0,2,0,2,0,4,0,1,0,0,0,1,"A","N","2018-11-03","201811030MTL"
"BOS",0,0,0,0,0,0,0,1,0,0,0,1,"A","N","2018-11-03","201811030NSH"
"NSH",0,1,0,0,0,1,0,0,0,0,0,0,"H","N","2018-11-03","201811030NSH"
"NJD",0,0,0,0,0,0,0,1,0,2,0,3,"A","N","2018-11-03","201811030NYI"
"NYI",0,1,0,2,0,3,0,0,0,0,0,0,"H","N","2018-11-03","201811030NYI"
"PIT",0,0,0,0,0,0,0,1,2,2,0,5,"H","N","2018-11-03","201811030PIT"
"TOR",0,1,2,2,0,5,0,0,0,0,0,0,"A","N","2018-11-03","201811030PIT"
"PHI",0,2,1,0,0,3,1,1,1,1,0,4,"A","N","2018-11-03","201811030SJS"
"SJS",1,1,1,1,0,4,0,2,1,0,0,3,"H","N","2018-11-03","201811030SJS"
"MIN",0,3,1,1,0,5,0,1,0,0,0,1,"A","N","2018-11-03","201811030STL"
"STL",0,1,0,0,0,1,0,3,1,1,0,5,"H","N","2018-11-03","201811030STL"
"CAR",0,0,0,0,0,0,0,1,1,1,0,3,"A","N","2018-11-03","201811030VEG"
"VEG",0,1,1,1,0,3,0,0,0,0,0,0,"H","N","2018-11-03","201811030VEG"
"DAL",1,2,1,0,0,4,0,0,2,1,0,3,"A","N","2018-11-03","201811030WSH"
"WSH",0,0,2,1,0,3,1,2,1,0,0,4,"H","N","2018-11-03","201811030WSH"
"ANA",1,0,2,0,0,3,0,0,1,1,0,2,"H","N","2018-11-04","201811040ANA"
"CBJ",0,0,1,1,0,2,1,0,2,0,0,3,"A","N","2018-11-04","201811040ANA"
"BUF",0,0,0,1,0,1,0,0,2,1,0,3,"A","N","2018-11-04","201811040NYR"
"NYR",0,0,2,1,0,3,0,0,0,1,0,1,"H","N","2018-11-04","201811040NYR"
"OTT",0,2,0,1,0,3,1,0,1,2,0,4,"H","N","2018-11-04","201811040OTT"
"TBL",1,0,1,2,0,4,0,2,0,1,0,3,"A","N","2018-11-04","201811040OTT"
"ARI",0,0,1,1,0,2,0,2,1,2,0,5,"H","N","2018-11-05","201811050ARI"
"PHI",0,2,1,2,0,5,0,0,1,1,0,2,"A","N","2018-11-05","201811050ARI"
"BOS",1,1,0,0,0,2,0,1,0,0,0,1,"H","N","2018-11-05","201811050BOS"
"DAL",0,1,0,0,0,1,1,1,0,0,0,2,"A","N","2018-11-05","201811050BOS"
"MTL",0,1,1,1,1,4,0,3,0,0,0,3,"A","Y","2018-11-05","201811050NYI"
"NYI",0,3,0,0,0,3,0,1,1,1,1,4,"H","Y","2018-11-05","201811050NYI"
"NJD",0,2,2,1,0,5,0,1,0,0,0,1,"A","N","2018-11-05","201811050PIT"
"PIT",0,1,0,0,0,1,0,2,2,1,0,5,"H","N","2018-11-05","201811050PIT"
"EDM",0,1,1,0,0,2,0,2,2,0,0,4,"A","N","2018-11-05","201811050WSH"
"WSH",0,2,2,0,0,4,0,1,1,0,0,2,"H","N","2018-11-05","201811050WSH"
"CBJ",0,1,2,1,0,4,0,0,0,1,0,1,"H","N","2018-11-06","201811060CBJ"
"DAL",0,0,0,1,0,1,0,1,2,1,0,4,"A","N","2018-11-06","201811060CBJ"
"DET",0,0,1,1,1,3,0,1,1,0,0,2,"H","Y","2018-11-06","201811060DET"
"VAN",0,1,1,0,0,2,0,0,1,1,1,3,"A","Y","2018-11-06","201811060DET"
"ANA",0,0,1,0,0,1,0,2,1,1,0,4,"A","N","2018-11-06","201811060LAK"
"LAK",0,2,1,1,0,4,0,0,1,0,0,1,"H","N","2018-11-06","201811060LAK"
"MTL",0,1,2,0,0,3,0,1,1,3,0,5,"A","N","2018-11-06","201811060NYR"
"NYR",0,1,1,3,0,5,0,1,2,0,0,3,"H","N","2018-11-06","201811060NYR"
"NJD",0,2,0,1,0,3,0,2,3,2,0,7,"A","N","2018-11-06","201811060OTT"
"OTT",0,2,3,2,0,7,0,2,0,1,0,3,"H","N","2018-11-06","201811060OTT"
"MIN",0,0,1,2,0,3,0,1,2,1,0,4,"A","N","2018-11-06","201811060SJS"
"SJS",0,1,2,1,0,4,0,0,1,2,0,3,"H","N","2018-11-06","201811060SJS"
"CAR",0,1,0,0,0,1,0,3,0,1,0,4,"A","N","2018-11-06","201811060STL"
"STL",0,3,0,1,0,4,0,1,0,0,0,1,"H","N","2018-11-06","201811060STL"
"EDM",0,0,1,1,0,2,0,2,2,1,0,5,"A","N","2018-11-06","201811060TBL"
"TBL",0,2,2,1,0,5,0,0,1,1,0,2,"H","N","2018-11-06","201811060TBL"
"TOR",0,1,1,1,0,3,0,0,1,0,0,1,"H","N","2018-11-06","201811060TOR"
"VEG",0,0,1,0,0,1,0,1,1,1,0,3,"A","N","2018-11-06","201811060TOR"
"ANA",0,2,0,1,0,3,0,1,0,1,0,2,"H","N","2018-11-07","201811070ANA"
"CGY",0,1,0,1,0,2,0,2,0,1,0,3,"A","N","2018-11-07","201811070ANA"
"COL",0,0,1,0,0,1,0,2,1,1,0,4,"H","N","2018-11-07","201811070COL"
"NSH",0,2,1,1,0,4,0,0,1,0,0,1,"A","N","2018-11-07","201811070COL"
"PIT",0,1,0,0,0,1,0,0,1,1,0,2,"A","N","2018-11-07","201811070WSH"
"WSH",0,0,1,1,0,2,0,1,0,0,0,1,"H","N","2018-11-07","201811070WSH"
"BOS",0,1,3,1,0,5,0,1,5,2,0,8,"H","N","2018-11-08","201811080BOS"
"VAN",0,1,5,2,0,8,0,1,3,1,0,5,"A","N","2018-11-08","201811080BOS"
"CAR",0,3,1,0,0,4,0,0,2,1,0,3,"A","N","2018-11-08","201811080CHI"
"CHI",0,0,2,1,0,3,0,3,1,0,0,4,"H","N","2018-11-08","201811080CHI"
"DAL",0,1,2,1,0,4,0,1,1,1,0,3,"H","N","2018-11-08","201811080DAL"
"SJS",0,1,1,1,0,3,0,1,2,1,0,4,"A","N","2018-11-08","201811080DAL"
"EDM",0,0,0,1,0,1,0,0,2,2,0,4,"A","N","2018-11-08","201811080FLA"
"FLA",0,0,2,2,0,4,0,0,0,1,0,1,"H","N","2018-11-08","201811080FLA"
"LAK",0,1,0,0,0,1,0,1,1,1,0,3,"H","N","2018-11-08","201811080LAK"
"MIN",0,1,1,1,0,3,0,1,0,0,0,1,"A","N","2018-11-08","201811080LAK"
"BUF",1,3,1,1,0,6,0,3,2,0,0,5,"A","N","2018-11-08","201811080MTL"
"MTL",0,3,2,0,0,5,1,3,1,1,0,6,"H","N","2018-11-08","201811080MTL"
"OTT",0,0,1,2,0,3,0,2,1,2,0,5,"H","N","2018-11-08","201811080OTT"
"VEG",0,2,1,2,0,5,0,0,1,2,0,3,"A","N","2018-11-08","201811080OTT"
"ARI",0,1,3,0,0,4,1,2,0,2,0,5,"A","N","2018-11-08","201811080PHI"
"PHI",1,2,0,2,0,5,0,1,3,0,0,4,"H","N","2018-11-08","201811080PHI"
"NYI",0,1,0,1,0,2,0,0,2,2,0,4,"A","N","2018-11-08","201811080TBL"
"TBL",0,0,2,2,0,4,0,1,0,1,0,2,"H","N","2018-11-08","201811080TBL"
"ANA",0,0,1,0,0,1,0,1,2,2,0,5,"H","N","2018-11-09","201811090ANA"
"MIN",0,1,2,2,0,5,0,0,1,0,0,1,"A","N","2018-11-09","201811090ANA"
"DET",1,0,0,2,0,3,0,0,2,0,0,2,"H","N","2018-11-09","201811090DET"
"NYR",0,0,2,0,0,2,1,0,0,2,0,3,"A","N","2018-11-09","201811090DET"
"SJS",0,0,0,0,0,0,0,1,2,1,0,4,"A","N","2018-11-09","201811090STL"
"STL",0,1,2,1,0,4,0,0,0,0,0,0,"H","N","2018-11-09","201811090STL"
"NJD",0,0,1,0,0,1,0,1,4,1,0,6,"A","N","2018-11-09","201811090TOR"
"TOR",0,1,4,1,0,6,0,0,1,0,0,1,"H","N","2018-11-09","201811090TOR"
"COL",0,0,0,2,0,2,0,2,0,3,0,5,"A","N","2018-11-09","201811090WPG"
"WPG",0,2,0,3,0,5,0,0,0,2,0,2,"H","N","2018-11-09","201811090WPG"
"CBJ",0,1,0,1,0,2,0,0,1,0,0,1,"A","N","2018-11-09","201811090WSH"
"WSH",0,0,1,0,0,1,0,1,0,1,0,2,"H","N","2018-11-09","201811090WSH"
"BOS",0,1,2,2,0,5,0,0,1,0,0,1,"H","N","2018-11-10","201811100BOS"
"TOR",0,0,1,0,0,1,0,1,2,2,0,5,"A","N","2018-11-10","201811100BOS"
"BUF",0,1,0,2,1,4,0,0,2,1,0,3,"H","Y","2018-11-10","201811100BUF"
"VAN",0,0,2,1,0,3,0,1,0,2,1,4,"A","Y","2018-11-10","201811100BUF"
"CAR",0,1,2,0,0,3,0,1,0,2,1,4,"H","Y","2018-11-10","201811100CAR"
"DET",0,1,0,2,1,4,0,1,2,0,0,3,"A","Y","2018-11-10","201811100CAR"
"CBJ",0,1,3,0,0,4,0,1,3,0,1,5,"H","Y","2018-11-10","201811100CBJ"
"NYR",0,1,3,0,1,5,0,1,3,0,0,4,"A","Y","2018-11-10","201811100CBJ"
"DAL",0,1,2,1,0,4,1,0,1,3,0,5,"H","N","2018-11-10","201811100DAL"
"NSH",1,0,1,3,0,5,0,1,2,1,0,4,"A","N","2018-11-10","201811100DAL"
"FLA",0,1,1,2,0,4,0,1,1,0,0,2,"H","N","2018-11-10","201811100FLA"
"NYI",0,1,1,0,0,2,0,1,1,2,0,4,"A","N","2018-11-10","201811100FLA"
"CGY",0,1,0,0,0,1,0,0,0,0,0,0,"A","N","2018-11-10","201811100LAK"
"LAK",0,0,0,0,0,0,0,1,0,0,0,1,"H","N","2018-11-10","201811100LAK"
"MTL",0,0,3,2,0,5,0,2,1,1,0,4,"H","N","2018-11-10","201811100MTL"
"VEG",0,2,1,1,0,4,0,0,3,2,0,5,"A","N","2018-11-10","201811100MTL"
"CHI",0,0,0,0,0,0,0,1,1,2,0,4,"A","N","2018-11-10","201811100PHI"
"PHI",0,1,1,2,0,4,0,0,0,0,0,0,"H","N","2018-11-10","201811100PHI"
"ARI",0,0,0,0,0,0,0,0,3,1,0,4,"A","N","2018-11-10","201811100PIT"
"PIT",0,0,3,1,0,4,0,0,0,0,0,0,"H","N","2018-11-10","201811100PIT"
"OTT",0,2,0,4,0,6,0,1,3,0,0,4,"A","N","2018-11-10","201811100TBL"
"TBL",0,1,3,0,0,4,0,2,0,4,0,6,"H","N","2018-11-10","201811100TBL"
"BOS",0,2,1,1,0,4,0,0,1,0,0,1,"H","N","2018-11-11","201811110BOS"
"VEG",0,0,1,0,0,1,0,2,1,1,0,4,"A","N","2018-11-11","201811110BOS"
"COL",0,2,2,0,0,4,0,0,0,1,0,1,"A","N","2018-11-11","201811110EDM"
"EDM",0,0,0,1,0,1,0,2,2,0,0,4,"H","N","2018-11-11","201811110EDM"
"FLA",0,0,5,0,0,5,0,1,0,0,0,1,"H","N","2018-11-11","201811110FLA"
"OTT",0,1,0,0,0,1,0,0,5,0,0,5,"A","N","2018-11-11","201811110FLA"
"CGY",0,0,1,0,0,1,0,1,1,1,0,3,"A","N","2018-11-11","201811110SJS"
"SJS",0,1,1,1,0,3,0,0,1,0,0,1,"H","N","2018-11-11","201811110SJS"
"MIN",0,0,2,1,0,3,0,1,1,0,0,2,"A","N","2018-11-11","201811110STL"
"STL",0,1,1,0,0,2,0,0,2,1,0,3,"H","N","2018-11-11","201811110STL"
"NJD",0,1,1,0,0,2,0,2,3,0,0,5,"A","N","2018-11-11","201811110WPG"
"WPG",0,2,3,0,0,5,0,1,1,0,0,2,"H","N","2018-11-11","201811110WPG"
"ARI",0,1,2,1,0,4,0,0,1,0,0,1,"A","N","2018-11-11","201811110WSH"
"WSH",0,0,1,0,0,1,0,1,2,1,0,4,"H","N","2018-11-11","201811110WSH"
"ANA",0,0,1,0,1,2,0,0,0,1,0,1,"H","Y","2018-11-12","201811120ANA"
"NSH",0,0,0,1,0,1,0,0,1,0,1,2,"A","Y","2018-11-12","201811120ANA"
"CAR",1,0,2,0,0,3,0,1,1,0,0,2,"H","N","2018-11-12","201811120CAR"
"CHI",0,1,1,0,0,2,1,0,2,0,0,3,"A","N","2018-11-12","201811120CAR"
"CBJ",0,0,1,1,0,2,0,0,1,0,0,1,"A","N","2018-11-12","201811120DAL"
"DAL",0,0,1,0,0,1,0,0,1,1,0,2,"H","N","2018-11-12","201811120DAL"
"NYR",0,0,1,1,0,2,0,0,1,0,0,1,"H","N","2018-11-12","201811120NYR"
"VAN",0,0,1,0,0,1,0,0,1,1,0,2,"A","N","2018-11-12","201811120NYR"
"BUF",0,1,1,0,0,2,0,0,1,0,0,1,"H","N","2018-11-13","201811130BUF"
"TBL",0,0,1,0,0,1,0,1,1,0,0,2,"A","N","2018-11-13","201811130BUF"
"ARI",0,0,0,1,0,1,0,3,1,2,0,6,"A","N","2018-11-13","201811130DET"
"DET",0,3,1,2,0,6,0,0,0,1,0,1,"H","N","2018-11-13","201811130DET"
"EDM",0,2,1,3,0,6,0,1,1,0,0,2,"H","N","2018-11-13","201811130EDM"
"MTL",0,1,1,0,0,2,0,2,1,3,0,6,"A","N","2018-11-13","201811130EDM"
"LAK",0,1,0,0,0,1,0,2,3,0,0,5,"H","N","2018-11-13","201811130LAK"
"TOR",0,2,3,0,0,5,0,1,0,0,0,1,"A","N","2018-11-13","201811130LAK"
"MIN",0,0,1,1,0,2,0,2,1,2,0,5,"H","N","2018-11-13","201811130MIN"
"WSH",0,2,1,2,0,5,0,0,1,1,0,2,"A","N","2018-11-13","201811130MIN"
"NJD",0,1,1,2,0,4,0,1,0,1,0,2,"H","N","2018-11-13","201811130NJD"
"PIT",0,1,0,1,0,2,0,1,1,2,0,4,"A","N","2018-11-13","201811130NJD"
"NYI",0,3,0,2,0,5,0,1,1,0,0,2,"H","N","2018-11-13","201811130NYI"
"VAN",0,1,1,0,0,2,0,3,0,2,0,5,"A","N","2018-11-13","201811130NYI"
"FLA",0,0,2,0,0,2,0,0,0,1,0,1,"A","N","2018-11-13","201811130PHI"
"PHI",0,0,0,1,0,1,0,0,2,0,0,2,"H","N","2018-11-13","201811130PHI"
"NSH",0,0,3,1,0,4,0,3,0,2,0,5,"A","N","2018-11-13","201811130SJS"
"SJS",0,3,0,2,0,5,0,0,3,1,0,4,"H","N","2018-11-13","201811130SJS"
"CHI",0,0,1,0,0,1,0,0,0,0,0,0,"H","N","2018-11-14","201811140CHI"
"STL",0,0,0,0,0,0,0,0,1,0,0,1,"A","N","2018-11-14","201811140CHI"
"BOS",0,2,1,0,0,3,0,1,1,4,0,6,"A","N","2018-11-14","201811140COL"
"COL",0,1,1,4,0,6,0,2,1,0,0,3,"H","N","2018-11-14","201811140COL"
"ANA",0,0,0,0,0,0,0,1,3,1,0,5,"A","N","2018-11-14","201811140VEG"
"VEG",0,1,3,1,0,5,0,0,0,0,0,0,"H","N","2018-11-14","201811140VEG"
"WPG",0,0,1,2,0,3,0,1,0,0,0,1,"H","N","2018-11-14","201811140WPG"
"WSH",0,1,0,0,0,1,0,0,1,2,0,3,"A","N","2018-11-14","201811140WPG"
"ARI",0,1,1,0,0,2,0,0,0,1,0,1,"H","N","2018-11-15","201811150ARI"
"NSH",0,0,0,1,0,1,0,1,1,0,0,2,"A","N","2018-11-15","201811150ARI"
"CBJ",0,0,3,4,0,7,0,2,1,0,0,3,"H","N","2018-11-15","201811150CBJ"
"FLA",0,2,1,0,0,3,0,0,3,4,0,7,"A","N","2018-11-15","201811150CBJ"
"CGY",0,0,2,0,0,2,0,1,0,2,0,3,"H","N","2018-11-15","201811150CGY"
"MTL",0,1,0,2,0,3,0,0,2,0,0,2,"A","N","2018-11-15","201811150CGY"
"MIN",0,2,3,1,0,6,0,0,1,1,0,2,"H","N","2018-11-15","201811150MIN"
"VAN",0,0,1,1,0,2,0,2,3,1,0,6,"A","N","2018-11-15","201811150MIN"
"NYI",0,2,3,2,0,7,0,2,1,2,0,5,"H","N","2018-11-15","201811150NYI"
"NYR",0,2,1,2,0,5,0,2,3,2,0,7,"A","N","2018-11-15","201811150NYI"
"DET",0,0,1,0,0,1,0,1,1,0,0,2,"A","N","2018-11-15","201811150OTT"
"OTT",0,1,1,0,0,2,0,0,1,0,0,1,"H","N","2018-11-15","201811150OTT"
"NJD",0,1,0,2,0,3,0,0,0,0,0,0,"A","N","2018-11-15","201811150PHI"
"PHI",0,0,0,0,0,0,0,1,0,2,0,3,"H","N","2018-11-15","201811150PHI"
"PIT",0,2,1,0,0,3,0,1,3,0,0,4,"H","N","2018-11-15","201811150PIT"
"TBL",0,1,3,0,0,4,0,2,1,0,0,3,"A","N","2018-11-15","201811150PIT"
"SJS",0,3,0,0,0,3,0,2,2,1,0,5,"H","N","2018-11-15","201811150SJS"
"TOR",0,2,2,1,0,5,0,3,0,0,0,3,"A","N","2018-11-15","201811150SJS"
"ANA",0,0,1,0,0,1,1,1,0,0,0,2,"H","N","2018-11-16","201811160ANA"
"TOR",1,1,0,0,0,2,0,0,1,0,0,1,"A","N","2018-11-16","201811160ANA"
"CHI",0,0,0,1,0,1,0,0,1,0,1,2,"H","Y","2018-11-16","201811160CHI"
"LAK",0,0,1,0,1,2,0,0,0,1,0,1,"A","Y","2018-11-16","201811160CHI"
"COL",0,1,0,1,0,2,1,0,2,0,0,3,"H","N","2018-11-16","201811160COL"
"WSH",1,0,2,0,0,3,0,1,0,1,0,2,"A","N","2018-11-16","201811160COL"
"BOS",0,0,0,0,0,0,1,0,0,0,0,1,"A","N","2018-11-16","201811160DAL"
"DAL",1,0,0,0,0,1,0,0,0,0,0,0,"H","N","2018-11-16","201811160DAL"
"STL",0,1,3,0,0,4,0,1,0,0,0,1,"A","N","2018-11-16","201811160VEG"
"VEG",0,1,0,0,0,1,0,1,3,0,0,4,"H","N","2018-11-16","201811160VEG"
"BUF",0,0,0,1,1,2,0,0,1,0,0,1,"A","Y","2018-11-16","201811160WPG"
"WPG",0,0,1,0,0,1,0,0,0,1,1,2,"H","Y","2018-11-16","201811160WPG"
"ARI",0,0,1,0,0,1,0,2,0,0,0,2,"H","N","2018-11-17","201811170ARI"
"BOS",0,2,0,0,0,2,0,0,1,0,0,1,"A","N","2018-11-17","201811170ARI"
"CAR",0,0,1,0,0,1,0,1,3,0,0,4,"H","N","2018-11-17","201811170CAR"
"CBJ",0,1,3,0,0,4,0,0,1,0,0,1,"A","N","2018-11-17","201811170CAR"
"CGY",0,0,1,3,0,4,0,1,1,0,0,2,"H","N","2018-11-17","201811170CGY"
"EDM",0,1,1,0,0,2,0,0,1,3,0,4,"A","N","2018-11-17","201811170CGY"
"BUF",0,1,0,2,0,3,0,2,0,0,0,2,"A","N","2018-11-17","201811170MIN"
"MIN",0,2,0,0,0,2,0,1,0,2,0,3,"H","N","2018-11-17","201811170MIN"
"DET",1,0,1,1,0,3,0,1,1,0,0,2,"A","N","2018-11-17","201811170NJD"
"NJD",0,1,1,0,0,2,1,0,1,1,0,3,"H","N","2018-11-17","201811170NJD"
"LAK",0,0,3,0,0,3,0,0,2,3,0,5,"A","N","2018-11-17","201811170NSH"
"NSH",0,0,2,3,0,5,0,0,3,0,0,3,"H","N","2018-11-17","201811170NSH"
"FLA",0,2,0,0,0,2,0,2,1,1,0,4,"A","N","2018-11-17","201811170NYR"
"NYR",0,2,1,1,0,4,0,2,0,0,0,2,"H","N","2018-11-17","201811170NYR"
"OTT",0,3,2,1,0,6,0,1,0,3,0,4,"H","N","2018-11-17","201811170OTT"
"PIT",0,1,0,3,0,4,0,3,2,1,0,6,"A","N","2018-11-17","201811170OTT"
"PHI",0,0,1,4,0,5,1,0,3,2,0,6,"H","N","2018-11-17","201811170PHI"
"TBL",1,0,3,2,0,6,0,0,1,4,0,5,"A","N","2018-11-17","201811170PHI"
"SJS",0,0,3,1,0,4,0,0,0,0,0,0,"H","N","2018-11-17","201811170SJS"
"STL",0,0,0,0,0,0,0,0,3,1,0,4,"A","N","2018-11-17","201811170SJS"
"MTL",0,0,1,2,0,3,0,0,1,1,0,2,"A","N","2018-11-17","201811170VAN"
"VAN",0,0,1,1,0,2,0,0,1,2,0,3,"H","N","2018-11-17","201811170VAN"
"ANA",0,1,2,0,0,3,1,0,2,1,0,4,"H","N","2018-11-18","201811180ANA"
"COL",1,0,2,1,0,4,0,1,2,0,0,3,"A","N","2018-11-18","201811180ANA"
"CAR",0,2,0,0,0,2,0,1,0,0,0,1,"H","N","2018-11-18","201811180CAR"
"NJD",0,1,0,0,0,1,0,2,0,0,0,2,"A","N","2018-11-18","201811180CAR"
"CHI",0,2,0,1,0,3,0,0,1,0,0,1,"H","N","2018-11-18","201811180CHI"
"MIN",0,0,1,0,0,1,0,2,0,1,0,3,"A","N","2018-11-18","201811180CHI"
"EDM",0,2,0,1,0,3,0,1,3,2,0,6,"H","N","2018-11-18","201811180EDM"
"VEG",0,1,3,2,0,6,0,2,0,1,0,3,"A","N","2018-11-18","201811180EDM"
"DAL",0,0,4,2,0,6,0,1,0,1,0,2,"A","N","2018-11-18","201811180NYI"
"NYI",0,1,0,1,0,2,0,0,4,2,0,6,"H","N","2018-11-18","201811180NYI"
"CGY",0,5,2,0,0,7,0,0,0,2,0,2,"H","N","2018-11-19","201811190CGY"
"VEG",0,0,0,2,0,2,0,5,2,0,0,7,"A","N","2018-11-19","201811190CGY"
"MTL",0,1,3,0,0,4,1,2,1,1,0,5,"H","N","2018-11-19","201811190MTL"
"WSH",1,2,1,1,0,5,0,1,3,0,0,4,"A","N","2018-11-19","201811190MTL"
"NSH",0,1,2,0,0,3,0,1,0,1,0,2,"H","N","2018-11-19","201811190NSH"
"TBL",0,1,0,1,0,2,0,1,2,0,0,3,"A","N","2018-11-19","201811190NSH"
"DAL",0,0,1,0,0,1,0,0,1,1,0,2,"A","N","2018-11-19","201811190NYR"
"NYR",0,0,1,1,0,2,0,0,1,0,0,1,"H","N","2018-11-19","201811190NYR"
"FLA",0,4,2,1,0,7,0,1,2,2,0,5,"A","N","2018-11-19","201811190OTT"
"OTT",0,1,2,2,0,5,0,4,2,1,0,7,"H","N","2018-11-19","201811190OTT"
"BUF",1,1,2,1,0,5,0,2,2,0,0,4,"A","N","2018-11-19","201811190PIT"
"PIT",0,2,2,0,0,4,1,1,2,1,0,5,"H","N","2018-11-19","201811190PIT"
"LAK",0,0,1,1,0,2,0,0,0,0,0,0,"A","N","2018-11-19","201811190STL"
"STL",0,0,0,0,0,0,0,0,1,1,0,2,"H","N","2018-11-19","201811190STL"
"CBJ",0,2,0,0,0,2,0,0,2,2,0,4,"A","N","2018-11-19","201811190TOR"
"TOR",0,0,2,2,0,4,0,2,0,0,0,2,"H","N","2018-11-19","201811190TOR"
"VAN",0,1,2,0,0,3,0,3,1,2,0,6,"H","N","2018-11-19","201811190VAN"
"WPG",0,3,1,2,0,6,0,1,2,0,0,3,"A","N","2018-11-19","201811190VAN"
"EDM",1,1,1,1,0,4,0,2,1,0,0,3,"A","N","2018-11-20","201811200SJS"
"SJS",0,2,1,0,0,3,1,1,1,1,0,4,"H","N","2018-11-20","201811200SJS"
"ANA",0,1,1,2,0,4,0,0,1,2,0,3,"H","N","2018-11-21","201811210ANA"
"VAN",0,0,1,2,0,3,0,1,1,2,0,4,"A","N","2018-11-21","201811210ANA"
"ARI",0,1,0,1,0,2,1,0,2,0,0,3,"H","N","2018-11-21","201811210ARI"
"VEG",1,0,2,0,0,3,0,1,0,1,0,2,"A","N","2018-11-21","201811210ARI"
"BUF",0,4,0,1,0,5,0,0,2,0,0,2,"H","N","2018-11-21","201811210BUF"
"PHI",0,0,2,0,0,2,0,4,0,1,0,5,"A","N","2018-11-21","201811210BUF"
"CAR",0,2,0,3,0,5,0,1,0,1,0,2,"H","N","2018-11-21","201811210CAR"
"TOR",0,1,0,1,0,2,0,2,0,3,0,5,"A","N","2018-11-21","201811210CAR"
"CGY",0,5,0,1,0,6,0,1,1,1,0,3,"H","N","2018-11-21","201811210CGY"
"WPG",0,1,1,1,0,3,0,5,0,1,0,6,"A","N","2018-11-21","201811210CGY"
"BOS",0,0,1,1,0,2,1,0,1,1,0,3,"A","N","2018-11-21","201811210DET"
"DET",1,0,1,1,0,3,0,0,1,1,0,2,"H","N","2018-11-21","201811210DET"
"COL",0,2,2,3,0,7,0,1,0,2,0,3,"A","N","2018-11-21","201811210LAK"
"LAK",0,1,0,2,0,3,0,2,2,3,0,7,"H","N","2018-11-21","201811210LAK"
"MIN",0,2,2,2,0,6,0,0,1,3,0,4,"H","N","2018-11-21","201811210MIN"
"OTT",0,0,1,3,0,4,0,2,2,2,0,6,"A","N","2018-11-21","201811210MIN"
"MTL",0,1,0,1,0,2,0,2,3,0,0,5,"A","N","2018-11-21","201811210NJD"
"NJD",0,2,3,0,0,5,0,1,0,1,0,2,"H","N","2018-11-21","201811210NJD"
"NSH",0,1,1,2,0,4,0,1,0,0,0,1,"H","N","2018-11-21","201811210NSH"
"STL",0,1,0,0,0,1,0,1,1,2,0,4,"A","N","2018-11-21","201811210NSH"
"NYI",0,0,0,0,0,0,0,3,1,1,0,5,"A","N","2018-11-21","201811210NYR"
"NYR",0,3,1,1,0,5,0,0,0,0,0,0,"H","N","2018-11-21","201811210NYR"
"DAL",0,0,0,1,0,1,0,3,2,0,0,5,"A","N","2018-11-21","201811210PIT"
"PIT",0,3,2,0,0,5,0,0,0,1,0,1,"H","N","2018-11-21","201811210PIT"
"FLA",0,1,1,1,0,3,0,2,2,3,0,7,"A","N","2018-11-21","201811210TBL"
"TBL",0,2,2,3,0,7,0,1,1,1,0,3,"H","N","2018-11-21","201811210TBL"
"CHI",0,0,1,1,0,2,0,2,1,1,0,4,"A","N","2018-11-21","201811210WSH"
"WSH",0,2,1,1,0,4,0,0,1,1,0,2,"H","N","2018-11-21","201811210WSH"
"ANA",1,0,0,1,0,2,0,0,0,1,0,1,"H","N","2018-11-23","201811230ANA"
"EDM",0,0,0,1,0,1,1,0,0,1,0,2,"A","N","2018-11-23","201811230ANA"
"ARI",0,0,0,1,0,1,0,3,0,2,0,5,"H","N","2018-11-23","201811230ARI"
"COL",0,3,0,2,0,5,0,0,0,1,0,1,"A","N","2018-11-23","201811230ARI"
"BOS",1,0,1,0,0,2,0,0,1,0,0,1,"H","N","2018-11-23","201811230BOS"
"PIT",0,0,1,0,0,1,1,0,1,0,0,2,"A","N","2018-11-23","201811230BOS"
"BUF",1,1,0,1,0,3,0,0,1,1,0,2,"H","N","2018-11-23","201811230BUF"
"MTL",0,0,1,1,0,2,1,1,0,1,0,3,"A","N","2018-11-23","201811230BUF"
"CAR",0,1,0,3,0,4,0,0,0,1,0,1,"H","N","2018-11-23","201811230CAR"
"FLA",0,0,0,1,0,1,0,1,0,3,0,4,"A","N","2018-11-23","201811230CAR"
"CBJ",0,2,1,1,0,4,0,1,1,0,0,2,"H","N","2018-11-23","201811230CBJ"
"TOR",0,1,1,0,0,2,0,2,1,1,0,4,"A","N","2018-11-23","201811230CBJ"
"DAL",0,1,2,3,0,6,0,1,1,2,0,4,"H","N","2018-11-23","201811230DAL"
"OTT",0,1,1,2,0,4,0,1,2,3,0,6,"A","N","2018-11-23","201811230DAL"
"MIN",0,0,0,4,0,4,0,1,1,0,0,2,"H","N","2018-11-23","201811230MIN"
"WPG",0,1,1,0,0,2,0,0,0,4,0,4,"A","N","2018-11-23","201811230MIN"
"NJD",0,0,1,2,0,3,1,1,1,1,0,4,"H","N","2018-11-23","201811230NJD"
"NYI",1,1,1,1,0,4,0,0,1,2,0,3,"A","N","2018-11-23","201811230NJD"
"NYR",0,0,0,0,0,0,0,1,0,3,0,4,"A","N","2018-11-23","201811230PHI"
"PHI",0,1,0,3,0,4,0,0,0,0,0,0,"H","N","2018-11-23","201811230PHI"
"SJS",0,2,0,2,0,4,0,0,0,0,0,0,"H","N","2018-11-23","201811230SJS"
"VAN",0,0,0,0,0,0,0,2,0,2,0,4,"A","N","2018-11-23","201811230SJS"
"NSH",0,1,0,1,0,2,0,3,2,1,0,6,"A","N","2018-11-23","201811230STL"
"STL",0,3,2,1,0,6,0,1,0,1,0,2,"H","N","2018-11-23","201811230STL"
"CHI",0,1,1,0,0,2,0,4,0,0,0,4,"A","N","2018-11-23","201811230TBL"
"TBL",0,4,0,0,0,4,0,1,1,0,0,2,"H","N","2018-11-23","201811230TBL"
"CGY",0,0,0,0,0,0,0,0,1,1,0,2,"A","N","2018-11-23","201811230VEG"
"VEG",0,0,1,1,0,2,0,0,0,0,0,0,"H","N","2018-11-23","201811230VEG"
"DET",0,1,0,0,0,1,0,0,1,2,0,3,"A","N","2018-11-23","201811230WSH"
"WSH",0,0,1,2,0,3,0,1,0,0,0,1,"H","N","2018-11-23","201811230WSH"
"COL",0,0,1,2,0,3,0,0,0,2,0,2,"H","N","2018-11-24","201811240COL"
"DAL",0,0,0,2,0,2,0,0,1,2,0,3,"A","N","2018-11-24","201811240COL"
"BUF",0,1,0,1,1,3,0,0,1,1,0,2,"A","Y","2018-11-24","201811240DET"
"DET",0,0,1,1,0,2,0,1,0,1,1,3,"H","Y","2018-11-24","201811240DET"
"CHI",1,0,2,2,0,5,0,2,2,0,0,4,"A","N","2018-11-24","201811240FLA"
"FLA",0,2,2,0,0,4,1,0,2,2,0,5,"H","N","2018-11-24","201811240FLA"
"LAK",0,0,2,0,0,2,0,0,2,2,0,4,"H","N","2018-11-24","201811240LAK"
"VAN",0,0,2,2,0,4,0,0,2,0,0,2,"A","N","2018-11-24","201811240LAK"
"BOS",0,2,0,1,0,3,0,0,0,2,0,2,"A","N","2018-11-24","201811240MTL"
"MTL",0,0,0,2,0,2,0,2,0,1,0,3,"H","N","2018-11-24","201811240MTL"
"CAR",0,0,0,1,0,1,0,2,1,1,0,4,"A","N","2018-11-24","201811240NYI"
"NYI",0,2,1,1,0,4,0,0,0,1,0,1,"H","N","2018-11-24","201811240NYI"
"NYR",0,1,1,1,0,3,0,0,3,2,0,5,"H","N","2018-11-24","201811240NYR"
"WSH",0,0,3,2,0,5,0,1,1,1,0,3,"A","N","2018-11-24","201811240NYR"
"CBJ",0,1,1,0,0,2,0,3,1,0,0,4,"A","N","2018-11-24","201811240PIT"
"PIT",0,3,1,0,0,4,0,1,1,0,0,2,"H","N","2018-11-24","201811240PIT"
"STL",0,2,0,2,0,4,0,2,4,2,0,8,"H","N","2018-11-24","201811240STL"
"WPG",0,2,4,2,0,8,0,2,0,2,0,4,"A","N","2018-11-24","201811240STL"
"PHI",0,0,0,0,0,0,0,4,2,0,0,6,"A","N","2018-11-24","201811240TOR"
"TOR",0,4,2,0,0,6,0,0,0,0,0,0,"H","N","2018-11-24","201811240TOR"
"SJS",0,0,0,0,0,0,0,4,1,1,0,6,"A","N","2018-11-24","201811240VEG"
"VEG",0,4,1,1,0,6,0,0,0,0,0,0,"H","N","2018-11-24","201811240VEG"
"ARI",0,0,0,1,0,1,0,2,2,2,0,6,"H","N","2018-11-25","201811250ARI"
"CGY",0,2,2,2,0,6,0,0,0,1,0,1,"A","N","2018-11-25","201811250ARI"
"EDM",0,1,1,0,0,2,0,1,1,3,0,5,"A","N","2018-11-25","201811250LAK"
"LAK",0,1,1,3,0,5,0,1,1,0,0,2,"H","N","2018-11-25","201811250LAK"
"ANA",0,0,2,0,0,2,0,1,2,2,0,5,"A","N","2018-11-25","201811250NSH"
"NSH",0,1,2,2,0,5,0,0,2,0,0,2,"H","N","2018-11-25","201811250NSH"
"NJD",0,1,0,1,0,2,0,4,1,0,0,5,"A","N","2018-11-25","201811250TBL"
"TBL",0,4,1,0,0,5,0,1,0,1,0,2,"H","N","2018-11-25","201811250TBL"
"CBJ",0,3,2,2,0,7,0,0,3,2,0,5,"A","N","2018-11-26","201811260DET"
"DET",0,0,3,2,0,5,0,3,2,2,0,7,"H","N","2018-11-26","201811260DET"
"FLA",1,0,2,1,0,4,0,0,2,1,0,3,"H","N","2018-11-26","201811260FLA"
"NJD",0,0,2,1,0,3,1,0,2,1,0,4,"A","N","2018-11-26","201811260FLA"
"NYI",0,1,0,0,0,1,0,1,1,2,0,4,"H","N","2018-11-26","201811260NYI"
"WSH",0,1,1,2,0,4,0,1,0,0,0,1,"A","N","2018-11-26","201811260NYI"
"NYR",0,1,0,3,0,4,0,1,0,1,0,2,"H","N","2018-11-26","201811260NYR"
"OTT",0,1,0,1,0,2,0,1,0,3,0,4,"A","N","2018-11-26","201811260NYR"
"BOS",0,0,2,0,0,2,0,1,2,1,0,4,"A","N","2018-11-26","201811260TOR"
"TOR",0,1,2,1,0,4,0,0,2,0,0,2,"H","N","2018-11-26","201811260TOR"
"BUF",1,0,1,1,0,3,0,0,0,2,0,2,"H","N","2018-11-27","201811270BUF"
"SJS",0,0,0,2,0,2,1,0,1,1,0,3,"A","N","2018-11-27","201811270BUF"
"CHI",0,0,2,1,0,3,0,3,3,2,0,8,"H","N","2018-11-27","201811270CHI"
"VEG",0,3,3,2,0,8,0,0,2,1,0,3,"A","N","2018-11-27","201811270CHI"
"DAL",0,0,0,0,0,0,1,0,0,0,0,1,"A","N","2018-11-27","201811270EDM"
"EDM",1,0,0,0,0,1,0,0,0,0,0,0,"H","N","2018-11-27","201811270EDM"
"ARI",0,1,0,3,0,4,0,1,2,0,0,3,"A","N","2018-11-27","201811270MIN"
"MIN",0,1,2,0,0,3,0,1,0,3,0,4,"H","N","2018-11-27","201811270MIN"
"CAR",0,1,1,0,0,2,0,0,0,1,0,1,"A","N","2018-11-27","201811270MTL"
"MTL",0,0,0,1,0,1,0,1,1,0,0,2,"H","N","2018-11-27","201811270MTL"
"COL",0,1,1,1,0,3,0,1,1,0,0,2,"A","N","2018-11-27","201811270NSH"
"NSH",0,1,1,0,0,2,0,1,1,1,0,3,"H","N","2018-11-27","201811270NSH"
"OTT",0,1,0,3,0,4,0,1,2,0,0,3,"A","N","2018-11-27","201811270PHI"
"PHI",0,1,2,0,0,3,0,1,0,3,0,4,"H","N","2018-11-27","201811270PHI"
"ANA",0,0,1,2,0,3,0,0,1,0,0,1,"A","N","2018-11-27","201811270TBL"
"TBL",0,0,1,0,0,1,0,0,1,2,0,3,"H","N","2018-11-27","201811270TBL"
"LAK",1,0,1,0,0,2,0,0,0,1,0,1,"A","N","2018-11-27","201811270VAN"
"VAN",0,0,0,1,0,1,1,0,1,0,0,2,"H","N","2018-11-27","201811270VAN"
"PIT",0,1,1,2,0,4,0,1,2,0,0,3,"A","N","2018-11-27","201811270WPG"
"WPG",0,1,2,0,0,3,0,1,1,2,0,4,"H","N","2018-11-27","201811270WPG"
"CGY",0,1,0,2,0,3,1,1,1,1,0,4,"H","N","2018-11-28","201811280CGY"
"DAL",1,1,1,1,0,4,0,1,0,2,0,3,"A","N","2018-11-28","201811280CGY"
"COL",0,1,2,3,0,6,0,0,2,1,0,3,"H","N","2018-11-28","201811280COL"
"PIT",0,0,2,1,0,3,0,1,2,3,0,6,"A","N","2018-11-28","201811280COL"
"DET",0,0,3,1,0,4,0,0,2,1,0,3,"H","N","2018-11-28","201811280DET"
"STL",0,0,2,1,0,3,0,0,3,1,0,4,"A","N","2018-11-28","201811280DET"
"ANA",0,1,1,1,0,3,0,0,2,0,0,2,"A","N","2018-11-28","201811280FLA"
"FLA",0,0,2,0,0,2,0,1,1,1,0,3,"H","N","2018-11-28","201811280FLA"
"SJS",0,1,1,1,0,3,0,3,1,1,0,5,"A","N","2018-11-28","201811280TOR"
"TOR",0,3,1,1,0,5,0,1,1,1,0,3,"H","N","2018-11-28","201811280TOR"
"BOS",0,0,1,0,1,2,0,1,0,0,0,1,"H","Y","2018-11-29","201811290BOS"
"NYI",0,1,0,0,0,1,0,0,1,0,1,2,"A","Y","2018-11-29","201811290BOS"
"CBJ",0,1,3,0,0,4,0,1,1,0,0,2,"H","N","2018-11-29","201811290CBJ"
"MIN",0,1,1,0,0,2,0,1,3,0,0,4,"A","N","2018-11-29","201811290CBJ"
"EDM",0,2,0,1,0,3,0,2,0,0,0,2,"H","N","2018-11-29","201811290EDM"
"LAK",0,2,0,0,0,2,0,2,0,1,0,3,"A","N","2018-11-29","201811290EDM"
"ARI",0,0,2,1,0,3,0,0,0,0,0,0,"A","N","2018-11-29","201811290NSH"
"NSH",0,0,0,0,0,0,0,0,2,1,0,3,"H","N","2018-11-29","201811290NSH"
"NYR",0,0,0,0,0,0,0,2,1,0,0,3,"A","N","2018-11-29","201811290OTT"
"OTT",0,2,1,0,0,3,0,0,0,0,0,0,"H","N","2018-11-29","201811290OTT"
"BUF",0,2,1,1,0,4,0,3,0,2,0,5,"A","N","2018-11-29","201811290TBL"
"TBL",0,3,0,2,0,5,0,2,1,1,0,4,"H","N","2018-11-29","201811290TBL"
"VAN",0,1,0,2,0,3,0,1,1,2,0,4,"H","N","2018-11-29","201811290VAN"
"VEG",0,1,1,2,0,4,0,1,0,2,0,3,"A","N","2018-11-29","201811290VAN"
"CHI",0,2,1,2,0,5,0,2,2,2,0,6,"A","N","2018-11-29","201811290WPG"
"WPG",0,2,2,2,0,6,0,2,1,2,0,5,"H","N","2018-11-29","201811290WPG"
"ANA",1,0,0,1,0,2,0,1,0,0,0,1,"A","N","2018-11-30","201811300CAR"
"CAR",0,1,0,0,0,1,1,0,0,1,0,2,"H","N","2018-11-30","201811300CAR"
"CGY",0,1,0,3,0,4,0,0,1,0,0,1,"H","N","2018-11-30","201811300CGY"
"LAK",0,0,1,0,0,1,0,1,0,3,0,4,"A","N","2018-11-30","201811300CGY"
"COL",0,0,1,1,0,2,1,2,0,0,0,3,"H","N","2018-11-30","201811300COL"
"STL",1,2,0,0,0,3,0,0,1,1,0,2,"A","N","2018-11-30","201811300COL"
"BUF",0,1,1,0,0,2,1,1,0,1,0,3,"A","N","2018-11-30","201811300FLA"
"FLA",1,1,0,1,0,3,0,1,1,0,0,2,"H","N","2018-11-30","201811300FLA"
"NJD",0,0,1,2,0,3,0,1,1,4,0,6,"A","N","2018-11-30","201811300WSH"
"WSH",0,1,1,4,0,6,0,0,1,2,0,3,"H","N","2018-11-30","201811300WSH"
"ARI",0,1,4,1,0,6,0,0,1,0,0,1,"H","N","2018-12-01","201812010ARI"
"STL",0,0,1,0,0,1,0,1,4,1,0,6,"A","N","2018-12-01","201812010ARI"
"BOS",0,1,0,1,0,2,0,0,2,2,0,4,"H","N","2018-12-01","201812010BOS"
"DET",0,0,2,2,0,4,0,1,0,1,0,2,"A","N","2018-12-01","201812010BOS"
"EDM",0,1,0,1,0,2,0,0,1,0,0,1,"H","N","2018-12-01","201812010EDM"
"VEG",0,0,1,0,0,1,0,1,0,1,0,2,"A","N","2018-12-01","201812010EDM"
"FLA",0,2,2,0,0,4,1,1,2,1,0,5,"H","N","2018-12-01","201812010FLA"
"TBL",1,1,2,1,0,5,0,2,2,0,0,4,"A","N","2018-12-01","201812010FLA"
"MIN",0,1,1,1,0,3,0,2,1,2,0,5,"H","N","2018-12-01","201812010MIN"
"TOR",0,2,1,2,0,5,0,1,1,1,0,3,"A","N","2018-12-01","201812010MIN"
"MTL",0,2,2,1,0,5,0,0,2,0,0,2,"H","N","2018-12-01","201812010MTL"
"NYR",0,0,2,0,0,2,0,2,2,1,0,5,"A","N","2018-12-01","201812010MTL"
"NJD",0,1,0,2,0,3,1,0,1,2,0,4,"H","N","2018-12-01","201812010NJD"
"WPG",1,0,1,2,0,4,0,1,0,2,0,3,"A","N","2018-12-01","201812010NJD"
"CHI",0,1,1,0,0,2,0,4,0,1,0,5,"A","N","2018-12-01","201812010NSH"
"NSH",0,4,0,1,0,5,0,1,1,0,0,2,"H","N","2018-12-01","201812010NSH"
"CBJ",0,0,2,0,0,2,0,0,2,1,0,3,"A","N","2018-12-01","201812010NYI"
"NYI",0,0,2,1,0,3,0,0,2,0,0,2,"H","N","2018-12-01","201812010NYI"
"OTT",0,0,3,3,0,6,0,0,1,1,0,2,"H","N","2018-12-01","201812010OTT"
"SJS",0,0,1,1,0,2,0,0,3,3,0,6,"A","N","2018-12-01","201812010OTT"
"PHI",0,1,1,2,0,4,0,1,1,0,0,2,"A","N","2018-12-01","201812010PIT"
"PIT",0,1,1,0,0,2,0,1,1,2,0,4,"H","N","2018-12-01","201812010PIT"
"DAL",0,0,0,2,0,2,0,1,0,0,0,1,"A","N","2018-12-01","201812010VAN"
"VAN",0,1,0,0,0,1,0,0,0,2,0,2,"H","N","2018-12-01","201812010VAN"
"CGY",0,1,2,0,0,3,0,1,1,0,0,2,"A","N","2018-12-02","201812020CHI"
"CHI",0,1,1,0,0,2,0,1,2,0,0,3,"H","N","2018-12-02","201812020CHI"
"COL",0,0,1,1,0,2,0,0,0,0,0,0,"A","N","2018-12-02","201812020DET"
"DET",0,0,0,0,0,0,0,0,1,1,0,2,"H","N","2018-12-02","201812020DET"
"CAR",0,0,0,0,0,0,0,0,0,2,0,2,"A","N","2018-12-02","201812020LAK"
"LAK",0,0,0,2,0,2,0,0,0,0,0,0,"H","N","2018-12-02","201812020LAK"
"MTL",0,0,1,0,0,1,0,2,1,0,0,3,"H","N","2018-12-02","201812020MTL"
"SJS",0,2,1,0,0,3,0,0,1,0,0,1,"A","N","2018-12-02","201812020MTL"
"NYR",0,1,2,0,0,3,0,0,0,3,1,4,"H","Y","2018-12-02","201812020NYR"
"WPG",0,0,0,3,1,4,0,1,2,0,0,3,"A","Y","2018-12-02","201812020NYR"
"ANA",0,1,2,3,0,6,0,3,2,0,0,5,"A","N","2018-12-02","201812020WSH"
"WSH",0,3,2,0,0,5,0,1,2,3,0,6,"H","N","2018-12-02","201812020WSH"
"DAL",0,1,0,3,0,4,0,0,0,1,0,1,"H","N","2018-12-03","201812030DAL"
"EDM",0,0,0,1,0,1,0,1,0,3,0,4,"A","N","2018-12-03","201812030DAL"
"NJD",0,0,1,0,0,1,0,2,2,1,0,5,"H","N","2018-12-03","201812030NJD"
"TBL",0,2,2,1,0,5,0,0,1,0,0,1,"A","N","2018-12-03","201812030NJD"
"BUF",0,0,1,0,0,1,0,1,1,0,0,2,"A","N","2018-12-03","201812030NSH"
"NSH",0,1,1,0,0,2,0,0,1,0,0,1,"H","N","2018-12-03","201812030NSH"
"BUF",0,0,1,2,0,3,1,0,2,1,0,4,"H","N","2018-12-04","201812040BUF"
"TOR",1,0,2,1,0,4,0,0,1,2,0,3,"A","N","2018-12-04","201812040BUF"
"CBJ",0,3,2,1,0,6,0,1,5,3,0,9,"H","N","2018-12-04","201812040CBJ"
"CGY",0,1,5,3,0,9,0,3,2,1,0,6,"A","N","2018-12-04","201812040CBJ"
"DET",0,2,2,1,0,5,0,0,3,2,1,6,"H","Y","2018-12-04","201812040DET"
"TBL",0,0,3,2,1,6,0,2,2,1,0,5,"A","Y","2018-12-04","201812040DET"
"BOS",0,0,0,0,0,0,0,0,4,1,0,5,"A","N","2018-12-04","201812040FLA"
"FLA",0,0,4,1,0,5,0,0,0,0,0,0,"H","N","2018-12-04","201812040FLA"
"ARI",0,1,1,0,0,2,0,0,0,1,0,1,"A","N","2018-12-04","201812040LAK"
"LAK",0,0,0,1,0,1,0,1,1,0,0,2,"H","N","2018-12-04","201812040LAK"
"MTL",0,1,3,1,0,5,0,0,1,1,0,2,"H","N","2018-12-04","201812040MTL"
"OTT",0,0,1,1,0,2,0,1,3,1,0,5,"A","N","2018-12-04","201812040MTL"
"NYI",0,0,0,1,0,1,0,0,0,3,0,3,"H","N","2018-12-04","201812040NYI"
"WPG",0,0,0,3,0,3,0,0,0,1,0,1,"A","N","2018-12-04","201812040NYI"
"COL",0,0,3,0,0,3,0,3,0,3,0,6,"A","N","2018-12-04","201812040PIT"
"PIT",0,3,0,3,0,6,0,0,3,0,0,3,"H","N","2018-12-04","201812040PIT"
"MIN",0,1,2,0,0,3,0,1,1,0,0,2,"A","N","2018-12-04","201812040VAN"
"VAN",0,1,1,0,0,2,0,1,2,0,0,3,"H","N","2018-12-04","201812040VAN"
"VEG",0,1,0,4,0,5,0,1,1,1,0,3,"H","N","2018-12-04","201812040VEG"
"WSH",0,1,1,1,0,3,0,1,0,4,0,5,"A","N","2018-12-04","201812040VEG"
"ANA",0,2,0,2,0,4,0,0,2,0,0,2,"H","N","2018-12-05","201812050ANA"
"CHI",0,0,2,0,0,2,0,2,0,2,0,4,"A","N","2018-12-05","201812050ANA"
"CAR",0,0,1,0,0,1,0,2,2,1,0,5,"A","N","2018-12-05","201812050SJS"
"SJS",0,2,2,1,0,5,0,0,1,0,0,1,"H","N","2018-12-05","201812050SJS"
"EDM",0,0,1,1,1,3,0,2,0,0,0,2,"A","Y","2018-12-05","201812050STL"
"STL",0,2,0,0,0,2,0,0,1,1,1,3,"H","Y","2018-12-05","201812050STL"
"ARI",0,1,1,0,0,2,0,0,2,2,0,4,"H","N","2018-12-06","201812060ARI"
"WSH",0,0,2,2,0,4,0,1,1,0,0,2,"A","N","2018-12-06","201812060ARI"
"CGY",0,0,1,1,0,2,0,0,0,0,0,0,"H","N","2018-12-06","201812060CGY"
"MIN",0,0,0,0,0,0,0,0,1,1,0,2,"A","N","2018-12-06","201812060CGY"
"COL",0,1,1,3,0,5,0,1,1,0,0,2,"A","N","2018-12-06","201812060FLA"
"FLA",0,1,1,0,0,2,0,1,1,3,0,5,"H","N","2018-12-06","201812060FLA"
"LAK",0,1,2,0,0,3,0,1,3,2,0,6,"H","N","2018-12-06","201812060LAK"
"NJD",0,1,3,2,0,6,0,1,2,0,0,3,"A","N","2018-12-06","201812060LAK"
"MTL",0,1,2,2,0,5,0,1,1,0,0,2,"A","N","2018-12-06","201812060OTT"
"OTT",0,1,1,0,0,2,0,1,2,2,0,5,"H","N","2018-12-06","201812060OTT"
"CBJ",1,2,0,1,0,4,0,1,0,2,0,3,"A","N","2018-12-06","201812060PHI"
"PHI",0,1,0,2,0,3,1,2,0,1,0,4,"H","N","2018-12-06","201812060PHI"
"NYI",0,1,0,1,0,2,0,2,3,1,0,6,"A","N","2018-12-06","201812060PIT"
"PIT",0,2,3,1,0,6,0,1,0,1,0,2,"H","N","2018-12-06","201812060PIT"
"BOS",0,1,0,1,0,2,0,1,0,2,0,3,"A","N","2018-12-06","201812060TBL"
"TBL",0,1,0,2,0,3,0,1,0,1,0,2,"H","N","2018-12-06","201812060TBL"
"DET",1,3,1,0,0,5,0,1,0,3,0,4,"A","N","2018-12-06","201812060TOR"
"TOR",0,1,0,3,0,4,1,3,1,0,0,5,"H","N","2018-12-06","201812060TOR"
"NSH",0,0,1,2,0,3,0,2,2,1,0,5,"A","N","2018-12-06","201812060VAN"
"VAN",0,2,2,1,0,5,0,0,1,2,0,3,"H","N","2018-12-06","201812060VAN"
"CHI",0,0,2,1,0,3,0,2,0,2,0,4,"A","N","2018-12-06","201812060VEG"
"VEG",0,2,0,2,0,4,0,0,2,1,0,3,"H","N","2018-12-06","201812060VEG"
"ANA",0,1,0,0,0,1,0,0,1,3,0,4,"H","N","2018-12-07","201812070ANA"
"CAR",0,0,1,3,0,4,0,1,0,0,0,1,"A","N","2018-12-07","201812070ANA"
"DAL",0,0,1,2,0,3,0,1,0,1,0,2,"H","N","2018-12-07","201812070DAL"
"SJS",0,1,0,1,0,2,0,0,1,2,0,3,"A","N","2018-12-07","201812070DAL"
"EDM",0,3,0,4,0,7,0,1,0,1,0,2,"H","N","2018-12-07","201812070EDM"
"MIN",0,1,0,1,0,2,0,3,0,4,0,7,"A","N","2018-12-07","201812070EDM"
"STL",0,0,1,0,0,1,0,0,0,0,0,0,"A","N","2018-12-07","201812070WPG"
"WPG",0,0,0,0,0,0,0,0,1,0,0,1,"H","N","2018-12-07","201812070WPG"
"ARI",0,0,2,1,0,3,0,2,1,2,0,5,"H","N","2018-12-08","201812080ARI"
"SJS",0,2,1,2,0,5,0,0,2,1,0,3,"A","N","2018-12-08","201812080ARI"
"BOS",0,1,2,3,0,6,0,0,0,3,0,3,"H","N","2018-12-08","201812080BOS"
"TOR",0,0,0,3,0,3,0,1,2,3,0,6,"A","N","2018-12-08","201812080BOS"
"BUF",0,2,0,0,0,2,0,1,1,4,0,6,"H","N","2018-12-08","201812080BUF"
"PHI",0,1,1,4,0,6,0,2,0,0,0,2,"A","N","2018-12-08","201812080BUF"
"CBJ",0,0,0,0,0,0,0,3,0,1,0,4,"H","N","2018-12-08","201812080CBJ"
"WSH",0,3,0,1,0,4,0,0,0,0,0,0,"A","N","2018-12-08","201812080CBJ"
"CGY",0,1,1,3,0,5,0,1,0,1,0,2,"H","N","2018-12-08","201812080CGY"
"NSH",0,1,0,1,0,2,0,1,1,3,0,5,"A","N","2018-12-08","201812080CGY"
"DET",0,2,0,0,0,2,0,0,2,1,0,3,"H","N","2018-12-08","201812080DET"
"NYI",0,0,2,1,0,3,0,2,0,0,0,2,"A","N","2018-12-08","201812080DET"
"FLA",0,0,3,1,0,4,0,2,1,1,1,5,"H","Y","2018-12-08","201812080FLA"
"NYR",0,2,1,1,1,5,0,0,3,1,0,4,"A","Y","2018-12-08","201812080FLA"
"LAK",0,1,2,2,0,5,0,1,0,0,0,1,"H","N","2018-12-08","201812080LAK"
"VEG",0,1,0,0,0,1,0,1,2,2,0,5,"A","N","2018-12-08","201812080LAK"
"OTT",1,1,0,0,0,2,0,0,1,0,0,1,"H","N","2018-12-08","201812080OTT"
"PIT",0,0,1,0,0,1,1,1,0,0,0,2,"A","N","2018-12-08","201812080OTT"
"COL",0,1,0,0,0,1,0,3,3,1,0,7,"A","N","2018-12-08","201812080TBL"
"TBL",0,3,3,1,0,7,0,1,0,0,0,1,"H","N","2018-12-08","201812080TBL"
"ANA",0,3,0,2,1,6,0,3,1,1,0,5,"H","Y","2018-12-09","201812090ANA"
"NJD",0,3,1,1,0,5,0,3,0,2,1,6,"A","Y","2018-12-09","201812090ANA"
"CHI",0,1,1,0,0,2,0,2,0,1,0,3,"H","N","2018-12-09","201812090CHI"
"MTL",0,2,0,1,0,3,0,1,1,0,0,2,"A","N","2018-12-09","201812090CHI"
"CGY",0,0,0,0,0,0,0,1,0,0,0,1,"A","N","2018-12-09","201812090EDM"
"EDM",0,1,0,0,0,1,0,0,0,0,0,0,"H","N","2018-12-09","201812090EDM"
"BOS",1,0,1,0,0,2,0,1,0,0,0,1,"A","N","2018-12-09","201812090OTT"
"OTT",0,1,0,0,0,1,1,0,1,0,0,2,"H","N","2018-12-09","201812090OTT"
"STL",0,0,0,1,0,1,0,3,2,1,0,6,"H","N","2018-12-09","201812090STL"
"VAN",0,3,2,1,0,6,0,0,0,1,0,1,"A","N","2018-12-09","201812090STL"
"DAL",0,1,0,1,0,2,0,1,2,1,0,4,"A","N","2018-12-09","201812090VEG"
"VEG",0,1,2,1,0,4,0,1,0,1,0,2,"H","N","2018-12-09","201812090VEG"
"PHI",0,1,0,0,0,1,0,2,3,2,0,7,"A","N","2018-12-09","201812090WPG"
"WPG",0,2,3,2,0,7,0,1,0,0,0,1,"H","N","2018-12-09","201812090WPG"
"DET",0,1,2,0,0,3,0,0,0,1,0,1,"H","N","2018-12-10","201812100DET"
"LAK",0,0,0,1,0,1,0,1,2,0,0,3,"A","N","2018-12-10","201812100DET"
"NYI",0,0,1,0,0,1,0,0,0,1,1,2,"H","Y","2018-12-10","201812100NYI"
"PIT",0,0,0,1,1,2,0,0,1,0,0,1,"A","Y","2018-12-10","201812100NYI"
"NJD",0,1,1,0,0,2,0,2,2,1,0,5,"A","N","2018-12-10","201812100SJS"
"SJS",0,2,2,1,0,5,0,1,1,0,0,2,"H","N","2018-12-10","201812100SJS"
"NYR",0,2,0,1,0,3,0,1,2,3,0,6,"A","N","2018-12-10","201812100TBL"
"TBL",0,1,2,3,0,6,0,2,0,1,0,3,"H","N","2018-12-10","201812100TBL"
"ARI",0,2,1,0,0,3,0,0,4,0,0,4,"A","N","2018-12-11","201812110BOS"
"BOS",0,0,4,0,0,4,0,2,1,0,0,3,"H","N","2018-12-11","201812110BOS"
"BUF",1,1,0,2,0,4,0,1,2,0,0,3,"H","N","2018-12-11","201812110BUF"
"LAK",0,1,2,0,0,3,1,1,0,2,0,4,"A","N","2018-12-11","201812110BUF"
"CAR",0,0,1,0,0,1,0,1,1,2,0,4,"H","N","2018-12-11","201812110CAR"
"TOR",0,1,1,2,0,4,0,0,1,0,0,1,"A","N","2018-12-11","201812110CAR"
"CBJ",0,1,0,1,0,2,0,0,0,3,0,3,"H","N","2018-12-11","201812110CBJ"
"VAN",0,0,0,3,0,3,0,1,0,1,0,2,"A","N","2018-12-11","201812110CBJ"
"COL",0,0,1,3,0,4,0,1,4,1,0,6,"H","N","2018-12-11","201812110COL"
"EDM",0,1,4,1,0,6,0,0,1,3,0,4,"A","N","2018-12-11","201812110COL"
"MIN",0,1,4,2,0,7,0,0,0,1,0,1,"H","N","2018-12-11","201812110MIN"
"MTL",0,0,0,1,0,1,0,1,4,2,0,7,"A","N","2018-12-11","201812110MIN"
"NSH",0,1,1,1,0,3,0,1,0,0,0,1,"H","N","2018-12-11","201812110NSH"
"OTT",0,1,0,0,0,1,0,1,1,1,0,3,"A","N","2018-12-11","201812110NSH"
"FLA",0,1,0,2,0,3,0,0,0,4,0,4,"A","N","2018-12-11","201812110STL"
"STL",0,0,0,4,0,4,0,1,0,2,0,3,"H","N","2018-12-11","201812110STL"
"CHI",0,0,2,1,0,3,0,3,1,2,0,6,"A","N","2018-12-11","201812110WPG"
"WPG",0,3,1,2,0,6,0,0,2,1,0,3,"H","N","2018-12-11","201812110WPG"
"DET",0,0,0,2,0,2,0,3,2,1,0,6,"A","N","2018-12-11","201812110WSH"
"WSH",0,3,2,1,0,6,0,0,0,2,0,2,"H","N","2018-12-11","201812110WSH"
"ANA",0,1,1,4,0,6,0,0,3,0,0,3,"H","N","2018-12-12","201812120ANA"
"DAL",0,0,3,0,0,3,0,1,1,4,0,6,"A","N","2018-12-12","201812120ANA"
"CGY",1,1,2,2,0,6,0,0,4,1,0,5,"H","N","2018-12-12","201812120CGY"
"PHI",0,0,4,1,0,5,1,1,2,2,0,6,"A","N","2018-12-12","201812120CGY"
"CHI",0,2,1,3,0,6,0,1,2,0,0,3,"H","N","2018-12-12","201812120CHI"
"PIT",0,1,2,0,0,3,0,2,1,3,0,6,"A","N","2018-12-12","201812120CHI"
"NYI",0,1,1,0,0,2,0,1,1,1,0,3,"H","N","2018-12-12","201812120NYI"
"VEG",0,1,1,1,0,3,0,1,1,0,0,2,"A","N","2018-12-12","201812120NYI"
"ARI",0,1,0,0,0,1,0,2,0,1,0,3,"A","N","2018-12-13","201812130BUF"
"BUF",0,2,0,1,0,3,0,1,0,0,0,1,"H","N","2018-12-13","201812130BUF"
"CBJ",0,2,2,0,0,4,0,1,0,0,0,1,"H","N","2018-12-13","201812130CBJ"
"LAK",0,1,0,0,0,1,0,2,2,0,0,4,"A","N","2018-12-13","201812130CBJ"
"FLA",0,1,0,0,0,1,0,1,2,2,0,5,"A","N","2018-12-13","201812130MIN"
"MIN",0,1,2,2,0,5,0,1,0,0,0,1,"H","N","2018-12-13","201812130MIN"
"CAR",0,0,1,3,0,4,0,0,2,4,0,6,"A","N","2018-12-13","201812130MTL"
"MTL",0,0,2,4,0,6,0,0,1,3,0,4,"H","N","2018-12-13","201812130MTL"
"NSH",1,2,1,0,0,4,0,1,0,2,0,3,"H","N","2018-12-13","201812130NSH"
"VAN",0,1,0,2,0,3,1,2,1,0,0,4,"A","N","2018-12-13","201812130NSH"
"DAL",0,0,1,1,0,2,0,0,1,2,0,3,"A","N","2018-12-13","201812130SJS"
"SJS",0,0,1,2,0,3,0,0,1,1,0,2,"H","N","2018-12-13","201812130SJS"
"TBL",0,1,3,0,0,4,0,1,0,0,0,1,"H","N","2018-12-13","201812130TBL"
"TOR",0,1,0,0,0,1,0,1,3,0,0,4,"A","N","2018-12-13","201812130TBL"
"EDM",0,1,3,0,0,4,1,2,1,1,0,5,"A","N","2018-12-13","201812130WPG"
"WPG",1,2,1,1,0,5,0,1,3,0,0,4,"H","N","2018-12-13","201812130WPG"
"CAR",0,2,2,1,0,5,0,1,3,1,1,6,"H","Y","2018-12-14","201812140CAR"
"WSH",0,1,3,1,1,6,0,2,2,1,0,5,"A","Y","2018-12-14","201812140CAR"
"CHI",0,1,1,1,0,3,1,1,2,0,0,4,"H","N","2018-12-14","201812140CHI"
"WPG",1,1,2,0,0,4,0,1,1,1,0,3,"A","N","2018-12-14","201812140CHI"
"DET",0,1,1,0,0,2,0,2,0,2,0,4,"H","N","2018-12-14","201812140DET"
"OTT",0,2,0,2,0,4,0,1,1,0,0,2,"A","N","2018-12-14","201812140DET"
"EDM",0,1,2,1,0,4,0,0,0,1,0,1,"H","N","2018-12-14","201812140EDM"
"PHI",0,0,0,1,0,1,0,1,2,1,0,4,"A","N","2018-12-14","201812140EDM"
"NJD",1,0,2,2,0,5,0,3,1,0,0,4,"H","N","2018-12-14","201812140NJD"
"VEG",0,3,1,0,0,4,1,0,2,2,0,5,"A","N","2018-12-14","201812140NJD"
"ARI",1,0,1,2,0,4,0,2,1,0,0,3,"A","N","2018-12-14","201812140NYR"
"NYR",0,2,1,0,0,3,1,0,1,2,0,4,"H","N","2018-12-14","201812140NYR"
"BOS",0,0,1,2,0,3,0,1,2,2,0,5,"A","N","2018-12-14","201812140PIT"
"PIT",0,1,2,2,0,5,0,0,1,2,0,3,"H","N","2018-12-14","201812140PIT"
"COL",0,2,0,1,0,3,1,2,0,1,0,4,"A","N","2018-12-14","201812140STL"
"STL",1,2,0,1,0,4,0,2,0,1,0,3,"H","N","2018-12-14","201812140STL"
"ANA",1,1,0,0,0,2,0,1,0,0,0,1,"A","N","2018-12-15","201812150CBJ"
"CBJ",0,1,0,0,0,1,1,1,0,0,0,2,"H","N","2018-12-15","201812150CBJ"
"COL",0,3,1,2,0,6,0,0,2,2,0,4,"H","N","2018-12-15","201812150COL"
"DAL",0,0,2,2,0,4,0,3,1,2,0,6,"A","N","2018-12-15","201812150COL"
"FLA",1,1,1,1,0,4,0,0,0,3,0,3,"H","N","2018-12-15","201812150FLA"
"TOR",0,0,0,3,0,3,1,1,1,1,0,4,"A","N","2018-12-15","201812150FLA"
"CGY",0,1,0,1,0,2,0,0,1,0,0,1,"A","N","2018-12-15","201812150MIN"
"MIN",0,0,1,0,0,1,0,1,0,1,0,2,"H","N","2018-12-15","201812150MIN"
"MTL",0,1,0,4,0,5,0,1,1,0,0,2,"H","N","2018-12-15","201812150MTL"
"OTT",0,1,1,0,0,2,0,1,0,4,0,5,"A","N","2018-12-15","201812150MTL"
"NJD",0,0,0,1,0,1,0,1,0,0,1,2,"A","Y","2018-12-15","201812150NSH"
"NSH",0,1,0,0,1,2,0,0,0,1,0,1,"H","Y","2018-12-15","201812150NSH"
"DET",0,2,0,1,0,3,0,1,0,2,1,4,"A","Y","2018-12-15","201812150NYI"
"NYI",0,1,0,2,1,4,0,2,0,1,0,3,"H","Y","2018-12-15","201812150NYI"
"LAK",0,0,2,1,0,3,1,2,1,0,0,4,"A","N","2018-12-15","201812150PIT"
"PIT",1,2,1,0,0,4,0,0,2,1,0,3,"H","N","2018-12-15","201812150PIT"
"PHI",0,1,0,0,0,1,0,3,1,1,0,5,"A","N","2018-12-15","201812150VAN"
"VAN",0,3,1,1,0,5,0,1,0,0,0,1,"H","N","2018-12-15","201812150VAN"
"BUF",0,1,2,0,0,3,0,2,1,0,1,4,"A","Y","2018-12-15","201812150WSH"
"WSH",0,2,1,0,1,4,0,1,2,0,0,3,"H","Y","2018-12-15","201812150WSH"
"BOS",0,0,1,1,0,2,0,0,1,3,0,4,"H","N","2018-12-16","201812160BOS"
"BUF",0,0,1,3,0,4,0,0,1,1,0,2,"A","N","2018-12-16","201812160BOS"
"ARI",0,0,0,0,0,0,0,0,2,1,0,3,"A","N","2018-12-16","201812160CAR"
"CAR",0,0,2,1,0,3,0,0,0,0,0,0,"H","N","2018-12-16","201812160CAR"
"CHI",0,3,0,0,0,3,0,2,3,2,0,7,"H","N","2018-12-16","201812160CHI"
"SJS",0,2,3,2,0,7,0,3,0,0,0,3,"A","N","2018-12-16","201812160CHI"
"NYR",0,1,1,1,0,3,1,1,2,0,0,4,"H","N","2018-12-16","201812160NYR"
"VEG",1,1,2,0,0,4,0,1,1,1,0,3,"A","N","2018-12-16","201812160NYR"
"CGY",0,4,1,2,0,7,0,0,2,0,0,2,"A","N","2018-12-16","201812160STL"
"STL",0,0,2,0,0,2,0,4,1,2,0,7,"H","N","2018-12-16","201812160STL"
"EDM",0,0,1,1,0,2,0,0,2,2,0,4,"A","N","2018-12-16","201812160VAN"
"VAN",0,0,2,2,0,4,0,0,1,1,0,2,"H","N","2018-12-16","201812160VAN"
"TBL",0,1,2,1,0,4,1,1,2,1,0,5,"A","N","2018-12-16","201812160WPG"
"WPG",1,1,2,1,0,5,0,1,2,1,0,4,"H","N","2018-12-16","201812160WPG"
"CBJ",0,0,0,1,0,1,0,0,0,0,0,0,"H","N","2018-12-17","201812170CBJ"
"VEG",0,0,0,0,0,0,0,0,0,1,0,1,"A","N","2018-12-17","201812170CBJ"
"COL",0,0,1,0,0,1,0,1,2,1,0,4,"H","N","2018-12-17","201812170COL"
"NYI",0,1,2,1,0,4,0,0,1,0,0,1,"A","N","2018-12-17","201812170COL"
"BOS",0,1,1,2,0,4,0,0,0,0,0,0,"A","N","2018-12-17","201812170MTL"
"MTL",0,0,0,0,0,0,0,1,1,2,0,4,"H","N","2018-12-17","201812170MTL"
"NSH",0,0,1,2,0,3,1,3,0,0,0,4,"A","N","2018-12-17","201812170OTT"
"OTT",1,3,0,0,0,4,0,0,1,2,0,3,"H","N","2018-12-17","201812170OTT"
"ANA",0,0,3,1,0,4,0,2,0,0,0,2,"A","N","2018-12-17","201812170PIT"
"PIT",0,2,0,0,0,2,0,0,3,1,0,4,"H","N","2018-12-17","201812170PIT"
"ARI",0,1,0,0,0,1,0,1,2,0,0,3,"H","N","2018-12-18","201812180ARI"
"NYI",0,1,2,0,0,3,0,1,0,0,0,1,"A","N","2018-12-18","201812180ARI"
"BUF",0,1,1,0,0,2,0,0,1,4,0,5,"H","N","2018-12-18","201812180BUF"
"FLA",0,0,1,4,0,5,0,1,1,0,0,2,"A","N","2018-12-18","201812180BUF"
"CHI",0,0,2,0,0,2,0,1,0,0,0,1,"H","N","2018-12-18","201812180CHI"
"NSH",0,1,0,0,0,1,0,0,2,0,0,2,"A","N","2018-12-18","201812180CHI"
"CGY",0,0,0,0,0,0,0,1,1,0,0,2,"A","N","2018-12-18","201812180DAL"
"DAL",0,1,1,0,0,2,0,0,0,0,0,0,"H","N","2018-12-18","201812180DAL"
"EDM",0,0,1,0,0,1,0,1,0,3,0,4,"H","N","2018-12-18","201812180EDM"
"STL",0,1,0,3,0,4,0,0,1,0,0,1,"A","N","2018-12-18","201812180EDM"
"LAK",0,1,2,1,0,4,0,0,1,0,0,1,"H","N","2018-12-18","201812180LAK"
"WPG",0,0,1,0,0,1,0,1,2,1,0,4,"A","N","2018-12-18","201812180LAK"
"MIN",0,0,0,0,0,0,0,0,2,2,0,4,"H","N","2018-12-18","201812180MIN"
"SJS",0,0,2,2,0,4,0,0,0,0,0,0,"A","N","2018-12-18","201812180MIN"
"NJD",0,1,0,1,0,2,0,3,2,2,0,7,"H","N","2018-12-18","201812180NJD"
"TOR",0,3,2,2,0,7,0,1,0,1,0,2,"A","N","2018-12-18","201812180NJD"
"ANA",0,0,1,0,0,1,0,0,0,3,0,3,"A","N","2018-12-18","201812180NYR"
"NYR",0,0,0,3,0,3,0,0,1,0,0,1,"H","N","2018-12-18","201812180NYR"
"DET",0,0,1,1,0,2,0,1,2,0,0,3,"A","N","2018-12-18","201812180PHI"
"PHI",0,1,2,0,0,3,0,0,1,1,0,2,"H","N","2018-12-18","201812180PHI"
"TBL",0,2,1,2,0,5,0,1,0,1,0,2,"A","N","2018-12-18","201812180VAN"
"VAN",0,1,0,1,0,2,0,2,1,2,0,5,"H","N","2018-12-18","201812180VAN"
"COL",0,0,1,1,0,2,0,1,0,0,0,1,"H","N","2018-12-19","201812190COL"
"MTL",0,1,0,0,0,1,0,0,1,1,0,2,"A","N","2018-12-19","201812190COL"
"PIT",0,0,2,0,0,2,0,0,1,0,0,1,"A","N","2018-12-19","201812190WSH"
"WSH",0,0,1,0,0,1,0,0,2,0,0,2,"H","N","2018-12-19","201812190WSH"
"ARI",0,0,1,0,0,1,0,0,1,1,0,2,"H","N","2018-12-20","201812200ARI"
"MTL",0,0,1,1,0,2,0,0,1,0,0,1,"A","N","2018-12-20","201812200ARI"
"ANA",0,0,0,1,0,1,0,0,2,1,0,3,"A","N","2018-12-20","201812200BOS"
"BOS",0,0,2,1,0,3,0,0,0,1,0,1,"H","N","2018-12-20","201812200BOS"
"CAR",0,0,1,0,0,1,0,1,1,2,0,4,"H","N","2018-12-20","201812200CAR"
"DET",0,1,1,2,0,4,0,0,1,0,0,1,"A","N","2018-12-20","201812200CAR"
"CBJ",0,1,1,0,0,2,0,0,1,0,0,1,"H","N","2018-12-20","201812200CBJ"
"NJD",0,0,1,0,0,1,0,1,1,0,0,2,"A","N","2018-12-20","201812200CBJ"
"CGY",0,3,0,1,0,4,0,1,2,1,1,5,"H","Y","2018-12-20","201812200CGY"
"TBL",0,1,2,1,1,5,0,3,0,1,0,4,"A","Y","2018-12-20","201812200CGY"
"CHI",0,2,1,2,0,5,0,0,1,1,0,2,"A","N","2018-12-20","201812200DAL"
"DAL",0,0,1,1,0,2,0,2,1,2,0,5,"H","N","2018-12-20","201812200DAL"
"NSH",0,0,1,0,0,1,0,1,1,0,0,2,"A","N","2018-12-20","201812200PHI"
"PHI",0,1,1,0,0,2,0,0,1,0,0,1,"H","N","2018-12-20","201812200PHI"
"MIN",0,1,0,0,0,1,0,1,0,1,0,2,"A","N","2018-12-20","201812200PIT"
"PIT",0,1,0,1,0,2,0,1,0,0,0,1,"H","N","2018-12-20","201812200PIT"
"SJS",0,2,1,0,0,3,0,3,0,2,0,5,"H","N","2018-12-20","201812200SJS"
"WPG",0,3,0,2,0,5,0,2,1,0,0,3,"A","N","2018-12-20","201812200SJS"
"FLA",0,0,0,1,0,1,0,1,2,3,0,6,"A","N","2018-12-20","201812200TOR"
"TOR",0,1,2,3,0,6,0,0,0,1,0,1,"H","N","2018-12-20","201812200TOR"
"STL",0,0,0,1,0,1,0,0,2,3,0,5,"A","N","2018-12-20","201812200VAN"
"VAN",0,0,2,3,0,5,0,0,0,1,0,1,"H","N","2018-12-20","201812200VAN"
"NYI",0,2,0,0,0,2,0,0,1,3,0,4,"A","N","2018-12-20","201812200VEG"
"VEG",0,0,1,3,0,4,0,2,0,0,0,2,"H","N","2018-12-20","201812200VEG"
"CHI",0,1,0,1,0,2,0,0,1,0,0,1,"A","N","2018-12-21","201812210COL"
"COL",0,0,1,0,0,1,0,1,0,1,0,2,"H","N","2018-12-21","201812210COL"
"NJD",0,2,3,0,0,5,0,0,2,0,0,2,"H","N","2018-12-21","201812210NJD"
"OTT",0,0,2,0,0,2,0,2,3,0,0,5,"A","N","2018-12-21","201812210NJD"
"BUF",0,0,0,1,0,1,0,0,1,1,0,2,"A","N","2018-12-21","201812210WSH"
"WSH",0,0,1,1,0,2,0,0,0,1,0,1,"H","N","2018-12-21","201812210WSH"
"ARI",0,2,2,2,0,6,0,1,0,3,0,4,"H","N","2018-12-22","201812220ARI"
"COL",0,1,0,3,0,4,0,2,2,2,0,6,"A","N","2018-12-22","201812220ARI"
"BOS",0,1,0,4,0,5,0,0,1,1,0,2,"H","N","2018-12-22","201812220BOS"
"NSH",0,0,1,1,0,2,0,1,0,4,0,5,"A","N","2018-12-22","201812220BOS"
"ANA",0,0,0,0,0,0,0,1,0,2,0,3,"A","N","2018-12-22","201812220BUF"
"BUF",0,1,0,2,0,3,0,0,0,0,0,0,"H","N","2018-12-22","201812220BUF"
"CAR",0,0,0,0,0,0,0,1,2,0,0,3,"H","N","2018-12-22","201812220CAR"
"PIT",0,1,2,0,0,3,0,0,0,0,0,0,"A","N","2018-12-22","201812220CAR"
"CGY",0,1,0,0,0,1,0,2,0,1,0,3,"H","N","2018-12-22","201812220CGY"
"STL",0,2,0,1,0,3,0,1,0,0,0,1,"A","N","2018-12-22","201812220CGY"
"DET",0,0,1,0,0,1,0,2,0,0,0,2,"H","N","2018-12-22","201812220DET"
"FLA",0,2,0,0,0,2,0,0,1,0,0,1,"A","N","2018-12-22","201812220DET"
"EDM",0,1,1,1,0,3,0,1,2,3,0,6,"H","N","2018-12-22","201812220EDM"
"TBL",0,1,2,3,0,6,0,1,1,1,0,3,"A","N","2018-12-22","201812220EDM"
"DAL",1,0,0,1,0,2,0,0,0,1,0,1,"A","N","2018-12-22","201812220MIN"
"MIN",0,0,0,1,0,1,1,0,0,1,0,2,"H","N","2018-12-22","201812220MIN"
"OTT",0,0,0,0,0,0,0,2,2,0,0,4,"H","N","2018-12-22","201812220OTT"
"WSH",0,2,2,0,0,4,0,0,0,0,0,0,"A","N","2018-12-22","201812220OTT"
"CBJ",0,1,3,0,0,4,0,1,1,1,0,3,"A","N","2018-12-22","201812220PHI"
"PHI",0,1,1,1,0,3,0,1,3,0,0,4,"H","N","2018-12-22","201812220PHI"
"LAK",1,1,0,1,0,3,0,0,0,2,0,2,"A","N","2018-12-22","201812220SJS"
"SJS",0,0,0,2,0,2,1,1,0,1,0,3,"H","N","2018-12-22","201812220SJS"
"NYR",0,0,1,2,0,3,0,1,0,4,0,5,"A","N","2018-12-22","201812220TOR"
"TOR",0,1,0,4,0,5,0,0,1,2,0,3,"H","N","2018-12-22","201812220TOR"
"VAN",0,0,0,0,0,0,0,0,0,1,0,1,"H","N","2018-12-22","201812220VAN"
"WPG",0,0,0,1,0,1,0,0,0,0,0,0,"A","N","2018-12-22","201812220VAN"
"MTL",1,1,1,1,0,4,0,1,2,0,0,3,"A","N","2018-12-22","201812220VEG"
"VEG",0,1,2,0,0,3,1,1,1,1,0,4,"H","N","2018-12-22","201812220VEG"
"BOS",0,2,1,0,0,3,0,1,3,1,0,5,"A","N","2018-12-23","201812230CAR"
"CAR",0,1,3,1,0,5,0,2,1,0,0,3,"H","N","2018-12-23","201812230CAR"
"CHI",0,1,1,1,0,3,0,1,3,2,0,6,"H","N","2018-12-23","201812230CHI"
"FLA",0,1,3,2,0,6,0,1,1,1,0,3,"A","N","2018-12-23","201812230CHI"
"DAL",0,0,1,0,0,1,0,0,1,2,0,3,"H","N","2018-12-23","201812230DAL"
"NYI",0,0,1,2,0,3,0,0,1,0,0,1,"A","N","2018-12-23","201812230DAL"
"CBJ",0,2,1,0,0,3,0,0,0,0,0,0,"A","N","2018-12-23","201812230NJD"
"NJD",0,0,0,0,0,0,0,2,1,0,0,3,"H","N","2018-12-23","201812230NJD"
"NYR",0,1,0,1,0,2,0,0,1,1,1,3,"H","Y","2018-12-23","201812230NYR"
"PHI",0,0,1,1,1,3,0,1,0,1,0,2,"A","Y","2018-12-23","201812230NYR"
"ARI",0,1,1,1,1,4,0,1,0,2,0,3,"A","Y","2018-12-23","201812230SJS"
"SJS",0,1,0,2,0,3,0,1,1,1,1,4,"H","Y","2018-12-23","201812230SJS"
"DET",0,2,1,1,0,4,1,1,2,1,0,5,"A","N","2018-12-23","201812230TOR"
"TOR",1,1,2,1,0,5,0,2,1,1,0,4,"H","N","2018-12-23","201812230TOR"
"LAK",1,0,2,1,0,4,0,1,1,1,0,3,"A","N","2018-12-23","201812230VEG"
"VEG",0,1,1,1,0,3,1,0,2,1,0,4,"H","N","2018-12-23","201812230VEG"
"BOS",0,0,1,1,0,2,0,2,0,3,0,5,"H","N","2018-12-27","201812270BOS"
"NJD",0,2,0,3,0,5,0,0,1,1,0,2,"A","N","2018-12-27","201812270BOS"
"CHI",0,1,2,2,0,5,0,1,0,1,0,2,"H","N","2018-12-27","201812270CHI"
"MIN",0,1,0,1,0,2,0,1,2,2,0,5,"A","N","2018-12-27","201812270CHI"
"EDM",0,1,1,0,0,2,0,4,0,0,0,4,"H","N","2018-12-27","201812270EDM"
"VAN",0,4,0,0,0,4,0,1,1,0,0,2,"A","N","2018-12-27","201812270EDM"
"ARI",0,1,0,0,0,1,0,1,0,1,0,2,"A","N","2018-12-27","201812270LAK"
"LAK",0,1,0,1,0,2,0,1,0,0,0,1,"H","N","2018-12-27","201812270LAK"
"DAL",0,1,1,0,0,2,0,0,0,0,0,0,"A","N","2018-12-27","201812270NSH"
"NSH",0,0,0,0,0,0,0,1,1,0,0,2,"H","N","2018-12-27","201812270NSH"
"CBJ",1,2,0,1,0,4,0,1,1,1,0,3,"A","N","2018-12-27","201812270NYR"
"NYR",0,1,1,1,0,3,1,2,0,1,0,4,"H","N","2018-12-27","201812270NYR"
"DET",0,1,0,1,0,2,0,0,3,2,0,5,"A","N","2018-12-27","201812270PIT"
"PIT",0,0,3,2,0,5,0,1,0,1,0,2,"H","N","2018-12-27","201812270PIT"
"ANA",0,1,0,1,0,2,0,1,1,2,0,4,"A","N","2018-12-27","201812270SJS"
"SJS",0,1,1,2,0,4,0,1,0,1,0,2,"H","N","2018-12-27","201812270SJS"
"BUF",0,0,1,0,0,1,0,0,3,1,0,4,"A","N","2018-12-27","201812270STL"
"STL",0,0,3,1,0,4,0,0,1,0,0,1,"H","N","2018-12-27","201812270STL"
"PHI",0,1,1,3,0,5,1,2,3,0,0,6,"A","N","2018-12-27","201812270TBL"
"TBL",1,2,3,0,0,6,0,1,1,3,0,5,"H","N","2018-12-27","201812270TBL"
"COL",0,1,0,0,0,1,0,1,0,1,0,2,"A","N","2018-12-27","201812270VEG"
"VEG",0,1,0,1,0,2,0,1,0,0,0,1,"H","N","2018-12-27","201812270VEG"
"CGY",0,0,2,2,0,4,0,0,1,0,0,1,"A","N","2018-12-27","201812270WPG"
"WPG",0,0,1,0,0,1,0,0,2,2,0,4,"H","N","2018-12-27","201812270WPG"
"CAR",0,0,0,1,0,1,0,0,2,1,0,3,"A","N","2018-12-27","201812270WSH"
"WSH",0,0,2,1,0,3,0,0,0,1,0,1,"H","N","2018-12-27","201812270WSH"
"CBJ",0,1,0,1,0,2,0,2,1,1,0,4,"H","N","2018-12-28","201812280CBJ"
"TOR",0,2,1,1,0,4,0,1,0,1,0,2,"A","N","2018-12-28","201812280CBJ"
"FLA",0,2,0,1,0,3,0,2,0,3,0,5,"H","N","2018-12-28","201812280FLA"
"MTL",0,2,0,3,0,5,0,2,0,1,0,3,"A","N","2018-12-28","201812280FLA"
"NYI",0,0,2,4,0,6,0,1,2,0,0,3,"H","N","2018-12-28","201812280NYI"
"OTT",0,1,2,0,0,3,0,0,2,4,0,6,"A","N","2018-12-28","201812280NYI"
"ANA",0,2,2,0,0,4,1,1,3,0,0,5,"H","N","2018-12-29","201812290ANA"
"ARI",1,1,3,0,0,5,0,2,2,0,0,4,"A","N","2018-12-29","201812290ANA"
"BOS",1,1,0,1,0,3,0,1,1,0,0,2,"A","N","2018-12-29","201812290BUF"
"BUF",0,1,1,0,0,2,1,1,0,1,0,3,"H","N","2018-12-29","201812290BUF"
"CGY",0,1,1,0,0,2,1,1,1,0,0,3,"H","N","2018-12-29","201812290CGY"
"VAN",1,1,1,0,0,3,0,1,1,0,0,2,"A","N","2018-12-29","201812290CGY"
"CHI",1,2,0,0,0,3,0,1,1,0,0,2,"A","N","2018-12-29","201812290COL"
"COL",0,1,1,0,0,2,1,2,0,0,0,3,"H","N","2018-12-29","201812290COL"
"DAL",0,0,3,2,0,5,0,0,0,1,0,1,"H","N","2018-12-29","201812290DAL"
"DET",0,0,0,1,0,1,0,0,3,2,0,5,"A","N","2018-12-29","201812290DAL"
"EDM",0,1,0,3,0,4,0,2,2,3,0,7,"H","N","2018-12-29","201812290EDM"
"SJS",0,2,2,3,0,7,0,1,0,3,0,4,"A","N","2018-12-29","201812290EDM"
"FLA",0,0,0,2,0,2,0,1,0,0,0,1,"H","N","2018-12-29","201812290FLA"
"PHI",0,1,0,0,0,1,0,0,0,2,0,2,"A","N","2018-12-29","201812290FLA"
"LAK",0,1,0,0,0,1,0,1,1,2,0,4,"H","N","2018-12-29","201812290LAK"
"VEG",0,1,1,2,0,4,0,1,0,0,0,1,"A","N","2018-12-29","201812290LAK"
"CAR",0,0,0,0,0,0,0,0,1,1,0,2,"A","N","2018-12-29","201812290NJD"
"NJD",0,0,1,1,0,2,0,0,0,0,0,0,"H","N","2018-12-29","201812290NJD"
"NSH",0,1,2,0,0,3,0,1,1,2,0,4,"H","N","2018-12-29","201812290NSH"
"NYR",0,1,1,2,0,4,0,1,2,0,0,3,"A","N","2018-12-29","201812290NSH"
"OTT",0,0,1,1,0,2,0,2,1,0,0,3,"H","N","2018-12-29","201812290OTT"
"WSH",0,2,1,0,0,3,0,0,1,1,0,2,"A","N","2018-12-29","201812290OTT"
"PIT",0,1,3,2,0,6,0,0,1,0,0,1,"A","N","2018-12-29","201812290STL"
"STL",0,0,1,0,0,1,0,1,3,2,0,6,"H","N","2018-12-29","201812290STL"
"MTL",0,3,2,0,0,5,0,2,2,2,0,6,"A","N","2018-12-29","201812290TBL"
"TBL",0,2,2,2,0,6,0,3,2,0,0,5,"H","N","2018-12-29","201812290TBL"
"NYI",0,1,3,0,0,4,0,0,0,0,0,0,"A","N","2018-12-29","201812290TOR"
"TOR",0,0,0,0,0,0,0,1,3,0,0,4,"H","N","2018-12-29","201812290TOR"
"MIN",0,1,1,1,0,3,0,0,0,1,0,1,"A","N","2018-12-29","201812290WPG"
"WPG",0,0,0,1,0,1,0,1,1,1,0,3,"H","N","2018-12-29","201812290WPG"
"ARI",0,0,1,0,0,1,0,1,1,3,0,5,"H","N","2018-12-30","201812300ARI"
"VEG",0,1,1,3,0,5,0,0,1,0,0,1,"A","N","2018-12-30","201812300ARI"
"ANA",0,1,0,0,0,1,1,1,0,0,0,2,"H","N","2018-12-31","201812310ANA"
"TBL",1,1,0,0,0,2,0,1,0,0,0,1,"A","N","2018-12-31","201812310ANA"
"BUF",0,0,0,1,0,1,0,0,1,2,0,3,"H","N","2018-12-31","201812310BUF"
"NYI",0,0,1,2,0,3,0,0,0,1,0,1,"A","N","2018-12-31","201812310BUF"
"CAR",0,1,2,0,0,3,0,0,0,1,0,1,"H","N","2018-12-31","201812310CAR"
"PHI",0,0,0,1,0,1,0,1,2,0,0,3,"A","N","2018-12-31","201812310CAR"
"CBJ",0,0,1,5,0,6,0,0,1,2,0,3,"H","N","2018-12-31","201812310CBJ"
"OTT",0,0,1,2,0,3,0,0,1,5,0,6,"A","N","2018-12-31","201812310CBJ"
"CGY",0,3,2,3,0,8,0,1,2,2,0,5,"H","N","2018-12-31","201812310CGY"
"SJS",0,1,2,2,0,5,0,3,2,3,0,8,"A","N","2018-12-31","201812310CGY"
"COL",0,0,0,2,0,2,1,0,2,0,0,3,"H","N","2018-12-31","201812310COL"
"LAK",1,0,2,0,0,3,0,0,0,2,0,2,"A","N","2018-12-31","201812310COL"
"DAL",0,0,2,0,0,2,1,1,0,1,0,3,"H","N","2018-12-31","201812310DAL"
"MTL",1,1,0,1,0,3,0,0,2,0,0,2,"A","N","2018-12-31","201812310DAL"
"DET",0,3,0,0,0,3,0,0,3,0,1,4,"H","Y","2018-12-31","201812310DET"
"FLA",0,0,3,0,1,4,0,3,0,0,0,3,"A","Y","2018-12-31","201812310DET"
"EDM",0,1,1,1,0,3,0,0,3,1,0,4,"H","N","2018-12-31","201812310EDM"
"WPG",0,0,3,1,0,4,0,1,1,1,0,3,"A","N","2018-12-31","201812310EDM"
"MIN",0,1,0,1,0,2,0,2,1,0,0,3,"H","N","2018-12-31","201812310MIN"
"PIT",0,2,1,0,0,3,0,1,0,1,0,2,"A","N","2018-12-31","201812310MIN"
"NJD",0,2,0,2,0,4,0,0,0,0,0,0,"H","N","2018-12-31","201812310NJD"
"VAN",0,0,0,0,0,0,0,2,0,2,0,4,"A","N","2018-12-31","201812310NJD"
"NYR",0,1,1,0,0,2,0,1,0,0,0,1,"A","N","2018-12-31","201812310STL"
"STL",0,1,0,0,0,1,0,1,1,0,0,2,"H","N","2018-12-31","201812310STL"
"NSH",0,1,3,2,0,6,0,2,1,0,0,3,"A","N","2018-12-31","201812310WSH"
"WSH",0,2,1,0,0,3,0,1,3,2,0,6,"H","N","2018-12-31","201812310WSH"
"BOS",0,1,1,2,0,4,0,1,1,0,0,2,"A","N","2019-01-01","201901010CHI"
"CHI",0,1,1,0,0,2,0,1,1,2,0,4,"H","N","2019-01-01","201901010CHI"
"NSH",0,0,2,2,0,4,0,0,0,0,0,0,"H","N","2019-01-01","201901010NSH"
"PHI",0,0,0,0,0,0,0,0,2,2,0,4,"A","N","2019-01-01","201901010NSH"
"LAK",0,0,0,0,0,0,0,0,0,2,0,2,"A","N","2019-01-01","201901010VEG"
"VEG",0,0,0,2,0,2,0,0,0,0,0,0,"H","N","2019-01-01","201901010VEG"
"ARI",0,1,0,0,0,1,0,0,2,1,0,3,"H","N","2019-01-02","201901020ARI"
"EDM",0,0,2,1,0,3,0,1,0,0,0,1,"A","N","2019-01-02","201901020ARI"
"COL",0,1,1,2,0,4,0,2,3,0,0,5,"H","N","2019-01-02","201901020COL"
"SJS",0,2,3,0,0,5,0,1,1,2,0,4,"A","N","2019-01-02","201901020COL"
"DAL",0,1,3,1,0,5,0,1,3,0,0,4,"H","N","2019-01-02","201901020DAL"
"NJD",0,1,3,0,0,4,0,1,3,1,0,5,"A","N","2019-01-02","201901020DAL"
"CGY",0,0,3,2,0,5,0,2,1,0,0,3,"A","N","2019-01-02","201901020DET"
"DET",0,2,1,0,0,3,0,0,3,2,0,5,"H","N","2019-01-02","201901020DET"
"NYR",0,0,1,1,0,2,0,0,4,3,0,7,"H","N","2019-01-02","201901020NYR"
"PIT",0,0,4,3,0,7,0,0,1,1,0,2,"A","N","2019-01-02","201901020NYR"
"OTT",0,0,1,2,0,3,1,0,2,1,0,4,"H","N","2019-01-02","201901020OTT"
"VAN",1,0,2,1,0,4,0,0,1,2,0,3,"A","N","2019-01-02","201901020OTT"
"BOS",0,2,1,3,0,6,0,1,1,2,0,4,"H","N","2019-01-03","201901030BOS"
"CGY",0,1,1,2,0,4,0,2,1,3,0,6,"A","N","2019-01-03","201901030BOS"
"BUF",0,2,0,2,0,4,0,0,1,2,0,3,"H","N","2019-01-03","201901030BUF"
"FLA",0,0,1,2,0,3,0,2,0,2,0,4,"A","N","2019-01-03","201901030BUF"
"LAK",0,0,1,1,0,2,0,3,2,1,0,6,"H","N","2019-01-03","201901030LAK"
"TBL",0,3,2,1,0,6,0,0,1,1,0,2,"A","N","2019-01-03","201901030LAK"
"MTL",0,1,1,0,0,2,0,0,0,0,0,0,"H","N","2019-01-03","201901030MTL"
"VAN",0,0,0,0,0,0,0,1,1,0,0,2,"A","N","2019-01-03","201901030MTL"
"CHI",0,1,0,1,0,2,1,1,1,0,0,3,"A","N","2019-01-03","201901030NYI"
"NYI",1,1,1,0,0,3,0,1,0,1,0,2,"H","N","2019-01-03","201901030NYI"
"CAR",0,0,3,2,0,5,0,0,0,3,0,3,"A","N","2019-01-03","201901030PHI"
"PHI",0,0,0,3,0,3,0,0,3,2,0,5,"H","N","2019-01-03","201901030PHI"
"STL",0,1,2,2,0,5,0,1,1,0,0,2,"H","N","2019-01-03","201901030STL"
"WSH",0,1,1,0,0,2,0,1,2,2,0,5,"A","N","2019-01-03","201901030STL"
"MIN",0,1,2,1,0,4,0,2,1,0,0,3,"A","N","2019-01-03","201901030TOR"
"TOR",0,2,1,0,0,3,0,1,2,1,0,4,"H","N","2019-01-03","201901030TOR"
"ANA",0,0,2,0,0,2,0,1,2,0,0,3,"H","N","2019-01-04","201901040ANA"
"VEG",0,1,2,0,0,3,0,0,2,0,0,2,"A","N","2019-01-04","201901040ANA"
"ARI",0,1,1,0,0,2,0,1,1,0,1,3,"H","Y","2019-01-04","201901040ARI"
"NJD",0,1,1,0,1,3,0,1,1,0,0,2,"A","Y","2019-01-04","201901040ARI"
"CAR",0,2,1,1,0,4,0,0,2,0,0,2,"H","N","2019-01-04","201901040CAR"
"CBJ",0,0,2,0,0,2,0,2,1,1,0,4,"A","N","2019-01-04","201901040CAR"
"COL",0,2,1,3,0,6,0,0,0,1,0,1,"H","N","2019-01-04","201901040COL"
"NYR",0,0,0,1,0,1,0,2,1,3,0,6,"A","N","2019-01-04","201901040COL"
"DAL",1,1,0,0,0,2,0,0,1,0,0,1,"H","N","2019-01-04","201901040DAL"
"WSH",0,0,1,0,0,1,1,1,0,0,0,2,"A","N","2019-01-04","201901040DAL"
"DET",1,0,2,1,0,4,0,1,1,1,0,3,"H","N","2019-01-04","201901040DET"
"NSH",0,1,1,1,0,3,1,0,2,1,0,4,"A","N","2019-01-04","201901040DET"
"PIT",0,2,1,1,0,4,0,0,0,0,0,0,"H","N","2019-01-04","201901040PIT"
"WPG",0,0,0,0,0,0,0,2,1,1,0,4,"A","N","2019-01-04","201901040PIT"
"BOS",0,1,1,0,0,2,0,0,0,1,0,1,"H","N","2019-01-05","201901050BOS"
"BUF",0,0,0,1,0,1,0,1,1,0,0,2,"A","N","2019-01-05","201901050BOS"
"CBJ",1,1,1,1,0,4,0,2,0,1,0,3,"A","N","2019-01-05","201901050FLA"
"FLA",0,2,0,1,0,3,1,1,1,1,0,4,"H","N","2019-01-05","201901050FLA"
"EDM",0,0,0,0,0,0,0,3,0,1,0,4,"A","N","2019-01-05","201901050LAK"
"LAK",0,3,0,1,0,4,0,0,0,0,0,0,"H","N","2019-01-05","201901050LAK"
"MTL",0,0,1,0,0,1,0,2,1,1,0,4,"H","N","2019-01-05","201901050MTL"
"NSH",0,2,1,1,0,4,0,0,1,0,0,1,"A","N","2019-01-05","201901050MTL"
"MIN",0,0,3,1,0,4,0,1,1,1,0,3,"A","N","2019-01-05","201901050OTT"
"OTT",0,1,1,1,0,3,0,0,3,1,0,4,"H","N","2019-01-05","201901050OTT"
"CGY",1,0,1,1,0,3,0,1,0,1,0,2,"A","N","2019-01-05","201901050PHI"
"PHI",0,1,0,1,0,2,1,0,1,1,0,3,"H","N","2019-01-05","201901050PHI"
"SJS",0,2,1,2,0,5,0,1,1,0,0,2,"H","N","2019-01-05","201901050SJS"
"TBL",0,1,1,0,0,2,0,2,1,2,0,5,"A","N","2019-01-05","201901050SJS"
"NYI",0,0,1,3,0,4,0,2,0,1,0,3,"A","N","2019-01-05","201901050STL"
"STL",0,2,0,1,0,3,0,0,1,3,0,4,"H","N","2019-01-05","201901050STL"
"TOR",0,2,0,3,0,5,0,0,0,0,0,0,"H","N","2019-01-05","201901050TOR"
"VAN",0,0,0,0,0,0,0,2,0,3,0,5,"A","N","2019-01-05","201901050TOR"
"ANA",0,0,0,0,0,0,0,3,1,0,0,4,"H","N","2019-01-06","201901060ANA"
"EDM",0,3,1,0,0,4,0,0,0,0,0,0,"A","N","2019-01-06","201901060ANA"
"ARI",0,2,3,0,0,5,0,0,0,0,0,0,"H","N","2019-01-06","201901060ARI"
"NYR",0,0,0,0,0,0,0,2,3,0,0,5,"A","N","2019-01-06","201901060ARI"
"DET",0,1,1,0,0,2,0,1,0,2,0,3,"H","N","2019-01-06","201901060DET"
"WSH",0,1,0,2,0,3,0,1,1,0,0,2,"A","N","2019-01-06","201901060DET"
"CAR",0,2,2,1,0,5,0,0,4,0,0,4,"A","N","2019-01-06","201901060OTT"
"OTT",0,0,4,0,0,4,0,2,2,1,0,5,"H","N","2019-01-06","201901060OTT"
"CHI",0,1,2,2,0,5,0,2,1,0,0,3,"A","N","2019-01-06","201901060PIT"
"PIT",0,2,1,0,0,3,0,1,2,2,0,5,"H","N","2019-01-06","201901060PIT"
"NJD",0,2,0,0,0,2,0,1,2,0,0,3,"A","N","2019-01-06","201901060VEG"
"VEG",0,1,2,0,0,3,0,2,0,0,0,2,"H","N","2019-01-06","201901060VEG"
"DAL",0,0,1,0,0,1,0,0,2,3,0,5,"A","N","2019-01-06","201901060WPG"
"WPG",0,0,2,3,0,5,0,0,1,0,0,1,"H","N","2019-01-06","201901060WPG"
"CGY",0,1,1,2,0,4,0,1,1,1,0,3,"A","N","2019-01-07","201901070CHI"
"CHI",0,1,1,1,0,3,0,1,1,2,0,4,"H","N","2019-01-07","201901070CHI"
"MIN",0,0,0,1,0,1,0,0,0,0,0,0,"A","N","2019-01-07","201901070MTL"
"MTL",0,0,0,0,0,0,0,0,0,1,0,1,"H","N","2019-01-07","201901070MTL"
"PHI",0,0,0,0,0,0,0,0,1,2,0,3,"H","N","2019-01-07","201901070PHI"
"STL",0,0,1,2,0,3,0,0,0,0,0,0,"A","N","2019-01-07","201901070PHI"
"LAK",0,0,1,0,0,1,0,1,1,1,0,3,"A","N","2019-01-07","201901070SJS"
"SJS",0,1,1,1,0,3,0,0,1,0,0,1,"H","N","2019-01-07","201901070SJS"
"NSH",0,0,2,2,0,4,0,0,0,0,0,0,"A","N","2019-01-07","201901070TOR"
"TOR",0,0,0,0,0,0,0,0,2,2,0,4,"H","N","2019-01-07","201901070TOR"
"BOS",0,3,1,0,0,4,0,0,0,0,0,0,"H","N","2019-01-08","201901080BOS"
"MIN",0,0,0,0,0,0,0,3,1,0,0,4,"A","N","2019-01-08","201901080BOS"
"BUF",0,0,5,0,0,5,0,1,0,0,0,1,"H","N","2019-01-08","201901080BUF"
"NJD",0,1,0,0,0,1,0,0,5,0,0,5,"A","N","2019-01-08","201901080BUF"
"DET",0,0,1,1,0,2,0,0,2,1,0,3,"H","N","2019-01-08","201901080DET"
"MTL",0,0,2,1,0,3,0,0,1,1,0,2,"A","N","2019-01-08","201901080DET"
"CAR",0,2,0,2,0,4,0,1,0,2,0,3,"A","N","2019-01-08","201901080NYI"
"NYI",0,1,0,2,0,3,0,2,0,2,0,4,"H","N","2019-01-08","201901080NYI"
"FLA",0,0,1,0,0,1,0,2,2,1,0,5,"A","N","2019-01-08","201901080PIT"
"PIT",0,2,2,1,0,5,0,0,1,0,0,1,"H","N","2019-01-08","201901080PIT"
"EDM",0,1,1,0,0,2,0,3,2,2,0,7,"A","N","2019-01-08","201901080SJS"
"SJS",0,3,2,2,0,7,0,1,1,0,0,2,"H","N","2019-01-08","201901080SJS"
"DAL",0,1,2,0,0,3,0,0,1,0,0,1,"A","N","2019-01-08","201901080STL"
"STL",0,0,1,0,0,1,0,1,2,0,0,3,"H","N","2019-01-08","201901080STL"
"CBJ",0,0,0,0,0,0,0,2,0,2,0,4,"A","N","2019-01-08","201901080TBL"
"TBL",0,2,0,2,0,4,0,0,0,0,0,0,"H","N","2019-01-08","201901080TBL"
"NYR",0,0,0,2,0,2,0,1,2,1,0,4,"A","N","2019-01-08","201901080VEG"
"VEG",0,1,2,1,0,4,0,0,0,2,0,2,"H","N","2019-01-08","201901080VEG"
"COL",0,1,2,1,0,4,0,2,2,3,0,7,"A","N","2019-01-08","201901080WPG"
"WPG",0,2,2,3,0,7,0,1,2,1,0,4,"H","N","2019-01-08","201901080WPG"
"PHI",0,1,0,2,0,3,0,1,3,1,0,5,"A","N","2019-01-08","201901080WSH"
"WSH",0,1,3,1,0,5,0,1,0,2,0,3,"H","N","2019-01-08","201901080WSH"
"ANA",0,1,0,0,0,1,1,0,0,1,0,2,"H","N","2019-01-09","201901090ANA"
"OTT",1,0,0,1,0,2,0,1,0,0,0,1,"A","N","2019-01-09","201901090ANA"
"CGY",0,2,1,2,0,5,0,2,0,1,0,3,"H","N","2019-01-09","201901090CGY"
"COL",0,2,0,1,0,3,0,2,1,2,0,5,"A","N","2019-01-09","201901090CGY"
"CHI",0,1,1,1,0,3,1,2,1,0,0,4,"H","N","2019-01-09","201901090CHI"
"NSH",1,2,1,0,0,4,0,1,1,1,0,3,"A","N","2019-01-09","201901090CHI"
"BOS",0,0,1,1,0,2,0,1,1,2,0,4,"H","N","2019-01-10","201901100BOS"
"WSH",0,1,1,2,0,4,0,0,1,1,0,2,"A","N","2019-01-10","201901100BOS"
"CBJ",1,1,0,2,0,4,0,0,0,3,0,3,"H","N","2019-01-10","201901100CBJ"
"NSH",0,0,0,3,0,3,1,1,0,2,0,4,"A","N","2019-01-10","201901100CBJ"
"EDM",0,1,1,1,1,4,0,1,1,1,0,3,"H","Y","2019-01-10","201901100EDM"
"FLA",0,1,1,1,0,3,0,1,1,1,1,4,"A","Y","2019-01-10","201901100EDM"
"LAK",0,0,1,0,0,1,0,0,2,2,0,4,"H","N","2019-01-10","201901100LAK"
"OTT",0,0,2,2,0,4,0,0,1,0,0,1,"A","N","2019-01-10","201901100LAK"
"MIN",0,1,2,0,0,3,0,0,1,1,0,2,"H","N","2019-01-10","201901100MIN"
"WPG",0,0,1,1,0,2,0,1,2,0,0,3,"A","N","2019-01-10","201901100MIN"
"NJD",0,0,2,0,0,2,0,3,0,1,0,4,"H","N","2019-01-10","201901100NJD"
"TOR",0,3,0,1,0,4,0,0,2,0,0,2,"A","N","2019-01-10","201901100NJD"
"NYI",0,2,1,1,0,4,0,1,1,1,0,3,"A","N","2019-01-10","201901100NYR"
"NYR",0,1,1,1,0,3,0,2,1,1,0,4,"H","N","2019-01-10","201901100NYR"
"DAL",0,0,0,1,0,1,0,0,2,0,0,2,"A","N","2019-01-10","201901100PHI"
"PHI",0,0,2,0,0,2,0,0,0,1,0,1,"H","N","2019-01-10","201901100PHI"
"MTL",0,0,1,0,0,1,0,2,1,1,0,4,"A","N","2019-01-10","201901100STL"
"STL",0,2,1,1,0,4,0,0,1,0,0,1,"H","N","2019-01-10","201901100STL"
"CAR",0,0,1,0,0,1,0,0,0,3,0,3,"A","N","2019-01-10","201901100TBL"
"TBL",0,0,0,3,0,3,0,0,1,0,0,1,"H","N","2019-01-10","201901100TBL"
"ARI",1,0,2,1,0,4,0,0,2,1,0,3,"A","N","2019-01-10","201901100VAN"
"VAN",0,0,2,1,0,3,1,0,2,1,0,4,"H","N","2019-01-10","201901100VAN"
"SJS",0,0,1,2,0,3,0,1,0,1,0,2,"A","N","2019-01-10","201901100VEG"
"VEG",0,1,0,1,0,2,0,0,1,2,0,3,"H","N","2019-01-10","201901100VEG"
"ANA",0,3,1,0,0,4,0,0,3,4,0,7,"H","N","2019-01-11","201901110ANA"
"PIT",0,0,3,4,0,7,0,3,1,0,0,4,"A","N","2019-01-11","201901110ANA"
"BUF",0,1,1,1,0,3,0,1,3,0,0,4,"A","N","2019-01-11","201901110CAR"
"CAR",0,1,3,0,0,4,0,1,1,1,0,3,"H","N","2019-01-11","201901110CAR"
"CGY",0,0,2,2,0,4,0,1,1,1,0,3,"H","N","2019-01-11","201901110CGY"
"FLA",0,1,1,1,0,3,0,0,2,2,0,4,"A","N","2019-01-11","201901110CGY"
"DET",0,0,1,1,0,2,0,2,1,1,0,4,"A","N","2019-01-11","201901110WPG"
"WPG",0,2,1,1,0,4,0,0,1,1,0,2,"H","N","2019-01-11","201901110WPG"
"BUF",0,2,0,1,0,3,0,1,1,3,0,5,"H","N","2019-01-12","201901120BUF"
"TBL",0,1,1,3,0,5,0,2,0,1,0,3,"A","N","2019-01-12","201901120BUF"
"CHI",0,2,1,0,0,3,1,0,2,1,0,4,"H","N","2019-01-12","201901120CHI"
"VEG",1,0,2,1,0,4,0,2,1,0,0,3,"A","N","2019-01-12","201901120CHI"
"DAL",0,0,0,1,0,1,0,2,0,1,0,3,"H","N","2019-01-12","201901120DAL"
"STL",0,2,0,1,0,3,0,0,0,1,0,1,"A","N","2019-01-12","201901120DAL"
"ARI",0,0,2,1,0,3,0,1,1,0,0,2,"A","N","2019-01-12","201901120EDM"
"EDM",0,1,1,0,0,2,0,0,2,1,0,3,"H","N","2019-01-12","201901120EDM"
"LAK",0,1,2,2,0,5,0,1,0,1,0,2,"H","N","2019-01-12","201901120LAK"
"PIT",0,1,0,1,0,2,0,1,2,2,0,5,"A","N","2019-01-12","201901120LAK"
"DET",0,1,2,2,0,5,0,1,1,0,0,2,"A","N","2019-01-12","201901120MIN"
"MIN",0,1,1,0,0,2,0,1,2,2,0,5,"H","N","2019-01-12","201901120MIN"
"COL",0,0,0,0,0,0,0,0,0,3,0,3,"A","N","2019-01-12","201901120MTL"
"MTL",0,0,0,3,0,3,0,0,0,0,0,0,"H","N","2019-01-12","201901120MTL"
"NJD",0,1,1,1,0,3,0,0,1,1,0,2,"H","N","2019-01-12","201901120NJD"
"PHI",0,0,1,1,0,2,0,1,1,1,0,3,"A","N","2019-01-12","201901120NJD"
"NYI",0,0,1,0,0,1,0,0,1,1,0,2,"H","N","2019-01-12","201901120NYI"
"NYR",0,0,1,1,0,2,0,0,1,0,0,1,"A","N","2019-01-12","201901120NYI"
"OTT",0,0,0,1,0,1,0,0,1,3,0,4,"A","N","2019-01-12","201901120SJS"
"SJS",0,0,1,3,0,4,0,0,0,1,0,1,"H","N","2019-01-12","201901120SJS"
"BOS",0,1,2,0,0,3,0,0,2,0,0,2,"A","N","2019-01-12","201901120TOR"
"TOR",0,0,2,0,0,2,0,1,2,0,0,3,"H","N","2019-01-12","201901120TOR"
"CBJ",1,1,0,0,0,2,0,0,0,1,0,1,"A","N","2019-01-12","201901120WSH"
"WSH",0,0,0,1,0,1,1,1,0,0,0,2,"H","N","2019-01-12","201901120WSH"
"CAR",0,2,3,1,0,6,0,0,2,1,0,3,"H","N","2019-01-13","201901130CAR"
"NSH",0,0,2,1,0,3,0,2,3,1,0,6,"A","N","2019-01-13","201901130CAR"
"CBJ",0,2,3,2,0,7,0,2,1,2,0,5,"H","N","2019-01-13","201901130CBJ"
"NYR",0,2,1,2,0,5,0,2,3,2,0,7,"A","N","2019-01-13","201901130CBJ"
"ARI",0,0,1,0,0,1,0,2,2,3,0,7,"A","N","2019-01-13","201901130CGY"
"CGY",0,2,2,3,0,7,0,0,1,0,0,1,"H","N","2019-01-13","201901130CGY"
"NYI",0,3,1,1,0,5,0,0,1,0,0,1,"H","N","2019-01-13","201901130NYI"
"TBL",0,0,1,0,0,1,0,3,1,1,0,5,"A","N","2019-01-13","201901130NYI"
"FLA",0,0,0,1,0,1,0,0,1,4,0,5,"A","N","2019-01-13","201901130VAN"
"VAN",0,0,1,4,0,5,0,0,0,1,0,1,"H","N","2019-01-13","201901130VAN"
"ANA",0,2,1,0,0,3,1,1,1,1,0,4,"A","N","2019-01-13","201901130WPG"
"WPG",1,1,1,1,0,4,0,2,1,0,0,3,"H","N","2019-01-13","201901130WPG"
"BOS",0,1,0,1,0,2,1,1,1,0,0,3,"H","N","2019-01-14","201901140BOS"
"MTL",1,1,1,0,0,3,0,1,0,1,0,2,"A","N","2019-01-14","201901140BOS"
"BUF",0,2,0,0,0,2,0,3,2,2,0,7,"A","N","2019-01-14","201901140EDM"
"EDM",0,3,2,2,0,7,0,2,0,0,0,2,"H","N","2019-01-14","201901140EDM"
"CHI",0,0,3,2,0,5,0,1,5,2,0,8,"A","N","2019-01-14","201901140NJD"
"NJD",0,1,5,2,0,8,0,0,3,2,0,5,"H","N","2019-01-14","201901140NJD"
"MIN",0,2,1,1,0,4,0,2,3,2,0,7,"A","N","2019-01-14","201901140PHI"
"PHI",0,2,3,2,0,7,0,2,1,1,0,4,"H","N","2019-01-14","201901140PHI"
"COL",0,0,3,3,0,6,0,0,2,1,0,3,"A","N","2019-01-14","201901140TOR"
"TOR",0,0,2,1,0,3,0,0,3,3,0,6,"H","N","2019-01-14","201901140TOR"
"STL",0,0,3,1,0,4,0,1,0,0,0,1,"A","N","2019-01-14","201901140WSH"
"WSH",0,1,0,0,0,1,0,0,3,1,0,4,"H","N","2019-01-14","201901140WSH"
"CBJ",0,3,1,0,0,4,0,0,1,0,0,1,"H","N","2019-01-15","201901150CBJ"
"NJD",0,0,1,0,0,1,0,3,1,0,0,4,"A","N","2019-01-15","201901150CBJ"
"DAL",0,0,0,0,0,0,0,1,0,1,0,2,"H","N","2019-01-15","201901150DAL"
"TBL",0,1,0,1,0,2,0,0,0,0,0,0,"A","N","2019-01-15","201901150DAL"
"ANA",0,0,1,0,0,1,0,0,0,3,0,3,"A","N","2019-01-15","201901150DET"
"DET",0,0,0,3,0,3,0,0,1,0,0,1,"H","N","2019-01-15","201901150DET"
"LAK",0,0,1,1,0,2,0,0,1,1,1,3,"A","Y","2019-01-15","201901150MIN"
"MIN",0,0,1,1,1,3,0,0,1,1,0,2,"H","Y","2019-01-15","201901150MIN"
"FLA",0,1,0,0,0,1,0,0,3,2,0,5,"A","N","2019-01-15","201901150MTL"
"MTL",0,0,3,2,0,5,0,1,0,0,0,1,"H","N","2019-01-15","201901150MTL"
"NSH",0,2,4,1,0,7,0,0,1,1,0,2,"H","N","2019-01-15","201901150NSH"
"WSH",0,0,1,1,0,2,0,2,4,1,0,7,"A","N","2019-01-15","201901150NSH"
"NYI",1,1,0,0,0,2,0,0,0,1,0,1,"H","N","2019-01-15","201901150NYI"
"STL",0,0,0,1,0,1,1,1,0,0,0,2,"A","N","2019-01-15","201901150NYI"
"CAR",0,1,0,1,0,2,0,3,1,2,0,6,"A","N","2019-01-15","201901150NYR"
"NYR",0,3,1,2,0,6,0,1,0,1,0,2,"H","N","2019-01-15","201901150NYR"
"PIT",0,1,0,1,0,2,0,2,1,2,0,5,"A","N","2019-01-15","201901150SJS"
"SJS",0,2,1,2,0,5,0,1,0,1,0,2,"H","N","2019-01-15","201901150SJS"
"VEG",0,0,0,1,0,1,0,0,2,2,0,4,"A","N","2019-01-15","201901150WPG"
"WPG",0,0,2,2,0,4,0,0,0,1,0,1,"H","N","2019-01-15","201901150WPG"
"ARI",0,2,2,2,0,6,0,1,1,1,0,3,"H","N","2019-01-16","201901160ARI"
"SJS",0,1,1,1,0,3,0,2,2,2,0,6,"A","N","2019-01-16","201901160ARI"
"BUF",1,0,1,2,0,4,0,1,0,2,0,3,"A","N","2019-01-16","201901160CGY"
"CGY",0,1,0,2,0,3,1,0,1,2,0,4,"H","N","2019-01-16","201901160CGY"
"COL",0,0,1,1,0,2,0,0,3,2,0,5,"A","N","2019-01-16","201901160OTT"
"OTT",0,0,3,2,0,5,0,0,1,1,0,2,"H","N","2019-01-16","201901160OTT"
"BOS",0,2,0,1,0,3,0,1,2,1,0,4,"A","N","2019-01-16","201901160PHI"
"PHI",0,1,2,1,0,4,0,2,0,1,0,3,"H","N","2019-01-16","201901160PHI"
"EDM",0,2,0,0,1,3,0,1,1,0,0,2,"A","Y","2019-01-16","201901160VAN"
"VAN",0,1,1,0,0,2,0,2,0,0,1,3,"H","Y","2019-01-16","201901160VAN"
"BOS",0,0,2,3,0,5,0,0,2,0,0,2,"H","N","2019-01-17","201901170BOS"
"STL",0,0,2,0,0,2,0,0,2,3,0,5,"A","N","2019-01-17","201901170BOS"
"DAL",0,0,0,1,0,1,0,1,1,0,0,2,"H","N","2019-01-17","201901170DAL"
"LAK",0,1,1,0,0,2,0,0,0,1,0,1,"A","N","2019-01-17","201901170DAL"
"ANA",0,3,0,0,0,3,0,0,0,0,0,0,"A","N","2019-01-17","201901170MIN"
"MIN",0,0,0,0,0,0,0,3,0,0,0,3,"H","N","2019-01-17","201901170MIN"
"NSH",0,0,1,0,0,1,0,1,2,2,0,5,"H","N","2019-01-17","201901170NSH"
"WPG",0,1,2,2,0,5,0,0,1,0,0,1,"A","N","2019-01-17","201901170NSH"
"NJD",0,0,0,1,0,1,0,3,0,1,0,4,"A","N","2019-01-17","201901170NYI"
"NYI",0,3,0,1,0,4,0,0,0,1,0,1,"H","N","2019-01-17","201901170NYI"
"CHI",0,1,0,2,0,3,0,2,1,1,0,4,"A","N","2019-01-17","201901170NYR"
"NYR",0,2,1,1,0,4,0,1,0,2,0,3,"H","N","2019-01-17","201901170NYR"
"TBL",0,1,1,0,0,2,0,1,2,1,0,4,"H","N","2019-01-17","201901170TBL"
"TOR",0,1,2,1,0,4,0,1,1,0,0,2,"A","N","2019-01-17","201901170TBL"
"ARI",0,1,0,1,0,2,1,0,2,0,0,3,"H","N","2019-01-18","201901180ARI"
"PIT",1,0,2,0,0,3,0,1,0,1,0,2,"A","N","2019-01-18","201901180ARI"
"CAR",0,0,1,0,0,1,0,1,3,0,0,4,"H","N","2019-01-18","201901180CAR"
"OTT",0,1,3,0,0,4,0,0,1,0,0,1,"A","N","2019-01-18","201901180CAR"
"CBJ",0,0,0,1,0,1,0,1,1,2,0,4,"H","N","2019-01-18","201901180CBJ"
"MTL",0,1,1,2,0,4,0,0,0,1,0,1,"A","N","2019-01-18","201901180CBJ"
"CGY",0,0,2,4,0,6,0,1,1,2,0,4,"H","N","2019-01-18","201901180CGY"
"DET",0,1,1,2,0,4,0,0,2,4,0,6,"A","N","2019-01-18","201901180CGY"
"FLA",0,2,0,1,0,3,0,1,0,0,0,1,"H","N","2019-01-18","201901180FLA"
"TOR",0,1,0,0,0,1,0,2,0,1,0,3,"A","N","2019-01-18","201901180FLA"
"BUF",0,1,2,0,0,3,0,2,1,1,0,4,"A","N","2019-01-18","201901180VAN"
"VAN",0,2,1,1,0,4,0,1,2,0,0,3,"H","N","2019-01-18","201901180VAN"
"NYI",0,0,0,2,0,2,0,0,0,0,0,0,"A","N","2019-01-18","201901180WSH"
"WSH",0,0,0,0,0,0,0,0,0,2,0,2,"H","N","2019-01-18","201901180WSH"
"BOS",0,1,0,1,0,2,0,1,1,1,0,3,"H","N","2019-01-19","201901190BOS"
"NYR",0,1,1,1,0,3,0,1,0,1,0,2,"A","N","2019-01-19","201901190BOS"
"COL",0,1,6,0,0,7,0,0,0,1,0,1,"H","N","2019-01-19","201901190COL"
"LAK",0,0,0,1,0,1,0,1,6,0,0,7,"A","N","2019-01-19","201901190COL"
"DAL",0,1,2,1,0,4,0,0,0,2,0,2,"H","N","2019-01-19","201901190DAL"
"WPG",0,0,0,2,0,2,0,1,2,1,0,4,"A","N","2019-01-19","201901190DAL"
"CGY",0,0,3,2,0,5,0,0,1,1,0,2,"A","N","2019-01-19","201901190EDM"
"EDM",0,0,1,1,0,2,0,0,3,2,0,5,"H","N","2019-01-19","201901190EDM"
"CBJ",0,0,1,0,0,1,0,2,0,0,0,2,"A","N","2019-01-19","201901190MIN"
"MIN",0,2,0,0,0,2,0,0,1,0,0,1,"H","N","2019-01-19","201901190MIN"
"MTL",0,0,0,2,0,2,0,0,2,3,0,5,"H","N","2019-01-19","201901190MTL"
"PHI",0,0,2,3,0,5,0,0,0,2,0,2,"A","N","2019-01-19","201901190MTL"
"ANA",0,2,0,1,0,3,0,1,0,1,0,2,"A","N","2019-01-19","201901190NJD"
"NJD",0,1,0,1,0,2,0,2,0,1,0,3,"H","N","2019-01-19","201901190NJD"
"FLA",0,2,1,1,0,4,0,0,0,2,0,2,"A","N","2019-01-19","201901190NSH"
"NSH",0,0,0,2,0,2,0,2,1,1,0,4,"H","N","2019-01-19","201901190NSH"
"OTT",0,1,0,1,0,2,0,1,1,1,0,3,"A","N","2019-01-19","201901190STL"
"STL",0,1,1,1,0,3,0,1,0,1,0,2,"H","N","2019-01-19","201901190STL"
"SJS",0,1,1,1,0,3,0,2,2,2,0,6,"A","N","2019-01-19","201901190TBL"
"TBL",0,2,2,2,0,6,0,1,1,1,0,3,"H","N","2019-01-19","201901190TBL"
"PIT",0,1,2,0,0,3,0,3,2,2,0,7,"A","N","2019-01-19","201901190VEG"
"VEG",0,3,2,2,0,7,0,1,2,0,0,3,"H","N","2019-01-19","201901190VEG"
"CHI",0,3,1,4,0,8,0,1,1,3,0,5,"H","N","2019-01-20","201901200CHI"
"WSH",0,1,1,3,0,5,0,3,1,4,0,8,"A","N","2019-01-20","201901200CHI"
"CAR",0,3,3,1,0,7,0,1,1,2,0,4,"A","N","2019-01-20","201901200EDM"
"EDM",0,1,1,2,0,4,0,3,3,1,0,7,"H","N","2019-01-20","201901200EDM"
"ANA",0,0,0,0,0,0,0,2,1,0,0,3,"A","N","2019-01-20","201901200NYI"
"NYI",0,2,1,0,0,3,0,0,0,0,0,0,"H","N","2019-01-20","201901200NYI"
"ARI",0,0,2,2,0,4,0,1,0,1,0,2,"A","N","2019-01-20","201901200TOR"
"TOR",0,1,0,1,0,2,0,0,2,2,0,4,"H","N","2019-01-20","201901200TOR"
"DET",0,0,2,0,0,2,0,1,0,2,0,3,"A","N","2019-01-20","201901200VAN"
"VAN",0,1,0,2,0,3,0,0,2,0,0,2,"H","N","2019-01-20","201901200VAN"
"COL",0,0,1,0,0,1,0,0,3,1,0,4,"H","N","2019-01-21","201901210COL"
"NSH",0,0,3,1,0,4,0,0,1,0,0,1,"A","N","2019-01-21","201901210COL"
"FLA",0,1,1,4,0,6,0,0,2,0,0,2,"H","N","2019-01-21","201901210FLA"
"SJS",0,0,2,0,0,2,0,1,1,4,0,6,"A","N","2019-01-21","201901210FLA"
"LAK",0,1,2,1,0,4,0,2,0,1,0,3,"H","N","2019-01-21","201901210LAK"
"STL",0,2,0,1,0,3,0,1,2,1,0,4,"A","N","2019-01-21","201901210LAK"
"MIN",0,0,2,2,0,4,0,1,1,0,0,2,"A","N","2019-01-21","201901210VEG"
"VEG",0,1,1,0,0,2,0,0,2,2,0,4,"H","N","2019-01-21","201901210VEG"
"CAR",0,1,0,1,0,2,1,1,1,0,0,3,"A","N","2019-01-22","201901220CGY"
"CGY",1,1,1,0,0,3,0,1,0,1,0,2,"H","N","2019-01-22","201901220CGY"
"CHI",0,0,2,0,1,3,0,1,1,0,0,2,"H","Y","2019-01-22","201901220CHI"
"NYI",0,1,1,0,0,2,0,0,2,0,1,3,"A","Y","2019-01-22","201901220CHI"
"DET",0,0,2,1,0,3,0,0,0,2,0,2,"A","N","2019-01-22","201901220EDM"
"EDM",0,0,0,2,0,2,0,0,2,1,0,3,"H","N","2019-01-22","201901220EDM"
"ARI",0,1,2,0,0,3,0,0,1,1,0,2,"A","N","2019-01-22","201901220OTT"
"OTT",0,0,1,1,0,2,0,1,2,0,0,3,"H","N","2019-01-22","201901220OTT"
"SJS",1,2,2,2,0,7,0,3,2,1,0,6,"A","N","2019-01-22","201901220WSH"
"WSH",0,3,2,1,0,6,1,2,2,2,0,7,"H","N","2019-01-22","201901220WSH"
"ANA",0,1,0,0,0,1,0,1,2,2,0,5,"H","N","2019-01-23","201901230ANA"
"STL",0,1,2,2,0,5,0,1,0,0,0,1,"A","N","2019-01-23","201901230ANA"
"COL",0,2,0,0,0,2,0,2,2,1,0,5,"H","N","2019-01-23","201901230COL"
"MIN",0,2,2,1,0,5,0,2,0,0,0,2,"A","N","2019-01-23","201901230COL"
"ARI",0,0,1,0,0,1,0,1,0,1,0,2,"A","N","2019-01-23","201901230MTL"
"MTL",0,1,0,1,0,2,0,0,1,0,0,1,"H","N","2019-01-23","201901230MTL"
"TOR",0,1,2,3,0,6,0,1,1,1,0,3,"H","N","2019-01-23","201901230TOR"
"WSH",0,1,1,1,0,3,0,1,2,3,0,6,"A","N","2019-01-23","201901230TOR"
"CAR",0,0,5,0,0,5,0,0,2,0,0,2,"A","N","2019-01-23","201901230VAN"
"VAN",0,0,2,0,0,2,0,0,5,0,0,5,"H","N","2019-01-23","201901230VAN"
"NSH",0,0,2,0,0,2,0,1,0,0,0,1,"A","N","2019-01-23","201901230VEG"
"VEG",0,1,0,0,0,1,0,0,2,0,0,2,"H","N","2019-01-23","201901230VEG"
"PHI",0,0,2,1,0,3,0,0,1,0,0,1,"H","N","2019-01-28","201901280PHI"
"WPG",0,0,1,0,0,1,0,0,2,1,0,3,"A","N","2019-01-28","201901280PHI"
"NJD",0,2,2,2,0,6,0,0,1,2,0,3,"A","N","2019-01-28","201901280PIT"
"PIT",0,0,1,2,0,3,0,2,2,2,0,6,"H","N","2019-01-28","201901280PIT"
"BOS",0,2,0,1,0,3,0,1,0,2,1,4,"H","Y","2019-01-29","201901290BOS"
"WPG",0,1,0,2,1,4,0,2,0,1,0,3,"A","Y","2019-01-29","201901290BOS"
"BUF",0,3,1,1,0,5,0,1,3,0,0,4,"A","N","2019-01-29","201901290CBJ"
"CBJ",0,1,3,0,0,4,0,3,1,1,0,5,"H","N","2019-01-29","201901290CBJ"
"NYR",0,0,0,0,0,0,0,1,0,0,0,1,"H","N","2019-01-29","201901290NYR"
"PHI",0,1,0,0,0,1,0,0,0,0,0,0,"A","N","2019-01-29","201901290NYR"
"BUF",0,0,0,0,0,0,0,1,0,0,0,1,"A","N","2019-01-30","201901300DAL"
"DAL",0,1,0,0,0,1,0,0,0,0,0,0,"H","N","2019-01-30","201901300DAL"
"PIT",0,3,1,0,0,4,0,0,0,2,0,2,"H","N","2019-01-30","201901300PIT"
"TBL",0,0,0,2,0,2,0,3,1,0,0,4,"A","N","2019-01-30","201901300PIT"
"BOS",0,1,1,0,0,2,1,1,0,1,0,3,"H","N","2019-01-31","201901310BOS"
"PHI",1,1,0,1,0,3,0,1,1,0,0,2,"A","N","2019-01-31","201901310BOS"
"NJD",0,2,0,1,0,3,0,1,1,2,0,4,"H","N","2019-01-31","201901310NJD"
"NYR",0,1,1,2,0,4,0,2,0,1,0,3,"A","N","2019-01-31","201901310NJD"
"CBJ",0,2,1,0,0,3,0,1,1,2,0,4,"A","N","2019-01-31","201901310WPG"
"WPG",0,1,1,2,0,4,0,2,1,0,0,3,"H","N","2019-01-31","201901310WPG"
"BUF",0,0,1,2,0,3,0,1,3,3,0,7,"H","N","2019-02-01","201902010BUF"
"CHI",0,1,3,3,0,7,0,0,1,2,0,3,"A","N","2019-02-01","201902010BUF"
"CAR",0,1,2,2,0,5,0,1,1,0,0,2,"H","N","2019-02-01","201902010CAR"
"VEG",0,1,1,0,0,2,0,1,2,2,0,5,"A","N","2019-02-01","201902010CAR"
"DAL",0,0,1,2,0,3,0,0,1,0,0,1,"H","N","2019-02-01","201902010DAL"
"MIN",0,0,1,0,0,1,0,0,1,2,0,3,"A","N","2019-02-01","201902010DAL"
"DET",1,0,1,1,0,3,0,0,1,1,0,2,"H","N","2019-02-01","201902010DET"
"TOR",0,0,1,1,0,2,1,0,1,1,0,3,"A","N","2019-02-01","201902010DET"
"FLA",0,0,1,0,0,1,0,0,0,4,0,4,"H","N","2019-02-01","201902010FLA"
"NSH",0,0,0,4,0,4,0,0,1,0,0,1,"A","N","2019-02-01","201902010FLA"
"NYI",0,0,0,0,0,0,0,0,0,0,1,1,"H","Y","2019-02-01","201902010NYI"
"TBL",0,0,0,0,1,1,0,0,0,0,0,0,"A","Y","2019-02-01","201902010NYI"
"OTT",0,0,1,2,0,3,0,2,1,2,0,5,"A","N","2019-02-01","201902010PIT"
"PIT",0,2,1,2,0,5,0,0,1,2,0,3,"H","N","2019-02-01","201902010PIT"
"CGY",0,1,1,1,0,3,0,2,1,1,0,4,"A","N","2019-02-01","201902010WSH"
"WSH",0,2,1,1,0,4,0,1,1,1,0,3,"H","N","2019-02-01","201902010WSH"
"CBJ",0,0,0,2,0,2,0,2,0,2,0,4,"H","N","2019-02-02","201902020CBJ"
"STL",0,2,0,2,0,4,0,0,0,2,0,2,"A","N","2019-02-02","201902020CBJ"
"COL",0,0,1,0,0,1,0,2,2,1,0,5,"H","N","2019-02-02","201902020COL"
"VAN",0,2,2,1,0,5,0,0,1,0,0,1,"A","N","2019-02-02","201902020COL"
"FLA",0,1,0,2,0,3,0,1,0,0,0,1,"H","N","2019-02-02","201902020FLA"
"VEG",0,1,0,0,0,1,0,1,0,2,0,3,"A","N","2019-02-02","201902020FLA"
"CHI",1,0,2,1,0,4,0,1,0,2,0,3,"A","N","2019-02-02","201902020MIN"
"MIN",0,1,0,2,0,3,1,0,2,1,0,4,"H","N","2019-02-02","201902020MIN"
"MTL",0,1,1,0,0,2,1,1,0,1,0,3,"H","N","2019-02-02","201902020MTL"
"NJD",1,1,0,1,0,3,0,1,1,0,0,2,"A","N","2019-02-02","201902020MTL"
"DAL",0,1,0,2,0,3,0,1,0,0,0,1,"A","N","2019-02-02","201902020NSH"
"NSH",0,1,0,0,0,1,0,1,0,2,0,3,"H","N","2019-02-02","201902020NSH"
"LAK",0,1,0,1,0,2,0,1,0,3,0,4,"A","N","2019-02-02","201902020NYI"
"NYI",0,1,0,3,0,4,0,1,0,1,0,2,"H","N","2019-02-02","201902020NYI"
"NYR",0,0,1,1,0,2,0,1,2,0,0,3,"H","N","2019-02-02","201902020NYR"
"TBL",0,1,2,0,0,3,0,0,1,1,0,2,"A","N","2019-02-02","201902020NYR"
"DET",0,2,0,0,0,2,0,0,0,0,0,0,"A","N","2019-02-02","201902020OTT"
"OTT",0,0,0,0,0,0,0,2,0,0,0,2,"H","N","2019-02-02","201902020OTT"
"EDM",0,2,1,1,0,4,1,1,1,2,0,5,"A","N","2019-02-02","201902020PHI"
"PHI",1,1,1,2,0,5,0,2,1,1,0,4,"H","N","2019-02-02","201902020PHI"
"ARI",0,0,1,1,0,2,1,0,2,0,0,3,"A","N","2019-02-02","201902020SJS"
"SJS",1,0,2,0,0,3,0,0,1,1,0,2,"H","N","2019-02-02","201902020SJS"
"PIT",0,2,0,0,0,2,0,1,2,0,0,3,"A","N","2019-02-02","201902020TOR"
"TOR",0,1,2,0,0,3,0,2,0,0,0,2,"H","N","2019-02-02","201902020TOR"
"ANA",0,0,2,1,0,3,0,6,2,1,0,9,"A","N","2019-02-02","201902020WPG"
"WPG",0,6,2,1,0,9,0,0,2,1,0,3,"H","N","2019-02-02","201902020WPG"
"CAR",0,1,1,1,0,3,0,1,2,1,0,4,"H","N","2019-02-03","201902030CAR"
"CGY",0,1,2,1,0,4,0,1,1,1,0,3,"A","N","2019-02-03","201902030CAR"
"EDM",0,1,2,0,0,3,1,1,1,1,0,4,"A","N","2019-02-03","201902030MTL"
"MTL",1,1,1,1,0,4,0,1,2,0,0,3,"H","N","2019-02-03","201902030MTL"
"BOS",0,0,1,0,0,1,0,0,0,0,0,0,"A","N","2019-02-03","201902030WSH"
"WSH",0,0,0,0,0,0,0,0,1,0,0,1,"H","N","2019-02-03","201902030WSH"
"ARI",0,1,1,2,0,4,0,0,1,4,0,5,"A","N","2019-02-04","201902040DAL"
"DAL",0,0,1,4,0,5,0,1,1,2,0,4,"H","N","2019-02-04","201902040DAL"
"LAK",1,1,0,2,0,4,0,1,1,1,0,3,"A","N","2019-02-04","201902040NYR"
"NYR",0,1,1,1,0,3,1,1,0,2,0,4,"H","N","2019-02-04","201902040NYR"
"PHI",0,1,1,0,0,2,0,0,1,0,0,1,"H","N","2019-02-04","201902040PHI"
"VAN",0,0,1,0,0,1,0,1,1,0,0,2,"A","N","2019-02-04","201902040PHI"
"ANA",0,0,0,1,0,1,0,0,3,3,0,6,"A","N","2019-02-04","201902040TOR"
"TOR",0,0,3,3,0,6,0,0,0,1,0,1,"H","N","2019-02-04","201902040TOR"
"BOS",0,0,1,2,0,3,0,0,1,0,0,1,"H","N","2019-02-05","201902050BOS"
"NYI",0,0,1,0,0,1,0,0,1,2,0,3,"A","N","2019-02-05","201902050BOS"
"BUF",0,1,2,1,1,5,0,0,3,1,0,4,"H","Y","2019-02-05","201902050BUF"
"MIN",0,0,3,1,0,4,0,1,2,1,1,5,"A","Y","2019-02-05","201902050BUF"
"CBJ",0,2,1,3,0,6,0,2,1,0,0,3,"A","N","2019-02-05","201902050COL"
"COL",0,2,1,0,0,3,0,2,1,3,0,6,"H","N","2019-02-05","201902050COL"
"CHI",0,1,0,5,0,6,0,2,0,0,0,2,"A","N","2019-02-05","201902050EDM"
"EDM",0,2,0,0,0,2,0,1,0,5,0,6,"H","N","2019-02-05","201902050EDM"
"FLA",0,1,0,1,0,2,0,0,0,3,0,3,"H","N","2019-02-05","201902050FLA"
"STL",0,0,0,3,0,3,0,1,0,1,0,2,"A","N","2019-02-05","201902050FLA"
"ANA",0,0,1,0,0,1,0,3,0,1,0,4,"A","N","2019-02-05","201902050MTL"
"MTL",0,3,0,1,0,4,0,0,1,0,0,1,"H","N","2019-02-05","201902050MTL"
"LAK",0,1,0,4,0,5,0,0,1,0,0,1,"A","N","2019-02-05","201902050NJD"
"NJD",0,0,1,0,0,1,0,1,0,4,0,5,"H","N","2019-02-05","201902050NJD"
"ARI",0,1,0,1,0,2,0,0,3,2,0,5,"A","N","2019-02-05","201902050NSH"
"NSH",0,0,3,2,0,5,0,1,0,1,0,2,"H","N","2019-02-05","201902050NSH"
"CAR",0,1,1,2,0,4,0,0,0,0,0,0,"A","N","2019-02-05","201902050PIT"
"PIT",0,0,0,0,0,0,0,1,1,2,0,4,"H","N","2019-02-05","201902050PIT"
"TBL",0,1,1,0,0,2,0,0,1,1,1,3,"H","Y","2019-02-05","201902050TBL"
"VEG",0,0,1,1,1,3,0,1,1,0,0,2,"A","Y","2019-02-05","201902050TBL"
"SJS",1,1,0,1,0,3,0,1,1,0,0,2,"A","N","2019-02-05","201902050WPG"
"WPG",0,1,1,0,0,2,1,1,0,1,0,3,"H","N","2019-02-05","201902050WPG"
"VAN",0,0,0,2,0,2,0,1,0,2,0,3,"A","N","2019-02-05","201902050WSH"
"WSH",0,1,0,2,0,3,0,0,0,2,0,2,"H","N","2019-02-05","201902050WSH"
"BOS",0,0,3,0,0,3,0,1,0,2,1,4,"A","Y","2019-02-06","201902060NYR"
"NYR",0,1,0,2,1,4,0,0,3,0,0,3,"H","Y","2019-02-06","201902060NYR"
"OTT",0,1,1,2,0,4,0,1,3,1,0,5,"A","N","2019-02-06","201902060TOR"
"TOR",0,1,3,1,0,5,0,1,1,2,0,4,"H","N","2019-02-06","201902060TOR"
"ARI",0,0,2,0,0,2,0,2,1,1,0,4,"H","N","2019-02-07","201902070ARI"
"CBJ",0,2,1,1,0,4,0,0,2,0,0,2,"A","N","2019-02-07","201902070ARI"
"BUF",0,0,2,3,0,5,1,1,1,3,0,6,"H","N","2019-02-07","201902070BUF"
"CAR",1,1,1,3,0,6,0,0,2,3,0,5,"A","N","2019-02-07","201902070BUF"
"CGY",0,1,1,0,0,2,0,3,1,1,0,5,"H","N","2019-02-07","201902070CGY"
"SJS",0,3,1,1,0,5,0,1,1,0,0,2,"A","N","2019-02-07","201902070CGY"
"CHI",1,2,1,0,0,4,0,0,2,1,0,3,"H","N","2019-02-07","201902070CHI"
"VAN",0,0,2,1,0,3,1,2,1,0,0,4,"A","N","2019-02-07","201902070CHI"
"DET",0,1,0,2,0,3,0,0,3,1,0,4,"H","N","2019-02-07","201902070DET"
"VEG",0,0,3,1,0,4,0,1,0,2,0,3,"A","N","2019-02-07","201902070DET"
"FLA",1,1,1,0,0,3,0,0,1,1,0,2,"H","N","2019-02-07","201902070FLA"
"PIT",0,0,1,1,0,2,1,1,1,0,0,3,"A","N","2019-02-07","201902070FLA"
"EDM",0,1,1,2,0,4,0,0,0,1,0,1,"A","N","2019-02-07","201902070MIN"
"MIN",0,0,0,1,0,1,0,1,1,2,0,4,"H","N","2019-02-07","201902070MIN"
"MTL",0,1,1,3,0,5,0,1,0,1,0,2,"H","N","2019-02-07","201902070MTL"
"WPG",0,1,0,1,0,2,0,1,1,3,0,5,"A","N","2019-02-07","201902070MTL"
"NJD",0,1,0,0,0,1,0,1,0,0,1,2,"H","Y","2019-02-07","201902070NJD"
"NYI",0,1,0,0,1,2,0,1,0,0,0,1,"A","Y","2019-02-07","201902070NJD"
"DAL",0,0,0,2,0,2,1,1,0,1,0,3,"A","N","2019-02-07","201902070NSH"
"NSH",1,1,0,1,0,3,0,0,0,2,0,2,"H","N","2019-02-07","201902070NSH"
"ANA",0,0,0,0,0,0,0,1,1,2,0,4,"A","N","2019-02-07","201902070OTT"
"OTT",0,1,1,2,0,4,0,0,0,0,0,0,"H","N","2019-02-07","201902070OTT"
"LAK",0,1,1,0,1,3,0,0,1,1,0,2,"A","Y","2019-02-07","201902070PHI"
"PHI",0,0,1,1,0,2,0,1,1,0,1,3,"H","Y","2019-02-07","201902070PHI"
"STL",1,0,0,0,0,1,0,0,0,0,0,0,"A","N","2019-02-07","201902070TBL"
"TBL",0,0,0,0,0,0,1,0,0,0,0,1,"H","N","2019-02-07","201902070TBL"
"COL",0,0,1,2,0,3,1,1,1,1,0,4,"A","N","2019-02-07","201902070WSH"
"WSH",1,1,1,1,0,4,0,0,1,2,0,3,"H","N","2019-02-07","201902070WSH"
"CAR",0,0,0,3,0,3,0,0,0,0,0,0,"A","N","2019-02-08","201902080NYR"
"NYR",0,0,0,0,0,0,0,0,0,3,0,3,"H","N","2019-02-08","201902080NYR"
"ARI",0,1,1,1,0,3,0,0,0,2,0,2,"H","N","2019-02-09","201902090ARI"
"DAL",0,0,0,2,0,2,0,1,1,1,0,3,"A","N","2019-02-09","201902090ARI"
"BOS",1,0,1,3,0,5,0,0,2,2,0,4,"H","N","2019-02-09","201902090BOS"
"LAK",0,0,2,2,0,4,1,0,1,3,0,5,"A","N","2019-02-09","201902090BOS"
"BUF",0,0,3,0,0,3,0,0,1,0,0,1,"H","N","2019-02-09","201902090BUF"
"DET",0,0,1,0,0,1,0,0,3,0,0,3,"A","N","2019-02-09","201902090BUF"
"EDM",0,0,1,1,0,2,0,2,1,2,0,5,"H","N","2019-02-09","201902090EDM"
"SJS",0,2,1,2,0,5,0,0,1,1,0,2,"A","N","2019-02-09","201902090EDM"
"MTL",0,1,1,1,0,3,1,2,0,1,0,4,"H","N","2019-02-09","201902090MTL"
"TOR",1,2,0,1,0,4,0,1,1,1,0,3,"A","N","2019-02-09","201902090MTL"
"MIN",0,1,2,1,0,4,0,1,0,1,0,2,"A","N","2019-02-09","201902090NJD"
"NJD",0,1,0,1,0,2,0,1,2,1,0,4,"H","N","2019-02-09","201902090NJD"
"COL",0,1,1,1,0,3,1,0,1,2,0,4,"A","N","2019-02-09","201902090NYI"
"NYI",1,0,1,2,0,4,0,1,1,1,0,3,"H","N","2019-02-09","201902090NYI"
"OTT",0,2,2,1,0,5,0,0,1,1,0,2,"H","N","2019-02-09","201902090OTT"
"WPG",0,0,1,1,0,2,0,2,2,1,0,5,"A","N","2019-02-09","201902090OTT"
"ANA",0,0,1,1,0,2,0,4,0,2,0,6,"A","N","2019-02-09","201902090PHI"
"PHI",0,4,0,2,0,6,0,0,1,1,0,2,"H","N","2019-02-09","201902090PHI"
"NSH",0,0,1,1,0,2,0,2,1,0,0,3,"A","N","2019-02-09","201902090STL"
"STL",0,2,1,0,0,3,0,0,1,1,0,2,"H","N","2019-02-09","201902090STL"
"PIT",0,1,2,1,0,4,0,2,1,2,0,5,"A","N","2019-02-09","201902090TBL"
"TBL",0,2,1,2,0,5,0,1,2,1,0,4,"H","N","2019-02-09","201902090TBL"
"CGY",0,2,1,0,0,3,0,2,1,0,1,4,"A","Y","2019-02-09","201902090VAN"
"VAN",0,2,1,0,1,4,0,2,1,0,0,3,"H","Y","2019-02-09","201902090VAN"
"CBJ",0,1,1,2,0,4,0,2,0,1,0,3,"A","N","2019-02-09","201902090VEG"
"VEG",0,2,0,1,0,3,0,1,1,2,0,4,"H","N","2019-02-09","201902090VEG"
"FLA",1,2,1,1,0,5,0,0,2,2,0,4,"A","N","2019-02-09","201902090WSH"
"WSH",0,0,2,2,0,4,1,2,1,1,0,5,"H","N","2019-02-09","201902090WSH"
"BOS",1,0,1,0,0,2,0,1,0,0,0,1,"H","N","2019-02-10","201902100BOS"
"COL",0,1,0,0,0,1,1,0,1,0,0,2,"A","N","2019-02-10","201902100BOS"
"BUF",0,0,1,0,0,1,0,0,1,2,0,3,"H","N","2019-02-10","201902100BUF"
"WPG",0,0,1,2,0,3,0,0,1,0,0,1,"A","N","2019-02-10","201902100BUF"
"CHI",0,2,0,3,0,5,0,0,1,1,0,2,"H","N","2019-02-10","201902100CHI"
"DET",0,0,1,1,0,2,0,2,0,3,0,5,"A","N","2019-02-10","201902100CHI"
"FLA",0,0,2,0,0,2,0,1,2,2,0,5,"H","N","2019-02-10","201902100FLA"
"TBL",0,1,2,2,0,5,0,0,2,0,0,2,"A","N","2019-02-10","201902100FLA"
"CAR",0,0,1,1,0,2,0,2,0,1,0,3,"A","N","2019-02-10","201902100NJD"
"NJD",0,2,0,1,0,3,0,0,1,1,0,2,"H","N","2019-02-10","201902100NJD"
"NSH",0,0,1,3,0,4,1,0,3,1,0,5,"H","N","2019-02-10","201902100NSH"
"STL",1,0,3,1,0,5,0,0,1,3,0,4,"A","N","2019-02-10","201902100NSH"
"MIN",0,0,1,0,0,1,0,1,1,0,0,2,"A","N","2019-02-10","201902100NYI"
"NYI",0,1,1,0,0,2,0,0,1,0,0,1,"H","N","2019-02-10","201902100NYI"
"NYR",0,2,0,2,0,4,0,1,0,0,0,1,"H","N","2019-02-10","201902100NYR"
"TOR",0,1,0,0,0,1,0,2,0,2,0,4,"A","N","2019-02-10","201902100NYR"
"PHI",0,0,0,1,0,1,0,1,1,2,0,4,"H","N","2019-02-11","201902110PHI"
"PIT",0,1,1,2,0,4,0,0,0,1,0,1,"A","N","2019-02-11","201902110PHI"
"SJS",0,3,3,1,0,7,0,1,0,1,0,2,"A","N","2019-02-11","201902110VAN"
"VAN",0,1,0,1,0,2,0,3,3,1,0,7,"H","N","2019-02-11","201902110VAN"
"LAK",0,2,1,1,0,4,0,2,3,1,0,6,"A","N","2019-02-11","201902110WSH"
"WSH",0,2,3,1,0,6,0,2,1,1,0,4,"H","N","2019-02-11","201902110WSH"
"BOS",0,3,1,2,0,6,0,1,1,1,0,3,"H","N","2019-02-12","201902120BOS"
"CHI",0,1,1,1,0,3,0,3,1,2,0,6,"A","N","2019-02-12","201902120BOS"
"BUF",0,1,1,1,0,3,0,1,0,0,0,1,"H","N","2019-02-12","201902120BUF"
"NYI",0,1,0,0,0,1,0,1,1,1,0,3,"A","N","2019-02-12","201902120BUF"
"CBJ",0,0,1,2,0,3,0,0,0,0,0,0,"H","N","2019-02-12","201902120CBJ"
"WSH",0,0,0,0,0,0,0,0,1,2,0,3,"A","N","2019-02-12","201902120CBJ"
"COL",0,1,0,1,0,2,0,1,3,1,0,5,"H","N","2019-02-12","201902120COL"
"TOR",0,1,3,1,0,5,0,1,0,1,0,2,"A","N","2019-02-12","201902120COL"
"DAL",0,1,1,1,0,3,0,0,0,0,0,0,"A","N","2019-02-12","201902120FLA"
"FLA",0,0,0,0,0,0,0,1,1,1,0,3,"H","N","2019-02-12","201902120FLA"
"MIN",0,3,0,1,0,4,0,1,2,2,0,5,"H","N","2019-02-12","201902120MIN"
"PHI",0,1,2,2,0,5,0,3,0,1,0,4,"A","N","2019-02-12","201902120MIN"
"DET",0,1,1,1,0,3,0,0,2,0,0,2,"A","N","2019-02-12","201902120NSH"
"NSH",0,0,2,0,0,2,0,1,1,1,0,3,"H","N","2019-02-12","201902120NSH"
"CAR",0,0,0,4,0,4,0,1,0,0,0,1,"A","N","2019-02-12","201902120OTT"
"OTT",0,1,0,0,0,1,0,0,0,4,0,4,"H","N","2019-02-12","201902120OTT"
"NJD",0,1,0,2,0,3,0,3,3,2,0,8,"A","N","2019-02-12","201902120STL"
"STL",0,3,3,2,0,8,0,1,0,2,0,3,"H","N","2019-02-12","201902120STL"
"CGY",0,1,1,1,0,3,0,3,2,1,0,6,"A","N","2019-02-12","201902120TBL"
"TBL",0,3,2,1,0,6,0,1,1,1,0,3,"H","N","2019-02-12","201902120TBL"
"ARI",0,0,2,3,0,5,0,0,2,0,0,2,"A","N","2019-02-12","201902120VEG"
"VEG",0,0,2,0,0,2,0,0,2,3,0,5,"H","N","2019-02-12","201902120VEG"
"NYR",0,0,2,1,0,3,0,2,0,2,0,4,"A","N","2019-02-12","201902120WPG"
"WPG",0,2,0,2,0,4,0,0,2,1,0,3,"H","N","2019-02-12","201902120WPG"
"ANA",0,1,0,0,0,1,0,0,0,0,0,0,"H","N","2019-02-13","201902130ANA"
"VAN",0,0,0,0,0,0,0,1,0,0,0,1,"A","N","2019-02-13","201902130ANA"
"EDM",0,1,0,0,0,1,0,0,2,1,0,3,"A","N","2019-02-13","201902130PIT"
"PIT",0,0,2,1,0,3,0,1,0,0,0,1,"H","N","2019-02-13","201902130PIT"
"ARI",0,0,0,0,0,0,0,2,1,1,0,4,"H","N","2019-02-14","201902140ARI"
"STL",0,2,1,1,0,4,0,0,0,0,0,0,"A","N","2019-02-14","201902140ARI"
"CBJ",0,0,0,0,0,0,0,1,2,0,0,3,"H","N","2019-02-14","201902140CBJ"
"NYI",0,1,2,0,0,3,0,0,0,0,0,0,"A","N","2019-02-14","201902140CBJ"
"CHI",0,1,2,2,0,5,0,2,0,0,0,2,"H","N","2019-02-14","201902140CHI"
"NJD",0,2,0,0,0,2,0,1,2,2,0,5,"A","N","2019-02-14","201902140CHI"
"DET",0,2,1,0,0,3,0,1,1,0,0,2,"H","N","2019-02-14","201902140DET"
"OTT",0,1,1,0,0,2,0,2,1,0,0,3,"A","N","2019-02-14","201902140DET"
"CGY",0,0,0,2,0,2,0,0,1,1,1,3,"A","Y","2019-02-14","201902140FLA"
"FLA",0,0,1,1,1,3,0,0,0,2,0,2,"H","Y","2019-02-14","201902140FLA"
"LAK",0,1,1,1,0,3,0,1,1,1,1,4,"H","Y","2019-02-14","201902140LAK"
"VAN",0,1,1,1,1,4,0,1,1,1,0,3,"A","Y","2019-02-14","201902140LAK"
"MTL",0,0,0,1,0,1,0,0,1,2,0,3,"A","N","2019-02-14","201902140NSH"
"NSH",0,0,1,2,0,3,0,0,0,1,0,1,"H","N","2019-02-14","201902140NSH"
"SJS",0,1,0,0,0,1,0,2,2,1,0,5,"H","N","2019-02-14","201902140SJS"
"WSH",0,2,2,1,0,5,0,1,0,0,0,1,"A","N","2019-02-14","201902140SJS"
"DAL",0,0,0,0,0,0,0,4,2,0,0,6,"A","N","2019-02-14","201902140TBL"
"TBL",0,4,2,0,0,6,0,0,0,0,0,0,"H","N","2019-02-14","201902140TBL"
"TOR",0,1,2,3,0,6,0,0,2,1,0,3,"A","N","2019-02-14","201902140VEG"
"VEG",0,0,2,1,0,3,0,1,2,3,0,6,"H","N","2019-02-14","201902140VEG"
"COL",0,2,1,1,0,4,0,1,0,0,0,1,"A","N","2019-02-14","201902140WPG"
"WPG",0,1,0,0,0,1,0,2,1,1,0,4,"H","N","2019-02-14","201902140WPG"
"ANA",0,0,0,0,0,0,0,1,1,1,0,3,"H","N","2019-02-15","201902150ANA"
"BOS",0,1,1,1,0,3,0,0,0,0,0,0,"A","N","2019-02-15","201902150ANA"
"BUF",0,0,2,0,0,2,0,2,1,3,0,6,"H","N","2019-02-15","201902150BUF"
"NYR",0,2,1,3,0,6,0,0,2,0,0,2,"A","N","2019-02-15","201902150BUF"
"CAR",0,2,0,1,0,3,0,1,0,0,0,1,"H","N","2019-02-15","201902150CAR"
"EDM",0,1,0,0,0,1,0,2,0,1,0,3,"A","N","2019-02-15","201902150CAR"
"MIN",0,2,2,0,0,4,1,0,2,2,0,5,"H","N","2019-02-15","201902150MIN"
"NJD",1,0,2,2,0,5,0,2,2,0,0,4,"A","N","2019-02-15","201902150MIN"
"ARI",0,0,2,0,0,2,0,0,0,0,0,0,"H","N","2019-02-16","201902160ARI"
"TOR",0,0,0,0,0,0,0,0,2,0,0,2,"A","N","2019-02-16","201902160ARI"
"CAR",0,2,0,1,0,3,0,0,0,0,0,0,"H","N","2019-02-16","201902160CAR"
"DAL",0,0,0,0,0,0,0,2,0,1,0,3,"A","N","2019-02-16","201902160CAR"
"CBJ",0,3,0,2,0,5,0,1,1,0,0,2,"A","N","2019-02-16","201902160CHI"
"CHI",0,1,1,0,0,2,0,3,0,2,0,5,"H","N","2019-02-16","201902160CHI"
"COL",0,0,0,0,0,0,0,0,0,3,0,3,"H","N","2019-02-16","201902160COL"
"STL",0,0,0,3,0,3,0,0,0,0,0,0,"A","N","2019-02-16","201902160COL"
"BOS",0,1,1,2,0,4,0,0,1,1,0,2,"A","N","2019-02-16","201902160LAK"
"LAK",0,0,1,1,0,2,0,1,1,2,0,4,"H","N","2019-02-16","201902160LAK"
"EDM",0,0,1,1,0,2,0,0,2,3,0,5,"A","N","2019-02-16","201902160NYI"
"NYI",0,0,2,3,0,5,0,0,1,1,0,2,"H","N","2019-02-16","201902160NYI"
"DET",0,1,0,4,0,5,1,1,2,2,0,6,"A","N","2019-02-16","201902160PHI"
"PHI",1,1,2,2,0,6,0,1,0,4,0,5,"H","N","2019-02-16","201902160PHI"
"CGY",0,1,4,0,0,5,0,1,1,2,0,4,"A","N","2019-02-16","201902160PIT"
"PIT",0,1,1,2,0,4,0,1,4,0,0,5,"H","N","2019-02-16","201902160PIT"
"SJS",0,1,1,1,0,3,0,1,0,1,0,2,"H","N","2019-02-16","201902160SJS"
"VAN",0,1,0,1,0,2,0,1,1,1,0,3,"A","N","2019-02-16","201902160SJS"
"MTL",0,0,0,0,0,0,0,0,0,3,0,3,"A","N","2019-02-16","201902160TBL"
"TBL",0,0,0,3,0,3,0,0,0,0,0,0,"H","N","2019-02-16","201902160TBL"
"NSH",0,0,0,1,0,1,0,1,1,3,0,5,"A","N","2019-02-16","201902160VEG"
"VEG",0,1,1,3,0,5,0,0,0,1,0,1,"H","N","2019-02-16","201902160VEG"
"OTT",1,1,1,1,0,4,0,2,0,1,0,3,"A","N","2019-02-16","201902160WPG"
"WPG",0,2,0,1,0,3,1,1,1,1,0,4,"H","N","2019-02-16","201902160WPG"
"ANA",0,0,2,3,0,5,0,1,1,0,0,2,"H","N","2019-02-17","201902170ANA"
"WSH",0,1,1,0,0,2,0,0,2,3,0,5,"A","N","2019-02-17","201902170ANA"
"DET",0,0,1,0,0,1,0,1,0,2,0,3,"H","N","2019-02-17","201902170DET"
"PHI",0,1,0,2,0,3,0,0,1,0,0,1,"A","N","2019-02-17","201902170DET"
"FLA",0,3,1,2,0,6,0,2,1,0,0,3,"H","N","2019-02-17","201902170FLA"
"MTL",0,2,1,0,0,3,0,3,1,2,0,6,"A","N","2019-02-17","201902170FLA"
"MIN",0,0,0,0,0,0,0,2,2,0,0,4,"H","N","2019-02-17","201902170MIN"
"STL",0,2,2,0,0,4,0,0,0,0,0,0,"A","N","2019-02-17","201902170MIN"
"BUF",0,0,1,0,0,1,0,0,2,2,0,4,"A","N","2019-02-17","201902170NJD"
"NJD",0,0,2,2,0,4,0,0,1,0,0,1,"H","N","2019-02-17","201902170NJD"
"NYR",0,1,2,2,0,5,0,1,2,3,0,6,"A","N","2019-02-17","201902170PIT"
"PIT",0,1,2,3,0,6,0,1,2,2,0,5,"H","N","2019-02-17","201902170PIT"
"CBJ",0,0,0,1,0,1,0,2,1,2,0,5,"H","N","2019-02-18","201902180CBJ"
"TBL",0,2,1,2,0,5,0,0,0,1,0,1,"A","N","2019-02-18","201902180CBJ"
"ARI",0,0,2,0,0,2,0,1,2,2,0,5,"A","N","2019-02-18","201902180CGY"
"CGY",0,1,2,2,0,5,0,0,2,0,0,2,"H","N","2019-02-18","201902180CGY"
"CHI",0,5,2,1,0,8,0,4,1,2,0,7,"H","N","2019-02-18","201902180CHI"
"OTT",0,4,1,2,0,7,0,5,2,1,0,8,"A","N","2019-02-18","201902180CHI"
"COL",0,1,1,1,0,3,0,0,0,0,0,0,"H","N","2019-02-18","201902180COL"
"VEG",0,0,0,0,0,0,0,1,1,1,0,3,"A","N","2019-02-18","201902180COL"
"LAK",0,0,0,2,0,2,0,2,1,0,0,3,"H","N","2019-02-18","201902180LAK"
"WSH",0,2,1,0,0,3,0,0,0,2,0,2,"A","N","2019-02-18","201902180LAK"
"BOS",1,3,1,1,0,6,0,1,3,1,0,5,"A","N","2019-02-18","201902180SJS"
"SJS",0,1,3,1,0,5,1,3,1,1,0,6,"H","N","2019-02-18","201902180SJS"
"CAR",0,0,1,0,0,1,0,0,1,1,0,2,"H","N","2019-02-19","201902190CAR"
"NYR",0,0,1,1,0,2,0,0,1,0,0,1,"A","N","2019-02-19","201902190CAR"
"DAL",0,0,3,0,0,3,0,1,2,2,0,5,"H","N","2019-02-19","201902190DAL"
"NSH",0,1,2,2,0,5,0,0,3,0,0,3,"A","N","2019-02-19","201902190DAL"
"ARI",0,0,1,1,1,3,0,0,0,2,0,2,"A","Y","2019-02-19","201902190EDM"
"EDM",0,0,0,2,0,2,0,0,1,1,1,3,"H","Y","2019-02-19","201902190EDM"
"BUF",0,0,1,1,0,2,0,0,0,4,0,4,"A","N","2019-02-19","201902190FLA"
"FLA",0,0,0,4,0,4,0,0,1,1,0,2,"H","N","2019-02-19","201902190FLA"
"ANA",0,0,1,3,0,4,0,0,0,0,0,0,"A","N","2019-02-19","201902190MIN"
"MIN",0,0,0,0,0,0,0,0,1,3,0,4,"H","N","2019-02-19","201902190MIN"
"CBJ",0,0,1,1,0,2,0,2,0,1,0,3,"A","N","2019-02-19","201902190MTL"
"MTL",0,2,0,1,0,3,0,0,1,1,0,2,"H","N","2019-02-19","201902190MTL"
"NJD",0,2,0,1,0,3,0,2,2,0,0,4,"H","N","2019-02-19","201902190NJD"
"PIT",0,2,2,0,0,4,0,2,0,1,0,3,"A","N","2019-02-19","201902190NJD"
"PHI",0,0,0,2,0,2,0,3,0,2,0,5,"H","N","2019-02-19","201902190PHI"
"TBL",0,3,0,2,0,5,0,0,0,2,0,2,"A","N","2019-02-19","201902190PHI"
"STL",1,2,0,0,0,3,0,0,0,2,0,2,"H","N","2019-02-19","201902190STL"
"TOR",0,0,0,2,0,2,1,2,0,0,0,3,"A","N","2019-02-19","201902190STL"
"CGY",0,2,0,2,0,4,0,0,1,1,0,2,"H","N","2019-02-20","201902200CGY"
"NYI",0,0,1,1,0,2,0,2,0,2,0,4,"A","N","2019-02-20","201902200CGY"
"COL",0,0,2,5,0,7,0,0,0,1,0,1,"H","N","2019-02-20","201902200COL"
"WPG",0,0,0,1,0,1,0,0,2,5,0,7,"A","N","2019-02-20","201902200COL"
"CHI",1,3,1,0,0,5,0,1,0,3,0,4,"A","N","2019-02-20","201902200DET"
"DET",0,1,0,3,0,4,1,3,1,0,0,5,"H","N","2019-02-20","201902200DET"
"BOS",0,1,0,1,1,3,0,1,0,1,0,2,"A","Y","2019-02-20","201902200VEG"
"VEG",0,1,0,1,0,2,0,1,0,1,1,3,"H","Y","2019-02-20","201902200VEG"
"DAL",0,0,4,1,0,5,0,0,2,0,0,2,"H","N","2019-02-21","201902210DAL"
"STL",0,0,2,0,0,2,0,0,4,1,0,5,"A","N","2019-02-21","201902210DAL"
"EDM",1,2,0,1,0,4,0,3,0,0,0,3,"H","N","2019-02-21","201902210EDM"
"NYI",0,3,0,0,0,3,1,2,0,1,0,4,"A","N","2019-02-21","201902210EDM"
"CAR",0,1,1,2,0,4,0,0,3,0,0,3,"A","N","2019-02-21","201902210FLA"
"FLA",0,0,3,0,0,3,0,1,1,2,0,4,"H","N","2019-02-21","201902210FLA"
"MTL",0,3,2,0,0,5,0,0,0,1,0,1,"H","N","2019-02-21","201902210MTL"
"PHI",0,0,0,1,0,1,0,3,2,0,0,5,"A","N","2019-02-21","201902210MTL"
"NJD",0,2,2,0,0,4,0,0,0,0,0,0,"H","N","2019-02-21","201902210NJD"
"OTT",0,0,0,0,0,0,0,2,2,0,0,4,"A","N","2019-02-21","201902210NJD"
"LAK",0,0,0,1,0,1,0,1,1,0,0,2,"A","N","2019-02-21","201902210NSH"
"NSH",0,1,1,0,0,2,0,0,0,1,0,1,"H","N","2019-02-21","201902210NSH"
"MIN",0,1,1,2,0,4,0,0,1,0,0,1,"A","N","2019-02-21","201902210NYR"
"NYR",0,0,1,0,0,1,0,1,1,2,0,4,"H","N","2019-02-21","201902210NYR"
"PIT",0,0,0,0,0,0,0,3,0,1,0,4,"H","N","2019-02-21","201902210PIT"
"SJS",0,3,0,1,0,4,0,0,0,0,0,0,"A","N","2019-02-21","201902210PIT"
"BUF",0,1,0,0,0,1,0,0,1,0,1,2,"A","Y","2019-02-21","201902210TBL"
"TBL",0,0,1,0,1,2,0,1,0,0,0,1,"H","Y","2019-02-21","201902210TBL"
"TOR",0,0,0,2,0,2,0,0,2,1,0,3,"H","N","2019-02-21","201902210TOR"
"WSH",0,0,2,1,0,3,0,0,0,2,0,2,"A","N","2019-02-21","201902210TOR"
"ARI",1,0,0,2,0,3,0,1,0,1,0,2,"A","N","2019-02-21","201902210VAN"
"VAN",0,1,0,1,0,2,1,0,0,2,0,3,"H","N","2019-02-21","201902210VAN"
"ANA",0,0,1,0,0,1,0,0,1,1,0,2,"A","N","2019-02-22","201902220CGY"
"CGY",0,0,1,1,0,2,0,0,1,0,0,1,"H","N","2019-02-22","201902220CGY"
"CHI",0,0,2,1,0,3,0,1,1,3,0,5,"H","N","2019-02-22","201902220CHI"
"COL",0,1,1,3,0,5,0,0,2,1,0,3,"A","N","2019-02-22","201902220CHI"
"DET",0,0,1,1,0,2,0,2,1,0,0,3,"H","N","2019-02-22","201902220DET"
"MIN",0,2,1,0,0,3,0,0,1,1,0,2,"A","N","2019-02-22","201902220DET"
"CBJ",0,1,0,2,0,3,0,0,0,0,0,0,"A","N","2019-02-22","201902220OTT"
"OTT",0,0,0,0,0,0,0,1,0,2,0,3,"H","N","2019-02-22","201902220OTT"
"VEG",0,1,1,1,0,3,0,2,2,2,0,6,"H","N","2019-02-22","201902220VEG"
"WPG",0,2,2,2,0,6,0,1,1,1,0,3,"A","N","2019-02-22","201902220VEG"
"BUF",0,2,1,2,0,5,0,0,1,1,0,2,"H","N","2019-02-23","201902230BUF"
"WSH",0,0,1,1,0,2,0,2,1,2,0,5,"A","N","2019-02-23","201902230BUF"
"CBJ",0,1,2,1,0,4,0,0,0,0,0,0,"H","N","2019-02-23","201902230CBJ"
"SJS",0,0,0,0,0,0,0,1,2,1,0,4,"A","N","2019-02-23","201902230CBJ"
"CAR",0,1,1,1,0,3,0,0,0,0,0,0,"A","N","2019-02-23","201902230DAL"
"DAL",0,0,0,0,0,0,0,1,1,1,0,3,"H","N","2019-02-23","201902230DAL"
"ANA",0,0,1,0,0,1,0,1,1,0,0,2,"A","N","2019-02-23","201902230EDM"
"EDM",0,1,1,0,0,2,0,0,1,0,0,1,"H","N","2019-02-23","201902230EDM"
"FLA",0,1,3,2,0,6,0,1,0,0,0,1,"H","N","2019-02-23","201902230FLA"
"LAK",0,1,0,0,0,1,0,1,3,2,0,6,"A","N","2019-02-23","201902230FLA"
"COL",0,1,2,2,0,5,0,0,0,0,0,0,"A","N","2019-02-23","201902230NSH"
"NSH",0,0,0,0,0,0,0,1,2,2,0,5,"H","N","2019-02-23","201902230NSH"
"NJD",0,0,0,2,0,2,0,3,0,2,0,5,"A","N","2019-02-23","201902230NYR"
"NYR",0,3,0,2,0,5,0,0,0,2,0,2,"H","N","2019-02-23","201902230NYR"
"PHI",1,1,0,2,0,4,0,1,1,1,0,3,"H","N","2019-02-23","201902230PHI"
"PIT",0,1,1,1,0,3,1,1,0,2,0,4,"A","N","2019-02-23","201902230PHI"
"BOS",0,0,1,0,0,1,0,1,0,0,1,2,"A","Y","2019-02-23","201902230STL"
"STL",0,1,0,0,1,2,0,0,1,0,0,1,"H","Y","2019-02-23","201902230STL"
"MTL",0,3,0,0,0,3,0,0,2,4,0,6,"A","N","2019-02-23","201902230TOR"
"TOR",0,0,2,4,0,6,0,3,0,0,0,3,"H","N","2019-02-23","201902230TOR"
"NYI",0,2,0,2,0,4,0,0,0,0,0,0,"A","N","2019-02-23","201902230VAN"
"VAN",0,0,0,0,0,0,0,2,0,2,0,4,"H","N","2019-02-23","201902230VAN"
"ARI",0,1,2,1,0,4,0,1,0,0,0,1,"H","N","2019-02-24","201902240ARI"
"WPG",0,1,0,0,0,1,0,1,2,1,0,4,"A","N","2019-02-24","201902240ARI"
"CHI",0,0,2,1,0,3,0,2,1,1,0,4,"H","N","2019-02-24","201902240CHI"
"DAL",0,2,1,1,0,4,0,0,2,1,0,3,"A","N","2019-02-24","201902240CHI"
"DET",0,2,1,0,0,3,0,1,3,1,0,5,"H","N","2019-02-24","201902240DET"
"SJS",0,1,3,1,0,5,0,2,1,0,0,3,"A","N","2019-02-24","201902240DET"
"MIN",1,0,1,0,0,2,0,0,0,1,0,1,"H","N","2019-02-24","201902240MIN"
"STL",0,0,0,1,0,1,1,0,1,0,0,2,"A","N","2019-02-24","201902240MIN"
"CGY",0,1,0,1,0,2,0,0,1,0,0,1,"A","N","2019-02-24","201902240OTT"
"OTT",0,0,1,0,0,1,0,1,0,1,0,2,"H","N","2019-02-24","201902240OTT"
"NYR",0,1,1,3,0,5,1,2,1,2,0,6,"A","N","2019-02-24","201902240WSH"
"WSH",1,2,1,2,0,6,0,1,1,3,0,5,"H","N","2019-02-24","201902240WSH"
"COL",0,0,2,1,0,3,1,0,2,1,0,4,"H","N","2019-02-25","201902250COL"
"FLA",1,0,2,1,0,4,0,0,2,1,0,3,"A","N","2019-02-25","201902250COL"
"MTL",0,0,0,1,0,1,0,1,1,0,0,2,"A","N","2019-02-25","201902250NJD"
"NJD",0,1,1,0,0,2,0,0,0,1,0,1,"H","N","2019-02-25","201902250NJD"
"EDM",0,1,0,1,0,2,0,0,2,0,1,3,"A","Y","2019-02-25","201902250NSH"
"NSH",0,0,2,0,1,3,0,1,0,1,0,2,"H","Y","2019-02-25","201902250NSH"
"LAK",0,0,0,3,0,3,0,2,0,1,1,4,"A","Y","2019-02-25","201902250TBL"
"TBL",0,2,0,1,1,4,0,0,0,3,0,3,"H","Y","2019-02-25","201902250TBL"
"BUF",0,1,1,1,0,3,0,0,4,1,0,5,"A","N","2019-02-25","201902250TOR"
"TOR",0,0,4,1,0,5,0,1,1,1,0,3,"H","N","2019-02-25","201902250TOR"
"ANA",0,0,0,0,0,0,0,2,1,1,0,4,"A","N","2019-02-25","201902250VAN"
"VAN",0,2,1,1,0,4,0,0,0,0,0,0,"H","N","2019-02-25","201902250VAN"
"ARI",0,0,2,1,1,4,0,0,1,2,0,3,"H","Y","2019-02-26","201902260ARI"
"FLA",0,0,1,2,0,3,0,0,2,1,1,4,"A","Y","2019-02-26","201902260ARI"
"BOS",0,1,3,0,0,4,0,1,0,0,0,1,"H","N","2019-02-26","201902260BOS"
"SJS",0,1,0,0,0,1,0,1,3,0,0,4,"A","N","2019-02-26","201902260BOS"
"CAR",0,2,4,0,0,6,0,0,0,1,0,1,"H","N","2019-02-26","201902260CAR"
"LAK",0,0,0,1,0,1,0,2,4,0,0,6,"A","N","2019-02-26","201902260CAR"
"CBJ",0,0,2,0,0,2,0,2,1,2,0,5,"H","N","2019-02-26","201902260CBJ"
"PIT",0,2,1,2,0,5,0,0,2,0,0,2,"A","N","2019-02-26","201902260CBJ"
"DET",0,0,1,0,0,1,0,1,5,2,0,8,"H","N","2019-02-26","201902260DET"
"MTL",0,1,5,2,0,8,0,0,1,0,0,1,"A","N","2019-02-26","201902260DET"
"CGY",0,0,1,2,0,3,0,0,1,0,0,1,"A","N","2019-02-26","201902260NYI"
"NYI",0,0,1,0,0,1,0,0,1,2,0,3,"H","N","2019-02-26","201902260NYI"
"BUF",0,1,1,0,0,2,0,2,1,2,0,5,"A","N","2019-02-26","201902260PHI"
"PHI",0,2,1,2,0,5,0,1,1,0,0,2,"H","N","2019-02-26","201902260PHI"
"NSH",0,0,0,0,0,0,0,0,0,2,0,2,"A","N","2019-02-26","201902260STL"
"STL",0,0,0,2,0,2,0,0,0,0,0,0,"H","N","2019-02-26","201902260STL"
"DAL",0,1,0,0,0,1,0,0,1,3,0,4,"A","N","2019-02-26","201902260VEG"
"VEG",0,0,1,3,0,4,0,1,0,0,0,1,"H","N","2019-02-26","201902260VEG"
"MIN",0,0,1,2,0,3,0,1,1,0,0,2,"A","N","2019-02-26","201902260WPG"
"WPG",0,1,1,0,0,2,0,0,1,2,0,3,"H","N","2019-02-26","201902260WPG"
"OTT",0,2,0,0,0,2,0,2,4,1,0,7,"A","N","2019-02-26","201902260WSH"
"WSH",0,2,4,1,0,7,0,2,0,0,0,2,"H","N","2019-02-26","201902260WSH"
"ANA",0,0,2,1,0,3,0,0,2,2,0,4,"H","N","2019-02-27","201902270ANA"
"CHI",0,0,2,2,0,4,0,0,2,1,0,3,"A","N","2019-02-27","201902270ANA"
"COL",0,2,0,0,1,3,0,1,0,1,0,2,"H","Y","2019-02-27","201902270COL"
"VAN",0,1,0,1,0,2,0,2,0,0,1,3,"A","Y","2019-02-27","201902270COL"
"CGY",0,0,2,0,0,2,0,0,1,0,0,1,"A","N","2019-02-27","201902270NJD"
"NJD",0,0,1,0,0,1,0,0,2,0,0,2,"H","N","2019-02-27","201902270NJD"
"NYR",0,0,3,0,0,3,1,2,1,0,0,4,"H","N","2019-02-27","201902270NYR"
"TBL",1,2,1,0,0,4,0,0,3,0,0,3,"A","N","2019-02-27","201902270NYR"
"EDM",0,1,0,1,0,2,0,1,4,1,0,6,"A","N","2019-02-27","201902270TOR"
"TOR",0,1,4,1,0,6,0,1,0,1,0,2,"H","N","2019-02-27","201902270TOR"
"ARI",0,2,2,1,0,5,0,1,0,1,0,2,"H","N","2019-02-28","201902280ARI"
"VAN",0,1,0,1,0,2,0,2,2,1,0,5,"A","N","2019-02-28","201902280ARI"
"BOS",0,0,1,3,0,4,0,0,0,1,0,1,"H","N","2019-02-28","201902280BOS"
"TBL",0,0,0,1,0,1,0,0,1,3,0,4,"A","N","2019-02-28","201902280BOS"
"CBJ",1,1,1,1,0,4,0,2,0,1,0,3,"H","N","2019-02-28","201902280CBJ"
"PHI",0,2,0,1,0,3,1,1,1,1,0,4,"A","N","2019-02-28","201902280CBJ"
"DAL",1,1,1,1,0,4,0,2,1,0,0,3,"A","N","2019-02-28","201902280LAK"
"LAK",0,2,1,0,0,3,1,1,1,1,0,4,"H","N","2019-02-28","201902280LAK"
"NYI",0,1,3,2,0,6,0,1,0,0,0,1,"H","N","2019-02-28","201902280NYI"
"TOR",0,1,0,0,0,1,0,1,3,2,0,6,"A","N","2019-02-28","201902280NYI"
"EDM",0,0,2,2,0,4,0,1,0,1,0,2,"A","N","2019-02-28","201902280OTT"
"OTT",0,1,0,1,0,2,0,0,2,2,0,4,"H","N","2019-02-28","201902280OTT"
"FLA",0,3,1,1,0,5,0,1,3,1,1,6,"A","Y","2019-02-28","201902280VEG"
"VEG",0,1,3,1,1,6,0,3,1,1,0,5,"H","Y","2019-02-28","201902280VEG"
"ANA",0,0,0,0,0,0,0,1,1,1,0,3,"H","N","2019-03-01","201903010ANA"
"VEG",0,1,1,1,0,3,0,0,0,0,0,0,"A","N","2019-03-01","201903010ANA"
"BUF",1,2,0,1,0,4,0,1,2,0,0,3,"H","N","2019-03-01","201903010BUF"
"PIT",0,1,2,0,0,3,1,2,0,1,0,4,"A","N","2019-03-01","201903010BUF"
"CAR",0,2,1,2,0,5,0,1,1,0,0,2,"H","N","2019-03-01","201903010CAR"
"STL",0,1,1,0,0,2,0,2,1,2,0,5,"A","N","2019-03-01","201903010CAR"
"NJD",0,0,2,1,0,3,0,2,1,3,0,6,"H","N","2019-03-01","201903010NJD"
"PHI",0,2,1,3,0,6,0,0,2,1,0,3,"A","N","2019-03-01","201903010NJD"
"NYI",0,1,0,0,0,1,0,0,0,3,0,3,"H","N","2019-03-01","201903010NYI"
"WSH",0,0,0,3,0,3,0,1,0,0,0,1,"A","N","2019-03-01","201903010NYI"
"MTL",0,0,2,2,0,4,0,1,0,1,0,2,"A","N","2019-03-01","201903010NYR"
"NYR",0,1,0,1,0,2,0,0,2,2,0,4,"H","N","2019-03-01","201903010NYR"
"COL",0,0,1,2,0,3,0,1,2,1,0,4,"A","N","2019-03-01","201903010SJS"
"SJS",0,1,2,1,0,4,0,0,1,2,0,3,"H","N","2019-03-01","201903010SJS"
"NSH",0,1,1,1,0,3,0,0,2,3,0,5,"A","N","2019-03-01","201903010WPG"
"WPG",0,0,2,3,0,5,0,1,1,1,0,3,"H","N","2019-03-01","201903010WPG"
"ARI",0,2,0,1,0,3,0,0,1,0,0,1,"H","N","2019-03-02","201903020ARI"
"DET",0,0,1,0,0,1,0,2,0,1,0,3,"A","N","2019-03-02","201903020ARI"
"BOS",0,1,0,0,0,1,0,0,0,0,0,0,"H","N","2019-03-02","201903020BOS"
"NJD",0,0,0,0,0,0,0,1,0,0,0,1,"A","N","2019-03-02","201903020BOS"
"CBJ",0,0,0,0,0,0,0,1,3,0,0,4,"H","N","2019-03-02","201903020CBJ"
"EDM",0,1,3,0,0,4,0,0,0,0,0,0,"A","N","2019-03-02","201903020CBJ"
"CGY",0,0,1,1,0,2,0,1,0,3,0,4,"H","N","2019-03-02","201903020CGY"
"MIN",0,1,0,3,0,4,0,0,1,1,0,2,"A","N","2019-03-02","201903020CGY"
"CAR",1,2,0,1,0,4,0,2,0,1,0,3,"A","N","2019-03-02","201903020FLA"
"FLA",0,2,0,1,0,3,1,2,0,1,0,4,"H","N","2019-03-02","201903020FLA"
"CHI",0,1,2,0,0,3,0,3,1,2,0,6,"A","N","2019-03-02","201903020LAK"
"LAK",0,3,1,2,0,6,0,1,2,0,0,3,"H","N","2019-03-02","201903020LAK"
"MTL",0,0,1,0,0,1,0,3,1,1,0,5,"H","N","2019-03-02","201903020MTL"
"PIT",0,3,1,1,0,5,0,0,1,0,0,1,"A","N","2019-03-02","201903020MTL"
"DAL",0,2,1,1,0,4,0,0,1,0,0,1,"A","N","2019-03-02","201903020STL"
"STL",0,0,1,0,0,1,0,2,1,1,0,4,"H","N","2019-03-02","201903020STL"
"OTT",0,1,0,0,0,1,0,2,2,1,0,5,"A","N","2019-03-02","201903020TBL"
"TBL",0,2,2,1,0,5,0,1,0,0,0,1,"H","N","2019-03-02","201903020TBL"
"BUF",0,2,0,0,0,2,0,2,2,1,0,5,"A","N","2019-03-02","201903020TOR"
"TOR",0,2,2,1,0,5,0,2,0,0,0,2,"H","N","2019-03-02","201903020TOR"
"ANA",0,1,1,0,0,2,0,0,0,1,0,1,"H","N","2019-03-03","201903030ANA"
"COL",0,0,0,1,0,1,0,1,1,0,0,2,"A","N","2019-03-03","201903030ANA"
"CBJ",0,1,1,0,0,2,0,1,1,3,0,5,"H","N","2019-03-03","201903030CBJ"
"WPG",0,1,1,3,0,5,0,1,1,0,0,2,"A","N","2019-03-03","201903030CBJ"
"FLA",0,2,0,0,0,2,0,1,2,0,0,3,"H","N","2019-03-03","201903030FLA"
"OTT",0,1,2,0,0,3,0,2,0,0,0,2,"A","N","2019-03-03","201903030FLA"
"MIN",0,0,2,0,0,2,0,1,0,1,1,3,"H","Y","2019-03-03","201903030MIN"
"NSH",0,1,0,1,1,3,0,0,2,0,0,2,"A","Y","2019-03-03","201903030MIN"
"NYI",0,0,0,1,0,1,0,2,2,0,0,4,"H","N","2019-03-03","201903030NYI"
"PHI",0,2,2,0,0,4,0,0,0,1,0,1,"A","N","2019-03-03","201903030NYI"
"NYR",0,1,1,0,0,2,0,2,0,0,1,3,"H","Y","2019-03-03","201903030NYR"
"WSH",0,2,0,0,1,3,0,1,1,0,0,2,"A","Y","2019-03-03","201903030NYR"
"CHI",0,1,1,0,0,2,0,1,1,3,0,5,"A","N","2019-03-03","201903030SJS"
"SJS",0,1,1,3,0,5,0,1,1,0,0,2,"H","N","2019-03-03","201903030SJS"
"VAN",0,0,0,0,0,0,0,0,3,0,0,3,"A","N","2019-03-03","201903030VEG"
"VEG",0,0,3,0,0,3,0,0,0,0,0,0,"H","N","2019-03-03","201903030VEG"
"BUF",0,3,0,0,0,3,0,1,3,0,0,4,"H","N","2019-03-04","201903040BUF"
"EDM",0,1,3,0,0,4,0,3,0,0,0,3,"A","N","2019-03-04","201903040BUF"
"CGY",0,0,1,1,0,2,0,3,1,2,0,6,"H","N","2019-03-04","201903040CGY"
"TOR",0,3,1,2,0,6,0,0,1,1,0,2,"A","N","2019-03-04","201903040CGY"
"ANA",0,1,0,2,0,3,0,1,0,0,0,1,"A","N","2019-03-05","201903050ARI"
"ARI",0,1,0,0,0,1,0,1,0,2,0,3,"H","N","2019-03-05","201903050ARI"
"BOS",1,0,2,1,0,4,0,1,1,1,0,3,"H","N","2019-03-05","201903050BOS"
"CAR",0,1,1,1,0,3,1,0,2,1,0,4,"A","N","2019-03-05","201903050BOS"
"COL",1,0,1,2,0,4,0,1,0,2,0,3,"H","N","2019-03-05","201903050COL"
"DET",0,1,0,2,0,3,1,0,1,2,0,4,"A","N","2019-03-05","201903050COL"
"DAL",0,0,1,0,0,1,0,0,0,0,0,0,"H","N","2019-03-05","201903050DAL"
"NYR",0,0,0,0,0,0,0,0,1,0,0,1,"A","N","2019-03-05","201903050DAL"
"LAK",0,0,0,1,0,1,0,1,1,1,0,3,"H","N","2019-03-05","201903050LAK"
"MTL",0,1,1,1,0,3,0,0,0,1,0,1,"A","N","2019-03-05","201903050LAK"
"CBJ",0,1,0,0,1,2,0,0,1,0,0,1,"A","Y","2019-03-05","201903050NJD"
"NJD",0,0,1,0,0,1,0,1,0,0,1,2,"H","Y","2019-03-05","201903050NJD"
"MIN",0,1,1,2,0,4,0,1,1,2,1,5,"A","Y","2019-03-05","201903050NSH"
"NSH",0,1,1,2,1,5,0,1,1,2,0,4,"H","Y","2019-03-05","201903050NSH"
"NYI",0,1,3,0,1,5,0,0,2,2,0,4,"H","Y","2019-03-05","201903050NYI"
"OTT",0,0,2,2,0,4,0,1,3,0,1,5,"A","Y","2019-03-05","201903050NYI"
"FLA",0,1,1,0,0,2,1,0,2,0,0,3,"A","N","2019-03-05","201903050PIT"
"PIT",1,0,2,0,0,3,0,1,1,0,0,2,"H","N","2019-03-05","201903050PIT"
"TBL",0,1,2,2,0,5,0,1,0,1,0,2,"H","N","2019-03-05","201903050TBL"
"WPG",0,1,0,1,0,2,0,1,2,2,0,5,"A","N","2019-03-05","201903050TBL"
"ANA",0,1,2,1,0,4,0,2,1,2,0,5,"H","N","2019-03-06","201903060ANA"
"STL",0,2,1,2,0,5,0,1,2,1,0,4,"A","N","2019-03-06","201903060ANA"
"PHI",0,0,1,2,0,3,0,2,3,0,0,5,"H","N","2019-03-06","201903060PHI"
"WSH",0,2,3,0,0,5,0,0,1,2,0,3,"A","N","2019-03-06","201903060PHI"
"TOR",0,0,2,0,0,2,1,0,0,2,0,3,"A","N","2019-03-06","201903060VAN"
"VAN",1,0,0,2,0,3,0,0,2,0,0,2,"H","N","2019-03-06","201903060VAN"
"CGY",0,0,1,0,0,1,0,1,0,1,0,2,"A","N","2019-03-06","201903060VEG"
"VEG",0,1,0,1,0,2,0,0,1,0,0,1,"H","N","2019-03-06","201903060VEG"
"ARI",0,1,0,1,0,2,0,0,0,0,0,0,"H","N","2019-03-07","201903070ARI"
"CGY",0,0,0,0,0,0,0,1,0,1,0,2,"A","N","2019-03-07","201903070ARI"
"BOS",0,0,1,3,0,4,0,0,2,1,0,3,"H","N","2019-03-07","201903070BOS"
"FLA",0,0,2,1,0,3,0,0,1,3,0,4,"A","N","2019-03-07","201903070BOS"
"BUF",0,0,3,1,0,4,0,2,0,2,1,5,"A","Y","2019-03-07","201903070CHI"
"CHI",0,2,0,2,1,5,0,0,3,1,0,4,"H","Y","2019-03-07","201903070CHI"
"COL",0,0,0,0,0,0,0,1,1,2,0,4,"A","N","2019-03-07","201903070DAL"
"DAL",0,1,1,2,0,4,0,0,0,0,0,0,"H","N","2019-03-07","201903070DAL"
"DET",0,0,1,1,1,3,0,1,0,1,0,2,"H","Y","2019-03-07","201903070DET"
"NYR",0,1,0,1,0,2,0,0,1,1,1,3,"A","Y","2019-03-07","201903070DET"
"EDM",0,2,1,0,0,3,0,0,1,1,0,2,"H","N","2019-03-07","201903070EDM"
"VAN",0,0,1,1,0,2,0,2,1,0,0,3,"A","N","2019-03-07","201903070EDM"
"LAK",0,0,0,0,0,0,0,0,3,1,0,4,"H","N","2019-03-07","201903070LAK"
"STL",0,0,3,1,0,4,0,0,0,0,0,0,"A","N","2019-03-07","201903070LAK"
"NYI",0,2,0,2,0,4,0,1,1,0,0,2,"A","N","2019-03-07","201903070OTT"
"OTT",0,1,1,0,0,2,0,2,0,2,0,4,"H","N","2019-03-07","201903070OTT"
"CBJ",0,0,0,0,0,0,0,1,1,1,0,3,"A","N","2019-03-07","201903070PIT"
"PIT",0,1,1,1,0,3,0,0,0,0,0,0,"H","N","2019-03-07","201903070PIT"
"MTL",0,1,1,0,0,2,0,2,1,2,0,5,"A","N","2019-03-07","201903070SJS"
"SJS",0,2,1,2,0,5,0,1,1,0,0,2,"H","N","2019-03-07","201903070SJS"
"MIN",0,1,0,2,0,3,0,0,0,0,0,0,"A","N","2019-03-07","201903070TBL"
"TBL",0,0,0,0,0,0,0,1,0,2,0,3,"H","N","2019-03-07","201903070TBL"
"ANA",0,2,3,3,0,8,0,1,1,0,0,2,"H","N","2019-03-08","201903080ANA"
"MTL",0,1,1,0,0,2,0,2,3,3,0,8,"A","N","2019-03-08","201903080ANA"
"CAR",0,0,0,1,0,1,0,4,1,3,0,8,"H","N","2019-03-08","201903080CAR"
"WPG",0,4,1,3,0,8,0,0,0,1,0,1,"A","N","2019-03-08","201903080CAR"
"FLA",0,3,2,1,0,6,0,0,2,0,0,2,"H","N","2019-03-08","201903080FLA"
"MIN",0,0,2,0,0,2,0,3,2,1,0,6,"A","N","2019-03-08","201903080FLA"
"NJD",0,0,0,0,0,0,0,1,0,2,0,3,"A","N","2019-03-08","201903080WSH"
"WSH",0,1,0,2,0,3,0,0,0,0,0,0,"H","N","2019-03-08","201903080WSH"
"ARI",0,2,0,2,0,4,0,1,0,1,0,2,"H","N","2019-03-09","201903090ARI"
"LAK",0,1,0,1,0,2,0,2,0,2,0,4,"A","N","2019-03-09","201903090ARI"
"BOS",0,0,1,2,0,3,0,0,1,1,0,2,"H","N","2019-03-09","201903090BOS"
"OTT",0,0,1,1,0,2,0,0,1,2,0,3,"A","N","2019-03-09","201903090BOS"
"CBJ",0,1,1,2,0,4,0,0,1,0,0,1,"H","N","2019-03-09","201903090CBJ"
"PIT",0,0,1,0,0,1,0,1,1,2,0,4,"A","N","2019-03-09","201903090CBJ"
"BUF",0,0,0,0,0,0,0,0,1,2,0,3,"A","N","2019-03-09","201903090COL"
"COL",0,0,1,2,0,3,0,0,0,0,0,0,"H","N","2019-03-09","201903090COL"
"CHI",0,2,0,0,0,2,0,1,0,0,0,1,"A","N","2019-03-09","201903090DAL"
"DAL",0,1,0,0,0,1,0,2,0,0,0,2,"H","N","2019-03-09","201903090DAL"
"EDM",0,0,0,2,0,2,0,1,1,1,0,3,"H","N","2019-03-09","201903090EDM"
"TOR",0,1,1,1,0,3,0,0,0,2,0,2,"A","N","2019-03-09","201903090EDM"
"CAR",0,2,0,3,0,5,0,0,1,2,0,3,"A","N","2019-03-09","201903090NSH"
"NSH",0,0,1,2,0,3,0,2,0,3,0,5,"H","N","2019-03-09","201903090NSH"
"NYI",0,1,0,1,0,2,0,2,3,0,0,5,"H","N","2019-03-09","201903090NYI"
"PHI",0,2,3,0,0,5,0,1,0,1,0,2,"A","N","2019-03-09","201903090NYI"
"NJD",0,2,0,0,0,2,0,0,1,3,0,4,"A","N","2019-03-09","201903090NYR"
"NYR",0,0,1,3,0,4,0,2,0,0,0,2,"H","N","2019-03-09","201903090NYR"
"SJS",1,2,0,0,0,3,0,1,1,0,0,2,"H","N","2019-03-09","201903090SJS"
"STL",0,1,1,0,0,2,1,2,0,0,0,3,"A","N","2019-03-09","201903090SJS"
"DET",0,0,1,1,0,2,0,2,0,1,0,3,"A","N","2019-03-09","201903090TBL"
"TBL",0,2,0,1,0,3,0,0,1,1,0,2,"H","N","2019-03-09","201903090TBL"
"VAN",0,1,1,0,0,2,0,5,1,0,0,6,"H","N","2019-03-09","201903090VAN"
"VEG",0,5,1,0,0,6,0,1,1,0,0,2,"A","N","2019-03-09","201903090VAN"
"ANA",0,1,0,1,0,2,0,3,0,0,0,3,"H","N","2019-03-10","201903100ANA"
"LAK",0,3,0,0,0,3,0,1,0,1,0,2,"A","N","2019-03-10","201903100ANA"
"CGY",0,3,1,2,0,6,0,1,2,0,0,3,"H","N","2019-03-10","201903100CGY"
"VEG",0,1,2,0,0,3,0,3,1,2,0,6,"A","N","2019-03-10","201903100CGY"
"DET",0,0,1,0,0,1,0,2,1,3,0,6,"A","N","2019-03-10","201903100FLA"
"FLA",0,2,1,3,0,6,0,0,1,0,0,1,"H","N","2019-03-10","201903100FLA"
"BOS",0,0,1,1,0,2,0,2,1,1,0,4,"A","N","2019-03-10","201903100PIT"
"PIT",0,2,1,1,0,4,0,0,1,1,0,2,"H","N","2019-03-10","201903100PIT"
"WPG",0,1,0,0,0,1,0,1,1,1,0,3,"A","N","2019-03-10","201903100WSH"
"WSH",0,1,1,1,0,3,0,1,0,0,0,1,"H","N","2019-03-10","201903100WSH"
"ARI",0,1,0,0,0,1,0,2,4,1,0,7,"A","N","2019-03-11","201903110CHI"
"CHI",0,2,4,1,0,7,0,1,0,0,0,1,"H","N","2019-03-11","201903110CHI"
"CAR",0,0,1,2,0,3,0,0,0,0,0,0,"A","N","2019-03-11","201903110COL"
"COL",0,0,0,0,0,0,0,0,1,2,0,3,"H","N","2019-03-11","201903110COL"
"EDM",1,2,0,0,0,3,0,0,1,1,0,2,"H","N","2019-03-11","201903110EDM"
"NYR",0,0,1,1,0,2,1,2,0,0,0,3,"A","N","2019-03-11","201903110EDM"
"MIN",0,0,0,0,0,0,0,0,1,2,0,3,"H","N","2019-03-11","201903110MIN"
"SJS",0,0,1,2,0,3,0,0,0,0,0,0,"A","N","2019-03-11","201903110MIN"
"CBJ",0,0,0,0,0,0,0,1,0,1,0,2,"A","N","2019-03-11","201903110NYI"
"NYI",0,1,0,1,0,2,0,0,0,0,0,0,"H","N","2019-03-11","201903110NYI"
"OTT",0,1,0,1,0,2,0,0,3,0,0,3,"A","N","2019-03-11","201903110PHI"
"PHI",0,0,3,0,0,3,0,1,0,1,0,2,"H","N","2019-03-11","201903110PHI"
"TBL",0,2,3,1,0,6,0,0,1,1,0,2,"A","N","2019-03-11","201903110TOR"
"TOR",0,0,1,1,0,2,0,2,3,1,0,6,"H","N","2019-03-11","201903110TOR"
"ANA",0,2,1,0,0,3,0,0,0,2,0,2,"H","N","2019-03-12","201903120ANA"
"NSH",0,0,0,2,0,2,0,2,1,0,0,3,"A","N","2019-03-12","201903120ANA"
"BUF",0,0,0,0,0,0,0,0,2,0,0,2,"H","N","2019-03-12","201903120BUF"
"DAL",0,0,2,0,0,2,0,0,0,0,0,0,"A","N","2019-03-12","201903120BUF"
"BOS",0,1,3,0,0,4,0,3,2,2,0,7,"A","N","2019-03-12","201903120CBJ"
"CBJ",0,3,2,2,0,7,0,1,3,0,0,4,"H","N","2019-03-12","201903120CBJ"
"CGY",0,1,2,6,0,9,0,2,2,0,0,4,"H","N","2019-03-12","201903120CGY"
"NJD",0,2,2,0,0,4,0,1,2,6,0,9,"A","N","2019-03-12","201903120CGY"
"DET",0,0,0,1,0,1,0,0,2,1,0,3,"A","N","2019-03-12","201903120MTL"
"MTL",0,0,2,1,0,3,0,0,0,1,0,1,"H","N","2019-03-12","201903120MTL"
"PIT",0,0,3,2,0,5,0,1,1,1,0,3,"H","N","2019-03-12","201903120PIT"
"WSH",0,1,1,1,0,3,0,0,3,2,0,5,"A","N","2019-03-12","201903120PIT"
"ARI",0,0,1,2,0,3,0,0,0,1,0,1,"A","N","2019-03-12","201903120STL"
"STL",0,0,0,1,0,1,0,0,1,2,0,3,"H","N","2019-03-12","201903120STL"
"SJS",0,2,1,2,0,5,0,2,1,1,0,4,"A","N","2019-03-12","201903120WPG"
"WPG",0,2,1,1,0,4,0,2,1,2,0,5,"H","N","2019-03-12","201903120WPG"
"EDM",0,2,1,0,0,3,0,2,3,1,0,6,"H","N","2019-03-13","201903130EDM"
"NJD",0,2,3,1,0,6,0,2,1,0,0,3,"A","N","2019-03-13","201903130EDM"
"CHI",0,4,1,0,0,5,0,0,1,3,0,4,"A","N","2019-03-13","201903130TOR"
"TOR",0,0,1,3,0,4,0,4,1,0,0,5,"H","N","2019-03-13","201903130TOR"
"NYR",0,0,0,1,0,1,0,0,3,1,0,4,"A","N","2019-03-13","201903130VAN"
"VAN",0,0,3,1,0,4,0,0,0,1,0,1,"H","N","2019-03-13","201903130VAN"
"ANA",0,0,1,0,0,1,0,2,2,2,0,6,"A","N","2019-03-14","201903140ARI"
"ARI",0,2,2,2,0,6,0,0,1,0,0,1,"H","N","2019-03-14","201903140ARI"
"BUF",0,0,0,0,0,0,0,0,3,2,0,5,"H","N","2019-03-14","201903140BUF"
"PIT",0,0,3,2,0,5,0,0,0,0,0,0,"A","N","2019-03-14","201903140BUF"
"DET",0,2,1,1,0,4,0,0,1,4,0,5,"H","N","2019-03-14","201903140DET"
"TBL",0,0,1,4,0,5,0,2,1,1,0,4,"A","N","2019-03-14","201903140DET"
"LAK",0,0,1,0,0,1,0,1,2,0,0,3,"H","N","2019-03-14","201903140LAK"
"NSH",0,1,2,0,0,3,0,0,1,0,0,1,"A","N","2019-03-14","201903140LAK"
"DAL",0,0,3,1,0,4,0,0,1,0,0,1,"A","N","2019-03-14","201903140MIN"
"MIN",0,0,1,0,0,1,0,0,3,1,0,4,"H","N","2019-03-14","201903140MIN"
"MTL",0,0,1,0,0,1,0,0,1,1,0,2,"A","N","2019-03-14","201903140NYI"
"NYI",0,0,1,1,0,2,0,0,1,0,0,1,"H","N","2019-03-14","201903140NYI"
"OTT",0,0,1,1,0,2,0,0,0,0,0,0,"H","N","2019-03-14","201903140OTT"
"STL",0,0,0,0,0,0,0,0,1,1,0,2,"A","N","2019-03-14","201903140OTT"
"PHI",0,0,2,0,0,2,0,2,2,1,0,5,"H","N","2019-03-14","201903140PHI"
"WSH",0,2,2,1,0,5,0,0,2,0,0,2,"A","N","2019-03-14","201903140PHI"
"FLA",0,1,2,1,0,4,0,2,0,0,0,2,"A","N","2019-03-14","201903140SJS"
"SJS",0,2,0,0,0,2,0,1,2,1,0,4,"H","N","2019-03-14","201903140SJS"
"BOS",0,1,1,1,0,3,0,2,0,2,0,4,"A","N","2019-03-14","201903140WPG"
"WPG",0,2,0,2,0,4,0,1,1,1,0,3,"H","N","2019-03-14","201903140WPG"
"CAR",0,0,0,0,0,0,0,2,0,1,0,3,"A","N","2019-03-15","201903150CBJ"
"CBJ",0,2,0,1,0,3,0,0,0,0,0,0,"H","N","2019-03-15","201903150CBJ"
"CGY",0,1,2,2,0,5,0,1,0,0,0,1,"H","N","2019-03-15","201903150CGY"
"NYR",0,1,0,0,0,1,0,1,2,2,0,5,"A","N","2019-03-15","201903150CGY"
"ANA",0,0,3,2,0,5,0,2,0,1,0,3,"A","N","2019-03-15","201903150COL"
"COL",0,2,0,1,0,3,0,0,3,2,0,5,"H","N","2019-03-15","201903150COL"
"DAL",0,1,0,0,0,1,0,1,0,1,0,2,"H","N","2019-03-15","201903150DAL"
"VEG",0,1,0,1,0,2,0,1,0,0,0,1,"A","N","2019-03-15","201903150DAL"
"PHI",0,1,4,1,0,6,0,1,3,3,0,7,"A","N","2019-03-15","201903150TOR"
"TOR",0,1,3,3,0,7,0,1,4,1,0,6,"H","N","2019-03-15","201903150TOR"
"NJD",0,0,0,2,1,3,0,0,1,1,0,2,"A","Y","2019-03-15","201903150VAN"
"VAN",0,0,1,1,0,2,0,0,0,2,1,3,"H","Y","2019-03-15","201903150VAN"
"ARI",0,1,1,0,0,2,1,1,1,0,0,3,"H","N","2019-03-16","201903160ARI"
"EDM",1,1,1,0,0,3,0,1,1,0,0,2,"A","N","2019-03-16","201903160ARI"
"BOS",1,1,0,0,0,2,0,1,0,0,0,1,"H","N","2019-03-16","201903160BOS"
"CBJ",0,1,0,0,0,1,1,1,0,0,0,2,"A","N","2019-03-16","201903160BOS"
"BUF",0,1,0,1,0,2,0,1,2,1,0,4,"A","N","2019-03-16","201903160CAR"
"CAR",0,1,2,1,0,4,0,1,0,1,0,2,"H","N","2019-03-16","201903160CAR"
"DET",0,1,1,0,0,2,0,1,0,0,0,1,"H","N","2019-03-16","201903160DET"
"NYI",0,1,0,0,0,1,0,1,1,0,0,2,"A","N","2019-03-16","201903160DET"
"FLA",0,1,1,2,0,4,0,1,0,2,0,3,"A","N","2019-03-16","201903160LAK"
"LAK",0,1,0,2,0,3,0,1,1,2,0,4,"H","N","2019-03-16","201903160LAK"
"MIN",0,2,1,2,0,5,0,1,0,1,0,2,"H","N","2019-03-16","201903160MIN"
"NYR",0,1,0,1,0,2,0,2,1,2,0,5,"A","N","2019-03-16","201903160MIN"
"CHI",0,0,1,1,0,2,0,0,0,0,0,0,"A","N","2019-03-16","201903160MTL"
"MTL",0,0,0,0,0,0,0,0,1,1,0,2,"H","N","2019-03-16","201903160MTL"
"OTT",0,1,3,2,0,6,0,0,1,1,0,2,"H","N","2019-03-16","201903160OTT"
"TOR",0,0,1,1,0,2,0,1,3,2,0,6,"A","N","2019-03-16","201903160OTT"
"PIT",0,0,1,0,0,1,0,2,2,1,0,5,"H","N","2019-03-16","201903160PIT"
"STL",0,2,2,1,0,5,0,0,1,0,0,1,"A","N","2019-03-16","201903160PIT"
"NSH",0,1,1,2,0,4,0,0,2,0,0,2,"A","N","2019-03-16","201903160SJS"
"SJS",0,0,2,0,0,2,0,1,1,2,0,4,"H","N","2019-03-16","201903160SJS"
"TBL",0,3,0,3,0,6,0,1,1,1,0,3,"H","N","2019-03-16","201903160TBL"
"WSH",0,1,1,1,0,3,0,3,0,3,0,6,"A","N","2019-03-16","201903160TBL"
"CGY",0,0,1,0,0,1,0,1,1,0,0,2,"A","N","2019-03-16","201903160WPG"
"WPG",0,1,1,0,0,2,0,0,1,0,0,1,"H","N","2019-03-16","201903160WPG"
"ANA",0,1,1,1,0,3,0,0,1,1,0,2,"H","N","2019-03-17","201903170ANA"
"FLA",0,0,1,1,0,2,0,1,1,1,0,3,"A","N","2019-03-17","201903170ANA"
"BUF",0,2,1,0,1,4,0,1,1,1,0,3,"H","Y","2019-03-17","201903170BUF"
"STL",0,1,1,1,0,3,0,2,1,0,1,4,"A","Y","2019-03-17","201903170BUF"
"COL",0,0,2,1,0,3,0,0,0,0,0,0,"H","N","2019-03-17","201903170COL"
"NJD",0,0,0,0,0,0,0,0,2,1,0,3,"A","N","2019-03-17","201903170COL"
"DAL",0,0,1,1,0,2,0,2,0,0,1,3,"H","Y","2019-03-17","201903170DAL"
"VAN",0,2,0,0,1,3,0,0,1,1,0,2,"A","Y","2019-03-17","201903170DAL"
"MIN",0,0,1,1,0,2,1,1,1,0,0,3,"H","N","2019-03-17","201903170MIN"
"NYI",1,1,1,0,0,3,0,0,1,1,0,2,"A","N","2019-03-17","201903170MIN"
"PHI",1,0,0,1,0,2,0,0,0,1,0,1,"A","N","2019-03-17","201903170PIT"
"PIT",0,0,0,1,0,1,1,0,0,1,0,2,"H","N","2019-03-17","201903170PIT"
"EDM",0,1,1,1,0,3,0,2,1,3,0,6,"A","N","2019-03-17","201903170VEG"
"VEG",0,2,1,3,0,6,0,1,1,1,0,3,"H","N","2019-03-17","201903170VEG"
"CHI",0,1,0,1,0,2,1,0,2,0,0,3,"H","N","2019-03-18","201903180CHI"
"VAN",1,0,2,0,0,3,0,1,0,1,0,2,"A","N","2019-03-18","201903180CHI"
"LAK",0,1,1,0,0,2,0,2,1,0,0,3,"H","N","2019-03-18","201903180LAK"
"WPG",0,2,1,0,0,3,0,1,1,0,0,2,"A","N","2019-03-18","201903180LAK"
"SJS",0,2,0,1,0,3,0,3,1,3,0,7,"H","N","2019-03-18","201903180SJS"
"VEG",0,3,1,3,0,7,0,2,0,1,0,3,"A","N","2019-03-18","201903180SJS"
"ARI",0,1,0,0,0,1,0,1,0,3,0,4,"A","N","2019-03-18","201903180TBL"
"TBL",0,1,0,3,0,4,0,1,0,0,0,1,"H","N","2019-03-18","201903180TBL"
"CAR",0,0,1,1,1,3,0,0,1,1,0,2,"H","Y","2019-03-19","201903190CAR"
"PIT",0,0,1,1,0,2,0,0,1,1,1,3,"A","Y","2019-03-19","201903190CAR"
"CBJ",0,1,0,1,0,2,0,2,1,1,0,4,"A","N","2019-03-19","201903190CGY"
"CGY",0,2,1,1,0,4,0,1,0,1,0,2,"H","N","2019-03-19","201903190CGY"
"DAL",0,1,1,2,0,4,0,1,1,0,0,2,"H","N","2019-03-19","201903190DAL"
"FLA",0,1,1,0,0,2,0,1,1,2,0,4,"A","N","2019-03-19","201903190DAL"
"COL",0,1,1,1,0,3,0,0,1,0,0,1,"A","N","2019-03-19","201903190MIN"
"MIN",0,0,1,0,0,1,0,1,1,1,0,3,"H","N","2019-03-19","201903190MIN"
"NJD",0,1,0,0,0,1,0,1,3,0,0,4,"H","N","2019-03-19","201903190NJD"
"WSH",0,1,3,0,0,4,0,1,0,0,0,1,"A","N","2019-03-19","201903190NJD"
"NSH",0,1,0,2,0,3,0,0,0,0,0,0,"H","N","2019-03-19","201903190NSH"
"TOR",0,0,0,0,0,0,0,1,0,2,0,3,"A","N","2019-03-19","201903190NSH"
"BOS",0,1,2,2,0,5,0,0,0,0,0,0,"A","N","2019-03-19","201903190NYI"
"NYI",0,0,0,0,0,0,0,1,2,2,0,5,"H","N","2019-03-19","201903190NYI"
"DET",0,1,1,1,0,3,0,0,0,2,0,2,"A","N","2019-03-19","201903190NYR"
"NYR",0,0,0,2,0,2,0,1,1,1,0,3,"H","N","2019-03-19","201903190NYR"
"MTL",0,1,1,1,0,3,0,0,0,1,0,1,"A","N","2019-03-19","201903190PHI"
"PHI",0,0,0,1,0,1,0,1,1,1,0,3,"H","N","2019-03-19","201903190PHI"
"EDM",0,0,2,0,0,2,0,1,3,3,0,7,"A","N","2019-03-19","201903190STL"
"STL",0,1,3,3,0,7,0,0,2,0,0,2,"H","N","2019-03-19","201903190STL"
"ANA",0,0,0,0,0,0,0,1,0,2,0,3,"H","N","2019-03-20","201903200ANA"
"WPG",0,1,0,2,0,3,0,0,0,0,0,0,"A","N","2019-03-20","201903200ANA"
"BUF",0,1,0,1,0,2,0,0,2,2,0,4,"H","N","2019-03-20","201903200BUF"
"TOR",0,0,2,2,0,4,0,1,0,1,0,2,"A","N","2019-03-20","201903200BUF"
"OTT",0,0,0,4,0,4,0,1,3,3,0,7,"A","N","2019-03-20","201903200VAN"
"VAN",0,1,3,3,0,7,0,0,0,4,0,4,"H","N","2019-03-20","201903200VAN"
"TBL",1,0,4,0,0,5,0,1,2,1,0,4,"A","N","2019-03-20","201903200WSH"
"WSH",0,1,2,1,0,4,1,0,4,0,0,5,"H","N","2019-03-20","201903200WSH"
"CAR",0,2,1,0,0,3,0,2,0,4,0,6,"H","N","2019-03-21","201903210CAR"
"TBL",0,2,0,4,0,6,0,2,1,0,0,3,"A","N","2019-03-21","201903210CAR"
"CGY",0,2,1,2,0,5,0,1,0,0,0,1,"H","N","2019-03-21","201903210CGY"
"OTT",0,1,0,0,0,1,0,2,1,2,0,5,"A","N","2019-03-21","201903210CGY"
"CHI",0,1,0,0,0,1,0,1,0,2,0,3,"H","N","2019-03-21","201903210CHI"
"PHI",0,1,0,2,0,3,0,1,0,0,0,1,"A","N","2019-03-21","201903210CHI"
"COL",0,0,1,2,0,3,0,0,0,1,0,1,"A","N","2019-03-21","201903210DAL"
"DAL",0,0,0,1,0,1,0,0,1,2,0,3,"H","N","2019-03-21","201903210DAL"
"CBJ",0,0,1,0,0,1,0,0,1,3,0,4,"A","N","2019-03-21","201903210EDM"
"EDM",0,0,1,3,0,4,0,0,1,0,0,1,"H","N","2019-03-21","201903210EDM"
"ARI",0,1,0,1,0,2,0,1,1,2,0,4,"A","N","2019-03-21","201903210FLA"
"FLA",0,1,1,2,0,4,0,1,0,1,0,2,"H","N","2019-03-21","201903210FLA"
"LAK",0,1,0,3,0,4,0,1,1,0,0,2,"H","N","2019-03-21","201903210LAK"
"SJS",0,1,1,0,0,2,0,1,0,3,0,4,"A","N","2019-03-21","201903210LAK"
"MTL",0,1,3,0,0,4,0,0,0,0,0,0,"H","N","2019-03-21","201903210MTL"
"NYI",0,0,0,0,0,0,0,1,3,0,0,4,"A","N","2019-03-21","201903210MTL"
"BOS",0,1,1,3,0,5,0,0,1,0,0,1,"A","N","2019-03-21","201903210NJD"
"NJD",0,0,1,0,0,1,0,1,1,3,0,5,"H","N","2019-03-21","201903210NJD"
"NSH",0,0,0,1,0,1,0,0,1,0,1,2,"H","Y","2019-03-21","201903210NSH"
"PIT",0,0,1,0,1,2,0,0,0,1,0,1,"A","Y","2019-03-21","201903210NSH"
"DET",0,1,0,1,0,2,0,1,2,2,0,5,"A","N","2019-03-21","201903210STL"
"STL",0,1,2,2,0,5,0,1,0,1,0,2,"H","N","2019-03-21","201903210STL"
"VEG",0,2,3,0,0,5,0,0,0,0,0,0,"H","N","2019-03-21","201903210VEG"
"WPG",0,0,0,0,0,0,0,2,3,0,0,5,"A","N","2019-03-21","201903210VEG"
"ANA",1,1,0,2,0,4,0,0,1,2,0,3,"H","N","2019-03-22","201903220ANA"
"SJS",0,0,1,2,0,3,1,1,0,2,0,4,"A","N","2019-03-22","201903220ANA"
"MIN",0,1,0,1,0,2,0,0,1,0,0,1,"A","N","2019-03-22","201903220WSH"
"WSH",0,0,1,0,0,1,0,1,0,1,0,2,"H","N","2019-03-22","201903220WSH"
"CAR",0,0,2,3,0,5,0,0,1,0,0,1,"H","N","2019-03-23","201903230CAR"
"MIN",0,0,1,0,0,1,0,0,2,3,0,5,"A","N","2019-03-23","201903230CAR"
"CHI",0,0,1,1,0,2,0,0,2,2,0,4,"A","N","2019-03-23","201903230COL"
"COL",0,0,2,2,0,4,0,0,1,1,0,2,"H","N","2019-03-23","201903230COL"
"DAL",0,0,2,0,0,2,0,1,1,1,0,3,"H","N","2019-03-23","201903230DAL"
"PIT",0,1,1,1,0,3,0,0,2,0,0,2,"A","N","2019-03-23","201903230DAL"
"EDM",0,1,1,1,0,3,1,2,0,1,0,4,"H","N","2019-03-23","201903230EDM"
"OTT",1,2,0,1,0,4,0,1,1,1,0,3,"A","N","2019-03-23","201903230EDM"
"BOS",0,1,5,1,0,7,0,0,2,1,0,3,"A","N","2019-03-23","201903230FLA"
"FLA",0,0,2,1,0,3,0,1,5,1,0,7,"H","N","2019-03-23","201903230FLA"
"ANA",0,1,1,1,0,3,0,1,1,1,1,4,"A","Y","2019-03-23","201903230LAK"
"LAK",0,1,1,1,1,4,0,1,1,1,0,3,"H","Y","2019-03-23","201903230LAK"
"BUF",0,1,2,1,0,4,0,0,4,3,0,7,"A","N","2019-03-23","201903230MTL"
"MTL",0,0,4,3,0,7,0,1,2,1,0,4,"H","N","2019-03-23","201903230MTL"
"ARI",0,1,0,0,0,1,0,1,0,0,1,2,"A","Y","2019-03-23","201903230NJD"
"NJD",0,1,0,0,1,2,0,1,0,0,0,1,"H","Y","2019-03-23","201903230NJD"
"NYI",0,1,1,2,0,4,0,1,0,1,0,2,"A","N","2019-03-23","201903230PHI"
"PHI",0,1,0,1,0,2,0,1,1,2,0,4,"H","N","2019-03-23","201903230PHI"
"STL",0,3,1,0,0,4,0,0,2,1,0,3,"H","N","2019-03-23","201903230STL"
"TBL",0,0,2,1,0,3,0,3,1,0,0,4,"A","N","2019-03-23","201903230STL"
"NYR",1,0,0,1,0,2,0,0,0,1,0,1,"A","N","2019-03-23","201903230TOR"
"TOR",0,0,0,1,0,1,1,0,0,1,0,2,"H","N","2019-03-23","201903230TOR"
"CGY",0,1,1,1,0,3,0,0,0,1,0,1,"A","N","2019-03-23","201903230VAN"
"VAN",0,0,0,1,0,1,0,1,1,1,0,3,"H","N","2019-03-23","201903230VAN"
"DET",1,1,0,1,0,3,0,0,1,1,0,2,"A","N","2019-03-23","201903230VEG"
"VEG",0,0,1,1,0,2,1,1,0,1,0,3,"H","N","2019-03-23","201903230VEG"
"NSH",0,0,0,0,0,0,0,0,3,2,0,5,"A","N","2019-03-23","201903230WPG"
"WPG",0,0,3,2,0,5,0,0,0,0,0,0,"H","N","2019-03-23","201903230WPG"
"CAR",1,0,0,1,0,2,0,1,0,0,0,1,"H","N","2019-03-24","201903240CAR"
"MTL",0,1,0,0,0,1,1,0,0,1,0,2,"A","N","2019-03-24","201903240CAR"
"CHI",1,0,0,1,0,2,0,0,1,0,0,1,"H","N","2019-03-24","201903240CHI"
"COL",0,0,1,0,0,1,1,0,0,1,0,2,"A","N","2019-03-24","201903240CHI"
"ARI",0,0,0,0,0,0,0,1,0,1,0,2,"A","N","2019-03-24","201903240NYI"
"NYI",0,1,0,1,0,2,0,0,0,0,0,0,"H","N","2019-03-24","201903240NYI"
"CBJ",0,1,2,2,0,5,0,0,0,0,0,0,"A","N","2019-03-24","201903240VAN"
"VAN",0,0,0,0,0,0,0,1,2,2,0,5,"H","N","2019-03-24","201903240VAN"
"PHI",0,0,1,0,0,1,0,1,1,1,0,3,"A","N","2019-03-24","201903240WSH"
"WSH",0,1,1,1,0,3,0,0,1,0,0,1,"H","N","2019-03-24","201903240WSH"
"CGY",0,0,0,0,0,0,0,1,0,2,0,3,"H","N","2019-03-25","201903250CGY"
"LAK",0,1,0,2,0,3,0,0,0,0,0,0,"A","N","2019-03-25","201903250CGY"
"MIN",0,0,0,0,0,0,0,1,0,0,0,1,"H","N","2019-03-25","201903250MIN"
"NSH",0,1,0,0,0,1,0,0,0,0,0,0,"A","N","2019-03-25","201903250MIN"
"BUF",0,1,0,0,0,1,0,1,0,2,0,3,"A","N","2019-03-25","201903250NJD"
"NJD",0,1,0,2,0,3,0,1,0,0,0,1,"H","N","2019-03-25","201903250NJD"
"NYR",0,2,0,0,0,2,0,1,3,1,0,5,"H","N","2019-03-25","201903250NYR"
"PIT",0,1,3,1,0,5,0,2,0,0,0,2,"A","N","2019-03-25","201903250NYR"
"DET",0,1,1,1,0,3,0,0,0,2,0,2,"A","N","2019-03-25","201903250SJS"
"SJS",0,0,0,2,0,2,0,1,1,1,0,3,"H","N","2019-03-25","201903250SJS"
"STL",0,1,1,1,0,3,0,0,1,0,0,1,"H","N","2019-03-25","201903250STL"
"VEG",0,0,1,0,0,1,0,1,1,1,0,3,"A","N","2019-03-25","201903250STL"
"BOS",0,1,3,0,0,4,0,2,0,3,0,5,"A","N","2019-03-25","201903250TBL"
"TBL",0,2,0,3,0,5,0,1,3,0,0,4,"H","N","2019-03-25","201903250TBL"
"FLA",0,2,0,3,0,5,0,4,1,2,0,7,"A","N","2019-03-25","201903250TOR"
"TOR",0,4,1,2,0,7,0,2,0,3,0,5,"H","N","2019-03-25","201903250TOR"
"DAL",0,0,3,2,0,5,0,0,0,2,0,2,"A","N","2019-03-25","201903250WPG"
"WPG",0,0,0,2,0,2,0,0,3,2,0,5,"H","N","2019-03-25","201903250WPG"
"ARI",0,0,0,1,0,1,0,0,0,0,0,0,"H","N","2019-03-26","201903260ARI"
"CHI",0,0,0,0,0,0,0,0,0,1,0,1,"A","N","2019-03-26","201903260ARI"
"CBJ",0,1,0,3,0,4,0,0,0,0,0,0,"H","N","2019-03-26","201903260CBJ"
"NYI",0,0,0,0,0,0,0,1,0,3,0,4,"A","N","2019-03-26","201903260CBJ"
"EDM",0,5,2,1,0,8,0,1,3,0,0,4,"H","N","2019-03-26","201903260EDM"
"LAK",0,1,3,0,0,4,0,5,2,1,0,8,"A","N","2019-03-26","201903260EDM"
"FLA",0,0,0,1,0,1,0,3,2,1,0,6,"A","N","2019-03-26","201903260MTL"
"MTL",0,3,2,1,0,6,0,0,0,1,0,1,"H","N","2019-03-26","201903260MTL"
"BUF",0,0,0,0,0,0,0,2,0,2,0,4,"A","N","2019-03-26","201903260OTT"
"OTT",0,2,0,2,0,4,0,0,0,0,0,0,"H","N","2019-03-26","201903260OTT"
"ANA",0,1,2,2,0,5,0,2,0,2,0,4,"A","N","2019-03-26","201903260VAN"
"VAN",0,2,0,2,0,4,0,1,2,2,0,5,"H","N","2019-03-26","201903260VAN"
"CAR",0,0,1,0,0,1,0,1,0,3,0,4,"A","N","2019-03-26","201903260WSH"
"WSH",0,1,0,3,0,4,0,0,1,0,0,1,"H","N","2019-03-26","201903260WSH"
"BOS",0,1,1,4,0,6,0,1,0,2,0,3,"H","N","2019-03-27","201903270BOS"
"NYR",0,1,0,2,0,3,0,1,1,4,0,6,"A","N","2019-03-27","201903270BOS"
"CGY",0,0,0,1,0,1,0,1,0,1,0,2,"H","N","2019-03-27","201903270CGY"
"DAL",0,1,0,1,0,2,0,0,0,1,0,1,"A","N","2019-03-27","201903270CGY"
"COL",0,2,2,0,0,4,0,0,2,1,0,3,"H","N","2019-03-27","201903270COL"
"VEG",0,0,2,1,0,3,0,2,2,0,0,4,"A","N","2019-03-27","201903270COL"
"PHI",0,0,3,1,1,5,0,2,0,2,0,4,"H","Y","2019-03-27","201903270PHI"
"TOR",0,2,0,2,0,4,0,0,3,1,1,5,"A","Y","2019-03-27","201903270PHI"
"BUF",0,0,2,2,0,4,1,1,1,2,0,5,"H","N","2019-03-28","201903280BUF"
"DET",1,1,1,2,0,5,0,0,2,2,0,4,"A","N","2019-03-28","201903280BUF"
"CAR",0,1,1,0,0,2,0,1,0,2,0,3,"H","N","2019-03-28","201903280CAR"
"WSH",0,1,0,2,0,3,0,1,1,0,0,2,"A","N","2019-03-28","201903280CAR"
"CBJ",0,0,3,3,0,6,0,1,1,0,0,2,"H","N","2019-03-28","201903280CBJ"
"MTL",0,1,1,0,0,2,0,0,3,3,0,6,"A","N","2019-03-28","201903280CBJ"
"DAL",0,0,1,1,1,3,0,1,1,0,0,2,"A","Y","2019-03-28","201903280EDM"
"EDM",0,1,1,0,0,2,0,0,1,1,1,3,"H","Y","2019-03-28","201903280EDM"
"FLA",0,1,2,2,0,5,0,1,0,1,0,2,"A","N","2019-03-28","201903280OTT"
"OTT",0,1,0,1,0,2,0,1,2,2,0,5,"H","N","2019-03-28","201903280OTT"
"CHI",0,3,2,0,0,5,0,1,3,0,0,4,"A","N","2019-03-28","201903280SJS"
"SJS",0,1,3,0,0,4,0,3,2,0,0,5,"H","N","2019-03-28","201903280SJS"
"LAK",0,1,0,1,0,2,0,0,2,0,1,3,"A","Y","2019-03-28","201903280VAN"
"VAN",0,0,2,0,1,3,0,1,0,1,0,2,"H","Y","2019-03-28","201903280VAN"
"NYI",0,1,1,3,0,5,0,2,1,1,0,4,"A","N","2019-03-28","201903280WPG"
"WPG",0,2,1,1,0,4,0,1,1,3,0,5,"H","N","2019-03-28","201903280WPG"
"ANA",0,1,0,0,0,1,0,1,2,3,0,6,"A","N","2019-03-29","201903290CGY"
"CGY",0,1,2,3,0,6,0,1,0,0,0,1,"H","N","2019-03-29","201903290CGY"
"ARI",0,0,0,2,0,2,0,0,2,0,1,3,"A","Y","2019-03-29","201903290COL"
"COL",0,0,2,0,1,3,0,0,0,2,0,2,"H","Y","2019-03-29","201903290COL"
"DET",0,1,1,2,0,4,0,0,0,0,0,0,"H","N","2019-03-29","201903290DET"
"NJD",0,0,0,0,0,0,0,1,1,2,0,4,"A","N","2019-03-29","201903290DET"
"NYR",0,0,2,2,0,4,0,2,0,0,0,2,"H","N","2019-03-29","201903290NYR"
"STL",0,2,0,0,0,2,0,0,2,2,0,4,"A","N","2019-03-29","201903290NYR"
"NSH",0,1,1,1,0,3,0,0,0,1,0,1,"A","N","2019-03-29","201903290PIT"
"PIT",0,0,0,1,0,1,0,1,1,1,0,3,"H","N","2019-03-29","201903290PIT"
"MIN",0,2,1,0,0,3,0,0,1,1,0,2,"A","N","2019-03-29","201903290VEG"
"VEG",0,0,1,1,0,2,0,2,1,0,0,3,"H","N","2019-03-29","201903290VEG"
"BOS",0,0,1,0,0,1,0,2,1,1,0,4,"H","N","2019-03-30","201903300BOS"
"FLA",0,2,1,1,0,4,0,0,1,0,0,1,"A","N","2019-03-30","201903300BOS"
"CAR",0,2,0,3,0,5,0,1,0,1,0,2,"H","N","2019-03-30","201903300CAR"
"PHI",0,1,0,1,0,2,0,2,0,3,0,5,"A","N","2019-03-30","201903300CAR"
"ANA",0,1,3,1,0,5,0,0,0,1,0,1,"A","N","2019-03-30","201903300EDM"
"EDM",0,0,0,1,0,1,0,1,3,1,0,5,"H","N","2019-03-30","201903300EDM"
"CHI",0,0,1,1,0,2,1,0,1,1,0,3,"A","N","2019-03-30","201903300LAK"
"LAK",1,0,1,1,0,3,0,0,1,1,0,2,"H","N","2019-03-30","201903300LAK"
"NJD",0,0,2,0,0,2,1,1,1,0,0,3,"H","N","2019-03-30","201903300NJD"
"STL",1,1,1,0,0,3,0,0,2,0,0,2,"A","N","2019-03-30","201903300NJD"
"CBJ",0,3,2,0,0,5,0,1,1,0,0,2,"A","N","2019-03-30","201903300NSH"
"NSH",0,1,1,0,0,2,0,3,2,0,0,5,"H","N","2019-03-30","201903300NSH"
"BUF",0,0,0,1,0,1,0,1,2,2,0,5,"A","N","2019-03-30","201903300NYI"
"NYI",0,1,2,2,0,5,0,0,0,1,0,1,"H","N","2019-03-30","201903300NYI"
"OTT",0,0,2,2,0,4,0,0,0,2,0,2,"H","N","2019-03-30","201903300OTT"
"TOR",0,0,0,2,0,2,0,0,2,2,0,4,"A","N","2019-03-30","201903300OTT"
"SJS",1,0,1,2,0,4,0,1,1,1,0,3,"H","N","2019-03-30","201903300SJS"
"VEG",0,1,1,1,0,3,1,0,1,2,0,4,"A","N","2019-03-30","201903300SJS"
"TBL",0,0,1,2,0,3,0,3,1,2,0,6,"H","N","2019-03-30","201903300TBL"
"WSH",0,3,1,2,0,6,0,0,1,2,0,3,"A","N","2019-03-30","201903300TBL"
"DAL",0,0,0,2,0,2,0,2,0,0,1,3,"A","Y","2019-03-30","201903300VAN"
"VAN",0,2,0,0,1,3,0,0,0,2,0,2,"H","Y","2019-03-30","201903300VAN"
"MTL",0,1,1,1,0,3,0,0,0,1,0,1,"A","N","2019-03-30","201903300WPG"
"WPG",0,0,0,1,0,1,0,1,1,1,0,3,"H","N","2019-03-30","201903300WPG"
"ARI",0,1,1,2,0,4,0,0,0,0,0,0,"H","N","2019-03-31","201903310ARI"
"MIN",0,0,0,0,0,0,0,1,1,2,0,4,"A","N","2019-03-31","201903310ARI"
"BUF",0,0,0,0,0,0,0,3,1,0,0,4,"H","N","2019-03-31","201903310BUF"
"CBJ",0,3,1,0,0,4,0,0,0,0,0,0,"A","N","2019-03-31","201903310BUF"
"BOS",0,0,3,0,0,3,0,2,0,4,0,6,"A","N","2019-03-31","201903310DET"
"DET",0,2,0,4,0,6,0,0,3,0,0,3,"H","N","2019-03-31","201903310DET"
"NYR",0,2,0,1,0,3,0,0,0,0,0,0,"A","N","2019-03-31","201903310PHI"
"PHI",0,0,0,0,0,0,0,2,0,1,0,3,"H","N","2019-03-31","201903310PHI"
"CAR",0,0,0,1,0,1,0,2,0,1,0,3,"A","N","2019-03-31","201903310PIT"
"PIT",0,2,0,1,0,3,0,0,0,1,0,1,"H","N","2019-03-31","201903310PIT"
"CGY",0,3,1,1,0,5,0,1,0,2,0,3,"A","N","2019-03-31","201903310SJS"
"SJS",0,1,0,2,0,3,0,3,1,1,0,5,"H","N","2019-03-31","201903310SJS"
"CHI",0,1,1,1,0,3,1,2,1,0,0,4,"H","N","2019-04-01","201904010CHI"
"WPG",1,2,1,0,0,4,0,1,1,1,0,3,"A","N","2019-04-01","201904010CHI"
"FLA",0,1,3,1,0,5,0,0,0,3,0,3,"H","N","2019-04-01","201904010FLA"
"WSH",0,0,0,3,0,3,0,1,3,1,0,5,"A","N","2019-04-01","201904010FLA"
"CGY",0,2,1,4,0,7,0,2,0,0,0,2,"A","N","2019-04-01","201904010LAK"
"LAK",0,2,0,0,0,2,0,2,1,4,0,7,"H","N","2019-04-01","201904010LAK"
"NJD",0,2,0,2,0,4,0,1,1,0,0,2,"H","N","2019-04-01","201904010NJD"
"NYR",0,1,1,0,0,2,0,2,0,2,0,4,"A","N","2019-04-01","201904010NJD"
"NYI",0,0,0,1,0,1,0,0,1,1,0,2,"H","N","2019-04-01","201904010NYI"
"TOR",0,0,1,1,0,2,0,0,0,1,0,1,"A","N","2019-04-01","201904010NYI"
"OTT",0,1,0,1,0,2,0,1,2,2,0,5,"H","N","2019-04-01","201904010OTT"
"TBL",0,1,2,2,0,5,0,1,0,1,0,2,"A","N","2019-04-01","201904010OTT"
"COL",0,0,0,2,0,2,0,1,0,1,1,3,"A","Y","2019-04-01","201904010STL"
"STL",0,1,0,1,1,3,0,0,0,2,0,2,"H","Y","2019-04-01","201904010STL"
"EDM",0,0,1,0,0,1,0,1,1,1,0,3,"A","N","2019-04-01","201904010VEG"
"VEG",0,1,1,1,0,3,0,0,1,0,0,1,"H","N","2019-04-01","201904010VEG"
"ARI",0,0,1,0,0,1,0,0,1,2,0,3,"H","N","2019-04-02","201904020ARI"
"LAK",0,0,1,2,0,3,0,0,1,0,0,1,"A","N","2019-04-02","201904020ARI"
"BUF",0,1,1,0,0,2,0,1,1,1,0,3,"H","N","2019-04-02","201904020BUF"
"NSH",0,1,1,1,0,3,0,1,1,0,0,2,"A","N","2019-04-02","201904020BUF"
"BOS",0,2,2,2,0,6,0,0,0,2,0,2,"A","N","2019-04-02","201904020CBJ"
"CBJ",0,0,0,2,0,2,0,2,2,2,0,6,"H","N","2019-04-02","201904020CBJ"
"COL",0,0,4,2,0,6,0,2,0,0,0,2,"H","N","2019-04-02","201904020COL"
"EDM",0,2,0,0,0,2,0,0,4,2,0,6,"A","N","2019-04-02","201904020COL"
"DAL",0,2,2,2,0,6,0,0,2,0,0,2,"H","N","2019-04-02","201904020DAL"
"PHI",0,0,2,0,0,2,0,2,2,2,0,6,"A","N","2019-04-02","201904020DAL"
"DET",0,1,1,2,0,4,0,1,0,0,0,1,"H","N","2019-04-02","201904020DET"
"PIT",0,1,0,0,0,1,0,1,1,2,0,4,"A","N","2019-04-02","201904020DET"
"MIN",0,3,1,1,0,5,0,0,1,0,0,1,"H","N","2019-04-02","201904020MIN"
"WPG",0,0,1,0,0,1,0,3,1,1,0,5,"A","N","2019-04-02","201904020MIN"
"MTL",0,1,1,2,0,4,0,1,1,0,0,2,"H","N","2019-04-02","201904020MTL"
"TBL",0,1,1,0,0,2,0,1,1,2,0,4,"A","N","2019-04-02","201904020MTL"
"CAR",0,1,1,2,0,4,0,0,1,0,0,1,"A","N","2019-04-02","201904020TOR"
"TOR",0,0,1,0,0,1,0,1,1,2,0,4,"H","N","2019-04-02","201904020TOR"
"SJS",0,2,0,0,0,2,0,1,0,3,0,4,"A","N","2019-04-02","201904020VAN"
"VAN",0,1,0,3,0,4,0,2,0,0,0,2,"H","N","2019-04-02","201904020VAN"
"ANA",0,2,1,0,0,3,0,1,0,0,0,1,"H","N","2019-04-03","201904030ANA"
"CGY",0,1,0,0,0,1,0,2,1,0,0,3,"A","N","2019-04-03","201904030ANA"
"CHI",0,1,1,1,1,4,0,0,1,2,0,3,"H","Y","2019-04-03","201904030CHI"
"STL",0,0,1,2,0,3,0,1,1,1,1,4,"A","Y","2019-04-03","201904030CHI"
"NYR",0,0,1,0,0,1,0,2,1,1,0,4,"H","N","2019-04-03","201904030NYR"
"OTT",0,2,1,1,0,4,0,0,1,0,0,1,"A","N","2019-04-03","201904030NYR"
"BUF",0,1,2,2,0,5,0,2,0,0,0,2,"H","N","2019-04-04","201904040BUF"
"OTT",0,2,0,0,0,2,0,1,2,2,0,5,"A","N","2019-04-04","201904040BUF"
"CAR",0,1,1,1,0,3,0,1,0,0,0,1,"H","N","2019-04-04","201904040CAR"
"NJD",0,1,0,0,0,1,0,1,1,1,0,3,"A","N","2019-04-04","201904040CAR"
"COL",1,0,1,1,0,3,0,2,0,0,0,2,"H","N","2019-04-04","201904040COL"
"WPG",0,2,0,0,0,2,1,0,1,1,0,3,"A","N","2019-04-04","201904040COL"
"EDM",0,1,1,0,0,2,0,2,1,0,0,3,"H","N","2019-04-04","201904040EDM"
"SJS",0,2,1,0,0,3,0,1,1,0,0,2,"A","N","2019-04-04","201904040EDM"
"FLA",0,0,0,1,0,1,0,0,1,0,1,2,"H","Y","2019-04-04","201904040FLA"
"NYI",0,0,1,0,1,2,0,0,0,1,0,1,"A","Y","2019-04-04","201904040FLA"
"BOS",0,0,1,2,0,3,0,0,0,0,0,0,"A","N","2019-04-04","201904040MIN"
"MIN",0,0,0,0,0,0,0,0,1,2,0,3,"H","N","2019-04-04","201904040MIN"
"NSH",0,0,1,2,0,3,0,2,0,0,0,2,"H","N","2019-04-04","201904040NSH"
"VAN",0,2,0,0,0,2,0,0,1,2,0,3,"A","N","2019-04-04","201904040NSH"
"DET",0,1,0,0,0,1,0,2,1,1,0,4,"A","N","2019-04-04","201904040PIT"
"PIT",0,2,1,1,0,4,0,1,0,0,0,1,"H","N","2019-04-04","201904040PIT"
"PHI",0,3,0,0,0,3,0,5,1,1,0,7,"A","N","2019-04-04","201904040STL"
"STL",0,5,1,1,0,7,0,3,0,0,0,3,"H","N","2019-04-04","201904040STL"
"TBL",0,0,1,2,0,3,0,1,0,0,0,1,"A","N","2019-04-04","201904040TOR"
"TOR",0,1,0,0,0,1,0,0,1,2,0,3,"H","N","2019-04-04","201904040TOR"
"ARI",0,1,2,1,0,4,0,1,0,0,0,1,"A","N","2019-04-04","201904040VEG"
"VEG",0,1,0,0,0,1,0,1,2,1,0,4,"H","N","2019-04-04","201904040VEG"
"MTL",0,1,0,0,0,1,0,1,1,0,0,2,"A","N","2019-04-04","201904040WSH"
"WSH",0,1,1,0,0,2,0,1,0,0,0,1,"H","N","2019-04-04","201904040WSH"
"ANA",0,1,2,2,0,5,0,1,0,1,0,2,"H","N","2019-04-05","201904050ANA"
"LAK",0,1,0,1,0,2,0,1,2,2,0,5,"A","N","2019-04-05","201904050ANA"
"CHI",0,1,3,2,0,6,0,0,0,1,0,1,"H","N","2019-04-05","201904050CHI"
"DAL",0,0,0,1,0,1,0,1,3,2,0,6,"A","N","2019-04-05","201904050CHI"
"CBJ",0,0,0,2,1,3,0,0,1,1,0,2,"A","Y","2019-04-05","201904050NYR"
"NYR",0,0,1,1,0,2,0,0,0,2,1,3,"H","Y","2019-04-05","201904050NYR"
"ARI",0,1,0,1,0,2,0,1,3,0,0,4,"H","N","2019-04-06","201904060ARI"
"WPG",0,1,3,0,0,4,0,1,0,1,0,2,"A","N","2019-04-06","201904060ARI"
"BOS",0,2,0,1,0,3,0,0,3,3,0,6,"H","N","2019-04-06","201904060BOS"
"TBL",0,0,3,3,0,6,0,2,0,1,0,3,"A","N","2019-04-06","201904060BOS"
"CGY",0,1,0,0,0,1,0,1,1,1,0,3,"H","N","2019-04-06","201904060CGY"
"EDM",0,1,1,1,0,3,0,1,0,0,0,1,"A","N","2019-04-06","201904060CGY"
"DAL",0,0,0,3,0,3,0,0,0,0,0,0,"H","N","2019-04-06","201904060DAL"
"MIN",0,0,0,0,0,0,0,0,0,3,0,3,"A","N","2019-04-06","201904060DAL"
"BUF",0,2,3,2,0,7,0,1,0,0,0,1,"A","N","2019-04-06","201904060DET"
"DET",0,1,0,0,0,1,0,2,3,2,0,7,"H","N","2019-04-06","201904060DET"
"FLA",0,0,1,2,0,3,1,1,2,0,0,4,"H","N","2019-04-06","201904060FLA"
"NJD",1,1,2,0,0,4,0,0,1,2,0,3,"A","N","2019-04-06","201904060FLA"
"LAK",0,2,1,2,0,5,0,0,2,0,0,2,"H","N","2019-04-06","201904060LAK"
"VEG",0,0,2,0,0,2,0,2,1,2,0,5,"A","N","2019-04-06","201904060LAK"
"MTL",0,1,3,1,1,6,0,2,2,1,0,5,"H","Y","2019-04-06","201904060MTL"
"TOR",0,2,2,1,0,5,0,1,3,1,1,6,"A","Y","2019-04-06","201904060MTL"
"CHI",0,2,0,0,0,2,0,0,2,3,0,5,"A","N","2019-04-06","201904060NSH"
"NSH",0,0,2,3,0,5,0,2,0,0,0,2,"H","N","2019-04-06","201904060NSH"
"CBJ",0,3,1,2,0,6,0,0,1,1,0,2,"A","N","2019-04-06","201904060OTT"
"OTT",0,0,1,1,0,2,0,3,1,2,0,6,"H","N","2019-04-06","201904060OTT"
"CAR",0,3,1,0,0,4,0,1,2,0,0,3,"A","N","2019-04-06","201904060PHI"
"PHI",0,1,2,0,0,3,0,3,1,0,0,4,"H","N","2019-04-06","201904060PHI"
"NYR",1,1,0,2,0,4,0,1,0,2,0,3,"A","N","2019-04-06","201904060PIT"
"PIT",0,1,0,2,0,3,1,1,0,2,0,4,"H","N","2019-04-06","201904060PIT"
"COL",0,1,1,0,0,2,0,2,1,2,0,5,"A","N","2019-04-06","201904060SJS"
"SJS",0,2,1,2,0,5,0,1,1,0,0,2,"H","N","2019-04-06","201904060SJS"
"STL",0,1,0,1,1,3,0,0,0,2,0,2,"H","Y","2019-04-06","201904060STL"
"VAN",0,0,0,2,0,2,0,1,0,1,1,3,"A","Y","2019-04-06","201904060STL"
"NYI",0,0,1,2,0,3,0,0,0,0,0,0,"A","N","2019-04-06","201904060WSH"
"WSH",0,0,0,0,0,0,0,0,1,2,0,3,"H","N","2019-04-06","201904060WSH"
"DAL",0,0,1,2,0,3,0,1,0,1,0,2,"A","N","2019-04-10","201904100NSH"
"NSH",0,1,0,1,0,2,0,0,1,2,0,3,"H","N","2019-04-10","201904100NSH"
"NYI",1,2,0,1,0,4,0,1,1,1,0,3,"H","N","2019-04-10","201904100NYI"
"PIT",0,1,1,1,0,3,1,2,0,1,0,4,"A","N","2019-04-10","201904100NYI"
"SJS",0,1,3,1,0,5,0,0,1,1,0,2,"H","N","2019-04-10","201904100SJS"
"VEG",0,0,1,1,0,2,0,1,3,1,0,5,"A","N","2019-04-10","201904100SJS"
"CBJ",0,0,1,3,0,4,0,3,0,0,0,3,"A","N","2019-04-10","201904100TBL"
"TBL",0,3,0,0,0,3,0,0,1,3,0,4,"H","N","2019-04-10","201904100TBL"
"STL",0,0,0,2,0,2,0,1,0,0,0,1,"A","N","2019-04-10","201904100WPG"
"WPG",0,1,0,0,0,1,0,0,0,2,0,2,"H","N","2019-04-10","201904100WPG"
"BOS",0,1,0,0,0,1,0,1,2,1,0,4,"H","N","2019-04-11","201904110BOS"
"TOR",0,1,2,1,0,4,0,1,0,0,0,1,"A","N","2019-04-11","201904110BOS"
"CGY",0,0,2,2,0,4,0,0,0,0,0,0,"H","N","2019-04-11","201904110CGY"
"COL",0,0,0,0,0,0,0,0,2,2,0,4,"A","N","2019-04-11","201904110CGY"
"CAR",0,0,0,2,0,2,0,3,0,1,0,4,"A","N","2019-04-11","201904110WSH"
"WSH",0,3,0,1,0,4,0,0,0,2,0,2,"H","N","2019-04-11","201904110WSH"
"NYI",0,0,1,2,0,3,0,0,1,0,0,1,"H","N","2019-04-12","201904120NYI"
"PIT",0,0,1,0,0,1,0,0,1,2,0,3,"A","N","2019-04-12","201904120NYI"
"SJS",0,3,0,0,0,3,0,3,1,1,0,5,"H","N","2019-04-12","201904120SJS"
"VEG",0,3,1,1,0,5,0,3,0,0,0,3,"A","N","2019-04-12","201904120SJS"
"CBJ",0,2,1,2,0,5,0,0,0,1,0,1,"A","N","2019-04-12","201904120TBL"
"TBL",0,0,0,1,0,1,0,2,1,2,0,5,"H","N","2019-04-12","201904120TBL"
"STL",0,1,2,1,0,4,0,1,2,0,0,3,"A","N","2019-04-12","201904120WPG"
"WPG",0,1,2,0,0,3,0,1,2,1,0,4,"H","N","2019-04-12","201904120WPG"
"BOS",0,2,1,1,0,4,0,0,0,1,0,1,"H","N","2019-04-13","201904130BOS"
"TOR",0,0,0,1,0,1,0,2,1,1,0,4,"A","N","2019-04-13","201904130BOS"
"CGY",0,0,1,1,0,2,1,0,1,1,0,3,"H","N","2019-04-13","201904130CGY"
"COL",1,0,1,1,0,3,0,0,1,1,0,2,"A","N","2019-04-13","201904130CGY"
"DAL",0,0,1,0,0,1,1,0,1,0,0,2,"A","N","2019-04-13","201904130NSH"
"NSH",1,0,1,0,0,2,0,0,1,0,0,1,"H","N","2019-04-13","201904130NSH"
"CAR",0,1,1,1,0,3,1,2,0,1,0,4,"A","N","2019-04-13","201904130WSH"
"WSH",1,2,0,1,0,4,0,1,1,1,0,3,"H","N","2019-04-13","201904130WSH"
"CBJ",0,0,2,1,0,3,0,0,0,1,0,1,"H","N","2019-04-14","201904140CBJ"
"TBL",0,0,0,1,0,1,0,0,2,1,0,3,"A","N","2019-04-14","201904140CBJ"
"NYI",0,2,0,2,0,4,0,1,0,0,0,1,"A","N","2019-04-14","201904140PIT"
"PIT",0,1,0,0,0,1,0,2,0,2,0,4,"H","N","2019-04-14","201904140PIT"
"STL",0,1,0,2,0,3,0,0,3,3,0,6,"H","N","2019-04-14","201904140STL"
"WPG",0,0,3,3,0,6,0,1,0,2,0,3,"A","N","2019-04-14","201904140STL"
"SJS",0,1,0,2,0,3,0,2,2,2,0,6,"A","N","2019-04-14","201904140VEG"
"VEG",0,2,2,2,0,6,0,1,0,2,0,3,"H","N","2019-04-14","201904140VEG"
"CAR",0,1,2,2,0,5,0,0,0,0,0,0,"H","N","2019-04-15","201904150CAR"
"WSH",0,0,0,0,0,0,0,1,2,2,0,5,"A","N","2019-04-15","201904150CAR"
"CGY",0,0,1,1,0,2,0,3,2,1,0,6,"A","N","2019-04-15","201904150COL"
"COL",0,3,2,1,0,6,0,0,1,1,0,2,"H","N","2019-04-15","201904150COL"
"DAL",0,0,1,1,0,2,0,0,2,1,0,3,"H","N","2019-04-15","201904150DAL"
"NSH",0,0,2,1,0,3,0,0,1,1,0,2,"A","N","2019-04-15","201904150DAL"
"BOS",0,0,2,0,0,2,0,0,3,0,0,3,"A","N","2019-04-15","201904150TOR"
"TOR",0,0,3,0,0,3,0,0,2,0,0,2,"H","N","2019-04-15","201904150TOR"
"CBJ",0,2,2,3,0,7,0,1,2,0,0,3,"H","N","2019-04-16","201904160CBJ"
"TBL",0,1,2,0,0,3,0,2,2,3,0,7,"A","N","2019-04-16","201904160CBJ"
"NYI",0,2,0,1,0,3,0,1,0,0,0,1,"A","N","2019-04-16","201904160PIT"
"PIT",0,1,0,0,0,1,0,2,0,1,0,3,"H","N","2019-04-16","201904160PIT"
"STL",0,0,0,1,0,1,1,0,0,1,0,2,"H","N","2019-04-16","201904160STL"
"WPG",1,0,0,1,0,2,0,0,0,1,0,1,"A","N","2019-04-16","201904160STL"
"SJS",0,0,0,0,0,0,0,2,1,2,0,5,"A","N","2019-04-16","201904160VEG"
"VEG",0,2,1,2,0,5,0,0,0,0,0,0,"H","N","2019-04-16","201904160VEG"
"CGY",0,0,1,1,0,2,1,0,0,2,0,3,"A","N","2019-04-17","201904170COL"
"COL",1,0,0,2,0,3,0,0,1,1,0,2,"H","N","2019-04-17","201904170COL"
"DAL",0,4,1,0,0,5,0,0,0,1,0,1,"H","N","2019-04-17","201904170DAL"
"NSH",0,0,0,1,0,1,0,4,1,0,0,5,"A","N","2019-04-17","201904170DAL"
"BOS",0,2,2,2,0,6,0,1,1,2,0,4,"A","N","2019-04-17","201904170TOR"
"TOR",0,1,1,2,0,4,0,2,2,2,0,6,"H","N","2019-04-17","201904170TOR"
"CAR",0,1,1,0,0,2,0,0,1,0,0,1,"H","N","2019-04-18","201904180CAR"
"WSH",0,0,1,0,0,1,0,1,1,0,0,2,"A","N","2019-04-18","201904180CAR"
"SJS",0,2,1,2,0,5,0,1,0,1,0,2,"H","N","2019-04-18","201904180SJS"
"VEG",0,1,0,1,0,2,0,2,1,2,0,5,"A","N","2019-04-18","201904180SJS"
"STL",0,0,0,3,0,3,0,2,0,0,0,2,"A","N","2019-04-18","201904180WPG"
"WPG",0,2,0,0,0,2,0,0,0,3,0,3,"H","N","2019-04-18","201904180WPG"
"BOS",0,0,0,1,0,1,0,0,0,2,0,2,"H","N","2019-04-19","201904190BOS"
"TOR",0,0,0,2,0,2,0,0,0,1,0,1,"A","N","2019-04-19","201904190BOS"
"CGY",0,1,0,0,0,1,0,2,2,1,0,5,"H","N","2019-04-19","201904190CGY"
"COL",0,2,2,1,0,5,0,1,0,0,0,1,"A","N","2019-04-19","201904190CGY"
"DAL",0,1,3,1,0,5,0,1,1,1,0,3,"A","N","2019-04-20","201904200NSH"
"NSH",0,1,1,1,0,3,0,1,3,1,0,5,"H","N","2019-04-20","201904200NSH"
"STL",0,1,1,1,0,3,0,0,0,2,0,2,"H","N","2019-04-20","201904200STL"
"WPG",0,0,0,2,0,2,0,1,1,1,0,3,"A","N","2019-04-20","201904200STL"
"CAR",0,0,0,0,0,0,0,1,2,3,0,6,"A","N","2019-04-20","201904200WSH"
"WSH",0,1,2,3,0,6,0,0,0,0,0,0,"H","N","2019-04-20","201904200WSH"
"BOS",0,2,1,1,0,4,0,1,0,1,0,2,"A","N","2019-04-21","201904210TOR"
"TOR",0,1,0,1,0,2,0,2,1,1,0,4,"H","N","2019-04-21","201904210TOR"
"SJS",1,1,0,0,0,2,0,0,1,0,0,1,"A","N","2019-04-21","201904210VEG"
"VEG",0,0,1,0,0,1,1,1,0,0,0,2,"H","N","2019-04-21","201904210VEG"
"CAR",0,1,1,3,0,5,0,2,0,0,0,2,"H","N","2019-04-22","201904220CAR"
"WSH",0,2,0,0,0,2,0,1,1,3,0,5,"A","N","2019-04-22","201904220CAR"
"DAL",1,0,1,0,0,2,0,1,0,0,0,1,"H","N","2019-04-22","201904220DAL"
"NSH",0,1,0,0,0,1,1,0,1,0,0,2,"A","N","2019-04-22","201904220DAL"
"BOS",0,2,0,3,0,5,0,0,1,0,0,1,"H","N","2019-04-23","201904230BOS"
"TOR",0,0,1,0,0,1,0,2,0,3,0,5,"A","N","2019-04-23","201904230BOS"
"SJS",1,0,0,4,0,5,0,1,1,2,0,4,"H","N","2019-04-23","201904230SJS"
"VEG",0,1,1,2,0,4,1,0,0,4,0,5,"A","N","2019-04-23","201904230SJS"
"CAR",1,0,2,1,0,4,0,2,1,0,0,3,"A","N","2019-04-24","201904240WSH"
"WSH",0,2,1,0,0,3,1,0,2,1,0,4,"H","N","2019-04-24","201904240WSH"
"BOS",1,1,0,1,0,3,0,0,0,2,0,2,"H","N","2019-04-25","201904250BOS"
"CBJ",0,0,0,2,0,2,1,1,0,1,0,3,"A","N","2019-04-25","201904250BOS"
"DAL",0,0,1,1,0,2,0,1,1,1,0,3,"A","N","2019-04-25","201904250STL"
"STL",0,1,1,1,0,3,0,0,1,1,0,2,"H","N","2019-04-25","201904250STL"
"CAR",1,0,0,0,0,1,0,0,0,0,0,0,"A","N","2019-04-26","201904260NYI"
"NYI",0,0,0,0,0,0,1,0,0,0,0,1,"H","N","2019-04-26","201904260NYI"
"COL",0,1,1,0,0,2,0,1,3,1,0,5,"A","N","2019-04-26","201904260SJS"
"SJS",0,1,3,1,0,5,0,1,1,0,0,2,"H","N","2019-04-26","201904260SJS"
"BOS",0,1,1,0,0,2,1,0,2,0,0,3,"H","N","2019-04-27","201904270BOS"
"CBJ",1,0,2,0,0,3,0,1,1,0,0,2,"A","N","2019-04-27","201904270BOS"
"DAL",0,3,0,1,0,4,0,1,0,1,0,2,"A","N","2019-04-27","201904270STL"
"STL",0,1,0,1,0,2,0,3,0,1,0,4,"H","N","2019-04-27","201904270STL"
"CAR",0,0,0,2,0,2,0,1,0,0,0,1,"A","N","2019-04-28","201904280NYI"
"NYI",0,1,0,0,0,1,0,0,0,2,0,2,"H","N","2019-04-28","201904280NYI"
"COL",0,0,2,2,0,4,0,1,0,2,0,3,"A","N","2019-04-28","201904280SJS"
"SJS",0,1,0,2,0,3,0,0,2,2,0,4,"H","N","2019-04-28","201904280SJS"
"DAL",0,1,0,2,0,3,0,1,1,2,0,4,"H","N","2019-04-29","201904290DAL"
"STL",0,1,1,2,0,4,0,1,0,2,0,3,"A","N","2019-04-29","201904290DAL"
"BOS",0,0,1,0,0,1,0,1,1,0,0,2,"A","N","2019-04-30","201904300CBJ"
"CBJ",0,1,1,0,0,2,0,0,1,0,0,1,"H","N","2019-04-30","201904300CBJ"
"COL",0,0,1,1,0,2,0,2,0,2,0,4,"H","N","2019-04-30","201904300COL"
"SJS",0,2,0,2,0,4,0,0,1,1,0,2,"A","N","2019-04-30","201904300COL"
"CAR",0,1,1,3,0,5,0,1,1,0,0,2,"H","N","2019-05-01","201905010CAR"
"NYI",0,1,1,0,0,2,0,1,1,3,0,5,"A","N","2019-05-01","201905010CAR"
"DAL",0,2,2,0,0,4,0,1,0,1,0,2,"H","N","2019-05-01","201905010DAL"
"STL",0,1,0,1,0,2,0,2,2,0,0,4,"A","N","2019-05-01","201905010DAL"
"BOS",0,2,0,2,0,4,0,1,0,0,0,1,"A","N","2019-05-02","201905020CBJ"
"CBJ",0,1,0,0,0,1,0,2,0,2,0,4,"H","N","2019-05-02","201905020CBJ"
"COL",0,0,1,2,0,3,0,0,0,0,0,0,"H","N","2019-05-02","201905020COL"
"SJS",0,0,0,0,0,0,0,0,1,2,0,3,"A","N","2019-05-02","201905020COL"
"CAR",0,1,3,1,0,5,0,1,0,1,0,2,"H","N","2019-05-03","201905030CAR"
"NYI",0,1,0,1,0,2,0,1,3,1,0,5,"A","N","2019-05-03","201905030CAR"
"DAL",0,1,1,0,0,2,0,0,0,1,0,1,"A","N","2019-05-03","201905030STL"
"STL",0,0,0,1,0,1,0,1,1,0,0,2,"H","N","2019-05-03","201905030STL"
"BOS",0,0,1,3,0,4,0,0,0,3,0,3,"H","N","2019-05-04","201905040BOS"
"CBJ",0,0,0,3,0,3,0,0,1,3,0,4,"A","N","2019-05-04","201905040BOS"
"COL",0,0,1,0,0,1,0,0,1,1,0,2,"A","N","2019-05-04","201905040SJS"
"SJS",0,0,1,1,0,2,0,0,1,0,0,1,"H","N","2019-05-04","201905040SJS"
"DAL",0,1,0,0,0,1,0,1,1,2,0,4,"H","N","2019-05-05","201905050DAL"
"STL",0,1,1,2,0,4,0,1,0,0,0,1,"A","N","2019-05-05","201905050DAL"
"BOS",0,0,1,2,0,3,0,0,0,0,0,0,"A","N","2019-05-06","201905060CBJ"
"CBJ",0,0,0,0,0,0,0,0,1,2,0,3,"H","N","2019-05-06","201905060CBJ"
"COL",1,0,2,1,0,4,0,0,2,1,0,3,"H","N","2019-05-06","201905060COL"
"SJS",0,0,2,1,0,3,1,0,2,1,0,4,"A","N","2019-05-06","201905060COL"
"DAL",0,1,0,0,0,1,1,1,0,0,0,2,"A","N","2019-05-07","201905070STL"
"STL",1,1,0,0,0,2,0,1,0,0,0,1,"H","N","2019-05-07","201905070STL"
"COL",0,1,0,1,0,2,0,2,1,0,0,3,"A","N","2019-05-08","201905080SJS"
"SJS",0,2,1,0,0,3,0,1,0,1,0,2,"H","N","2019-05-08","201905080SJS"
"BOS",0,1,0,4,0,5,0,1,1,0,0,2,"H","N","2019-05-09","201905090BOS"
"CAR",0,1,1,0,0,2,0,1,0,4,0,5,"A","N","2019-05-09","201905090BOS"
"SJS",0,2,3,1,0,6,0,1,1,1,0,3,"H","N","2019-05-11","201905110SJS"
"STL",0,1,1,1,0,3,0,2,3,1,0,6,"A","N","2019-05-11","201905110SJS"
"BOS",0,2,2,2,0,6,0,0,0,2,0,2,"H","N","2019-05-12","201905120BOS"
"CAR",0,0,0,2,0,2,0,2,2,2,0,6,"A","N","2019-05-12","201905120BOS"
"SJS",0,0,2,0,0,2,0,1,2,1,0,4,"H","N","2019-05-13","201905130SJS"
"STL",0,1,2,1,0,4,0,0,2,0,0,2,"A","N","2019-05-13","201905130SJS"
"BOS",0,0,2,0,0,2,0,0,1,0,0,1,"A","N","2019-05-14","201905140CAR"
"CAR",0,0,1,0,0,1,0,0,2,0,0,2,"H","N","2019-05-14","201905140CAR"
"SJS",1,2,1,1,0,5,0,0,4,0,0,4,"A","N","2019-05-15","201905150STL"
"STL",0,0,4,0,0,4,1,2,1,1,0,5,"H","N","2019-05-15","201905150STL"
"BOS",0,0,2,2,0,4,0,0,0,0,0,0,"A","N","2019-05-16","201905160CAR"
"CAR",0,0,0,0,0,0,0,0,2,2,0,4,"H","N","2019-05-16","201905160CAR"
"SJS",0,0,0,1,0,1,0,2,0,0,0,2,"A","N","2019-05-17","201905170STL"
"STL",0,2,0,0,0,2,0,0,0,1,0,1,"H","N","2019-05-17","201905170STL"
"SJS",0,0,0,0,0,0,0,1,2,2,0,5,"H","N","2019-05-19","201905190SJS"
"STL",0,1,2,2,0,5,0,0,0,0,0,0,"A","N","2019-05-19","201905190SJS"
"SJS",0,0,1,0,0,1,0,2,1,2,0,5,"A","N","2019-05-21","201905210STL"
"STL",0,2,1,2,0,5,0,0,1,0,0,1,"H","N","2019-05-21","201905210STL"
"BOS",0,0,2,2,0,4,0,1,1,0,0,2,"H","N","2019-05-27","201905270BOS"
"STL",0,1,1,0,0,2,0,0,2,2,0,4,"A","N","2019-05-27","201905270BOS"
"BOS",0,2,0,0,0,2,1,2,0,0,0,3,"H","N","2019-05-29","201905290BOS"
"STL",1,2,0,0,0,3,0,2,0,0,0,2,"A","N","2019-05-29","201905290BOS"
"BOS",0,3,2,2,0,7,0,0,1,1,0,2,"A","N","2019-06-01","201906010STL"
"STL",0,0,1,1,0,2,0,3,2,2,0,7,"H","N","2019-06-01","201906010STL"
"BOS",0,1,1,0,0,2,0,2,0,2,0,4,"A","N","2019-06-03","201906030STL"
"STL",0,2,0,2,0,4,0,1,1,0,0,2,"H","N","2019-06-03","201906030STL"
"BOS",0,0,0,1,0,1,0,0,1,1,0,2,"H","N","2019-06-06","201906060BOS"
"STL",0,0,1,1,0,2,0,0,0,1,0,1,"A","N","2019-06-06","201906060BOS"
"BOS",0,1,0,4,0,5,0,0,0,1,0,1,"A","N","2019-06-09","201906090STL"
"STL",0,0,0,1,0,1,0,1,0,4,0,5,"H","N","2019-06-09","201906090STL"
"BOS",0,0,0,1,0,1,0,2,0,2,0,4,"H","N","2019-06-12","201906120BOS"
"STL",0,2,0,2,0,4,0,0,0,1,0,1,"A","N","2019-06-12","201906120BOS"
"EDM",0,1,0,2,0,3,0,0,1,1,0,2,"H","N","2019-10-02","201910020EDM"
"VAN",0,0,1,1,0,2,0,1,0,2,0,3,"A","N","2019-10-02","201910020EDM"
"STL",0,2,0,0,0,2,1,1,1,0,0,3,"H","N","2019-10-02","201910020STL"
"WSH",1,1,1,0,0,3,0,2,0,0,0,2,"A","N","2019-10-02","201910020STL"
"OTT",0,1,1,1,0,3,0,0,4,1,0,5,"A","N","2019-10-02","201910020TOR"
"TOR",0,0,4,1,0,5,0,1,1,1,0,3,"H","N","2019-10-02","201910020TOR"
"SJS",0,1,0,0,0,1,0,2,1,1,0,4,"A","N","2019-10-02","201910020VEG"
"VEG",0,2,1,1,0,4,0,1,0,0,0,1,"H","N","2019-10-02","201910020VEG"
"ANA",0,1,1,0,0,2,0,0,1,0,0,1,"H","N","2019-10-03","201910030ANA"
"ARI",0,0,1,0,0,1,0,1,1,0,0,2,"A","N","2019-10-03","201910030ANA"
"CAR",0,1,1,1,1,4,0,0,3,0,0,3,"H","Y","2019-10-03","201910030CAR"
"MTL",0,0,3,0,0,3,0,1,1,1,1,4,"A","Y","2019-10-03","201910030CAR"
"CGY",0,1,2,0,0,3,0,2,2,1,0,5,"A","N","2019-10-03","201910030COL"
"COL",0,2,2,1,0,5,0,1,2,0,0,3,"H","N","2019-10-03","201910030COL"
"BOS",0,2,0,0,0,2,0,0,1,0,0,1,"A","N","2019-10-03","201910030DAL"
"DAL",0,0,1,0,0,1,0,2,0,0,0,2,"H","N","2019-10-03","201910030DAL"
"MIN",0,0,2,0,0,2,0,0,1,4,0,5,"A","N","2019-10-03","201910030NSH"
"NSH",0,0,1,4,0,5,0,0,2,0,0,2,"H","N","2019-10-03","201910030NSH"
"NYR",0,1,2,3,0,6,0,1,2,1,0,4,"H","N","2019-10-03","201910030NYR"
"WPG",0,1,2,1,0,4,0,1,2,3,0,6,"A","N","2019-10-03","201910030NYR"
"BUF",0,1,2,0,0,3,0,0,1,0,0,1,"A","N","2019-10-03","201910030PIT"
"PIT",0,0,1,0,0,1,0,1,2,0,0,3,"H","N","2019-10-03","201910030PIT"
"FLA",0,0,1,1,0,2,0,1,1,3,0,5,"A","N","2019-10-03","201910030TBL"
"TBL",0,1,1,3,0,5,0,0,1,1,0,2,"H","N","2019-10-03","201910030TBL"
"CBJ",0,0,1,0,0,1,0,1,1,2,0,4,"H","N","2019-10-04","201910040CBJ"
"TOR",0,1,1,2,0,4,0,0,1,0,0,1,"A","N","2019-10-04","201910040CBJ"
"NJD",0,1,3,0,0,4,0,0,1,3,1,5,"H","Y","2019-10-04","201910040NJD"
"WPG",0,0,1,3,1,5,0,1,3,0,0,4,"A","Y","2019-10-04","201910040NJD"
"NYI",0,1,0,0,0,1,0,1,1,0,0,2,"H","N","2019-10-04","201910040NYI"
"WSH",0,1,1,0,0,2,0,1,0,0,0,1,"A","N","2019-10-04","201910040NYI"
"CHI",0,1,1,1,0,3,0,1,2,1,0,4,"A","N","2019-10-04","201910040PHI"
"PHI",0,1,2,1,0,4,0,1,1,1,0,3,"H","N","2019-10-04","201910040PHI"
"SJS",0,0,0,1,0,1,0,2,2,1,0,5,"H","N","2019-10-04","201910040SJS"
"VEG",0,2,2,1,0,5,0,0,0,1,0,1,"A","N","2019-10-04","201910040SJS"
"ANA",0,1,2,0,0,3,0,0,1,0,0,1,"H","N","2019-10-05","201910050ANA"
"SJS",0,0,1,0,0,1,0,1,2,0,0,3,"A","N","2019-10-05","201910050ANA"
"ARI",0,0,0,0,0,0,0,1,0,0,0,1,"H","N","2019-10-05","201910050ARI"
"BOS",0,1,0,0,0,1,0,0,0,0,0,0,"A","N","2019-10-05","201910050ARI"
"BUF",0,2,3,2,0,7,0,0,1,1,0,2,"H","N","2019-10-05","201910050BUF"
"NJD",0,0,1,1,0,2,0,2,3,2,0,7,"A","N","2019-10-05","201910050BUF"
"CGY",0,1,1,1,0,3,0,0,0,0,0,0,"H","N","2019-10-05","201910050CGY"
"VAN",0,0,0,0,0,0,0,1,1,1,0,3,"A","N","2019-10-05","201910050CGY"
"COL",0,2,1,1,0,4,0,1,1,0,0,2,"H","N","2019-10-05","201910050COL"
"MIN",0,1,1,0,0,2,0,2,1,1,0,4,"A","N","2019-10-05","201910050COL"
"EDM",0,2,1,3,0,6,0,3,0,2,0,5,"H","N","2019-10-05","201910050EDM"
"LAK",0,3,0,2,0,5,0,2,1,3,0,6,"A","N","2019-10-05","201910050EDM"
"FLA",0,0,3,1,0,4,0,0,1,2,0,3,"H","N","2019-10-05","201910050FLA"
"TBL",0,0,1,2,0,3,0,0,3,1,0,4,"A","N","2019-10-05","201910050FLA"
"DET",0,2,0,3,0,5,0,0,2,1,0,3,"A","N","2019-10-05","201910050NSH"
"NSH",0,0,2,1,0,3,0,2,0,3,0,5,"H","N","2019-10-05","201910050NSH"
"NYR",0,1,2,1,0,4,0,1,0,0,0,1,"A","N","2019-10-05","201910050OTT"
"OTT",0,1,0,0,0,1,0,1,2,1,0,4,"H","N","2019-10-05","201910050OTT"
"CBJ",0,0,1,1,0,2,0,0,5,2,0,7,"A","N","2019-10-05","201910050PIT"
"PIT",0,0,5,2,0,7,0,0,1,1,0,2,"H","N","2019-10-05","201910050PIT"
"DAL",0,1,1,0,0,2,0,1,0,2,0,3,"A","N","2019-10-05","201910050STL"
"STL",0,1,0,2,0,3,0,1,1,0,0,2,"H","N","2019-10-05","201910050STL"
"MTL",0,1,0,4,1,6,0,2,1,2,0,5,"A","Y","2019-10-05","201910050TOR"
"TOR",0,2,1,2,0,5,0,1,0,4,1,6,"H","Y","2019-10-05","201910050TOR"
"CAR",1,0,0,2,0,3,0,1,1,0,0,2,"A","N","2019-10-05","201910050WSH"
"WSH",0,1,1,0,0,2,1,0,0,2,0,3,"H","N","2019-10-05","201910050WSH"
"CAR",1,1,1,1,0,4,0,3,0,0,0,3,"H","N","2019-10-06","201910060CAR"
"TBL",0,3,0,0,0,3,1,1,1,1,0,4,"A","N","2019-10-06","201910060CAR"
"DAL",0,2,0,1,0,3,0,0,2,2,0,4,"A","N","2019-10-06","201910060DET"
"DET",0,0,2,2,0,4,0,2,0,1,0,3,"H","N","2019-10-06","201910060DET"
"NYI",0,0,3,1,0,4,0,0,1,0,0,1,"H","N","2019-10-06","201910060NYI"
"WPG",0,0,1,0,0,1,0,0,3,1,0,4,"A","N","2019-10-06","201910060NYI"
"BUF",0,0,2,1,0,3,1,2,0,1,0,4,"A","N","2019-10-07","201910070CBJ"
"CBJ",1,2,0,1,0,4,0,0,2,1,0,3,"H","N","2019-10-07","201910070CBJ"
"STL",0,0,2,1,0,3,0,0,2,0,0,2,"A","N","2019-10-07","201910070TOR"
"TOR",0,0,2,0,0,2,0,0,2,1,0,3,"H","N","2019-10-07","201910070TOR"
"CGY",0,0,2,1,0,3,1,2,1,0,0,4,"H","N","2019-10-08","201910080CGY"
"LAK",1,2,1,0,0,4,0,0,2,1,0,3,"A","N","2019-10-08","201910080CGY"
"ANA",0,0,0,3,0,3,0,0,1,0,0,1,"A","N","2019-10-08","201910080DET"
"DET",0,0,1,0,0,1,0,0,0,3,0,3,"H","N","2019-10-08","201910080DET"
"CAR",0,4,1,1,0,6,0,0,1,2,0,3,"A","N","2019-10-08","201910080FLA"
"FLA",0,0,1,2,0,3,0,4,1,1,0,6,"H","N","2019-10-08","201910080FLA"
"NSH",0,1,1,3,0,5,0,0,1,1,0,2,"H","N","2019-10-08","201910080NSH"
"SJS",0,0,1,1,0,2,0,1,1,3,0,5,"A","N","2019-10-08","201910080NSH"
"EDM",0,2,2,1,0,5,0,1,0,1,0,2,"A","N","2019-10-08","201910080NYI"
"NYI",0,1,0,1,0,2,0,2,2,1,0,5,"H","N","2019-10-08","201910080NYI"
"PIT",0,1,0,0,0,1,0,2,2,0,0,4,"H","N","2019-10-08","201910080PIT"
"WPG",0,2,2,0,0,4,0,1,0,0,0,1,"A","N","2019-10-08","201910080PIT"
"BOS",0,2,2,0,0,4,0,2,0,1,0,3,"A","N","2019-10-08","201910080VEG"
"VEG",0,2,0,1,0,3,0,2,2,0,0,4,"H","N","2019-10-08","201910080VEG"
"DAL",1,0,1,2,0,4,0,1,1,1,0,3,"A","N","2019-10-08","201910080WSH"
"WSH",0,1,1,1,0,3,1,0,1,2,0,4,"H","N","2019-10-08","201910080WSH"
"BUF",1,1,2,1,0,5,0,2,0,2,0,4,"H","N","2019-10-09","201910090BUF"
"MTL",0,2,0,2,0,4,1,1,2,1,0,5,"A","N","2019-10-09","201910090BUF"
"NJD",0,0,0,0,0,0,0,0,1,3,0,4,"A","N","2019-10-09","201910090PHI"
"PHI",0,0,1,3,0,4,0,0,0,0,0,0,"H","N","2019-10-09","201910090PHI"
"LAK",0,0,1,1,0,2,0,2,2,4,0,8,"A","N","2019-10-09","201910090VAN"
"VAN",0,2,2,4,0,8,0,0,1,1,0,2,"H","N","2019-10-09","201910090VAN"
"ARI",0,2,2,0,0,4,0,1,0,0,0,1,"H","N","2019-10-10","201910100ARI"
"VEG",0,1,0,0,0,1,0,2,2,0,0,4,"A","N","2019-10-10","201910100ARI"
"CHI",0,2,2,0,0,4,0,2,2,1,0,5,"H","N","2019-10-10","201910100CHI"
"SJS",0,2,2,1,0,5,0,2,2,0,0,4,"A","N","2019-10-10","201910100CHI"
"BOS",0,2,0,0,0,2,0,1,1,2,0,4,"A","N","2019-10-10","201910100COL"
"COL",0,1,1,2,0,4,0,2,0,0,0,2,"H","N","2019-10-10","201910100COL"
"CGY",0,0,0,2,1,3,0,0,1,1,0,2,"A","Y","2019-10-10","201910100DAL"
"DAL",0,0,1,1,0,2,0,0,0,2,1,3,"H","Y","2019-10-10","201910100DAL"
"DET",0,2,1,1,0,4,0,1,1,0,0,2,"A","N","2019-10-10","201910100MTL"
"MTL",0,1,1,0,0,2,0,2,1,1,0,4,"H","N","2019-10-10","201910100MTL"
"EDM",0,1,1,1,1,4,0,1,1,1,0,3,"A","Y","2019-10-10","201910100NJD"
"NJD",0,1,1,1,0,3,0,1,1,1,1,4,"H","Y","2019-10-10","201910100NJD"
"NSH",0,1,1,4,0,6,0,1,3,1,0,5,"H","N","2019-10-10","201910100NSH"
"WSH",0,1,3,1,0,5,0,1,1,4,0,6,"A","N","2019-10-10","201910100NSH"
"OTT",0,2,1,1,0,4,0,0,2,4,0,6,"H","N","2019-10-10","201910100OTT"
"STL",0,0,2,4,0,6,0,2,1,1,0,4,"A","N","2019-10-10","201910100OTT"
"ANA",0,0,1,0,0,1,0,0,1,1,0,2,"A","N","2019-10-10","201910100PIT"
"PIT",0,0,1,1,0,2,0,0,1,0,0,1,"H","N","2019-10-10","201910100PIT"
"TBL",0,4,1,2,0,7,0,3,0,0,0,3,"A","N","2019-10-10","201910100TOR"
"TOR",0,3,0,0,0,3,0,4,1,2,0,7,"H","N","2019-10-10","201910100TOR"
"MIN",0,1,0,1,0,2,0,0,2,3,0,5,"A","N","2019-10-10","201910100WPG"
"WPG",0,0,2,3,0,5,0,1,0,1,0,2,"H","N","2019-10-10","201910100WPG"
"BUF",0,0,1,1,1,3,0,0,0,2,0,2,"H","Y","2019-10-11","201910110BUF"
"FLA",0,0,0,2,0,2,0,0,1,1,1,3,"A","Y","2019-10-11","201910110BUF"
"CAR",0,2,2,1,0,5,0,1,1,0,0,2,"H","N","2019-10-11","201910110CAR"
"NYI",0,1,1,0,0,2,0,2,2,1,0,5,"A","N","2019-10-11","201910110CAR"
"ANA",0,0,2,0,0,2,0,0,1,0,0,1,"A","N","2019-10-11","201910110CBJ"
"CBJ",0,0,1,0,0,1,0,0,2,0,0,2,"H","N","2019-10-11","201910110CBJ"
"BOS",0,2,1,0,0,3,0,0,0,0,0,0,"H","N","2019-10-12","201910120BOS"
"NJD",0,0,0,0,0,0,0,2,1,0,0,3,"A","N","2019-10-12","201910120BOS"
"CAR",0,1,1,0,0,2,0,1,1,1,0,3,"H","N","2019-10-12","201910120CAR"
"CBJ",0,1,1,1,0,3,0,1,1,0,0,2,"A","N","2019-10-12","201910120CAR"
"CHI",0,2,0,0,0,2,1,0,1,1,0,3,"H","N","2019-10-12","201910120CHI"
"WPG",1,0,1,1,0,3,0,2,0,0,0,2,"A","N","2019-10-12","201910120CHI"
"ARI",0,0,0,2,0,2,1,0,0,2,0,3,"A","N","2019-10-12","201910120COL"
"COL",1,0,0,2,0,3,0,0,0,2,0,2,"H","N","2019-10-12","201910120COL"
"DAL",0,0,0,1,0,1,0,1,1,2,0,4,"H","N","2019-10-12","201910120DAL"
"WSH",0,1,1,2,0,4,0,0,0,1,0,1,"A","N","2019-10-12","201910120DAL"
"DET",0,1,0,1,0,2,0,1,1,3,0,5,"H","N","2019-10-12","201910120DET"
"TOR",0,1,1,3,0,5,0,1,0,1,0,2,"A","N","2019-10-12","201910120DET"
"LAK",0,2,2,3,0,7,0,1,0,3,0,4,"H","N","2019-10-12","201910120LAK"
"NSH",0,1,0,3,0,4,0,2,2,3,0,7,"A","N","2019-10-12","201910120LAK"
"MIN",0,0,2,2,0,4,0,1,4,2,0,7,"H","N","2019-10-12","201910120MIN"
"PIT",0,1,4,2,0,7,0,0,2,2,0,4,"A","N","2019-10-12","201910120MIN"
"MTL",0,2,1,3,0,6,0,1,2,0,0,3,"H","N","2019-10-12","201910120MTL"
"STL",0,1,2,0,0,3,0,2,1,3,0,6,"A","N","2019-10-12","201910120MTL"
"FLA",0,1,0,1,0,2,0,0,2,0,1,3,"A","Y","2019-10-12","201910120NYI"
"NYI",0,0,2,0,1,3,0,1,0,1,0,2,"H","Y","2019-10-12","201910120NYI"
"EDM",0,0,1,3,0,4,0,1,0,0,0,1,"A","N","2019-10-12","201910120NYR"
"NYR",0,1,0,0,0,1,0,0,1,3,0,4,"H","N","2019-10-12","201910120NYR"
"OTT",0,0,2,2,0,4,0,0,1,1,0,2,"H","N","2019-10-12","201910120OTT"
"TBL",0,0,1,1,0,2,0,0,2,2,0,4,"A","N","2019-10-12","201910120OTT"
"PHI",0,0,1,1,0,2,0,1,1,0,1,3,"A","Y","2019-10-12","201910120VAN"
"VAN",0,1,1,0,1,3,0,0,1,1,0,2,"H","Y","2019-10-12","201910120VAN"
"CGY",0,0,2,0,0,2,0,1,3,2,0,6,"A","N","2019-10-12","201910120VEG"
"VEG",0,1,3,2,0,6,0,0,2,0,0,2,"H","N","2019-10-12","201910120VEG"
"LAK",0,1,0,1,0,2,0,2,2,1,0,5,"H","N","2019-10-13","201910130LAK"
"VEG",0,2,2,1,0,5,0,1,0,1,0,2,"A","N","2019-10-13","201910130LAK"
"CGY",0,0,1,0,0,1,0,2,1,0,0,3,"A","N","2019-10-13","201910130SJS"
"SJS",0,2,1,0,0,3,0,0,1,0,0,1,"H","N","2019-10-13","201910130SJS"
"PIT",0,1,3,3,0,7,0,1,1,0,0,2,"A","N","2019-10-13","201910130WPG"
"WPG",0,1,1,0,0,2,0,1,3,3,0,7,"H","N","2019-10-13","201910130WPG"
"ANA",0,0,1,1,0,2,0,1,1,2,0,4,"A","N","2019-10-14","201910140BOS"
"BOS",0,1,1,2,0,4,0,0,1,1,0,2,"H","N","2019-10-14","201910140BOS"
"BUF",0,0,2,2,0,4,0,0,0,0,0,0,"H","N","2019-10-14","201910140BUF"
"DAL",0,0,0,0,0,0,0,0,2,2,0,4,"A","N","2019-10-14","201910140BUF"
"CHI",0,0,1,2,0,3,0,0,0,1,0,1,"H","N","2019-10-14","201910140CHI"
"EDM",0,0,0,1,0,1,0,0,1,2,0,3,"A","N","2019-10-14","201910140CHI"
"FLA",0,1,2,3,0,6,0,2,2,0,0,4,"A","N","2019-10-14","201910140NJD"
"NJD",0,2,2,0,0,4,0,1,2,3,0,6,"H","N","2019-10-14","201910140NJD"
"NYI",1,0,0,2,0,3,0,1,0,1,0,2,"H","N","2019-10-14","201910140NYI"
"STL",0,1,0,1,0,2,1,0,0,2,0,3,"A","N","2019-10-14","201910140NYI"
"MIN",0,0,0,2,0,2,0,0,0,0,0,0,"A","N","2019-10-14","201910140OTT"
"OTT",0,0,0,0,0,0,0,0,0,2,0,2,"H","N","2019-10-14","201910140OTT"
"COL",0,4,0,2,0,6,0,0,2,1,0,3,"A","N","2019-10-14","201910140WSH"
"WSH",0,0,2,1,0,3,0,4,0,2,0,6,"H","N","2019-10-14","201910140WSH"
"CGY",0,1,1,1,0,3,0,0,0,1,0,1,"H","N","2019-10-15","201910150CGY"
"PHI",0,0,0,1,0,1,0,1,1,1,0,3,"A","N","2019-10-15","201910150CGY"
"CAR",0,0,1,1,0,2,0,0,0,0,0,0,"A","N","2019-10-15","201910150LAK"
"LAK",0,0,0,0,0,0,0,0,1,1,0,2,"H","N","2019-10-15","201910150LAK"
"MTL",0,1,0,0,0,1,0,1,2,0,0,3,"H","N","2019-10-15","201910150MTL"
"TBL",0,1,2,0,0,3,0,1,0,0,0,1,"A","N","2019-10-15","201910150MTL"
"MIN",0,1,0,1,0,2,0,0,4,0,0,4,"A","N","2019-10-15","201910150TOR"
"TOR",0,0,4,0,0,4,0,1,0,1,0,2,"H","N","2019-10-15","201910150TOR"
"DET",0,1,0,0,0,1,0,1,3,1,0,5,"A","N","2019-10-15","201910150VAN"
"VAN",0,1,3,1,0,5,0,1,0,0,0,1,"H","N","2019-10-15","201910150VAN"
"NSH",0,1,3,1,0,5,0,2,0,0,0,2,"A","N","2019-10-15","201910150VEG"
"VEG",0,2,0,0,0,2,0,1,3,1,0,5,"H","N","2019-10-15","201910150VEG"
"ARI",0,1,3,0,0,4,0,1,0,1,0,2,"A","N","2019-10-15","201910150WPG"
"WPG",0,1,0,1,0,2,0,1,3,0,0,4,"H","N","2019-10-15","201910150WPG"
"ANA",0,1,3,1,0,5,0,2,0,0,0,2,"H","N","2019-10-16","201910160ANA"
"BUF",0,2,0,0,0,2,0,1,3,1,0,5,"A","N","2019-10-16","201910160ANA"
"CBJ",0,2,0,1,0,3,0,1,0,1,0,2,"H","N","2019-10-16","201910160CBJ"
"DAL",0,1,0,1,0,2,0,2,0,1,0,3,"A","N","2019-10-16","201910160CBJ"
"EDM",0,2,3,1,0,6,0,1,0,2,0,3,"H","N","2019-10-16","201910160EDM"
"PHI",0,1,0,2,0,3,0,2,3,1,0,6,"A","N","2019-10-16","201910160EDM"
"COL",0,1,0,1,0,2,1,1,1,0,0,3,"A","N","2019-10-16","201910160PIT"
"PIT",1,1,1,0,0,3,0,1,0,1,0,2,"H","N","2019-10-16","201910160PIT"
"CAR",0,1,0,1,0,2,0,3,1,1,0,5,"A","N","2019-10-16","201910160SJS"
"SJS",0,3,1,1,0,5,0,1,0,1,0,2,"H","N","2019-10-16","201910160SJS"
"TOR",0,2,0,1,0,3,0,1,3,0,0,4,"A","N","2019-10-16","201910160WSH"
"WSH",0,1,3,0,0,4,0,2,0,1,0,3,"H","N","2019-10-16","201910160WSH"
"ARI",0,2,1,2,0,5,0,0,1,1,0,2,"H","N","2019-10-17","201910170ARI"
"NSH",0,0,1,1,0,2,0,2,1,2,0,5,"A","N","2019-10-17","201910170ARI"
"BOS",0,1,1,1,0,3,0,1,1,1,1,4,"H","Y","2019-10-17","201910170BOS"
"TBL",0,1,1,1,1,4,0,1,1,1,0,3,"A","Y","2019-10-17","201910170BOS"
"CGY",0,1,1,3,0,5,0,0,1,0,0,1,"H","N","2019-10-17","201910170CGY"
"DET",0,0,1,0,0,1,0,1,1,3,0,5,"A","N","2019-10-17","201910170CGY"
"BUF",0,2,1,0,0,3,0,0,0,0,0,0,"A","N","2019-10-17","201910170LAK"
"LAK",0,0,0,0,0,0,0,2,1,0,0,3,"H","N","2019-10-17","201910170LAK"
"MIN",0,0,0,0,0,0,0,3,0,1,0,4,"A","N","2019-10-17","201910170MTL"
"MTL",0,3,0,1,0,4,0,0,0,0,0,0,"H","N","2019-10-17","201910170MTL"
"NJD",0,1,2,2,0,5,0,1,0,1,0,2,"H","N","2019-10-17","201910170NJD"
"NYR",0,1,0,1,0,2,0,1,2,2,0,5,"A","N","2019-10-17","201910170NJD"
"STL",0,1,2,0,0,3,0,0,2,1,1,4,"H","Y","2019-10-17","201910170STL"
"VAN",0,0,2,1,1,4,0,1,2,0,0,3,"A","Y","2019-10-17","201910170STL"
"OTT",0,1,0,1,0,2,0,2,0,0,1,3,"A","Y","2019-10-17","201910170VEG"
"VEG",0,2,0,0,1,3,0,1,0,1,0,2,"H","Y","2019-10-17","201910170VEG"
"NYI",0,0,2,1,0,3,0,1,0,0,0,1,"A","N","2019-10-17","201910170WPG"
"WPG",0,1,0,0,0,1,0,0,2,1,0,3,"H","N","2019-10-17","201910170WPG"
"ANA",0,2,2,0,0,4,0,0,2,0,0,2,"H","N","2019-10-18","201910180ANA"
"CAR",0,0,2,0,0,2,0,2,2,0,0,4,"A","N","2019-10-18","201910180ANA"
"CBJ",0,0,1,1,0,2,1,1,0,1,0,3,"A","N","2019-10-18","201910180CHI"
"CHI",1,1,0,1,0,3,0,0,1,1,0,2,"H","N","2019-10-18","201910180CHI"
"DET",0,0,1,0,0,1,0,0,2,0,0,2,"A","N","2019-10-18","201910180EDM"
"EDM",0,0,2,0,0,2,0,0,1,0,0,1,"H","N","2019-10-18","201910180EDM"
"COL",1,1,3,0,0,5,0,3,1,0,0,4,"A","N","2019-10-18","201910180FLA"
"FLA",0,3,1,0,0,4,1,1,3,0,0,5,"H","N","2019-10-18","201910180FLA"
"DAL",0,0,1,1,0,2,0,0,1,3,0,4,"A","N","2019-10-18","201910180PIT"
"PIT",0,0,1,3,0,4,0,0,1,1,0,2,"H","N","2019-10-18","201910180PIT"
"NYR",0,1,1,0,0,2,0,2,1,2,0,5,"A","N","2019-10-18","201910180WSH"
"WSH",0,2,1,2,0,5,0,1,1,0,0,2,"H","N","2019-10-18","201910180WSH"
"ARI",0,2,1,2,0,5,0,0,0,2,0,2,"H","N","2019-10-19","201910190ARI"
"OTT",0,0,0,2,0,2,0,2,1,2,0,5,"A","N","2019-10-19","201910190ARI"
"CBJ",0,1,1,0,0,2,1,2,0,0,0,3,"H","N","2019-10-19","201910190CBJ"
"NYI",1,2,0,0,0,3,0,1,1,0,0,2,"A","N","2019-10-19","201910190CBJ"
"CGY",0,0,0,1,0,1,0,1,3,0,0,4,"A","N","2019-10-19","201910190LAK"
"LAK",0,1,3,0,0,4,0,0,0,1,0,1,"H","N","2019-10-19","201910190LAK"
"NJD",0,1,0,0,0,1,0,0,0,0,0,0,"H","N","2019-10-19","201910190NJD"
"VAN",0,0,0,0,0,0,0,1,0,0,0,1,"A","N","2019-10-19","201910190NJD"
"FLA",0,0,2,0,1,3,0,0,0,2,0,2,"A","Y","2019-10-19","201910190NSH"
"NSH",0,0,0,2,0,2,0,0,2,0,1,3,"H","Y","2019-10-19","201910190NSH"
"DAL",0,2,0,2,0,4,0,1,0,0,0,1,"A","N","2019-10-19","201910190PHI"
"PHI",0,1,0,0,0,1,0,2,0,2,0,4,"H","N","2019-10-19","201910190PHI"
"PIT",0,0,0,0,0,0,0,0,1,2,0,3,"H","N","2019-10-19","201910190PIT"
"VEG",0,0,1,2,0,3,0,0,0,0,0,0,"A","N","2019-10-19","201910190PIT"
"BUF",0,1,1,2,0,4,0,1,0,2,0,3,"A","N","2019-10-19","201910190SJS"
"SJS",0,1,0,2,0,3,0,1,1,2,0,4,"H","N","2019-10-19","201910190SJS"
"MTL",0,1,3,1,0,5,0,1,0,1,0,2,"A","N","2019-10-19","201910190STL"
"STL",0,1,0,1,0,2,0,1,3,1,0,5,"H","N","2019-10-19","201910190STL"
"COL",0,1,3,2,0,6,0,1,0,1,0,2,"A","N","2019-10-19","201910190TBL"
"TBL",0,1,0,1,0,2,0,1,3,2,0,6,"H","N","2019-10-19","201910190TBL"
"BOS",0,1,0,2,0,3,1,2,0,1,0,4,"A","N","2019-10-19","201910190TOR"
"TOR",1,2,0,1,0,4,0,1,0,2,0,3,"H","N","2019-10-19","201910190TOR"
"ANA",0,0,1,0,0,1,0,0,1,1,0,2,"H","N","2019-10-20","201910200ANA"
"CGY",0,0,1,1,0,2,0,0,1,0,0,1,"A","N","2019-10-20","201910200ANA"
"CHI",0,0,1,2,0,3,0,1,1,3,0,5,"H","N","2019-10-20","201910200CHI"
"WSH",0,1,1,3,0,5,0,0,1,2,0,3,"A","N","2019-10-20","201910200CHI"
"MIN",0,1,1,2,0,4,0,0,2,1,0,3,"H","N","2019-10-20","201910200MIN"
"MTL",0,0,2,1,0,3,0,1,1,2,0,4,"A","N","2019-10-20","201910200MIN"
"NYR",0,0,1,1,0,2,0,3,0,0,0,3,"H","N","2019-10-20","201910200NYR"
"VAN",0,3,0,0,0,3,0,0,1,1,0,2,"A","N","2019-10-20","201910200NYR"
"EDM",0,0,0,0,0,0,0,0,0,0,1,1,"A","Y","2019-10-20","201910200WPG"
"WPG",0,0,0,0,1,1,0,0,0,0,0,0,"H","Y","2019-10-20","201910200WPG"
"DAL",0,1,1,0,0,2,0,0,0,1,0,1,"H","N","2019-10-21","201910210DAL"
"OTT",0,0,0,1,0,1,0,1,1,0,0,2,"A","N","2019-10-21","201910210DAL"
"PHI",0,1,4,1,0,6,0,0,0,2,0,2,"H","N","2019-10-21","201910210PHI"
"VEG",0,0,0,2,0,2,0,1,4,1,0,6,"A","N","2019-10-21","201910210PHI"
"COL",0,1,0,0,0,1,0,1,2,0,0,3,"A","N","2019-10-21","201910210STL"
"STL",0,1,2,0,0,3,0,1,0,0,0,1,"H","N","2019-10-21","201910210STL"
"CBJ",1,2,0,1,0,4,0,2,1,0,0,3,"A","N","2019-10-21","201910210TOR"
"TOR",0,2,1,0,0,3,1,2,0,1,0,4,"H","N","2019-10-21","201910210TOR"
"BOS",0,1,1,2,0,4,0,0,2,0,0,2,"H","N","2019-10-22","201910220BOS"
"TOR",0,0,2,0,0,2,0,1,1,2,0,4,"A","N","2019-10-22","201910220BOS"
"BUF",1,0,2,1,0,4,0,2,0,1,0,3,"H","N","2019-10-22","201910220BUF"
"SJS",0,2,0,1,0,3,1,0,2,1,0,4,"A","N","2019-10-22","201910220BUF"
"CGY",0,0,2,1,0,3,0,0,3,2,0,5,"H","N","2019-10-22","201910220CGY"
"WSH",0,0,3,2,0,5,0,0,2,1,0,3,"A","N","2019-10-22","201910220CGY"
"CHI",0,1,0,0,0,1,0,0,0,1,1,2,"H","Y","2019-10-22","201910220CHI"
"VEG",0,0,0,1,1,2,0,1,0,0,0,1,"A","Y","2019-10-22","201910220CHI"
"DET",0,1,1,0,0,2,0,0,0,5,0,5,"H","N","2019-10-22","201910220DET"
"VAN",0,0,0,5,0,5,0,1,1,0,0,2,"A","N","2019-10-22","201910220DET"
"FLA",0,0,2,2,0,4,0,0,1,1,0,2,"H","N","2019-10-22","201910220FLA"
"PIT",0,0,1,1,0,2,0,0,2,2,0,4,"A","N","2019-10-22","201910220FLA"
"EDM",0,0,0,0,0,0,0,3,0,0,0,3,"A","N","2019-10-22","201910220MIN"
"MIN",0,3,0,0,0,3,0,0,0,0,0,0,"H","N","2019-10-22","201910220MIN"
"ANA",0,0,0,1,0,1,0,2,2,2,0,6,"A","N","2019-10-22","201910220NSH"
"NSH",0,2,2,2,0,6,0,0,0,1,0,1,"H","N","2019-10-22","201910220NSH"
"ARI",1,1,1,0,0,3,0,0,2,0,0,2,"A","N","2019-10-22","201910220NYR"
"NYR",0,0,2,0,0,2,1,1,1,0,0,3,"H","N","2019-10-22","201910220NYR"
"LAK",0,1,1,1,0,3,0,1,1,0,0,2,"A","N","2019-10-22","201910220WPG"
"WPG",0,1,1,0,0,2,0,1,1,1,0,3,"H","N","2019-10-22","201910220WPG"
"DET",0,0,2,0,0,2,0,1,3,1,0,5,"A","N","2019-10-23","201910230OTT"
"OTT",0,1,3,1,0,5,0,0,2,0,0,2,"H","N","2019-10-23","201910230OTT"
"PIT",0,0,2,0,0,2,0,1,0,2,0,3,"A","N","2019-10-23","201910230TBL"
"TBL",0,1,0,2,0,3,0,0,2,0,0,2,"H","N","2019-10-23","201910230TBL"
"CAR",0,3,0,0,0,3,1,1,2,0,0,4,"A","N","2019-10-24","201910240CBJ"
"CBJ",1,1,2,0,0,4,0,3,0,0,0,3,"H","N","2019-10-24","201910240CBJ"
"CGY",0,1,1,3,1,6,0,0,2,3,0,5,"H","Y","2019-10-24","201910240CGY"
"FLA",0,0,2,3,0,5,0,1,1,3,1,6,"A","Y","2019-10-24","201910240CGY"
"CHI",0,0,0,1,0,1,0,1,1,2,0,4,"H","N","2019-10-24","201910240CHI"
"PHI",0,1,1,2,0,4,0,0,0,1,0,1,"A","N","2019-10-24","201910240CHI"
"ANA",0,0,1,0,0,1,0,2,0,0,0,2,"A","N","2019-10-24","201910240DAL"
"DAL",0,2,0,0,0,2,0,0,1,0,0,1,"H","N","2019-10-24","201910240DAL"
"EDM",1,1,0,2,0,4,0,0,3,0,0,3,"H","N","2019-10-24","201910240EDM"
"WSH",0,0,3,0,0,3,1,1,0,2,0,4,"A","N","2019-10-24","201910240EDM"
"MTL",0,1,1,0,0,2,0,1,3,0,0,4,"H","N","2019-10-24","201910240MTL"
"SJS",0,1,3,0,0,4,0,1,1,0,0,2,"A","N","2019-10-24","201910240MTL"
"MIN",0,0,0,0,0,0,0,0,2,2,0,4,"A","N","2019-10-24","201910240NSH"
"NSH",0,0,2,2,0,4,0,0,0,0,0,0,"H","N","2019-10-24","201910240NSH"
"ARI",0,1,0,1,0,2,0,1,1,2,0,4,"A","N","2019-10-24","201910240NYI"
"NYI",0,1,1,2,0,4,0,1,0,1,0,2,"H","N","2019-10-24","201910240NYI"
"BUF",0,0,2,0,0,2,0,3,1,2,0,6,"A","N","2019-10-24","201910240NYR"
"NYR",0,3,1,2,0,6,0,0,2,0,0,2,"H","N","2019-10-24","201910240NYR"
"LAK",0,1,1,0,0,2,0,1,2,2,0,5,"A","N","2019-10-24","201910240STL"
"STL",0,1,2,2,0,5,0,1,1,0,0,2,"H","N","2019-10-24","201910240STL"
"BUF",0,0,1,1,0,2,0,0,0,0,0,0,"A","N","2019-10-25","201910250DET"
"DET",0,0,0,0,0,0,0,0,1,1,0,2,"H","N","2019-10-25","201910250DET"
"ARI",0,1,2,2,0,5,0,2,1,0,0,3,"A","N","2019-10-25","201910250NJD"
"NJD",0,2,1,0,0,3,0,1,2,2,0,5,"H","N","2019-10-25","201910250NJD"
"NYI",0,2,2,0,0,4,0,1,0,1,0,2,"A","N","2019-10-25","201910250OTT"
"OTT",0,1,0,1,0,2,0,2,2,0,0,4,"H","N","2019-10-25","201910250OTT"
"SJS",0,1,0,0,0,1,0,0,1,3,0,4,"A","N","2019-10-25","201910250TOR"
"TOR",0,0,1,3,0,4,0,1,0,0,0,1,"H","N","2019-10-25","201910250TOR"
"VAN",0,2,3,0,0,5,0,1,1,3,1,6,"H","Y","2019-10-25","201910250VAN"
"WSH",0,1,1,3,1,6,0,2,3,0,0,5,"A","Y","2019-10-25","201910250VAN"
"COL",0,2,3,1,0,6,0,1,0,0,0,1,"A","N","2019-10-25","201910250VEG"
"VEG",0,1,0,0,0,1,0,2,3,1,0,6,"H","N","2019-10-25","201910250VEG"
"BOS",0,1,1,1,0,3,0,0,0,0,0,0,"H","N","2019-10-26","201910260BOS"
"STL",0,0,0,0,0,0,0,1,1,1,0,3,"A","N","2019-10-26","201910260BOS"
"CAR",0,1,1,2,0,4,0,0,0,0,0,0,"H","N","2019-10-26","201910260CAR"
"CHI",0,0,0,0,0,0,0,1,1,2,0,4,"A","N","2019-10-26","201910260CAR"
"ANA",0,2,1,2,0,5,0,0,1,1,0,2,"A","N","2019-10-26","201910260COL"
"COL",0,0,1,1,0,2,0,2,1,2,0,5,"H","N","2019-10-26","201910260COL"
"DAL",0,0,0,0,0,0,0,0,0,3,0,3,"H","N","2019-10-26","201910260DAL"
"PIT",0,0,0,3,0,3,0,0,0,0,0,0,"A","N","2019-10-26","201910260DAL"
"LAK",0,0,1,0,0,1,0,1,1,3,0,5,"A","N","2019-10-26","201910260MIN"
"MIN",0,1,1,3,0,5,0,0,1,0,0,1,"H","N","2019-10-26","201910260MIN"
"MTL",0,2,0,3,0,5,0,1,1,0,0,2,"H","N","2019-10-26","201910260MTL"
"TOR",0,1,1,0,0,2,0,2,0,3,0,5,"A","N","2019-10-26","201910260MTL"
"CBJ",0,1,2,1,0,4,0,1,1,5,0,7,"A","N","2019-10-26","201910260PHI"
"PHI",0,1,1,5,0,7,0,1,2,1,0,4,"H","N","2019-10-26","201910260PHI"
"NSH",1,1,0,1,0,3,0,0,2,0,0,2,"A","N","2019-10-26","201910260TBL"
"TBL",0,0,2,0,0,2,1,1,0,1,0,3,"H","N","2019-10-26","201910260TBL"
"CGY",0,0,1,0,0,1,1,0,0,1,0,2,"A","N","2019-10-26","201910260WPG"
"WPG",1,0,0,1,0,2,0,0,1,0,0,1,"H","N","2019-10-26","201910260WPG"
"CHI",0,1,3,1,0,5,0,0,0,1,0,1,"H","N","2019-10-27","201910270CHI"
"LAK",0,0,0,1,0,1,0,1,3,1,0,5,"A","N","2019-10-27","201910270CHI"
"DET",0,0,1,3,0,4,1,2,1,1,0,5,"H","N","2019-10-27","201910270DET"
"STL",1,2,1,1,0,5,0,0,1,3,0,4,"A","N","2019-10-27","201910270DET"
"EDM",0,0,0,2,0,2,0,0,3,3,0,6,"H","N","2019-10-27","201910270EDM"
"FLA",0,0,3,3,0,6,0,0,0,2,0,2,"A","N","2019-10-27","201910270EDM"
"NYI",0,3,2,0,0,5,0,2,0,1,0,3,"H","N","2019-10-27","201910270NYI"
"PHI",0,2,0,1,0,3,0,3,2,0,0,5,"A","N","2019-10-27","201910270NYI"
"BOS",0,0,4,3,0,7,0,1,0,3,0,4,"A","N","2019-10-27","201910270NYR"
"NYR",0,1,0,3,0,4,0,0,4,3,0,7,"H","N","2019-10-27","201910270NYR"
"OTT",0,2,2,1,0,5,0,1,1,0,0,2,"H","N","2019-10-27","201910270OTT"
"SJS",0,1,1,0,0,2,0,2,2,1,0,5,"A","N","2019-10-27","201910270OTT"
"ANA",0,1,0,1,0,2,0,3,1,1,0,5,"A","N","2019-10-27","201910270VEG"
"VEG",0,3,1,1,0,5,0,1,0,1,0,2,"H","N","2019-10-27","201910270VEG"
"ARI",0,1,1,0,1,3,0,2,0,0,0,2,"A","Y","2019-10-28","201910280BUF"
"BUF",0,2,0,0,0,2,0,1,1,0,1,3,"H","Y","2019-10-28","201910280BUF"
"FLA",0,1,1,0,0,2,0,5,1,1,0,7,"A","N","2019-10-28","201910280VAN"
"VAN",0,5,1,1,0,7,0,1,1,0,0,2,"H","N","2019-10-28","201910280VAN"
"ANA",0,1,4,2,0,7,0,2,1,1,0,4,"H","N","2019-10-29","201910290ANA"
"WPG",0,2,1,1,0,4,0,1,4,2,0,7,"A","N","2019-10-29","201910290ANA"
"BOS",0,2,3,0,0,5,0,0,1,0,0,1,"H","N","2019-10-29","201910290BOS"
"SJS",0,0,1,0,0,1,0,2,3,0,0,5,"A","N","2019-10-29","201910290BOS"
"CAR",0,0,0,2,0,2,0,1,0,0,0,1,"H","N","2019-10-29","201910290CAR"
"CGY",0,1,0,0,0,1,0,0,0,2,0,2,"A","N","2019-10-29","201910290CAR"
"DAL",0,0,1,5,0,6,0,2,1,0,0,3,"H","N","2019-10-29","201910290DAL"
"MIN",0,2,1,0,0,3,0,0,1,5,0,6,"A","N","2019-10-29","201910290DAL"
"DET",0,2,0,1,0,3,0,0,0,1,0,1,"H","N","2019-10-29","201910290DET"
"EDM",0,0,0,1,0,1,0,2,0,1,0,3,"A","N","2019-10-29","201910290DET"
"CHI",0,0,0,0,0,0,0,1,1,1,0,3,"A","N","2019-10-29","201910290NSH"
"NSH",0,1,1,1,0,3,0,0,0,0,0,0,"H","N","2019-10-29","201910290NSH"
"NYR",0,0,1,3,0,4,0,1,0,0,0,1,"H","N","2019-10-29","201910290NYR"
"TBL",0,1,0,0,0,1,0,0,1,3,0,4,"A","N","2019-10-29","201910290NYR"
"PHI",0,0,0,1,0,1,0,4,2,1,0,7,"A","N","2019-10-29","201910290PIT"
"PIT",0,4,2,1,0,7,0,0,0,1,0,1,"H","N","2019-10-29","201910290PIT"
"TOR",0,1,1,1,0,3,1,1,1,1,0,4,"H","N","2019-10-29","201910290TOR"
"WSH",1,1,1,1,0,4,0,1,1,1,0,3,"A","N","2019-10-29","201910290TOR"
"ARI",0,0,0,1,0,1,0,1,1,2,0,4,"H","N","2019-10-30","201910300ARI"
"MTL",0,1,1,2,0,4,0,0,0,1,0,1,"A","N","2019-10-30","201910300ARI"
"CBJ",0,0,1,0,0,1,0,2,2,0,0,4,"H","N","2019-10-30","201910300CBJ"
"EDM",0,2,2,0,0,4,0,0,1,0,0,1,"A","N","2019-10-30","201910300CBJ"
"COL",0,2,0,1,0,3,1,1,0,2,0,4,"H","N","2019-10-30","201910300COL"
"FLA",1,1,0,2,0,4,0,2,0,1,0,3,"A","N","2019-10-30","201910300COL"
"LAK",0,1,1,1,0,3,0,2,1,2,0,5,"H","N","2019-10-30","201910300LAK"
"VAN",0,2,1,2,0,5,0,1,1,1,0,3,"A","N","2019-10-30","201910300LAK"
"NJD",0,1,3,2,0,6,1,2,1,3,0,7,"H","N","2019-10-30","201910300NJD"
"TBL",1,2,1,3,0,7,0,1,3,2,0,6,"A","N","2019-10-30","201910300NJD"
"MIN",0,0,1,0,0,1,0,0,1,1,0,2,"A","N","2019-10-30","201910300STL"
"STL",0,0,1,1,0,2,0,0,1,0,0,1,"H","N","2019-10-30","201910300STL"
"CGY",1,1,0,4,0,6,0,2,2,1,0,5,"A","N","2019-10-31","201910310NSH"
"NSH",0,2,2,1,0,5,1,1,0,4,0,6,"H","N","2019-10-31","201910310NSH"
"MTL",1,1,1,2,0,5,0,2,0,2,0,4,"A","N","2019-10-31","201910310VEG"
"VEG",0,2,0,2,0,4,1,1,1,2,0,5,"H","N","2019-10-31","201910310VEG"
"ANA",1,1,0,0,0,2,0,0,0,1,0,1,"H","N","2019-11-01","201911010ANA"
"VAN",0,0,0,1,0,1,1,1,0,0,0,2,"A","N","2019-11-01","201911010ANA"
"CAR",0,1,4,2,0,7,0,1,2,0,0,3,"H","N","2019-11-01","201911010CAR"
"DET",0,1,2,0,0,3,0,1,4,2,0,7,"A","N","2019-11-01","201911010CAR"
"COL",0,0,1,0,0,1,0,1,1,0,0,2,"H","N","2019-11-01","201911010COL"
"DAL",0,1,1,0,0,2,0,0,1,0,0,1,"A","N","2019-11-01","201911010COL"
"NJD",0,1,1,1,0,3,0,1,1,1,1,4,"H","Y","2019-11-01","201911010NJD"
"PHI",0,1,1,1,1,4,0,1,1,1,0,3,"A","Y","2019-11-01","201911010NJD"
"NYI",0,0,2,3,0,5,0,0,1,1,0,2,"H","N","2019-11-01","201911010NYI"
"TBL",0,0,1,1,0,2,0,0,2,3,0,5,"A","N","2019-11-01","201911010NYI"
"SJS",0,0,1,1,0,2,0,1,1,1,0,3,"H","N","2019-11-01","201911010SJS"
"WPG",0,1,1,1,0,3,0,0,1,1,0,2,"A","N","2019-11-01","201911010SJS"
"CBJ",0,1,2,0,0,3,1,1,2,0,0,4,"A","N","2019-11-01","201911010STL"
"STL",1,1,2,0,0,4,0,1,2,0,0,3,"H","N","2019-11-01","201911010STL"
"BUF",0,0,1,0,0,1,0,4,1,1,0,6,"A","N","2019-11-01","201911010WSH"
"WSH",0,4,1,1,0,6,0,0,1,0,0,1,"H","N","2019-11-01","201911010WSH"
"ARI",0,2,1,0,0,3,0,0,0,0,0,0,"H","N","2019-11-02","201911020ARI"
"COL",0,0,0,0,0,0,0,2,1,0,0,3,"A","N","2019-11-02","201911020ARI"
"BOS",0,1,1,3,0,5,0,1,1,0,0,2,"H","N","2019-11-02","201911020BOS"
"OTT",0,1,1,0,0,2,0,1,1,3,0,5,"A","N","2019-11-02","201911020BOS"
"BUF",0,0,0,0,0,0,0,1,0,0,0,1,"H","N","2019-11-02","201911020BUF"
"NYI",0,1,0,0,0,1,0,0,0,0,0,0,"A","N","2019-11-02","201911020BUF"
"CAR",0,2,1,0,0,3,0,2,1,2,0,5,"H","N","2019-11-02","201911020CAR"
"NJD",0,2,1,2,0,5,0,2,1,0,0,3,"A","N","2019-11-02","201911020CAR"
"CBJ",0,0,0,0,0,0,0,1,1,1,0,3,"H","N","2019-11-02","201911020CBJ"
"CGY",0,1,1,1,0,3,0,0,0,0,0,0,"A","N","2019-11-02","201911020CBJ"
"DAL",0,1,1,2,0,4,0,0,0,1,0,1,"H","N","2019-11-02","201911020DAL"
"MTL",0,0,0,1,0,1,0,1,1,2,0,4,"A","N","2019-11-02","201911020DAL"
"DET",0,0,0,0,0,0,0,2,1,1,0,4,"A","N","2019-11-02","201911020FLA"
"FLA",0,2,1,1,0,4,0,0,0,0,0,0,"H","N","2019-11-02","201911020FLA"
"CHI",0,2,0,1,0,3,1,2,0,1,0,4,"A","N","2019-11-02","201911020LAK"
"LAK",1,2,0,1,0,4,0,2,0,1,0,3,"H","N","2019-11-02","201911020LAK"
"MIN",0,1,2,0,0,3,1,2,0,1,0,4,"H","N","2019-11-02","201911020MIN"
"STL",1,2,0,1,0,4,0,1,2,0,0,3,"A","N","2019-11-02","201911020MIN"
"NSH",0,0,1,0,0,1,0,1,1,0,0,2,"H","N","2019-11-02","201911020NSH"
"NYR",0,1,1,0,0,2,0,0,1,0,0,1,"A","N","2019-11-02","201911020NSH"
"PHI",0,1,1,1,0,3,0,1,1,1,1,4,"H","Y","2019-11-02","201911020PHI"
"TOR",0,1,1,1,1,4,0,1,1,1,0,3,"A","Y","2019-11-02","201911020PHI"
"EDM",1,0,1,0,0,2,0,0,0,1,0,1,"A","N","2019-11-02","201911020PIT"
"PIT",0,0,0,1,0,1,1,0,1,0,0,2,"H","N","2019-11-02","201911020PIT"
"SJS",0,0,0,2,0,2,0,2,2,1,0,5,"H","N","2019-11-02","201911020SJS"
"VAN",0,2,2,1,0,5,0,0,0,2,0,2,"A","N","2019-11-02","201911020SJS"
"VEG",0,3,0,0,0,3,1,1,0,2,0,4,"H","N","2019-11-02","201911020VEG"
"WPG",1,1,0,2,0,4,0,3,0,0,0,3,"A","N","2019-11-02","201911020VEG"
"ANA",0,0,1,1,0,2,1,2,0,0,0,3,"H","N","2019-11-03","201911030ANA"
"CHI",1,2,0,0,0,3,0,0,1,1,0,2,"A","N","2019-11-03","201911030ANA"
"CGY",0,2,0,0,0,2,0,2,1,1,0,4,"A","N","2019-11-03","201911030WSH"
"WSH",0,2,1,1,0,4,0,2,0,0,0,2,"H","N","2019-11-03","201911030WSH"
"BOS",0,2,1,3,0,6,0,0,4,0,0,4,"H","N","2019-11-04","201911040BOS"
"PIT",0,0,4,0,0,4,0,2,1,3,0,6,"A","N","2019-11-04","201911040BOS"
"DET",0,1,0,0,0,1,0,0,5,1,0,6,"H","N","2019-11-04","201911040DET"
"NSH",0,0,5,1,0,6,0,1,0,0,0,1,"A","N","2019-11-04","201911040DET"
"ARI",1,1,1,0,0,3,0,1,0,1,0,2,"A","N","2019-11-04","201911040EDM"
"EDM",0,1,0,1,0,2,1,1,1,0,0,3,"H","N","2019-11-04","201911040EDM"
"NYR",0,1,1,0,0,2,0,2,3,1,0,6,"H","N","2019-11-04","201911040NYR"
"OTT",0,2,3,1,0,6,0,1,1,0,0,2,"A","N","2019-11-04","201911040NYR"
"ANA",0,0,2,0,0,2,0,0,1,3,0,4,"H","N","2019-11-05","201911050ANA"
"MIN",0,0,1,3,0,4,0,0,2,0,0,2,"A","N","2019-11-05","201911050ANA"
"CBJ",0,0,1,0,0,1,0,1,1,0,0,2,"H","N","2019-11-05","201911050CBJ"
"VEG",0,1,1,0,0,2,0,0,1,0,0,1,"A","N","2019-11-05","201911050CBJ"
"ARI",0,1,1,1,0,3,1,0,1,2,0,4,"A","N","2019-11-05","201911050CGY"
"CGY",1,0,1,2,0,4,0,1,1,1,0,3,"H","N","2019-11-05","201911050CGY"
"COL",0,1,0,0,0,1,0,2,1,1,0,4,"A","N","2019-11-05","201911050DAL"
"DAL",0,2,1,1,0,4,0,1,0,0,0,1,"H","N","2019-11-05","201911050DAL"
"BOS",0,1,2,1,0,4,0,3,1,1,0,5,"A","N","2019-11-05","201911050MTL"
"MTL",0,3,1,1,0,5,0,1,2,1,0,4,"H","N","2019-11-05","201911050MTL"
"NYI",0,1,1,2,0,4,0,1,0,0,0,1,"H","N","2019-11-05","201911050NYI"
"OTT",0,1,0,0,0,1,0,1,1,2,0,4,"A","N","2019-11-05","201911050NYI"
"CAR",0,0,1,0,0,1,0,1,0,3,0,4,"A","N","2019-11-05","201911050PHI"
"PHI",0,1,0,3,0,4,0,0,1,0,0,1,"H","N","2019-11-05","201911050PHI"
"CHI",0,0,0,2,0,2,0,0,2,2,0,4,"A","N","2019-11-05","201911050SJS"
"SJS",0,0,2,2,0,4,0,0,0,2,0,2,"H","N","2019-11-05","201911050SJS"
"LAK",0,0,1,0,0,1,0,0,1,2,0,3,"A","N","2019-11-05","201911050TOR"
"TOR",0,0,1,2,0,3,0,0,1,0,0,1,"H","N","2019-11-05","201911050TOR"
"STL",1,0,1,0,0,2,0,0,0,1,0,1,"A","N","2019-11-05","201911050VAN"
"VAN",0,0,0,1,0,1,1,0,1,0,0,2,"H","N","2019-11-05","201911050VAN"
"NJD",0,1,0,0,1,2,0,0,1,0,0,1,"A","Y","2019-11-05","201911050WPG"
"WPG",0,0,1,0,0,1,0,1,0,0,1,2,"H","Y","2019-11-05","201911050WPG"
"EDM",0,1,0,1,0,2,0,1,2,2,0,5,"H","N","2019-11-06","201911060EDM"
"STL",0,1,2,2,0,5,0,1,0,1,0,2,"A","N","2019-11-06","201911060EDM"
"DET",0,0,1,0,0,1,0,0,3,2,0,5,"A","N","2019-11-06","201911060NYR"
"NYR",0,0,3,2,0,5,0,0,1,0,0,1,"H","N","2019-11-06","201911060NYR"
"ARI",0,1,1,0,0,2,0,1,1,1,0,3,"H","N","2019-11-07","201911070ARI"
"CBJ",0,1,1,1,0,3,0,1,1,0,0,2,"A","N","2019-11-07","201911070ARI"
"CAR",0,0,1,1,0,2,0,1,1,2,0,4,"H","N","2019-11-07","201911070CAR"
"NYR",0,1,1,2,0,4,0,0,1,1,0,2,"A","N","2019-11-07","201911070CAR"
"CGY",0,0,4,1,0,5,0,1,1,0,0,2,"H","N","2019-11-07","201911070CGY"
"NJD",0,1,1,0,0,2,0,0,4,1,0,5,"A","N","2019-11-07","201911070CGY"
"CHI",0,2,0,3,0,5,0,0,1,1,0,2,"H","N","2019-11-07","201911070CHI"
"VAN",0,0,1,1,0,2,0,2,0,3,0,5,"A","N","2019-11-07","201911070CHI"
"COL",0,2,6,1,0,9,0,1,2,1,0,4,"H","N","2019-11-07","201911070COL"
"NSH",0,1,2,1,0,4,0,2,6,1,0,9,"A","N","2019-11-07","201911070COL"
"FLA",0,2,2,0,0,4,1,1,2,1,0,5,"H","N","2019-11-07","201911070FLA"
"WSH",1,1,2,1,0,5,0,2,2,0,0,4,"A","N","2019-11-07","201911070FLA"
"NYI",0,1,2,0,0,3,1,0,0,3,0,4,"H","N","2019-11-07","201911070NYI"
"PIT",1,0,0,3,0,4,0,1,2,0,0,3,"A","N","2019-11-07","201911070NYI"
"LAK",0,0,1,1,0,2,1,0,1,1,0,3,"A","N","2019-11-07","201911070OTT"
"OTT",1,0,1,1,0,3,0,0,1,1,0,2,"H","N","2019-11-07","201911070OTT"
"MTL",0,0,1,1,0,2,1,1,1,0,0,3,"A","N","2019-11-07","201911070PHI"
"PHI",1,1,1,0,0,3,0,0,1,1,0,2,"H","N","2019-11-07","201911070PHI"
"MIN",0,0,2,3,0,5,0,4,2,0,0,6,"A","N","2019-11-07","201911070SJS"
"SJS",0,4,2,0,0,6,0,0,2,3,0,5,"H","N","2019-11-07","201911070SJS"
"TOR",1,0,0,1,0,2,0,0,0,1,0,1,"H","N","2019-11-07","201911070TOR"
"VEG",0,0,0,1,0,1,1,0,0,1,0,2,"A","N","2019-11-07","201911070TOR"
"BUF",0,0,1,1,0,2,0,2,0,1,0,3,"H","N","2019-11-08","201911080BUF"
"TBL",0,2,0,1,0,3,0,0,1,1,0,2,"A","N","2019-11-08","201911080BUF"
"BOS",0,1,1,0,0,2,0,2,1,1,0,4,"A","N","2019-11-08","201911080DET"
"DET",0,2,1,1,0,4,0,1,1,0,0,2,"H","N","2019-11-08","201911080DET"
"EDM",0,0,3,1,0,4,0,0,0,0,0,0,"H","N","2019-11-08","201911080EDM"
"NJD",0,0,0,0,0,0,0,0,3,1,0,4,"A","N","2019-11-08","201911080EDM"
"VAN",0,0,1,0,0,1,0,0,2,2,0,4,"A","N","2019-11-08","201911080WPG"
"WPG",0,0,2,2,0,4,0,0,1,0,0,1,"H","N","2019-11-08","201911080WPG"
"ARI",0,2,1,0,0,3,0,0,3,1,0,4,"H","N","2019-11-09","201911090ARI"
"MIN",0,0,3,1,0,4,0,2,1,0,0,3,"A","N","2019-11-09","201911090ARI"
"CGY",0,0,0,2,0,2,1,1,1,0,0,3,"H","N","2019-11-09","201911090CGY"
"STL",1,1,1,0,0,3,0,0,0,2,0,2,"A","N","2019-11-09","201911090CGY"
"CBJ",0,2,0,0,0,2,0,1,2,1,0,4,"A","N","2019-11-09","201911090COL"
"COL",0,1,2,1,0,4,0,2,0,0,0,2,"H","N","2019-11-09","201911090COL"
"LAK",0,0,1,1,0,2,0,3,0,0,0,3,"A","N","2019-11-09","201911090MTL"
"MTL",0,3,0,0,0,3,0,0,1,1,0,2,"H","N","2019-11-09","201911090MTL"
"FLA",0,0,0,1,0,1,0,1,0,1,0,2,"A","N","2019-11-09","201911090NYI"
"NYI",0,1,0,1,0,2,0,0,0,1,0,1,"H","N","2019-11-09","201911090NYI"
"CAR",0,0,1,0,0,1,0,3,0,1,0,4,"A","N","2019-11-09","201911090OTT"
"OTT",0,3,0,1,0,4,0,0,1,0,0,1,"H","N","2019-11-09","201911090OTT"
"CHI",0,0,2,0,0,2,0,0,1,1,1,3,"A","Y","2019-11-09","201911090PIT"
"PIT",0,0,1,1,1,3,0,0,2,0,0,2,"H","Y","2019-11-09","201911090PIT"
"NSH",0,0,1,0,0,1,0,0,0,1,1,2,"A","Y","2019-11-09","201911090SJS"
"SJS",0,0,0,1,1,2,0,0,1,0,0,1,"H","Y","2019-11-09","201911090SJS"
"BUF",0,1,0,2,0,3,0,1,2,2,0,5,"A","N","2019-11-09","201911090TBL"
"TBL",0,1,2,2,0,5,0,1,0,2,0,3,"H","N","2019-11-09","201911090TBL"
"PHI",0,2,0,0,1,3,0,0,1,1,0,2,"A","Y","2019-11-09","201911090TOR"
"TOR",0,0,1,1,0,2,0,2,0,0,1,3,"H","Y","2019-11-09","201911090TOR"
"VEG",0,1,1,0,0,2,0,2,1,2,0,5,"A","N","2019-11-09","201911090WSH"
"WSH",0,2,1,2,0,5,0,1,1,0,0,2,"H","N","2019-11-09","201911090WSH"
"ANA",0,1,0,1,0,2,0,2,2,2,0,6,"H","N","2019-11-10","201911100ANA"
"EDM",0,2,2,2,0,6,0,1,0,1,0,2,"A","N","2019-11-10","201911100ANA"
"BOS",0,0,0,2,0,2,0,2,0,0,1,3,"H","Y","2019-11-10","201911100BOS"
"PHI",0,2,0,0,1,3,0,0,0,2,0,2,"A","Y","2019-11-10","201911100BOS"
"CHI",0,4,0,1,0,5,0,1,0,3,0,4,"H","N","2019-11-10","201911100CHI"
"TOR",0,1,0,3,0,4,0,4,0,1,0,5,"A","N","2019-11-10","201911100CHI"
"DET",0,1,0,2,0,3,0,1,1,0,0,2,"H","N","2019-11-10","201911100DET"
"VEG",0,1,1,0,0,2,0,1,0,2,0,3,"A","N","2019-11-10","201911100DET"
"FLA",0,2,2,1,1,6,0,1,4,0,0,5,"A","Y","2019-11-10","201911100NYR"
"NYR",0,1,4,0,0,5,0,2,2,1,1,6,"H","Y","2019-11-10","201911100NYR"
"NJD",0,2,0,0,0,2,0,0,1,0,0,1,"A","N","2019-11-10","201911100VAN"
"VAN",0,0,1,0,0,1,0,2,0,0,0,2,"H","N","2019-11-10","201911100VAN"
"DAL",0,0,2,0,0,2,1,1,0,1,0,3,"A","N","2019-11-10","201911100WPG"
"WPG",1,1,0,1,0,3,0,0,2,0,0,2,"H","N","2019-11-10","201911100WPG"
"CAR",0,2,3,3,0,8,0,0,1,1,0,2,"H","N","2019-11-11","201911110CAR"
"OTT",0,0,1,1,0,2,0,2,3,3,0,8,"A","N","2019-11-11","201911110CAR"
"ARI",0,1,2,0,1,4,0,0,1,2,0,3,"A","Y","2019-11-11","201911110WSH"
"WSH",0,0,1,2,0,3,0,1,2,0,1,4,"H","Y","2019-11-11","201911110WSH"
"ANA",0,0,3,0,0,3,1,0,2,1,0,4,"H","N","2019-11-12","201911120ANA"
"DET",1,0,2,1,0,4,0,0,3,0,0,3,"A","N","2019-11-12","201911120ANA"
"BOS",0,0,4,0,0,4,0,0,0,4,1,5,"H","Y","2019-11-12","201911120BOS"
"FLA",0,0,0,4,1,5,0,0,4,0,0,4,"A","Y","2019-11-12","201911120BOS"
"LAK",0,1,1,1,0,3,0,0,1,0,0,1,"H","N","2019-11-12","201911120LAK"
"MIN",0,0,1,0,0,1,0,1,1,1,0,3,"A","N","2019-11-12","201911120LAK"
"CBJ",0,1,0,1,0,2,0,0,0,2,1,3,"A","Y","2019-11-12","201911120MTL"
"MTL",0,0,0,2,1,3,0,1,0,1,0,2,"H","Y","2019-11-12","201911120MTL"
"NYR",1,2,0,0,0,3,0,0,2,0,0,2,"H","N","2019-11-12","201911120NYR"
"PIT",0,0,2,0,0,2,1,2,0,0,0,3,"A","N","2019-11-12","201911120NYR"
"EDM",0,0,1,2,0,3,0,3,2,1,0,6,"A","N","2019-11-12","201911120SJS"
"SJS",0,3,2,1,0,6,0,0,1,2,0,3,"H","N","2019-11-12","201911120SJS"
"ARI",0,0,1,1,1,3,0,1,1,0,0,2,"A","Y","2019-11-12","201911120STL"
"STL",0,1,1,0,0,2,0,0,1,1,1,3,"H","Y","2019-11-12","201911120STL"
"NSH",0,0,1,2,0,3,0,0,1,4,0,5,"A","N","2019-11-12","201911120VAN"
"VAN",0,0,1,4,0,5,0,0,1,2,0,3,"H","N","2019-11-12","201911120VAN"
"COL",0,1,0,3,0,4,0,0,0,0,0,0,"A","N","2019-11-12","201911120WPG"
"WPG",0,0,0,0,0,0,0,1,0,3,0,4,"H","N","2019-11-12","201911120WPG"
"CGY",0,0,0,1,0,1,0,0,1,2,0,3,"H","N","2019-11-13","201911130CGY"
"DAL",0,0,1,2,0,3,0,0,0,1,0,1,"A","N","2019-11-13","201911130CGY"
"NJD",0,2,0,0,0,2,0,1,0,3,0,4,"H","N","2019-11-13","201911130NJD"
"OTT",0,1,0,3,0,4,0,2,0,0,0,2,"A","N","2019-11-13","201911130NJD"
"NYI",0,2,1,2,0,5,0,0,2,2,0,4,"H","N","2019-11-13","201911130NYI"
"TOR",0,0,2,2,0,4,0,2,1,2,0,5,"A","N","2019-11-13","201911130NYI"
"PHI",0,0,0,1,0,1,0,1,0,0,1,2,"H","Y","2019-11-13","201911130PHI"
"WSH",0,1,0,0,1,2,0,0,0,1,0,1,"A","Y","2019-11-13","201911130PHI"
"CHI",0,1,2,2,0,5,0,2,0,1,0,3,"A","N","2019-11-13","201911130VEG"
"VEG",0,2,0,1,0,3,0,1,2,2,0,5,"H","N","2019-11-13","201911130VEG"
"ANA",0,1,1,1,0,3,0,1,1,3,0,5,"H","N","2019-11-14","201911140ANA"
"SJS",0,1,1,3,0,5,0,1,1,1,0,3,"A","N","2019-11-14","201911140ANA"
"BUF",0,1,1,2,0,4,1,2,1,1,0,5,"H","N","2019-11-14","201911140BUF"
"CAR",1,2,1,1,0,5,0,1,1,2,0,4,"A","N","2019-11-14","201911140BUF"
"COL",0,1,1,0,0,2,0,4,2,0,0,6,"A","N","2019-11-14","201911140EDM"
"EDM",0,4,2,0,0,6,0,1,1,0,0,2,"H","N","2019-11-14","201911140EDM"
"FLA",0,0,1,2,0,3,0,0,1,3,0,4,"H","N","2019-11-14","201911140FLA"
"WPG",0,0,1,3,0,4,0,0,1,2,0,3,"A","N","2019-11-14","201911140FLA"
"DET",0,0,1,1,0,2,1,1,0,1,0,3,"A","N","2019-11-14","201911140LAK"
"LAK",1,1,0,1,0,3,0,0,1,1,0,2,"H","N","2019-11-14","201911140LAK"
"ARI",0,0,1,1,0,2,0,1,0,2,0,3,"A","N","2019-11-14","201911140MIN"
"MIN",0,1,0,2,0,3,0,0,1,1,0,2,"H","N","2019-11-14","201911140MIN"
"NYR",0,1,0,2,0,3,0,4,4,1,0,9,"A","N","2019-11-14","201911140TBL"
"TBL",0,4,4,1,0,9,0,1,0,2,0,3,"H","N","2019-11-14","201911140TBL"
"DAL",0,1,2,1,0,4,0,0,2,0,0,2,"A","N","2019-11-14","201911140VAN"
"VAN",0,0,2,0,0,2,0,1,2,1,0,4,"H","N","2019-11-14","201911140VAN"
"CBJ",1,1,0,1,0,3,0,1,1,0,0,2,"H","N","2019-11-15","201911150CBJ"
"STL",0,1,1,0,0,2,1,1,0,1,0,3,"A","N","2019-11-15","201911150CBJ"
"NJD",0,1,1,0,0,2,0,0,0,1,0,1,"H","N","2019-11-15","201911150NJD"
"PIT",0,0,0,1,0,1,0,1,1,0,0,2,"A","N","2019-11-15","201911150NJD"
"OTT",0,0,2,0,0,2,0,1,0,0,0,1,"H","N","2019-11-15","201911150OTT"
"PHI",0,1,0,0,0,1,0,0,2,0,0,2,"A","N","2019-11-15","201911150OTT"
"BOS",0,1,0,3,0,4,0,0,1,1,0,2,"A","N","2019-11-15","201911150TOR"
"TOR",0,0,1,1,0,2,0,1,0,3,0,4,"H","N","2019-11-15","201911150TOR"
"MTL",0,0,4,1,0,5,0,0,0,2,0,2,"A","N","2019-11-15","201911150WSH"
"WSH",0,0,0,2,0,2,0,0,4,1,0,5,"H","N","2019-11-15","201911150WSH"
"ARI",0,0,2,1,0,3,0,0,0,0,0,0,"H","N","2019-11-16","201911160ARI"
"CGY",0,0,0,0,0,0,0,0,2,1,0,3,"A","N","2019-11-16","201911160ARI"
"BOS",0,1,1,0,0,2,0,1,0,1,1,3,"H","Y","2019-11-16","201911160BOS"
"WSH",0,1,0,1,1,3,0,1,1,0,0,2,"A","Y","2019-11-16","201911160BOS"
"BUF",0,0,2,2,0,4,0,0,1,1,0,2,"H","N","2019-11-16","201911160BUF"
"OTT",0,0,1,1,0,2,0,0,2,2,0,4,"A","N","2019-11-16","201911160BUF"
"DAL",1,1,1,2,0,5,0,2,2,0,0,4,"A","N","2019-11-16","201911160EDM"
"EDM",0,2,2,0,0,4,1,1,1,2,0,5,"H","N","2019-11-16","201911160EDM"
"FLA",0,2,2,0,0,4,0,2,1,0,0,3,"H","N","2019-11-16","201911160FLA"
"NYR",0,2,1,0,0,3,0,2,2,0,0,4,"A","N","2019-11-16","201911160FLA"
"LAK",0,2,1,1,0,4,0,0,3,0,0,3,"H","N","2019-11-16","201911160LAK"
"VEG",0,0,3,0,0,3,0,2,1,1,0,4,"A","N","2019-11-16","201911160LAK"
"CAR",1,2,1,0,0,4,0,0,3,0,0,3,"A","N","2019-11-16","201911160MIN"
"MIN",0,0,3,0,0,3,1,2,1,0,0,4,"H","N","2019-11-16","201911160MIN"
"MTL",0,1,2,0,0,3,1,1,1,1,0,4,"H","N","2019-11-16","201911160MTL"
"NJD",1,1,1,1,0,4,0,1,2,0,0,3,"A","N","2019-11-16","201911160MTL"
"CHI",0,2,2,3,0,7,0,0,0,2,0,2,"A","N","2019-11-16","201911160NSH"
"NSH",0,0,0,2,0,2,0,2,2,3,0,7,"H","N","2019-11-16","201911160NSH"
"NYI",0,0,0,3,1,4,0,2,1,0,0,3,"A","Y","2019-11-16","201911160PHI"
"PHI",0,2,1,0,0,3,0,0,0,3,1,4,"H","Y","2019-11-16","201911160PHI"
"PIT",0,2,3,1,0,6,0,0,1,0,0,1,"H","N","2019-11-16","201911160PIT"
"TOR",0,0,1,0,0,1,0,2,3,1,0,6,"A","N","2019-11-16","201911160PIT"
"DET",0,0,2,1,0,3,0,1,2,0,1,4,"A","Y","2019-11-16","201911160SJS"
"SJS",0,1,2,0,1,4,0,0,2,1,0,3,"H","Y","2019-11-16","201911160SJS"
"ANA",0,2,1,1,0,4,0,0,1,0,0,1,"A","N","2019-11-16","201911160STL"
"STL",0,0,1,0,0,1,0,2,1,1,0,4,"H","N","2019-11-16","201911160STL"
"TBL",0,1,0,2,0,3,0,1,2,1,0,4,"H","N","2019-11-16","201911160TBL"
"WPG",0,1,2,1,0,4,0,1,0,2,0,3,"A","N","2019-11-16","201911160TBL"
"COL",1,1,2,1,0,5,0,1,1,2,0,4,"A","N","2019-11-16","201911160VAN"
"VAN",0,1,1,2,0,4,1,1,2,1,0,5,"H","N","2019-11-16","201911160VAN"
"BUF",0,0,0,1,0,1,0,1,1,2,0,4,"A","N","2019-11-17","201911170CHI"
"CHI",0,1,1,2,0,4,0,0,0,1,0,1,"H","N","2019-11-17","201911170CHI"
"CGY",0,0,0,0,0,0,0,1,1,4,0,6,"A","N","2019-11-17","201911170VEG"
"VEG",0,1,1,4,0,6,0,0,0,0,0,0,"H","N","2019-11-17","201911170VEG"
"ARI",0,2,1,0,0,3,0,0,0,0,0,0,"H","N","2019-11-18","201911180ARI"
"LAK",0,0,0,0,0,0,0,2,1,0,0,3,"A","N","2019-11-18","201911180ARI"
"ANA",0,0,0,2,0,2,0,1,2,2,0,5,"A","N","2019-11-18","201911180WSH"
"WSH",0,1,2,2,0,5,0,0,0,2,0,2,"H","N","2019-11-18","201911180WSH"
"BUF",0,0,0,1,0,1,0,2,1,1,0,4,"H","N","2019-11-19","201911190BUF"
"MIN",0,2,1,1,0,4,0,0,0,1,0,1,"A","N","2019-11-19","201911190BUF"
"CBJ",0,1,1,3,0,5,0,1,1,0,0,2,"H","N","2019-11-19","201911190CBJ"
"MTL",0,1,1,0,0,2,0,1,1,3,0,5,"A","N","2019-11-19","201911190CBJ"
"CGY",0,0,1,1,0,2,0,2,1,0,0,3,"H","N","2019-11-19","201911190CGY"
"COL",0,2,1,0,0,3,0,0,1,1,0,2,"A","N","2019-11-19","201911190CGY"
"CAR",0,1,2,1,0,4,0,0,0,2,0,2,"A","N","2019-11-19","201911190CHI"
"CHI",0,0,0,2,0,2,0,1,2,1,0,4,"H","N","2019-11-19","201911190CHI"
"DAL",0,1,2,3,0,6,0,0,1,0,0,1,"H","N","2019-11-19","201911190DAL"
"VAN",0,0,1,0,0,1,0,1,2,3,0,6,"A","N","2019-11-19","201911190DAL"
"DET",0,2,0,1,0,3,0,1,3,0,0,4,"H","N","2019-11-19","201911190DET"
"OTT",0,1,3,0,0,4,0,2,0,1,0,3,"A","N","2019-11-19","201911190DET"
"FLA",0,2,2,1,0,5,0,1,1,0,0,2,"H","N","2019-11-19","201911190FLA"
"PHI",0,1,1,0,0,2,0,2,2,1,0,5,"A","N","2019-11-19","201911190FLA"
"BOS",0,2,0,3,0,5,0,0,1,0,0,1,"A","N","2019-11-19","201911190NJD"
"NJD",0,0,1,0,0,1,0,2,0,3,0,5,"H","N","2019-11-19","201911190NJD"
"NSH",0,0,1,0,0,1,0,1,1,0,0,2,"H","N","2019-11-19","201911190NSH"
"WPG",0,1,1,0,0,2,0,0,1,0,0,1,"A","N","2019-11-19","201911190NSH"
"NYI",1,0,2,2,0,5,0,2,1,1,0,4,"A","N","2019-11-19","201911190PIT"
"PIT",0,2,1,1,0,4,1,0,2,2,0,5,"H","N","2019-11-19","201911190PIT"
"EDM",0,3,1,1,0,5,0,1,0,1,0,2,"A","N","2019-11-19","201911190SJS"
"SJS",0,1,0,1,0,2,0,3,1,1,0,5,"H","N","2019-11-19","201911190SJS"
"STL",0,0,1,2,0,3,0,1,0,0,0,1,"H","N","2019-11-19","201911190STL"
"TBL",0,1,0,0,0,1,0,0,1,2,0,3,"A","N","2019-11-19","201911190STL"
"TOR",0,0,0,2,0,2,0,0,1,3,0,4,"A","N","2019-11-19","201911190VEG"
"VEG",0,0,1,3,0,4,0,0,0,2,0,2,"H","N","2019-11-19","201911190VEG"
"MTL",0,0,1,0,0,1,1,0,1,0,0,2,"H","N","2019-11-20","201911200MTL"
"OTT",1,0,1,0,0,2,0,0,1,0,0,1,"A","N","2019-11-20","201911200MTL"
"NYR",0,0,1,3,0,4,0,0,0,1,0,1,"H","N","2019-11-20","201911200NYR"
"WSH",0,0,0,1,0,1,0,0,1,3,0,4,"A","N","2019-11-20","201911200NYR"
"ARI",0,0,0,1,0,1,0,1,1,1,0,3,"H","N","2019-11-21","201911210ARI"
"TOR",0,1,1,1,0,3,0,0,0,1,0,1,"A","N","2019-11-21","201911210ARI"
"BOS",0,1,1,1,0,3,0,1,0,1,0,2,"H","N","2019-11-21","201911210BOS"
"BUF",0,1,0,1,0,2,0,1,1,1,0,3,"A","N","2019-11-21","201911210BOS"
"CAR",0,2,0,1,0,3,0,2,1,2,0,5,"H","N","2019-11-21","201911210CAR"
"PHI",0,2,1,2,0,5,0,2,0,1,0,3,"A","N","2019-11-21","201911210CAR"
"CBJ",0,1,1,3,0,5,0,1,2,1,0,4,"H","N","2019-11-21","201911210CBJ"
"DET",0,1,2,1,0,4,0,1,1,3,0,5,"A","N","2019-11-21","201911210CBJ"
"CHI",0,0,0,2,0,2,0,1,0,3,0,4,"H","N","2019-11-21","201911210CHI"
"TBL",0,1,0,3,0,4,0,0,0,2,0,2,"A","N","2019-11-21","201911210CHI"
"DAL",0,0,3,2,0,5,0,0,1,2,0,3,"H","N","2019-11-21","201911210DAL"
"WPG",0,0,1,2,0,3,0,0,3,2,0,5,"A","N","2019-11-21","201911210DAL"
"ANA",0,1,3,0,0,4,1,0,2,2,0,5,"A","N","2019-11-21","201911210FLA"
"FLA",1,0,2,2,0,5,0,1,3,0,0,4,"H","N","2019-11-21","201911210FLA"
"EDM",0,0,1,0,0,1,0,3,1,1,0,5,"A","N","2019-11-21","201911210LAK"
"LAK",0,3,1,1,0,5,0,0,1,0,0,1,"H","N","2019-11-21","201911210LAK"
"COL",0,0,2,0,0,2,0,0,2,1,0,3,"A","N","2019-11-21","201911210MIN"
"MIN",0,0,2,1,0,3,0,0,2,0,0,2,"H","N","2019-11-21","201911210MIN"
"NSH",0,1,1,1,0,3,0,2,3,1,0,6,"H","N","2019-11-21","201911210NSH"
"VAN",0,2,3,1,0,6,0,1,1,1,0,3,"A","N","2019-11-21","201911210NSH"
"NYI",1,1,1,1,0,4,0,1,1,1,0,3,"H","N","2019-11-21","201911210NYI"
"PIT",0,1,1,1,0,3,1,1,1,1,0,4,"A","N","2019-11-21","201911210NYI"
"CGY",0,0,0,0,0,0,0,1,2,2,0,5,"A","N","2019-11-21","201911210STL"
"STL",0,1,2,2,0,5,0,0,0,0,0,0,"H","N","2019-11-21","201911210STL"
"SJS",1,0,1,0,0,2,0,0,0,1,0,1,"A","N","2019-11-21","201911210VEG"
"VEG",0,0,0,1,0,1,1,0,1,0,0,2,"H","N","2019-11-21","201911210VEG"
"NYR",0,1,0,0,0,1,0,2,2,0,0,4,"A","N","2019-11-22","201911220OTT"
"OTT",0,2,2,0,0,4,0,1,0,0,0,1,"H","N","2019-11-22","201911220OTT"
"NJD",0,0,1,0,0,1,0,1,1,2,0,4,"A","N","2019-11-22","201911220PIT"
"PIT",0,1,1,2,0,4,0,0,1,0,0,1,"H","N","2019-11-22","201911220PIT"
"BOS",1,0,2,2,0,5,0,1,2,1,0,4,"H","N","2019-11-23","201911230BOS"
"MIN",0,1,2,1,0,4,1,0,2,2,0,5,"A","N","2019-11-23","201911230BOS"
"CAR",0,2,1,1,0,4,0,2,0,0,0,2,"H","N","2019-11-23","201911230CAR"
"FLA",0,2,0,0,0,2,0,2,1,1,0,4,"A","N","2019-11-23","201911230CAR"
"COL",0,1,1,1,0,3,0,4,0,1,0,5,"H","N","2019-11-23","201911230COL"
"TOR",0,4,0,1,0,5,0,1,1,1,0,3,"A","N","2019-11-23","201911230COL"
"CHI",0,1,0,0,0,1,0,1,0,0,1,2,"A","Y","2019-11-23","201911230DAL"
"DAL",0,1,0,0,1,2,0,1,0,0,0,1,"H","Y","2019-11-23","201911230DAL"
"ARI",0,1,1,1,0,3,0,0,1,1,0,2,"A","N","2019-11-23","201911230LAK"
"LAK",0,0,1,1,0,2,0,1,1,1,0,3,"H","N","2019-11-23","201911230LAK"
"MTL",0,3,1,1,0,5,0,0,3,3,0,6,"H","N","2019-11-23","201911230MTL"
"NYR",0,0,3,3,0,6,0,3,1,1,0,5,"A","N","2019-11-23","201911230MTL"
"DET",0,0,1,0,0,1,0,0,1,4,0,5,"A","N","2019-11-23","201911230NJD"
"NJD",0,0,1,4,0,5,0,0,1,0,0,1,"H","N","2019-11-23","201911230NJD"
"CGY",0,0,0,2,1,3,0,0,1,1,0,2,"A","Y","2019-11-23","201911230PHI"
"PHI",0,0,1,1,0,2,0,0,0,2,1,3,"H","Y","2019-11-23","201911230PHI"
"NYI",0,0,1,0,0,1,1,0,1,0,0,2,"A","N","2019-11-23","201911230SJS"
"SJS",1,0,1,0,0,2,0,0,1,0,0,1,"H","N","2019-11-23","201911230SJS"
"NSH",0,3,0,1,0,4,0,1,0,1,0,2,"A","N","2019-11-23","201911230STL"
"STL",0,1,0,1,0,2,0,3,0,1,0,4,"H","N","2019-11-23","201911230STL"
"ANA",0,1,1,0,0,2,0,1,3,2,0,6,"A","N","2019-11-23","201911230TBL"
"TBL",0,1,3,2,0,6,0,1,1,0,0,2,"H","N","2019-11-23","201911230TBL"
"EDM",0,2,1,1,0,4,0,1,1,0,0,2,"A","N","2019-11-23","201911230VEG"
"VEG",0,1,1,0,0,2,0,2,1,1,0,4,"H","N","2019-11-23","201911230VEG"
"CBJ",0,1,2,0,0,3,0,1,2,1,0,4,"A","N","2019-11-23","201911230WPG"
"WPG",0,1,2,1,0,4,0,1,2,0,0,3,"H","N","2019-11-23","201911230WPG"
"VAN",0,1,0,0,1,2,0,1,0,0,0,1,"A","Y","2019-11-23","201911230WSH"
"WSH",0,1,0,0,0,1,0,1,0,0,1,2,"H","Y","2019-11-23","201911230WSH"
"ARI",0,1,2,0,0,3,0,1,1,1,1,4,"H","Y","2019-11-24","201911240ARI"
"EDM",0,1,1,1,1,4,0,1,2,0,0,3,"A","Y","2019-11-24","201911240ARI"
"CAR",0,0,1,1,0,2,0,0,0,0,0,0,"A","N","2019-11-24","201911240DET"
"DET",0,0,0,0,0,0,0,0,1,1,0,2,"H","N","2019-11-24","201911240DET"
"BUF",0,2,2,1,0,5,0,0,1,1,0,2,"A","N","2019-11-24","201911240FLA"
"FLA",0,0,1,1,0,2,0,2,2,1,0,5,"H","N","2019-11-24","201911240FLA"
"ANA",0,0,1,2,0,3,0,0,0,0,0,0,"H","N","2019-11-25","201911250ANA"
"NYI",0,0,0,0,0,0,0,0,1,2,0,3,"A","N","2019-11-25","201911250ANA"
"CBJ",0,0,0,1,0,1,0,0,0,0,0,0,"H","N","2019-11-25","201911250CBJ"
"OTT",0,0,0,0,0,0,0,0,0,1,0,1,"A","N","2019-11-25","201911250CBJ"
"DAL",0,2,1,1,0,4,0,0,1,1,0,2,"H","N","2019-11-25","201911250DAL"
"VEG",0,0,1,1,0,2,0,2,1,1,0,4,"A","N","2019-11-25","201911250DAL"
"LAK",0,0,1,2,0,3,1,1,2,0,0,4,"H","N","2019-11-25","201911250LAK"
"SJS",1,1,2,0,0,4,0,0,1,2,0,3,"A","N","2019-11-25","201911250LAK"
"NSH",0,2,0,0,1,3,0,0,1,1,0,2,"H","Y","2019-11-25","201911250NSH"
"STL",0,0,1,1,0,2,0,2,0,0,1,3,"A","Y","2019-11-25","201911250NSH"
"MIN",0,0,1,1,0,2,1,1,0,1,0,3,"A","N","2019-11-25","201911250NYR"
"NYR",1,1,0,1,0,3,0,0,1,1,0,2,"H","N","2019-11-25","201911250NYR"
"PHI",0,0,1,1,0,2,0,1,0,0,0,1,"H","N","2019-11-25","201911250PHI"
"VAN",0,1,0,0,0,1,0,0,1,1,0,2,"A","N","2019-11-25","201911250PHI"
"CGY",0,1,1,0,0,2,1,1,1,0,0,3,"A","N","2019-11-25","201911250PIT"
"PIT",1,1,1,0,0,3,0,1,1,0,0,2,"H","N","2019-11-25","201911250PIT"
"BUF",0,1,1,0,0,2,0,1,2,2,0,5,"A","N","2019-11-25","201911250TBL"
"TBL",0,1,2,2,0,5,0,1,1,0,0,2,"H","N","2019-11-25","201911250TBL"
"CHI",0,1,0,2,0,3,0,0,0,0,0,0,"H","N","2019-11-26","201911260CHI"
"DAL",0,0,0,0,0,0,0,1,0,2,0,3,"A","N","2019-11-26","201911260CHI"
"BOS",0,3,3,2,0,8,0,1,0,0,0,1,"A","N","2019-11-26","201911260MTL"
"MTL",0,1,0,0,0,1,0,3,3,2,0,8,"H","N","2019-11-26","201911260MTL"
"MIN",0,1,1,1,0,3,0,1,1,0,0,2,"A","N","2019-11-26","201911260NJD"
"NJD",0,1,1,0,0,2,0,1,1,1,0,3,"H","N","2019-11-26","201911260NJD"
"ANA",0,1,1,1,0,3,0,2,0,1,1,4,"A","Y","2019-11-27","201911270ARI"
"ARI",0,2,0,1,1,4,0,1,1,1,0,3,"H","Y","2019-11-27","201911270ARI"
"BUF",0,0,1,1,0,2,1,1,0,1,0,3,"H","N","2019-11-27","201911270BUF"
"CGY",1,1,0,1,0,3,0,0,1,1,0,2,"A","N","2019-11-27","201911270BUF"
"CBJ",0,2,0,0,0,2,0,1,2,0,0,3,"H","N","2019-11-27","201911270CBJ"
"PHI",0,1,2,0,0,3,0,2,0,0,0,2,"A","N","2019-11-27","201911270CBJ"
"COL",0,0,1,3,0,4,0,1,0,0,0,1,"H","N","2019-11-27","201911270COL"
"EDM",0,1,0,0,0,1,0,0,1,3,0,4,"A","N","2019-11-27","201911270COL"
"DET",0,0,0,0,0,0,0,3,3,0,0,6,"H","N","2019-11-27","201911270DET"
"TOR",0,3,3,0,0,6,0,0,0,0,0,0,"A","N","2019-11-27","201911270DET"
"LAK",0,1,1,2,0,4,0,1,0,0,0,1,"H","N","2019-11-27","201911270LAK"
"NYI",0,1,0,0,0,1,0,1,1,2,0,4,"A","N","2019-11-27","201911270LAK"
"NSH",0,0,2,1,0,3,1,1,1,1,0,4,"H","N","2019-11-27","201911270NSH"
"VEG",1,1,1,1,0,4,0,0,2,1,0,3,"A","N","2019-11-27","201911270NSH"
"CAR",0,0,2,0,0,2,0,3,0,0,0,3,"A","N","2019-11-27","201911270NYR"
"NYR",0,3,0,0,0,3,0,0,2,0,0,2,"H","N","2019-11-27","201911270NYR"
"BOS",0,0,0,2,0,2,0,0,0,1,0,1,"A","N","2019-11-27","201911270OTT"
"OTT",0,0,0,1,0,1,0,0,0,2,0,2,"H","N","2019-11-27","201911270OTT"
"PIT",0,2,0,6,0,8,0,1,3,2,0,6,"H","N","2019-11-27","201911270PIT"
"VAN",0,1,3,2,0,6,0,2,0,6,0,8,"A","N","2019-11-27","201911270PIT"
"SJS",0,1,0,0,0,1,0,2,2,1,0,5,"H","N","2019-11-27","201911270SJS"
"WPG",0,2,2,1,0,5,0,1,0,0,0,1,"A","N","2019-11-27","201911270SJS"
"STL",0,0,2,2,0,4,0,0,2,1,0,3,"A","N","2019-11-27","201911270TBL"
"TBL",0,0,2,1,0,3,0,0,2,2,0,4,"H","N","2019-11-27","201911270TBL"
"FLA",0,0,2,1,0,3,0,1,1,2,0,4,"A","N","2019-11-27","201911270WSH"
"WSH",0,1,1,2,0,4,0,0,2,1,0,3,"H","N","2019-11-27","201911270WSH"
"MTL",0,1,2,1,0,4,0,2,2,2,0,6,"H","N","2019-11-28","201911280MTL"
"NJD",0,2,2,2,0,6,0,1,2,1,0,4,"A","N","2019-11-28","201911280MTL"
"ANA",0,0,0,0,0,0,0,0,2,1,0,3,"H","N","2019-11-29","201911290ANA"
"WPG",0,0,2,1,0,3,0,0,0,0,0,0,"A","N","2019-11-29","201911290ANA"
"BOS",1,0,1,1,0,3,0,1,1,0,0,2,"H","N","2019-11-29","201911290BOS"
"NYR",0,1,1,0,0,2,1,0,1,1,0,3,"A","N","2019-11-29","201911290BOS"
"BUF",0,0,4,2,0,6,0,1,1,2,0,4,"H","N","2019-11-29","201911290BUF"
"TOR",0,1,1,2,0,4,0,0,4,2,0,6,"A","N","2019-11-29","201911290BUF"
"CAR",0,0,0,0,0,0,0,2,1,0,0,3,"H","N","2019-11-29","201911290CAR"
"NSH",0,2,1,0,0,3,0,0,0,0,0,0,"A","N","2019-11-29","201911290CAR"
"CBJ",0,1,3,1,0,5,0,1,0,1,0,2,"H","N","2019-11-29","201911290CBJ"
"PIT",0,1,0,1,0,2,0,1,3,1,0,5,"A","N","2019-11-29","201911290CBJ"
"CHI",0,1,1,0,0,2,0,3,2,0,0,5,"H","N","2019-11-29","201911290CHI"
"COL",0,3,2,0,0,5,0,1,1,0,0,2,"A","N","2019-11-29","201911290CHI"
"DAL",0,0,0,1,0,1,0,1,0,2,0,3,"H","N","2019-11-29","201911290DAL"
"STL",0,1,0,2,0,3,0,0,0,1,0,1,"A","N","2019-11-29","201911290DAL"
"MIN",0,0,3,4,0,7,0,1,1,0,0,2,"H","N","2019-11-29","201911290MIN"
"OTT",0,1,1,0,0,2,0,0,3,4,0,7,"A","N","2019-11-29","201911290MIN"
"DET",0,1,0,0,0,1,0,2,1,3,0,6,"A","N","2019-11-29","201911290PHI"
"PHI",0,2,1,3,0,6,0,1,0,0,0,1,"H","N","2019-11-29","201911290PHI"
"LAK",0,0,0,1,0,1,0,2,2,0,0,4,"A","N","2019-11-29","201911290SJS"
"SJS",0,2,2,0,0,4,0,0,0,1,0,1,"H","N","2019-11-29","201911290SJS"
"ARI",0,0,1,0,0,1,0,0,1,0,1,2,"A","Y","2019-11-29","201911290VEG"
"VEG",0,0,1,0,1,2,0,0,1,0,0,1,"H","Y","2019-11-29","201911290VEG"
"TBL",0,1,2,0,0,3,1,0,1,2,0,4,"A","N","2019-11-29","201911290WSH"
"WSH",1,0,1,2,0,4,0,1,2,0,0,3,"H","N","2019-11-29","201911290WSH"
"ARI",0,2,0,0,0,2,0,1,2,1,0,4,"H","N","2019-11-30","201911300ARI"
"SJS",0,1,2,1,0,4,0,2,0,0,0,2,"A","N","2019-11-30","201911300ARI"
"CGY",0,1,0,2,0,3,0,0,0,1,0,1,"H","N","2019-11-30","201911300CGY"
"OTT",0,0,0,1,0,1,0,1,0,2,0,3,"A","N","2019-11-30","201911300CGY"
"CHI",0,1,1,1,0,3,0,3,4,0,0,7,"A","N","2019-11-30","201911300COL"
"COL",0,3,4,0,0,7,0,1,1,1,0,3,"H","N","2019-11-30","201911300COL"
"DET",0,1,0,1,0,2,0,0,2,3,0,5,"H","N","2019-11-30","201911300DET"
"WSH",0,0,2,3,0,5,0,1,0,1,0,2,"A","N","2019-11-30","201911300DET"
"EDM",0,1,1,0,0,2,0,2,2,1,0,5,"H","N","2019-11-30","201911300EDM"
"VAN",0,2,2,1,0,5,0,1,1,0,0,2,"A","N","2019-11-30","201911300EDM"
"FLA",0,0,1,2,0,3,0,0,0,0,0,0,"H","N","2019-11-30","201911300FLA"
"NSH",0,0,0,0,0,0,0,0,1,2,0,3,"A","N","2019-11-30","201911300FLA"
"LAK",0,2,0,0,0,2,0,0,0,1,0,1,"H","N","2019-11-30","201911300LAK"
"WPG",0,0,0,1,0,1,0,2,0,0,0,2,"A","N","2019-11-30","201911300LAK"
"MTL",0,1,1,1,0,3,1,0,2,1,0,4,"H","N","2019-11-30","201911300MTL"
"PHI",1,0,2,1,0,4,0,1,1,1,0,3,"A","N","2019-11-30","201911300MTL"
"NJD",0,0,0,0,0,0,0,1,0,3,0,4,"H","N","2019-11-30","201911300NJD"
"NYR",0,1,0,3,0,4,0,0,0,0,0,0,"A","N","2019-11-30","201911300NJD"
"CBJ",0,0,0,0,0,0,0,1,1,0,0,2,"A","N","2019-11-30","201911300NYI"
"NYI",0,1,1,0,0,2,0,0,0,0,0,0,"H","N","2019-11-30","201911300NYI"
"PIT",0,0,1,1,0,2,0,1,1,3,0,5,"A","N","2019-11-30","201911300STL"
"STL",0,1,1,3,0,5,0,0,1,1,0,2,"H","N","2019-11-30","201911300STL"
"CAR",0,3,0,0,0,3,0,0,0,2,0,2,"A","N","2019-11-30","201911300TBL"
"TBL",0,0,0,2,0,2,0,3,0,0,0,3,"H","N","2019-11-30","201911300TBL"
"BUF",0,0,0,1,0,1,1,0,1,0,0,2,"A","N","2019-11-30","201911300TOR"
"TOR",1,0,1,0,0,2,0,0,0,1,0,1,"H","N","2019-11-30","201911300TOR"
"BOS",0,0,0,3,0,3,0,1,0,0,0,1,"H","N","2019-12-01","201912010BOS"
"MTL",0,1,0,0,0,1,0,0,0,3,0,3,"A","N","2019-12-01","201912010BOS"
"DAL",0,0,1,1,0,2,0,0,1,1,1,3,"A","Y","2019-12-01","201912010MIN"
"MIN",0,0,1,1,1,3,0,0,1,1,0,2,"H","Y","2019-12-01","201912010MIN"
"EDM",0,1,1,1,0,3,0,1,1,0,0,2,"A","N","2019-12-01","201912010VAN"
"VAN",0,1,1,0,0,2,0,1,1,1,0,3,"H","N","2019-12-01","201912010VAN"
"ANA",0,2,1,1,0,4,0,0,2,0,0,2,"H","N","2019-12-02","201912020ANA"
"LAK",0,0,2,0,0,2,0,2,1,1,0,4,"A","N","2019-12-02","201912020ANA"
"BUF",0,5,2,0,0,7,0,0,1,0,0,1,"H","N","2019-12-02","201912020BUF"
"NJD",0,0,1,0,0,1,0,5,2,0,0,7,"A","N","2019-12-02","201912020BUF"
"CHI",0,0,0,0,0,0,0,2,0,2,0,4,"H","N","2019-12-02","201912020CHI"
"STL",0,2,0,2,0,4,0,0,0,0,0,0,"A","N","2019-12-02","201912020CHI"
"DET",0,0,1,0,0,1,0,2,1,1,0,4,"H","N","2019-12-02","201912020DET"
"NYI",0,2,1,1,0,4,0,0,1,0,0,1,"A","N","2019-12-02","201912020DET"
"NYR",0,0,1,0,0,1,0,2,2,0,0,4,"H","N","2019-12-02","201912020NYR"
"VEG",0,2,2,0,0,4,0,0,1,0,0,1,"A","N","2019-12-02","201912020NYR"
"BOS",0,0,0,2,0,2,0,0,0,0,0,0,"H","N","2019-12-03","201912030BOS"
"CAR",0,0,0,0,0,0,0,0,0,2,0,2,"A","N","2019-12-03","201912030BOS"
"ARI",0,1,2,1,0,4,0,0,1,1,0,2,"A","N","2019-12-03","201912030CBJ"
"CBJ",0,0,1,1,0,2,0,1,2,1,0,4,"H","N","2019-12-03","201912030CBJ"
"FLA",0,2,0,0,0,2,0,0,2,2,0,4,"H","N","2019-12-03","201912030FLA"
"MIN",0,0,2,2,0,4,0,2,0,0,0,2,"A","N","2019-12-03","201912030FLA"
"MTL",0,1,1,2,0,4,0,0,0,2,0,2,"H","N","2019-12-03","201912030MTL"
"NYI",0,0,0,2,0,2,0,1,1,2,0,4,"A","N","2019-12-03","201912030MTL"
"NJD",0,1,1,1,0,3,0,0,1,3,0,4,"H","N","2019-12-03","201912030NJD"
"VEG",0,0,1,3,0,4,0,1,1,1,0,3,"A","N","2019-12-03","201912030NJD"
"NSH",0,0,1,1,0,2,1,1,1,0,0,3,"H","N","2019-12-03","201912030NSH"
"TBL",1,1,1,0,0,3,0,0,1,1,0,2,"A","N","2019-12-03","201912030NSH"
"PHI",0,0,1,5,0,6,0,0,0,1,0,1,"H","N","2019-12-03","201912030PHI"
"TOR",0,0,0,1,0,1,0,0,1,5,0,6,"A","N","2019-12-03","201912030PHI"
"SJS",0,1,0,1,0,2,0,3,2,0,0,5,"H","N","2019-12-03","201912030SJS"
"WSH",0,3,2,0,0,5,0,1,0,1,0,2,"A","N","2019-12-03","201912030SJS"
"OTT",0,0,1,1,0,2,0,4,0,1,0,5,"A","N","2019-12-03","201912030VAN"
"VAN",0,4,0,1,0,5,0,0,1,1,0,2,"H","N","2019-12-03","201912030VAN"
"DAL",0,0,1,0,0,1,0,1,3,1,0,5,"A","N","2019-12-03","201912030WPG"
"WPG",0,1,3,1,0,5,0,0,1,0,0,1,"H","N","2019-12-03","201912030WPG"
"EDM",0,1,1,0,0,2,0,0,3,2,0,5,"H","N","2019-12-04","201912040EDM"
"OTT",0,0,3,2,0,5,0,1,1,0,0,2,"A","N","2019-12-04","201912040EDM"
"LAK",0,0,0,1,0,1,0,2,0,1,0,3,"H","N","2019-12-04","201912040LAK"
"WSH",0,2,0,1,0,3,0,0,0,1,0,1,"A","N","2019-12-04","201912040LAK"
"PIT",0,1,1,1,0,3,0,0,0,0,0,0,"H","N","2019-12-04","201912040PIT"
"STL",0,0,0,0,0,0,0,1,1,1,0,3,"A","N","2019-12-04","201912040PIT"
"COL",0,0,1,2,0,3,0,0,1,0,0,1,"A","N","2019-12-04","201912040TOR"
"TOR",0,0,1,0,0,1,0,0,1,2,0,3,"H","N","2019-12-04","201912040TOR"
"BOS",0,0,0,3,0,3,1,2,0,1,0,4,"H","N","2019-12-05","201912050BOS"
"CHI",1,2,0,1,0,4,0,0,0,3,0,3,"A","N","2019-12-05","201912050BOS"
"CAR",0,1,1,0,1,3,0,1,1,0,0,2,"H","Y","2019-12-05","201912050CAR"
"SJS",0,1,1,0,0,2,0,1,1,0,1,3,"A","Y","2019-12-05","201912050CAR"
"CBJ",0,1,0,1,0,2,0,1,2,0,0,3,"H","N","2019-12-05","201912050CBJ"
"NYR",0,1,2,0,0,3,0,1,0,1,0,2,"A","N","2019-12-05","201912050CBJ"
"BUF",0,1,0,2,0,3,0,1,2,1,0,4,"A","N","2019-12-05","201912050CGY"
"CGY",0,1,2,1,0,4,0,1,0,2,0,3,"H","N","2019-12-05","201912050CGY"
"DAL",1,1,1,0,0,3,0,0,0,2,0,2,"H","N","2019-12-05","201912050DAL"
"WPG",0,0,0,2,0,2,1,1,1,0,0,3,"A","N","2019-12-05","201912050DAL"
"COL",0,2,1,0,0,3,0,0,1,1,0,2,"A","N","2019-12-05","201912050MTL"
"MTL",0,0,1,1,0,2,0,2,1,0,0,3,"H","N","2019-12-05","201912050MTL"
"NYI",1,0,1,1,0,3,0,0,1,1,0,2,"H","N","2019-12-05","201912050NYI"
"VEG",0,0,1,1,0,2,1,0,1,1,0,3,"A","N","2019-12-05","201912050NYI"
"ARI",0,1,0,2,0,3,0,0,0,1,0,1,"A","N","2019-12-05","201912050PHI"
"PHI",0,0,0,1,0,1,0,1,0,2,0,3,"H","N","2019-12-05","201912050PHI"
"MIN",0,3,1,1,0,5,0,2,1,1,0,4,"A","N","2019-12-05","201912050TBL"
"TBL",0,2,1,1,0,4,0,3,1,1,0,5,"H","N","2019-12-05","201912050TBL"
"ANA",0,0,1,1,0,2,0,1,1,1,0,3,"H","N","2019-12-06","201912060ANA"
"WSH",0,1,1,1,0,3,0,0,1,1,0,2,"A","N","2019-12-06","201912060ANA"
"EDM",0,2,0,0,0,2,0,0,0,1,0,1,"H","N","2019-12-06","201912060EDM"
"LAK",0,0,0,1,0,1,0,2,0,0,0,2,"A","N","2019-12-06","201912060EDM"
"CHI",0,0,1,0,1,2,0,1,0,0,0,1,"A","Y","2019-12-06","201912060NJD"
"NJD",0,1,0,0,0,1,0,0,1,0,1,2,"H","Y","2019-12-06","201912060NJD"
"MTL",0,1,0,1,0,2,0,0,1,0,0,1,"A","N","2019-12-06","201912060NYR"
"NYR",0,0,1,0,0,1,0,1,0,1,0,2,"H","N","2019-12-06","201912060NYR"
"ARI",0,0,0,0,0,0,0,0,0,2,0,2,"A","N","2019-12-06","201912060PIT"
"PIT",0,0,0,2,0,2,0,0,0,0,0,0,"H","N","2019-12-06","201912060PIT"
"BOS",0,1,0,0,0,1,0,1,2,1,0,4,"H","N","2019-12-07","201912070BOS"
"COL",0,1,2,1,0,4,0,1,0,0,0,1,"A","N","2019-12-07","201912070BOS"
"CAR",0,2,2,2,0,6,0,1,1,0,0,2,"H","N","2019-12-07","201912070CAR"
"MIN",0,1,1,0,0,2,0,2,2,2,0,6,"A","N","2019-12-07","201912070CAR"
"CGY",0,1,2,1,0,4,0,2,0,1,0,3,"H","N","2019-12-07","201912070CGY"
"LAK",0,2,0,1,0,3,0,1,2,1,0,4,"A","N","2019-12-07","201912070CGY"
"DAL",0,2,1,0,0,3,0,0,0,1,0,1,"H","N","2019-12-07","201912070DAL"
"NYI",0,0,0,1,0,1,0,2,1,0,0,3,"A","N","2019-12-07","201912070DAL"
"DET",0,0,1,2,0,3,0,2,1,2,0,5,"H","N","2019-12-07","201912070DET"
"PIT",0,2,1,2,0,5,0,0,1,2,0,3,"A","N","2019-12-07","201912070DET"
"CBJ",0,0,0,1,0,1,0,1,1,2,0,4,"A","N","2019-12-07","201912070FLA"
"FLA",0,1,1,2,0,4,0,0,0,1,0,1,"H","N","2019-12-07","201912070FLA"
"NJD",0,2,1,1,0,4,0,2,2,2,0,6,"A","N","2019-12-07","201912070NSH"
"NSH",0,2,2,2,0,6,0,2,1,1,0,4,"H","N","2019-12-07","201912070NSH"
"OTT",0,1,1,1,0,3,0,2,0,2,0,4,"A","N","2019-12-07","201912070PHI"
"PHI",0,2,0,2,0,4,0,1,1,1,0,3,"H","N","2019-12-07","201912070PHI"
"STL",0,1,0,1,0,2,0,4,1,0,0,5,"H","N","2019-12-07","201912070STL"
"TOR",0,4,1,0,0,5,0,1,0,1,0,2,"A","N","2019-12-07","201912070STL"
"SJS",0,0,0,1,0,1,0,1,2,4,0,7,"A","N","2019-12-07","201912070TBL"
"TBL",0,1,2,4,0,7,0,0,0,1,0,1,"H","N","2019-12-07","201912070TBL"
"BUF",0,0,3,2,0,5,1,1,2,2,0,6,"A","N","2019-12-07","201912070VAN"
"VAN",1,1,2,2,0,6,0,0,3,2,0,5,"H","N","2019-12-07","201912070VAN"
"ARI",0,1,2,0,1,4,0,3,0,0,0,3,"A","Y","2019-12-08","201912080CHI"
"CHI",0,3,0,0,0,3,0,1,2,0,1,4,"H","Y","2019-12-08","201912080CHI"
"BUF",1,2,0,0,0,3,0,0,2,0,0,2,"A","N","2019-12-08","201912080EDM"
"EDM",0,0,2,0,0,2,1,2,0,0,0,3,"H","N","2019-12-08","201912080EDM"
"FLA",0,2,1,2,0,5,0,1,0,0,0,1,"H","N","2019-12-08","201912080FLA"
"SJS",0,1,0,0,0,1,0,2,1,2,0,5,"A","N","2019-12-08","201912080FLA"
"NYR",0,2,2,1,0,5,0,0,0,0,0,0,"A","N","2019-12-08","201912080VEG"
"VEG",0,0,0,0,0,0,0,2,2,1,0,5,"H","N","2019-12-08","201912080VEG"
"ANA",0,1,0,1,0,2,0,1,1,1,0,3,"A","N","2019-12-08","201912080WPG"
"WPG",0,1,1,1,0,3,0,1,0,1,0,2,"H","N","2019-12-08","201912080WPG"
"CGY",1,0,2,2,0,5,0,1,1,2,0,4,"A","N","2019-12-09","201912090COL"
"COL",0,1,1,2,0,4,1,0,2,2,0,5,"H","N","2019-12-09","201912090COL"
"BOS",0,1,0,1,0,2,0,2,1,2,0,5,"A","N","2019-12-09","201912090OTT"
"OTT",0,2,1,2,0,5,0,1,0,1,0,2,"H","N","2019-12-09","201912090OTT"
"NYI",0,0,2,3,0,5,0,0,1,0,0,1,"A","N","2019-12-09","201912090TBL"
"TBL",0,0,1,0,0,1,0,0,2,3,0,5,"H","N","2019-12-09","201912090TBL"
"CBJ",0,1,1,3,0,5,0,0,0,2,0,2,"A","N","2019-12-09","201912090WSH"
"WSH",0,0,0,2,0,2,0,1,1,3,0,5,"H","N","2019-12-09","201912090WSH"
"ARI",0,0,1,1,0,2,0,2,2,1,0,5,"H","N","2019-12-10","201912100ARI"
"CGY",0,2,2,1,0,5,0,0,1,1,0,2,"A","N","2019-12-10","201912100ARI"
"BUF",0,1,1,3,0,5,0,1,0,1,0,2,"H","N","2019-12-10","201912100BUF"
"STL",0,1,0,1,0,2,0,1,1,3,0,5,"A","N","2019-12-10","201912100BUF"
"DAL",0,2,0,0,0,2,0,0,0,0,0,0,"H","N","2019-12-10","201912100DAL"
"NJD",0,0,0,0,0,0,0,2,0,0,0,2,"A","N","2019-12-10","201912100DAL"
"CAR",0,3,0,3,0,6,0,0,1,2,0,3,"A","N","2019-12-10","201912100EDM"
"EDM",0,0,1,2,0,3,0,3,0,3,0,6,"H","N","2019-12-10","201912100EDM"
"FLA",0,0,0,1,0,1,0,1,1,0,0,2,"H","N","2019-12-10","201912100FLA"
"TBL",0,1,1,0,0,2,0,0,0,1,0,1,"A","N","2019-12-10","201912100FLA"
"LAK",0,1,1,1,0,3,0,0,0,1,0,1,"H","N","2019-12-10","201912100LAK"
"NYR",0,0,0,1,0,1,0,1,1,1,0,3,"A","N","2019-12-10","201912100LAK"
"ANA",0,2,0,0,1,3,0,0,1,1,0,2,"A","Y","2019-12-10","201912100MIN"
"MIN",0,0,1,1,0,2,0,2,0,0,1,3,"H","Y","2019-12-10","201912100MIN"
"NSH",0,0,0,3,0,3,0,0,0,1,0,1,"H","N","2019-12-10","201912100NSH"
"SJS",0,0,0,1,0,1,0,0,0,3,0,3,"A","N","2019-12-10","201912100NSH"
"MTL",0,0,3,1,0,4,0,1,0,0,0,1,"A","N","2019-12-10","201912100PIT"
"PIT",0,1,0,0,0,1,0,0,3,1,0,4,"H","N","2019-12-10","201912100PIT"
"TOR",0,0,2,2,0,4,0,0,0,1,0,1,"A","N","2019-12-10","201912100VAN"
"VAN",0,0,0,1,0,1,0,0,2,2,0,4,"H","N","2019-12-10","201912100VAN"
"CHI",0,0,0,1,0,1,0,0,3,2,0,5,"A","N","2019-12-10","201912100VEG"
"VEG",0,0,3,2,0,5,0,0,0,1,0,1,"H","N","2019-12-10","201912100VEG"
"DET",0,0,1,0,0,1,0,1,3,1,0,5,"A","N","2019-12-10","201912100WPG"
"WPG",0,1,3,1,0,5,0,0,1,0,0,1,"H","N","2019-12-10","201912100WPG"
"COL",0,1,1,1,0,3,0,0,0,1,0,1,"H","N","2019-12-11","201912110COL"
"PHI",0,0,0,1,0,1,0,1,1,1,0,3,"A","N","2019-12-11","201912110COL"
"MTL",1,1,0,1,0,3,0,0,0,2,0,2,"H","N","2019-12-11","201912110MTL"
"OTT",0,0,0,2,0,2,1,1,0,1,0,3,"A","N","2019-12-11","201912110MTL"
"BOS",0,1,0,1,0,2,0,0,2,1,0,3,"A","N","2019-12-11","201912110WSH"
"WSH",0,0,2,1,0,3,0,1,0,1,0,2,"H","N","2019-12-11","201912110WSH"
"ANA",0,0,0,1,0,1,0,1,1,0,0,2,"H","N","2019-12-12","201912120ANA"
"LAK",0,1,1,0,0,2,0,0,0,1,0,1,"A","N","2019-12-12","201912120ANA"
"ARI",0,3,1,1,0,5,0,0,1,1,0,2,"H","N","2019-12-12","201912120ARI"
"CHI",0,0,1,1,0,2,0,3,1,1,0,5,"A","N","2019-12-12","201912120ARI"
"BUF",0,1,2,1,0,4,0,2,1,0,0,3,"H","N","2019-12-12","201912120BUF"
"NSH",0,2,1,0,0,3,0,1,2,1,0,4,"A","N","2019-12-12","201912120BUF"
"CGY",0,1,0,3,0,4,0,1,1,0,0,2,"H","N","2019-12-12","201912120CGY"
"TOR",0,1,1,0,0,2,0,1,0,3,0,4,"A","N","2019-12-12","201912120CGY"
"DET",0,2,2,1,0,5,0,0,2,0,0,2,"H","N","2019-12-12","201912120DET"
"WPG",0,0,2,0,0,2,0,2,2,1,0,5,"A","N","2019-12-12","201912120DET"
"FLA",0,0,1,0,0,1,0,0,2,1,0,3,"H","N","2019-12-12","201912120FLA"
"NYI",0,0,2,1,0,3,0,0,1,0,0,1,"A","N","2019-12-12","201912120FLA"
"EDM",0,1,1,3,0,5,0,2,2,2,0,6,"A","N","2019-12-12","201912120MIN"
"MIN",0,2,2,2,0,6,0,1,1,3,0,5,"H","N","2019-12-12","201912120MIN"
"CBJ",0,0,0,0,0,0,1,0,0,0,0,1,"A","N","2019-12-12","201912120PIT"
"PIT",1,0,0,0,0,1,0,0,0,0,0,0,"H","N","2019-12-12","201912120PIT"
"NYR",0,0,2,4,0,6,0,1,1,1,0,3,"A","N","2019-12-12","201912120SJS"
"SJS",0,1,1,1,0,3,0,0,2,4,0,6,"H","N","2019-12-12","201912120SJS"
"STL",0,1,3,0,0,4,0,2,0,0,0,2,"H","N","2019-12-12","201912120STL"
"VEG",0,2,0,0,0,2,0,1,3,0,0,4,"A","N","2019-12-12","201912120STL"
"BOS",0,1,0,1,0,2,0,0,1,2,0,3,"A","N","2019-12-12","201912120TBL"
"TBL",0,0,1,2,0,3,0,1,0,1,0,2,"H","N","2019-12-12","201912120TBL"
"CAR",0,0,0,0,0,0,1,0,0,0,0,1,"A","N","2019-12-12","201912120VAN"
"VAN",1,0,0,0,0,1,0,0,0,0,0,0,"H","N","2019-12-12","201912120VAN"
"COL",0,1,1,1,0,3,0,0,0,1,0,1,"H","N","2019-12-13","201912130COL"
"NJD",0,0,0,1,0,1,0,1,1,1,0,3,"A","N","2019-12-13","201912130COL"
"DAL",0,1,0,1,0,2,1,0,2,0,0,3,"H","N","2019-12-13","201912130DAL"
"VEG",1,0,2,0,0,3,0,1,0,1,0,2,"A","N","2019-12-13","201912130DAL"
"ANA",0,1,1,1,1,4,0,2,0,1,0,3,"H","Y","2019-12-14","201912140ANA"
"NYR",0,2,0,1,0,3,0,1,1,1,1,4,"A","Y","2019-12-14","201912140ANA"
"ARI",0,1,0,0,0,1,0,1,0,1,0,2,"H","N","2019-12-14","201912140ARI"
"NJD",0,1,0,1,0,2,0,1,0,0,0,1,"A","N","2019-12-14","201912140ARI"
"CAR",0,0,2,2,0,4,0,0,0,0,0,0,"A","N","2019-12-14","201912140CGY"
"CGY",0,0,0,0,0,0,0,0,2,2,0,4,"H","N","2019-12-14","201912140CGY"
"EDM",0,0,0,1,0,1,0,1,1,2,0,4,"H","N","2019-12-14","201912140EDM"
"TOR",0,1,1,2,0,4,0,0,0,1,0,1,"A","N","2019-12-14","201912140EDM"
"BOS",0,1,2,1,0,4,0,0,0,2,0,2,"A","N","2019-12-14","201912140FLA"
"FLA",0,0,0,2,0,2,0,1,2,1,0,4,"H","N","2019-12-14","201912140FLA"
"MIN",0,2,1,1,0,4,0,1,0,0,0,1,"H","N","2019-12-14","201912140MIN"
"PHI",0,1,0,0,0,1,0,2,1,1,0,4,"A","N","2019-12-14","201912140MIN"
"DET",0,1,0,1,0,2,0,0,0,1,0,1,"A","N","2019-12-14","201912140MTL"
"MTL",0,0,0,1,0,1,0,1,0,1,0,2,"H","N","2019-12-14","201912140MTL"
"DAL",0,0,4,0,0,4,0,0,1,0,0,1,"A","N","2019-12-14","201912140NSH"
"NSH",0,0,1,0,0,1,0,0,4,0,0,4,"H","N","2019-12-14","201912140NSH"
"BUF",0,0,1,1,0,2,1,1,0,1,0,3,"A","N","2019-12-14","201912140NYI"
"NYI",1,1,0,1,0,3,0,0,1,1,0,2,"H","N","2019-12-14","201912140NYI"
"CBJ",0,1,0,2,0,3,1,2,1,0,0,4,"A","N","2019-12-14","201912140OTT"
"OTT",1,2,1,0,0,4,0,1,0,2,0,3,"H","N","2019-12-14","201912140OTT"
"LAK",0,2,0,2,0,4,0,0,2,2,1,5,"A","Y","2019-12-14","201912140PIT"
"PIT",0,0,2,2,1,5,0,2,0,2,0,4,"H","Y","2019-12-14","201912140PIT"
"SJS",0,1,0,3,0,4,0,0,0,2,0,2,"H","N","2019-12-14","201912140SJS"
"VAN",0,0,0,2,0,2,0,1,0,3,0,4,"A","N","2019-12-14","201912140SJS"
"CHI",0,0,1,2,0,3,0,0,0,4,0,4,"A","N","2019-12-14","201912140STL"
"STL",0,0,0,4,0,4,0,0,1,2,0,3,"H","N","2019-12-14","201912140STL"
"TBL",0,0,1,1,0,2,0,1,0,4,0,5,"H","N","2019-12-14","201912140TBL"
"WSH",0,1,0,4,0,5,0,0,1,1,0,2,"A","N","2019-12-14","201912140TBL"
"CHI",0,2,1,2,0,5,0,1,2,0,0,3,"H","N","2019-12-15","201912150CHI"
"MIN",0,1,2,0,0,3,0,2,1,2,0,5,"A","N","2019-12-15","201912150CHI"
"DET",0,0,0,2,0,2,0,1,2,1,0,4,"H","N","2019-12-15","201912150DET"
"LAK",0,1,2,1,0,4,0,0,0,2,0,2,"A","N","2019-12-15","201912150DET"
"VAN",0,1,0,2,0,3,0,2,2,2,0,6,"A","N","2019-12-15","201912150VEG"
"VEG",0,2,2,2,0,6,0,1,0,2,0,3,"H","N","2019-12-15","201912150VEG"
"PHI",0,0,2,1,0,3,0,2,4,1,0,7,"A","N","2019-12-15","201912150WPG"
"WPG",0,2,4,1,0,7,0,0,2,1,0,3,"H","N","2019-12-15","201912150WPG"
"CBJ",0,1,0,2,0,3,0,0,0,0,0,0,"H","N","2019-12-16","201912160CBJ"
"WSH",0,0,0,0,0,0,0,1,0,2,0,3,"A","N","2019-12-16","201912160CBJ"
"DAL",0,0,0,1,0,1,0,2,0,0,0,2,"H","N","2019-12-16","201912160DAL"
"EDM",0,2,0,0,0,2,0,0,0,1,0,1,"A","N","2019-12-16","201912160DAL"
"FLA",0,1,5,0,0,6,0,0,1,0,0,1,"H","N","2019-12-16","201912160FLA"
"OTT",0,0,1,0,0,1,0,1,5,0,0,6,"A","N","2019-12-16","201912160FLA"
"NSH",0,1,2,2,0,5,0,1,0,1,0,2,"A","N","2019-12-16","201912160NYR"
"NYR",0,1,0,1,0,2,0,1,2,2,0,5,"H","N","2019-12-16","201912160NYR"
"COL",0,0,2,0,0,2,0,1,2,2,0,5,"A","N","2019-12-16","201912160STL"
"STL",0,1,2,2,0,5,0,0,2,0,0,2,"H","N","2019-12-16","201912160STL"
"BOS",0,1,1,1,0,3,1,1,1,1,0,4,"H","N","2019-12-17","201912170BOS"
"LAK",1,1,1,1,0,4,0,1,1,1,0,3,"A","N","2019-12-17","201912170BOS"
"CGY",0,1,0,0,0,1,0,0,2,2,0,4,"H","N","2019-12-17","201912170CGY"
"PIT",0,0,2,2,0,4,0,1,0,0,0,1,"A","N","2019-12-17","201912170CGY"
"CBJ",0,2,1,2,0,5,0,2,1,0,0,3,"A","N","2019-12-17","201912170DET"
"DET",0,2,1,0,0,3,0,2,1,2,0,5,"H","N","2019-12-17","201912170DET"
"NSH",0,1,4,3,0,8,0,0,3,0,0,3,"A","N","2019-12-17","201912170NYI"
"NYI",0,0,3,0,0,3,0,1,4,3,0,8,"H","N","2019-12-17","201912170NYI"
"ANA",0,0,1,0,0,1,0,0,2,2,0,4,"A","N","2019-12-17","201912170PHI"
"PHI",0,0,2,2,0,4,0,0,1,0,0,1,"H","N","2019-12-17","201912170PHI"
"ARI",0,1,1,1,0,3,0,1,1,0,0,2,"A","N","2019-12-17","201912170SJS"
"SJS",0,1,1,0,0,2,0,1,1,1,0,3,"H","N","2019-12-17","201912170SJS"
"OTT",0,1,2,0,0,3,1,2,1,0,0,4,"A","N","2019-12-17","201912170TBL"
"TBL",1,2,1,0,0,4,0,1,2,0,0,3,"H","N","2019-12-17","201912170TBL"
"BUF",0,0,0,3,0,3,0,1,2,2,0,5,"A","N","2019-12-17","201912170TOR"
"TOR",0,1,2,2,0,5,0,0,0,3,0,3,"H","N","2019-12-17","201912170TOR"
"MTL",0,0,1,2,0,3,0,1,0,0,0,1,"A","N","2019-12-17","201912170VAN"
"VAN",0,1,0,0,0,1,0,0,1,2,0,3,"H","N","2019-12-17","201912170VAN"
"MIN",0,1,0,1,0,2,0,0,2,1,0,3,"A","N","2019-12-17","201912170VEG"
"VEG",0,0,2,1,0,3,0,1,0,1,0,2,"H","N","2019-12-17","201912170VEG"
"CAR",0,1,4,1,0,6,0,1,1,1,0,3,"A","N","2019-12-17","201912170WPG"
"WPG",0,1,1,1,0,3,0,1,4,1,0,6,"H","N","2019-12-17","201912170WPG"
"CHI",0,1,0,0,0,1,0,1,2,1,0,4,"H","N","2019-12-18","201912180CHI"
"COL",0,1,2,1,0,4,0,1,0,0,0,1,"A","N","2019-12-18","201912180CHI"
"ANA",0,1,0,0,0,1,0,0,2,1,0,3,"A","N","2019-12-18","201912180NJD"
"NJD",0,0,2,1,0,3,0,1,0,0,0,1,"H","N","2019-12-18","201912180NJD"
"EDM",0,0,0,1,0,1,0,0,1,1,0,2,"A","N","2019-12-18","201912180STL"
"STL",0,0,1,1,0,2,0,0,0,1,0,1,"H","N","2019-12-18","201912180STL"
"ARI",0,1,1,3,0,5,0,0,4,4,0,8,"H","N","2019-12-19","201912190ARI"
"MIN",0,0,4,4,0,8,0,1,1,3,0,5,"A","N","2019-12-19","201912190ARI"
"BOS",0,1,0,1,0,2,0,0,2,0,1,3,"H","Y","2019-12-19","201912190BOS"
"NYI",0,0,2,0,1,3,0,1,0,1,0,2,"A","Y","2019-12-19","201912190BOS"
"CBJ",1,1,0,1,0,3,0,1,1,0,0,2,"H","N","2019-12-19","201912190CBJ"
"LAK",0,1,1,0,0,2,1,1,0,1,0,3,"A","N","2019-12-19","201912190CBJ"
"CGY",0,2,0,1,0,3,1,0,2,1,0,4,"H","N","2019-12-19","201912190CGY"
"MTL",1,0,2,1,0,4,0,2,0,1,0,3,"A","N","2019-12-19","201912190CGY"
"CAR",0,0,0,3,0,3,0,0,0,1,0,1,"A","N","2019-12-19","201912190COL"
"COL",0,0,0,1,0,1,0,0,0,3,0,3,"H","N","2019-12-19","201912190COL"
"NSH",0,1,0,3,0,4,1,0,3,1,0,5,"A","N","2019-12-19","201912190OTT"
"OTT",1,0,3,1,0,5,0,1,0,3,0,4,"H","N","2019-12-19","201912190OTT"
"BUF",0,0,0,1,0,1,0,3,3,0,0,6,"A","N","2019-12-19","201912190PHI"
"PHI",0,3,3,0,0,6,0,0,0,1,0,1,"H","N","2019-12-19","201912190PHI"
"DAL",1,1,1,1,0,4,0,2,1,0,0,3,"A","N","2019-12-19","201912190TBL"
"TBL",0,2,1,0,0,3,1,1,1,1,0,4,"H","N","2019-12-19","201912190TBL"
"VAN",1,3,0,1,0,5,0,1,2,1,0,4,"H","N","2019-12-19","201912190VAN"
"VEG",0,1,2,1,0,4,1,3,0,1,0,5,"A","N","2019-12-19","201912190VAN"
"CHI",0,1,0,3,0,4,0,0,0,1,0,1,"A","N","2019-12-19","201912190WPG"
"WPG",0,0,0,1,0,1,0,1,0,3,0,4,"H","N","2019-12-19","201912190WPG"
"EDM",0,0,2,0,0,2,0,2,1,2,0,5,"H","N","2019-12-20","201912200EDM"
"PIT",0,2,1,2,0,5,0,0,2,0,0,2,"A","N","2019-12-20","201912200EDM"
"DAL",0,1,1,2,0,4,0,2,5,0,0,7,"A","N","2019-12-20","201912200FLA"
"FLA",0,2,5,0,0,7,0,1,1,2,0,4,"H","N","2019-12-20","201912200FLA"
"NJD",0,1,1,1,0,3,0,2,1,3,0,6,"H","N","2019-12-20","201912200NJD"
"WSH",0,2,1,3,0,6,0,1,1,1,0,3,"A","N","2019-12-20","201912200NJD"
"NYR",0,2,1,0,0,3,0,2,1,3,0,6,"H","N","2019-12-20","201912200NYR"
"TOR",0,2,1,3,0,6,0,2,1,0,0,3,"A","N","2019-12-20","201912200NYR"
"BOS",0,0,2,1,0,3,1,0,1,2,0,4,"H","N","2019-12-21","201912210BOS"
"NSH",1,0,1,2,0,4,0,0,2,1,0,3,"A","N","2019-12-21","201912210BOS"
"BUF",0,0,2,1,0,3,0,0,1,1,0,2,"H","N","2019-12-21","201912210BUF"
"LAK",0,0,1,1,0,2,0,0,2,1,0,3,"A","N","2019-12-21","201912210BUF"
"CAR",0,0,0,2,0,2,0,1,1,2,0,4,"H","N","2019-12-21","201912210CAR"
"FLA",0,1,1,2,0,4,0,0,0,2,0,2,"A","N","2019-12-21","201912210CAR"
"CBJ",0,2,1,2,0,5,0,1,0,0,0,1,"H","N","2019-12-21","201912210CBJ"
"NJD",0,1,0,0,0,1,0,2,1,2,0,5,"A","N","2019-12-21","201912210CBJ"
"CHI",0,0,1,4,0,5,0,1,2,0,0,3,"A","N","2019-12-21","201912210COL"
"COL",0,1,2,0,0,3,0,0,1,4,0,5,"H","N","2019-12-21","201912210COL"
"EDM",0,2,1,1,0,4,0,1,1,1,0,3,"H","N","2019-12-21","201912210EDM"
"MTL",0,1,1,1,0,3,0,2,1,1,0,4,"A","N","2019-12-21","201912210EDM"
"MIN",0,0,0,0,0,0,0,2,1,3,0,6,"H","N","2019-12-21","201912210MIN"
"WPG",0,2,1,3,0,6,0,0,0,0,0,0,"A","N","2019-12-21","201912210MIN"
"ANA",0,2,2,1,1,6,0,2,2,1,0,5,"A","Y","2019-12-21","201912210NYI"
"NYI",0,2,2,1,0,5,0,2,2,1,1,6,"H","Y","2019-12-21","201912210NYI"
"OTT",0,0,3,1,0,4,0,1,2,1,1,5,"H","Y","2019-12-21","201912210OTT"
"PHI",0,1,2,1,1,5,0,0,3,1,0,4,"A","Y","2019-12-21","201912210OTT"
"SJS",0,0,2,0,0,2,0,0,2,3,0,5,"H","N","2019-12-21","201912210SJS"
"STL",0,0,2,3,0,5,0,0,2,0,0,2,"A","N","2019-12-21","201912210SJS"
"DET",0,0,0,1,0,1,0,0,1,3,0,4,"A","N","2019-12-21","201912210TOR"
"TOR",0,0,1,3,0,4,0,0,0,1,0,1,"H","N","2019-12-21","201912210TOR"
"PIT",0,0,1,0,0,1,0,2,1,1,0,4,"A","N","2019-12-21","201912210VAN"
"VAN",0,2,1,1,0,4,0,0,1,0,0,1,"H","N","2019-12-21","201912210VAN"
"TBL",0,0,0,1,0,1,0,0,1,2,0,3,"A","N","2019-12-21","201912210WSH"
"WSH",0,0,1,2,0,3,0,0,0,1,0,1,"H","N","2019-12-21","201912210WSH"
"CGY",0,1,2,2,0,5,0,1,0,0,0,1,"A","N","2019-12-22","201912220DAL"
"DAL",0,1,0,0,0,1,0,1,2,2,0,5,"H","N","2019-12-22","201912220DAL"
"ARI",0,2,1,2,0,5,0,0,0,2,0,2,"A","N","2019-12-22","201912220DET"
"DET",0,0,0,2,0,2,0,2,1,2,0,5,"H","N","2019-12-22","201912220DET"
"ANA",0,1,0,0,0,1,0,3,1,1,0,5,"A","N","2019-12-22","201912220NYR"
"NYR",0,3,1,1,0,5,0,1,0,0,0,1,"H","N","2019-12-22","201912220NYR"
"SJS",0,0,0,1,0,1,0,0,1,2,0,3,"H","N","2019-12-22","201912220SJS"
"VEG",0,0,1,2,0,3,0,0,0,1,0,1,"A","N","2019-12-22","201912220SJS"
"BOS",0,4,1,2,0,7,0,0,1,2,0,3,"H","N","2019-12-23","201912230BOS"
"WSH",0,0,1,2,0,3,0,4,1,2,0,7,"A","N","2019-12-23","201912230BOS"
"CHI",0,1,0,0,0,1,0,1,4,2,0,7,"H","N","2019-12-23","201912230CHI"
"NJD",0,1,4,2,0,7,0,1,0,0,0,1,"A","N","2019-12-23","201912230CHI"
"LAK",0,1,0,0,0,1,0,4,0,0,0,4,"H","N","2019-12-23","201912230LAK"
"STL",0,4,0,0,0,4,0,1,0,0,0,1,"A","N","2019-12-23","201912230LAK"
"CGY",0,0,0,0,0,0,0,0,2,1,0,3,"A","N","2019-12-23","201912230MIN"
"MIN",0,0,2,1,0,3,0,0,0,0,0,0,"H","N","2019-12-23","201912230MIN"
"ARI",0,0,1,1,0,2,0,1,1,1,0,3,"A","N","2019-12-23","201912230NSH"
"NSH",0,1,1,1,0,3,0,0,1,1,0,2,"H","N","2019-12-23","201912230NSH"
"CBJ",0,0,2,1,0,3,0,1,1,0,0,2,"A","N","2019-12-23","201912230NYI"
"NYI",0,1,1,0,0,2,0,0,2,1,0,3,"H","N","2019-12-23","201912230NYI"
"BUF",0,0,1,0,0,1,0,1,0,2,0,3,"A","N","2019-12-23","201912230OTT"
"OTT",0,1,0,2,0,3,0,0,1,0,0,1,"H","N","2019-12-23","201912230OTT"
"NYR",0,0,1,0,0,1,0,0,1,4,0,5,"A","N","2019-12-23","201912230PHI"
"PHI",0,0,1,4,0,5,0,0,1,0,0,1,"H","N","2019-12-23","201912230PHI"
"FLA",0,0,1,0,0,1,0,3,2,1,0,6,"A","N","2019-12-23","201912230TBL"
"TBL",0,3,2,1,0,6,0,0,1,0,0,1,"H","N","2019-12-23","201912230TBL"
"CAR",0,2,3,1,0,6,0,3,0,5,0,8,"A","N","2019-12-23","201912230TOR"
"TOR",0,3,0,5,0,8,0,2,3,1,0,6,"H","N","2019-12-23","201912230TOR"
"EDM",0,1,1,0,0,2,0,1,0,3,0,4,"A","N","2019-12-23","201912230VAN"
"VAN",0,1,0,3,0,4,0,1,1,0,0,2,"H","N","2019-12-23","201912230VAN"
"COL",0,3,2,2,0,7,0,1,1,1,0,3,"A","N","2019-12-23","201912230VEG"
"VEG",0,1,1,1,0,3,0,3,2,2,0,7,"H","N","2019-12-23","201912230VEG"
"MTL",0,2,3,1,0,6,0,1,1,0,0,2,"A","N","2019-12-23","201912230WPG"
"WPG",0,1,1,0,0,2,0,2,3,1,0,6,"H","N","2019-12-23","201912230WPG"
"ANA",0,0,3,1,0,4,0,0,1,2,0,3,"H","N","2019-12-27","201912270ANA"
"VEG",0,0,1,2,0,3,0,0,3,1,0,4,"A","N","2019-12-27","201912270ANA"
"BOS",0,1,1,1,0,3,0,0,0,0,0,0,"A","N","2019-12-27","201912270BUF"
"BUF",0,0,0,0,0,0,0,1,1,1,0,3,"H","N","2019-12-27","201912270BUF"
"CHI",0,3,0,2,0,5,0,1,0,1,0,2,"H","N","2019-12-27","201912270CHI"
"NYI",0,1,0,1,0,2,0,3,0,2,0,5,"A","N","2019-12-27","201912270CHI"
"COL",0,2,1,1,0,4,0,2,1,3,0,6,"H","N","2019-12-27","201912270COL"
"MIN",0,2,1,3,0,6,0,2,1,1,0,4,"A","N","2019-12-27","201912270COL"
"CGY",0,2,2,1,0,5,0,1,0,0,0,1,"A","N","2019-12-27","201912270EDM"
"EDM",0,1,0,0,0,1,0,2,2,1,0,5,"H","N","2019-12-27","201912270EDM"
"NJD",0,1,3,0,0,4,1,2,1,1,0,5,"H","N","2019-12-27","201912270NJD"
"TOR",1,2,1,1,0,5,0,1,3,0,0,4,"A","N","2019-12-27","201912270NJD"
"NSH",0,1,0,1,0,2,0,3,2,0,0,5,"H","N","2019-12-27","201912270NSH"
"PIT",0,3,2,0,0,5,0,1,0,1,0,2,"A","N","2019-12-27","201912270NSH"
"CAR",0,1,1,1,0,3,0,1,3,1,0,5,"A","N","2019-12-27","201912270NYR"
"NYR",0,1,3,1,0,5,0,1,1,1,0,3,"H","N","2019-12-27","201912270NYR"
"LAK",1,0,0,2,0,3,0,0,2,0,0,2,"A","N","2019-12-27","201912270SJS"
"SJS",0,0,2,0,0,2,1,0,0,2,0,3,"H","N","2019-12-27","201912270SJS"
"STL",1,1,2,1,0,5,0,1,1,2,0,4,"A","N","2019-12-27","201912270WPG"
"WPG",0,1,1,2,0,4,1,1,2,1,0,5,"H","N","2019-12-27","201912270WPG"
"CBJ",0,0,1,0,0,1,1,0,0,1,0,2,"A","N","2019-12-27","201912270WSH"
"WSH",1,0,0,1,0,2,0,0,1,0,0,1,"H","N","2019-12-27","201912270WSH"
"CAR",0,1,3,2,0,6,0,0,2,2,0,4,"H","N","2019-12-28","201912280CAR"
"WSH",0,0,2,2,0,4,0,1,3,2,0,6,"A","N","2019-12-28","201912280CAR"
"COL",0,1,1,0,0,2,0,1,0,1,1,3,"A","Y","2019-12-28","201912280DAL"
"DAL",0,1,0,1,1,3,0,1,1,0,0,2,"H","Y","2019-12-28","201912280DAL"
"DET",0,2,1,1,0,4,0,1,3,1,0,5,"A","N","2019-12-28","201912280FLA"
"FLA",0,1,3,1,0,5,0,2,1,1,0,4,"H","N","2019-12-28","201912280FLA"
"NSH",0,0,3,1,0,4,0,3,1,2,0,6,"A","N","2019-12-28","201912280PIT"
"PIT",0,3,1,2,0,6,0,0,3,1,0,4,"H","N","2019-12-28","201912280PIT"
"PHI",0,0,0,1,0,1,0,1,2,3,0,6,"A","N","2019-12-28","201912280SJS"
"SJS",0,1,2,3,0,6,0,0,0,1,0,1,"H","N","2019-12-28","201912280SJS"
"MTL",0,2,1,1,0,4,0,1,3,1,0,5,"A","N","2019-12-28","201912280TBL"
"TBL",0,1,3,1,0,5,0,2,1,1,0,4,"H","N","2019-12-28","201912280TBL"
"NYR",1,2,2,0,0,5,0,1,1,2,0,4,"A","N","2019-12-28","201912280TOR"
"TOR",0,1,1,2,0,4,1,2,2,0,0,5,"H","N","2019-12-28","201912280TOR"
"LAK",0,0,1,1,0,2,0,2,0,1,0,3,"A","N","2019-12-28","201912280VAN"
"VAN",0,2,0,1,0,3,0,0,1,1,0,2,"H","N","2019-12-28","201912280VAN"
"ARI",0,1,0,0,0,1,0,2,2,0,0,4,"A","N","2019-12-28","201912280VEG"
"VEG",0,2,2,0,0,4,0,1,0,0,0,1,"H","N","2019-12-28","201912280VEG"
"ANA",0,1,0,0,0,1,1,1,0,0,0,2,"H","N","2019-12-29","201912290ANA"
"PHI",1,1,0,0,0,2,0,1,0,0,0,1,"A","N","2019-12-29","201912290ANA"
"ARI",0,2,0,0,0,2,0,0,0,4,0,4,"H","N","2019-12-29","201912290ARI"
"DAL",0,0,0,4,0,4,0,2,0,0,0,2,"A","N","2019-12-29","201912290ARI"
"BOS",0,1,0,2,0,3,0,0,1,1,0,2,"H","N","2019-12-29","201912290BOS"
"BUF",0,0,1,1,0,2,0,1,0,2,0,3,"A","N","2019-12-29","201912290BOS"
"CBJ",0,2,0,0,0,2,0,0,0,2,1,3,"H","Y","2019-12-29","201912290CBJ"
"CHI",0,0,0,2,1,3,0,2,0,0,0,2,"A","Y","2019-12-29","201912290CBJ"
"CGY",0,0,1,1,0,2,0,3,0,2,0,5,"H","N","2019-12-29","201912290CGY"
"VAN",0,3,0,2,0,5,0,0,1,1,0,2,"A","N","2019-12-29","201912290CGY"
"FLA",0,2,3,1,0,6,0,1,2,2,0,5,"H","N","2019-12-29","201912290FLA"
"MTL",0,1,2,2,0,5,0,2,3,1,0,6,"A","N","2019-12-29","201912290FLA"
"MIN",0,1,0,0,0,1,0,0,0,3,0,3,"H","N","2019-12-29","201912290MIN"
"NYI",0,0,0,3,0,3,0,1,0,0,0,1,"A","N","2019-12-29","201912290MIN"
"NJD",1,1,2,0,0,4,0,0,2,1,0,3,"A","N","2019-12-29","201912290OTT"
"OTT",0,0,2,1,0,3,1,1,2,0,0,4,"H","N","2019-12-29","201912290OTT"
"STL",0,1,1,2,0,4,0,0,1,0,0,1,"H","N","2019-12-29","201912290STL"
"WPG",0,0,1,0,0,1,0,1,1,2,0,4,"A","N","2019-12-29","201912290STL"
"DET",0,0,1,0,0,1,0,0,1,1,0,2,"A","N","2019-12-29","201912290TBL"
"TBL",0,0,1,1,0,2,0,0,1,0,0,1,"H","N","2019-12-29","201912290TBL"
"OTT",0,0,2,0,0,2,0,2,2,1,0,5,"A","N","2019-12-30","201912300PIT"
"PIT",0,2,2,1,0,5,0,0,2,0,0,2,"H","N","2019-12-30","201912300PIT"
"ARI",0,1,0,2,0,3,0,1,0,0,0,1,"H","N","2019-12-31","201912310ARI"
"STL",0,1,0,0,0,1,0,1,0,2,0,3,"A","N","2019-12-31","201912310ARI"
"BUF",0,1,3,0,0,4,0,0,3,3,0,6,"H","N","2019-12-31","201912310BUF"
"TBL",0,0,3,3,0,6,0,1,3,0,0,4,"A","N","2019-12-31","201912310BUF"
"CAR",0,1,1,1,0,3,0,1,0,0,0,1,"H","N","2019-12-31","201912310CAR"
"MTL",0,1,0,0,0,1,0,1,1,1,0,3,"A","N","2019-12-31","201912310CAR"
"CBJ",0,1,1,2,0,4,0,0,1,0,0,1,"H","N","2019-12-31","201912310CBJ"
"FLA",0,0,1,0,0,1,0,1,1,2,0,4,"A","N","2019-12-31","201912310CBJ"
"CGY",0,0,1,2,0,3,0,3,1,1,0,5,"H","N","2019-12-31","201912310CGY"
"CHI",0,3,1,1,0,5,0,0,1,2,0,3,"A","N","2019-12-31","201912310CGY"
"COL",0,1,1,2,0,4,0,1,2,4,0,7,"H","N","2019-12-31","201912310COL"
"WPG",0,1,2,4,0,7,0,1,1,2,0,4,"A","N","2019-12-31","201912310COL"
"DET",0,0,1,1,0,2,0,0,0,0,0,0,"H","N","2019-12-31","201912310DET"
"SJS",0,0,0,0,0,0,0,0,1,1,0,2,"A","N","2019-12-31","201912310DET"
"EDM",0,3,3,1,0,7,0,0,1,4,0,5,"H","N","2019-12-31","201912310EDM"
"NYR",0,0,1,4,0,5,0,3,3,1,0,7,"A","N","2019-12-31","201912310EDM"
"LAK",0,4,0,1,0,5,0,0,1,2,0,3,"H","N","2019-12-31","201912310LAK"
"PHI",0,0,1,2,0,3,0,4,0,1,0,5,"A","N","2019-12-31","201912310LAK"
"MIN",0,0,1,0,0,1,0,2,1,1,0,4,"H","N","2019-12-31","201912310MIN"
"TOR",0,2,1,1,0,4,0,0,1,0,0,1,"A","N","2019-12-31","201912310MIN"
"BOS",0,1,1,0,0,2,0,0,1,1,1,3,"A","Y","2019-12-31","201912310NJD"
"NJD",0,0,1,1,1,3,0,1,1,0,0,2,"H","Y","2019-12-31","201912310NJD"
"ANA",0,1,0,1,0,2,0,2,1,2,0,5,"A","N","2019-12-31","201912310VEG"
"VEG",0,2,1,2,0,5,0,1,0,1,0,2,"H","N","2019-12-31","201912310VEG"
"NYI",0,2,2,0,0,4,0,2,1,0,0,3,"A","N","2019-12-31","201912310WSH"
"WSH",0,2,1,0,0,3,0,2,2,0,0,4,"H","N","2019-12-31","201912310WSH"
"DAL",0,0,1,3,0,4,0,2,0,0,0,2,"H","N","2020-01-01","202001010DAL"
"NSH",0,2,0,0,0,2,0,0,1,3,0,4,"A","N","2020-01-01","202001010DAL"
"ANA",0,1,1,0,0,2,0,1,0,3,0,4,"A","N","2020-01-02","202001020ARI"
"ARI",0,1,0,3,0,4,0,1,1,0,0,2,"H","N","2020-01-02","202001020ARI"
"BOS",0,0,1,0,0,1,1,0,0,1,0,2,"H","N","2020-01-02","202001020BOS"
"CBJ",1,0,0,1,0,2,0,0,1,0,0,1,"A","N","2020-01-02","202001020BOS"
"BUF",1,1,0,1,0,3,0,2,0,0,0,2,"H","N","2020-01-02","202001020BUF"
"EDM",0,2,0,0,0,2,1,1,0,1,0,3,"A","N","2020-01-02","202001020BUF"
"CGY",0,3,1,0,0,4,0,2,1,0,0,3,"H","N","2020-01-02","202001020CGY"
"NYR",0,2,1,0,0,3,0,3,1,0,0,4,"A","N","2020-01-02","202001020CGY"
"COL",0,1,3,3,0,7,0,0,2,1,0,3,"H","N","2020-01-02","202001020COL"
"STL",0,0,2,1,0,3,0,1,3,3,0,7,"A","N","2020-01-02","202001020COL"
"MTL",0,1,0,0,0,1,0,2,0,0,0,2,"H","N","2020-01-02","202001020MTL"
"TBL",0,2,0,0,0,2,0,1,0,0,0,1,"A","N","2020-01-02","202001020MTL"
"NJD",0,0,1,1,0,2,0,0,1,0,0,1,"A","N","2020-01-02","202001020NYI"
"NYI",0,0,1,0,0,1,0,0,1,1,0,2,"H","N","2020-01-02","202001020NYI"
"FLA",0,1,4,1,0,6,0,2,0,1,0,3,"A","N","2020-01-02","202001020OTT"
"OTT",0,2,0,1,0,3,0,1,4,1,0,6,"H","N","2020-01-02","202001020OTT"
"PIT",0,1,1,0,0,2,1,2,0,0,0,3,"H","N","2020-01-02","202001020PIT"
"SJS",1,2,0,0,0,3,0,1,1,0,0,2,"A","N","2020-01-02","202001020PIT"
"CHI",0,1,3,1,0,5,0,1,3,3,0,7,"A","N","2020-01-02","202001020VAN"
"VAN",0,1,3,3,0,7,0,1,3,1,0,5,"H","N","2020-01-02","202001020VAN"
"PHI",0,2,1,1,0,4,0,4,1,0,0,5,"A","N","2020-01-02","202001020VEG"
"VEG",0,4,1,0,0,5,0,2,1,1,0,4,"H","N","2020-01-02","202001020VEG"
"TOR",0,2,3,1,0,6,0,0,3,0,0,3,"A","N","2020-01-02","202001020WPG"
"WPG",0,0,3,0,0,3,0,2,3,1,0,6,"H","N","2020-01-02","202001020WPG"
"CAR",0,0,0,3,0,3,0,0,2,2,0,4,"H","N","2020-01-03","202001030CAR"
"WSH",0,0,2,2,0,4,0,0,0,3,0,3,"A","N","2020-01-03","202001030CAR"
"DAL",0,1,2,1,0,4,0,1,0,0,0,1,"H","N","2020-01-03","202001030DAL"
"DET",0,1,0,0,0,1,0,1,2,1,0,4,"A","N","2020-01-03","202001030DAL"
"ARI",0,3,1,2,0,6,0,0,0,2,0,2,"H","N","2020-01-04","202001040ARI"
"PHI",0,0,0,2,0,2,0,3,1,2,0,6,"A","N","2020-01-04","202001040ARI"
"BOS",0,1,0,0,0,1,0,0,2,2,0,4,"H","N","2020-01-04","202001040BOS"
"EDM",0,0,2,2,0,4,0,1,0,0,0,1,"A","N","2020-01-04","202001040BOS"
"BUF",0,1,2,0,0,3,0,0,0,2,0,2,"H","N","2020-01-04","202001040BUF"
"FLA",0,0,0,2,0,2,0,1,2,0,0,3,"A","N","2020-01-04","202001040BUF"
"CBJ",0,0,1,1,0,2,0,0,2,1,0,3,"H","N","2020-01-04","202001040CBJ"
"SJS",0,0,2,1,0,3,0,0,1,1,0,2,"A","N","2020-01-04","202001040CBJ"
"LAK",0,0,1,0,0,1,0,2,0,2,0,4,"H","N","2020-01-04","202001040LAK"
"NSH",0,2,0,2,0,4,0,0,1,0,0,1,"A","N","2020-01-04","202001040LAK"
"MIN",1,1,0,1,0,3,0,0,1,1,0,2,"H","N","2020-01-04","202001040MIN"
"WPG",0,0,1,1,0,2,1,1,0,1,0,3,"A","N","2020-01-04","202001040MIN"
"MTL",0,1,1,0,0,2,1,1,0,1,0,3,"H","N","2020-01-04","202001040MTL"
"PIT",1,1,0,1,0,3,0,1,1,0,0,2,"A","N","2020-01-04","202001040MTL"
"COL",0,0,2,3,0,5,0,0,0,2,0,2,"A","N","2020-01-04","202001040NJD"
"NJD",0,0,0,2,0,2,0,0,2,3,0,5,"H","N","2020-01-04","202001040NJD"
"OTT",0,0,3,0,0,3,0,0,2,3,0,5,"H","N","2020-01-04","202001040OTT"
"TBL",0,0,2,3,0,5,0,0,3,0,0,3,"A","N","2020-01-04","202001040OTT"
"NYI",0,0,0,0,0,0,0,0,2,1,0,3,"A","N","2020-01-04","202001040TOR"
"TOR",0,0,2,1,0,3,0,0,0,0,0,0,"H","N","2020-01-04","202001040TOR"
"NYR",0,1,0,0,0,1,0,1,0,1,0,2,"A","N","2020-01-04","202001040VAN"
"VAN",0,1,0,1,0,2,0,1,0,0,0,1,"H","N","2020-01-04","202001040VAN"
"STL",0,3,0,1,0,4,1,0,2,2,0,5,"A","N","2020-01-04","202001040VEG"
"VEG",1,0,2,2,0,5,0,3,0,1,0,4,"H","N","2020-01-04","202001040VEG"
"ANA",0,1,3,0,1,5,0,1,1,2,0,4,"H","Y","2020-01-05","202001050ANA"
"NSH",0,1,1,2,0,4,0,1,3,0,1,5,"A","Y","2020-01-05","202001050ANA"
"CAR",0,0,0,1,0,1,0,2,1,0,0,3,"H","N","2020-01-05","202001050CAR"
"TBL",0,2,1,0,0,3,0,0,0,1,0,1,"A","N","2020-01-05","202001050CAR"
"CHI",0,0,2,2,0,4,0,2,0,0,0,2,"H","N","2020-01-05","202001050CHI"
"DET",0,2,0,0,0,2,0,0,2,2,0,4,"A","N","2020-01-05","202001050CHI"
"CGY",0,2,0,2,1,5,0,3,0,1,0,4,"A","Y","2020-01-05","202001050MIN"
"MIN",0,3,0,1,0,4,0,2,0,2,1,5,"H","Y","2020-01-05","202001050MIN"
"FLA",0,2,0,2,0,4,0,1,0,0,0,1,"A","N","2020-01-05","202001050PIT"
"PIT",0,1,0,0,0,1,0,2,0,2,0,4,"H","N","2020-01-05","202001050PIT"
"SJS",0,0,3,1,0,4,1,0,2,2,0,5,"A","N","2020-01-05","202001050WSH"
"WSH",1,0,2,2,0,5,0,0,3,1,0,4,"H","N","2020-01-05","202001050WSH"
"CBJ",0,0,2,2,0,4,0,1,0,1,0,2,"A","N","2020-01-06","202001060LAK"
"LAK",0,1,0,1,0,2,0,0,2,2,0,4,"H","N","2020-01-06","202001060LAK"
"MTL",0,0,1,1,0,2,0,0,2,1,0,3,"H","N","2020-01-06","202001060MTL"
"WPG",0,0,2,1,0,3,0,0,1,1,0,2,"A","N","2020-01-06","202001060MTL"
"COL",0,0,0,0,0,0,0,0,0,1,0,1,"A","N","2020-01-06","202001060NYI"
"NYI",0,0,0,1,0,1,0,0,0,0,0,0,"H","N","2020-01-06","202001060NYI"
"EDM",0,1,3,2,0,6,0,0,3,1,0,4,"A","N","2020-01-06","202001060TOR"
"TOR",0,0,3,1,0,4,0,1,3,2,0,6,"H","N","2020-01-06","202001060TOR"
"ANA",0,1,1,1,0,3,0,1,2,1,0,4,"H","N","2020-01-07","202001070ANA"
"CBJ",0,1,2,1,0,4,0,1,1,1,0,3,"A","N","2020-01-07","202001070ANA"
"CAR",1,2,2,0,0,5,0,2,1,1,0,4,"H","N","2020-01-07","202001070CAR"
"PHI",0,2,1,1,0,4,1,2,2,0,0,5,"A","N","2020-01-07","202001070CAR"
"CGY",0,0,2,0,0,2,0,1,0,0,0,1,"A","N","2020-01-07","202001070CHI"
"CHI",0,1,0,0,0,1,0,0,2,0,0,2,"H","N","2020-01-07","202001070CHI"
"DET",0,0,1,3,0,4,0,1,1,1,0,3,"H","N","2020-01-07","202001070DET"
"MTL",0,1,1,1,0,3,0,0,1,3,0,4,"A","N","2020-01-07","202001070DET"
"ARI",0,0,3,2,0,5,0,0,2,0,0,2,"A","N","2020-01-07","202001070FLA"
"FLA",0,0,2,0,0,2,0,0,3,2,0,5,"H","N","2020-01-07","202001070FLA"
"NJD",0,1,1,1,0,3,1,2,0,1,0,4,"H","N","2020-01-07","202001070NJD"
"NYI",1,2,0,1,0,4,0,1,1,1,0,3,"A","N","2020-01-07","202001070NJD"
"BOS",0,1,2,3,0,6,0,0,1,1,0,2,"A","N","2020-01-07","202001070NSH"
"NSH",0,0,1,1,0,2,0,1,2,3,0,6,"H","N","2020-01-07","202001070NSH"
"COL",0,2,1,0,0,3,0,2,2,1,0,5,"A","N","2020-01-07","202001070NYR"
"NYR",0,2,2,1,0,5,0,2,1,0,0,3,"H","N","2020-01-07","202001070NYR"
"SJS",0,0,0,2,0,2,0,0,2,1,0,3,"A","N","2020-01-07","202001070STL"
"STL",0,0,2,1,0,3,0,0,0,2,0,2,"H","N","2020-01-07","202001070STL"
"TBL",0,0,6,3,0,9,0,1,1,0,0,2,"H","N","2020-01-07","202001070TBL"
"VAN",0,1,1,0,0,2,0,0,6,3,0,9,"A","N","2020-01-07","202001070TBL"
"PIT",0,2,1,1,0,4,0,0,2,1,0,3,"A","N","2020-01-07","202001070VEG"
"VEG",0,0,2,1,0,3,0,2,1,1,0,4,"H","N","2020-01-07","202001070VEG"
"OTT",0,1,0,0,0,1,0,0,3,3,0,6,"A","N","2020-01-07","202001070WSH"
"WSH",0,0,3,3,0,6,0,1,0,0,0,1,"H","N","2020-01-07","202001070WSH"
"DAL",0,0,2,0,0,2,0,1,0,0,0,1,"A","N","2020-01-08","202001080LAK"
"LAK",0,1,0,0,0,1,0,0,2,0,0,2,"H","N","2020-01-08","202001080LAK"
"PHI",0,2,1,0,0,3,0,2,0,0,0,2,"H","N","2020-01-08","202001080PHI"
"WSH",0,2,0,0,0,2,0,2,1,0,0,3,"A","N","2020-01-08","202001080PHI"
"TOR",0,1,1,1,0,3,0,2,1,0,1,4,"H","Y","2020-01-08","202001080TOR"
"WPG",0,2,1,0,1,4,0,1,1,1,0,3,"A","Y","2020-01-08","202001080TOR"
"ANA",0,0,0,0,0,0,0,1,1,1,0,3,"H","N","2020-01-09","202001090ANA"
"DAL",0,1,1,1,0,3,0,0,0,0,0,0,"A","N","2020-01-09","202001090ANA"
"BOS",0,1,2,2,0,5,0,1,2,1,0,4,"H","N","2020-01-09","202001090BOS"
"WPG",0,1,2,1,0,4,0,1,2,2,0,5,"A","N","2020-01-09","202001090BOS"
"CGY",0,1,1,0,0,2,0,0,1,0,0,1,"H","N","2020-01-09","202001090CGY"
"MIN",0,0,1,0,0,1,0,1,1,0,0,2,"A","N","2020-01-09","202001090CGY"
"CHI",0,0,1,1,0,2,0,3,0,2,0,5,"H","N","2020-01-09","202001090CHI"
"NSH",0,3,0,2,0,5,0,0,1,1,0,2,"A","N","2020-01-09","202001090CHI"
"FLA",0,3,1,1,0,5,0,1,0,1,0,2,"H","N","2020-01-09","202001090FLA"
"VAN",0,1,0,1,0,2,0,3,1,1,0,5,"A","N","2020-01-09","202001090FLA"
"EDM",0,0,1,3,0,4,0,1,1,0,0,2,"A","N","2020-01-09","202001090MTL"
"MTL",0,1,1,0,0,2,0,0,1,3,0,4,"H","N","2020-01-09","202001090MTL"
"NJD",0,2,1,0,0,3,0,3,2,1,0,6,"A","N","2020-01-09","202001090NYR"
"NYR",0,3,2,1,0,6,0,2,1,0,0,3,"H","N","2020-01-09","202001090NYR"
"CBJ",0,0,1,0,0,1,0,0,2,1,0,3,"A","N","2020-01-09","202001090SJS"
"SJS",0,0,2,1,0,3,0,0,1,0,0,1,"H","N","2020-01-09","202001090SJS"
"BUF",0,0,1,0,0,1,0,2,1,2,0,5,"A","N","2020-01-09","202001090STL"
"STL",0,2,1,2,0,5,0,0,1,0,0,1,"H","N","2020-01-09","202001090STL"
"ARI",0,0,0,0,0,0,0,2,2,0,0,4,"A","N","2020-01-09","202001090TBL"
"TBL",0,2,2,0,0,4,0,0,0,0,0,0,"H","N","2020-01-09","202001090TBL"
"LAK",0,4,0,1,0,5,0,0,2,0,0,2,"A","N","2020-01-09","202001090VEG"
"VEG",0,0,2,0,0,2,0,4,0,1,0,5,"H","N","2020-01-09","202001090VEG"
"ARI",0,0,0,0,0,0,0,1,2,0,0,3,"A","N","2020-01-10","202001100CAR"
"CAR",0,1,2,0,0,3,0,0,0,0,0,0,"H","N","2020-01-10","202001100CAR"
"COL",0,1,1,1,0,3,1,0,1,2,0,4,"H","N","2020-01-10","202001100COL"
"PIT",1,0,1,2,0,4,0,1,1,1,0,3,"A","N","2020-01-10","202001100COL"
"DET",0,1,1,0,1,3,0,0,2,0,0,2,"H","Y","2020-01-10","202001100DET"
"OTT",0,0,2,0,0,2,0,1,1,0,1,3,"A","Y","2020-01-10","202001100DET"
"BUF",0,1,1,1,0,3,0,1,1,4,0,6,"H","N","2020-01-11","202001110BUF"
"VAN",0,1,1,4,0,6,0,1,1,1,0,3,"A","N","2020-01-11","202001110BUF"
"CAR",0,1,0,1,0,2,0,0,0,0,0,0,"H","N","2020-01-11","202001110CAR"
"LAK",0,0,0,0,0,0,0,1,0,1,0,2,"A","N","2020-01-11","202001110CAR"
"CGY",0,2,1,1,0,4,0,2,1,0,0,3,"H","N","2020-01-11","202001110CGY"
"EDM",0,2,1,0,0,3,0,2,1,1,0,4,"A","N","2020-01-11","202001110CGY"
"ANA",0,1,0,1,0,2,0,1,2,1,0,4,"A","N","2020-01-11","202001110CHI"
"CHI",0,1,2,1,0,4,0,1,0,1,0,2,"H","N","2020-01-11","202001110CHI"
"BOS",1,0,1,1,0,3,0,1,0,1,0,2,"A","N","2020-01-11","202001110NYI"
"NYI",0,1,0,1,0,2,1,0,1,1,0,3,"H","N","2020-01-11","202001110NYI"
"MTL",1,1,0,0,0,2,0,0,0,1,0,1,"A","N","2020-01-11","202001110OTT"
"OTT",0,0,0,1,0,1,1,1,0,0,0,2,"H","N","2020-01-11","202001110OTT"
"PHI",0,0,0,0,0,0,0,0,1,0,0,1,"H","N","2020-01-11","202001110PHI"
"TBL",0,0,1,0,0,1,0,0,0,0,0,0,"A","N","2020-01-11","202001110PHI"
"DAL",0,1,0,0,0,1,0,1,1,0,0,2,"A","N","2020-01-11","202001110SJS"
"SJS",0,1,1,0,0,2,0,1,0,0,0,1,"H","N","2020-01-11","202001110SJS"
"NYR",0,1,1,0,0,2,0,2,3,0,0,5,"A","N","2020-01-11","202001110STL"
"STL",0,2,3,0,0,5,0,1,1,0,0,2,"H","N","2020-01-11","202001110STL"
"CBJ",0,1,1,1,0,3,0,0,0,0,0,0,"A","N","2020-01-11","202001110VEG"
"VEG",0,0,0,0,0,0,0,1,1,1,0,3,"H","N","2020-01-11","202001110VEG"
"NJD",0,1,3,1,0,5,0,0,1,0,0,1,"A","N","2020-01-11","202001110WSH"
"WSH",0,0,1,0,0,1,0,1,3,1,0,5,"H","N","2020-01-11","202001110WSH"
"ARI",0,1,1,1,0,3,0,1,1,1,1,4,"H","Y","2020-01-12","202001120ARI"
"PIT",0,1,1,1,1,4,0,1,1,1,0,3,"A","Y","2020-01-12","202001120ARI"
"BUF",0,3,0,2,0,5,0,0,1,0,0,1,"A","N","2020-01-12","202001120DET"
"DET",0,0,1,0,0,1,0,3,0,2,0,5,"H","N","2020-01-12","202001120DET"
"FLA",0,3,4,1,0,8,0,0,3,1,0,4,"H","N","2020-01-12","202001120FLA"
"TOR",0,0,3,1,0,4,0,3,4,1,0,8,"A","N","2020-01-12","202001120FLA"
"MIN",0,0,1,0,0,1,0,0,3,1,0,4,"H","N","2020-01-12","202001120MIN"
"VAN",0,0,3,1,0,4,0,0,1,0,0,1,"A","N","2020-01-12","202001120MIN"
"NJD",0,0,2,1,0,3,0,0,1,0,0,1,"H","N","2020-01-12","202001120NJD"
"TBL",0,0,1,0,0,1,0,0,2,1,0,3,"A","N","2020-01-12","202001120NJD"
"NSH",0,1,0,0,0,1,0,0,0,0,0,0,"A","N","2020-01-12","202001120WPG"
"WPG",0,0,0,0,0,0,0,1,0,0,0,1,"H","N","2020-01-12","202001120WPG"
"CGY",0,0,0,0,0,0,0,1,0,1,0,2,"A","N","2020-01-13","202001130MTL"
"MTL",0,1,0,1,0,2,0,0,0,0,0,0,"H","N","2020-01-13","202001130MTL"
"NYI",0,1,0,1,0,2,0,1,2,3,0,6,"A","N","2020-01-13","202001130NYR"
"NYR",0,1,2,3,0,6,0,1,0,1,0,2,"H","N","2020-01-13","202001130NYR"
"BOS",0,2,3,0,0,5,0,1,3,1,1,6,"A","Y","2020-01-13","202001130PHI"
"PHI",0,1,3,1,1,6,0,2,3,0,0,5,"H","Y","2020-01-13","202001130PHI"
"ANA",0,1,0,0,0,1,0,1,2,1,0,4,"A","N","2020-01-13","202001130STL"
"STL",0,1,2,1,0,4,0,1,0,0,0,1,"H","N","2020-01-13","202001130STL"
"CAR",0,0,0,0,0,0,0,2,0,0,0,2,"A","N","2020-01-13","202001130WSH"
"WSH",0,2,0,0,0,2,0,0,0,0,0,0,"H","N","2020-01-13","202001130WSH"
"ARI",0,1,2,3,0,6,0,0,2,1,0,3,"H","N","2020-01-14","202001140ARI"
"SJS",0,0,2,1,0,3,0,1,2,3,0,6,"A","N","2020-01-14","202001140ARI"
"BUF",0,0,2,2,0,4,0,0,1,1,0,2,"H","N","2020-01-14","202001140BUF"
"VEG",0,0,1,1,0,2,0,0,2,2,0,4,"A","N","2020-01-14","202001140BUF"
"BOS",0,0,0,0,0,0,0,1,0,2,0,3,"A","N","2020-01-14","202001140CBJ"
"CBJ",0,1,0,2,0,3,0,0,0,0,0,0,"H","N","2020-01-14","202001140CBJ"
"COL",0,2,0,0,0,2,1,0,1,1,0,3,"H","N","2020-01-14","202001140COL"
"DAL",1,0,1,1,0,3,0,2,0,0,0,2,"A","N","2020-01-14","202001140COL"
"EDM",0,2,1,1,0,4,0,2,0,0,0,2,"H","N","2020-01-14","202001140EDM"
"NSH",0,2,0,0,0,2,0,2,1,1,0,4,"A","N","2020-01-14","202001140EDM"
"DET",0,1,0,1,0,2,0,4,2,2,0,8,"A","N","2020-01-14","202001140NYI"
"NYI",0,4,2,2,0,8,0,1,0,1,0,2,"H","N","2020-01-14","202001140NYI"
"CHI",1,0,1,1,0,3,0,2,0,0,0,2,"A","N","2020-01-14","202001140OTT"
"OTT",0,2,0,0,0,2,1,0,1,1,0,3,"H","N","2020-01-14","202001140OTT"
"MIN",0,0,1,2,0,3,0,2,2,3,0,7,"A","N","2020-01-14","202001140PIT"
"PIT",0,2,2,3,0,7,0,0,1,2,0,3,"H","N","2020-01-14","202001140PIT"
"LAK",0,2,0,1,0,3,0,2,0,1,1,4,"A","Y","2020-01-14","202001140TBL"
"TBL",0,2,0,1,1,4,0,2,0,1,0,3,"H","Y","2020-01-14","202001140TBL"
"NJD",0,0,1,3,0,4,0,3,2,2,0,7,"A","N","2020-01-14","202001140TOR"
"TOR",0,3,2,2,0,7,0,0,1,3,0,4,"H","N","2020-01-14","202001140TOR"
"VAN",0,0,0,0,0,0,0,2,1,1,0,4,"A","N","2020-01-14","202001140WPG"
"WPG",0,2,1,1,0,4,0,0,0,0,0,0,"H","N","2020-01-14","202001140WPG"
"CHI",0,2,1,1,0,4,0,0,1,0,0,1,"A","N","2020-01-15","202001150MTL"
"MTL",0,0,1,0,0,1,0,2,1,1,0,4,"H","N","2020-01-15","202001150MTL"
"PHI",1,0,2,1,0,4,0,1,0,2,0,3,"A","N","2020-01-15","202001150STL"
"STL",0,1,0,2,0,3,1,0,2,1,0,4,"H","N","2020-01-15","202001150STL"
"BOS",0,2,0,2,0,4,0,1,0,0,0,1,"H","N","2020-01-16","202001160BOS"
"PIT",0,1,0,0,0,1,0,2,0,2,0,4,"A","N","2020-01-16","202001160BOS"
"CAR",0,0,1,1,0,2,0,1,0,2,0,3,"A","N","2020-01-16","202001160CBJ"
"CBJ",0,1,0,2,0,3,0,0,1,1,0,2,"H","N","2020-01-16","202001160CBJ"
"COL",0,2,2,0,0,4,0,0,0,0,0,0,"H","N","2020-01-16","202001160COL"
"SJS",0,0,0,0,0,0,0,2,2,0,0,4,"A","N","2020-01-16","202001160COL"
"BUF",0,1,1,2,0,4,0,0,1,0,0,1,"A","N","2020-01-16","202001160DAL"
"DAL",0,0,1,0,0,1,0,1,1,2,0,4,"H","N","2020-01-16","202001160DAL"
"FLA",0,1,1,2,0,4,0,0,0,3,0,3,"H","N","2020-01-16","202001160FLA"
"LAK",0,0,0,3,0,3,0,1,1,2,0,4,"A","N","2020-01-16","202001160FLA"
"MIN",0,1,2,0,0,3,0,0,1,1,0,2,"H","N","2020-01-16","202001160MIN"
"TBL",0,0,1,1,0,2,0,1,2,0,0,3,"A","N","2020-01-16","202001160MIN"
"ANA",0,2,1,1,0,4,0,1,0,1,0,2,"A","N","2020-01-16","202001160NSH"
"NSH",0,1,0,1,0,2,0,2,1,1,0,4,"H","N","2020-01-16","202001160NSH"
"NYI",0,1,0,1,0,2,0,0,1,2,0,3,"H","N","2020-01-16","202001160NYI"
"NYR",0,0,1,2,0,3,0,1,0,1,0,2,"A","N","2020-01-16","202001160NYI"
"OTT",0,0,0,2,0,2,0,1,1,2,0,4,"H","N","2020-01-16","202001160OTT"
"VEG",0,1,1,2,0,4,0,0,0,2,0,2,"A","N","2020-01-16","202001160OTT"
"MTL",0,1,2,1,0,4,0,1,0,0,0,1,"A","N","2020-01-16","202001160PHI"
"PHI",0,1,0,0,0,1,0,1,2,1,0,4,"H","N","2020-01-16","202001160PHI"
"CGY",0,0,1,0,1,2,0,0,0,1,0,1,"A","Y","2020-01-16","202001160TOR"
"TOR",0,0,0,1,0,1,0,0,1,0,1,2,"H","Y","2020-01-16","202001160TOR"
"ARI",0,1,0,0,0,1,0,1,1,1,0,3,"A","N","2020-01-16","202001160VAN"
"VAN",0,1,1,1,0,3,0,1,0,0,0,1,"H","N","2020-01-16","202001160VAN"
"NJD",0,0,1,1,0,2,0,2,1,2,0,5,"A","N","2020-01-16","202001160WSH"
"WSH",0,2,1,2,0,5,0,0,1,1,0,2,"H","N","2020-01-16","202001160WSH"
"ANA",1,1,0,0,0,2,0,1,0,0,0,1,"A","N","2020-01-17","202001170CAR"
"CAR",0,1,0,0,0,1,1,1,0,0,0,2,"H","N","2020-01-17","202001170CAR"
"DET",0,0,1,0,0,1,1,0,0,1,0,2,"H","N","2020-01-17","202001170DET"
"PIT",1,0,0,1,0,2,0,0,1,0,0,1,"A","N","2020-01-17","202001170DET"
"TBL",0,3,2,2,0,7,0,0,1,0,0,1,"A","N","2020-01-17","202001170WPG"
"WPG",0,0,1,0,0,1,0,3,2,2,0,7,"H","N","2020-01-17","202001170WPG"
"CBJ",0,1,4,0,0,5,0,0,0,0,0,0,"H","N","2020-01-18","202001180CBJ"
"NJD",0,0,0,0,0,0,0,1,4,0,0,5,"A","N","2020-01-18","202001180CBJ"
"COL",0,1,3,1,0,5,0,1,1,1,0,3,"H","N","2020-01-18","202001180COL"
"STL",0,1,1,1,0,3,0,1,3,1,0,5,"A","N","2020-01-18","202001180COL"
"DET",0,0,1,0,0,1,0,2,0,2,0,4,"H","N","2020-01-18","202001180DET"
"FLA",0,2,0,2,0,4,0,0,1,0,0,1,"A","N","2020-01-18","202001180DET"
"ARI",0,0,2,1,0,3,0,3,3,1,0,7,"A","N","2020-01-18","202001180EDM"
"EDM",0,3,3,1,0,7,0,0,2,1,0,3,"H","N","2020-01-18","202001180EDM"
"DAL",0,0,0,0,0,0,0,2,3,2,0,7,"A","N","2020-01-18","202001180MIN"
"MIN",0,2,3,2,0,7,0,0,0,0,0,0,"H","N","2020-01-18","202001180MIN"
"MTL",0,3,0,1,1,5,0,0,2,2,0,4,"H","Y","2020-01-18","202001180MTL"
"VEG",0,0,2,2,0,4,0,3,0,1,1,5,"A","Y","2020-01-18","202001180MTL"
"BUF",0,1,0,0,0,1,0,0,1,1,0,2,"A","N","2020-01-18","202001180NSH"
"NSH",0,0,1,1,0,2,0,1,0,0,0,1,"H","N","2020-01-18","202001180NSH"
"NYI",0,2,2,0,0,4,0,1,0,5,0,6,"H","N","2020-01-18","202001180NYI"
"WSH",0,1,0,5,0,6,0,2,2,0,0,4,"A","N","2020-01-18","202001180NYI"
"CGY",0,0,0,2,0,2,0,1,2,2,0,5,"A","N","2020-01-18","202001180OTT"
"OTT",0,1,2,2,0,5,0,0,0,2,0,2,"H","N","2020-01-18","202001180OTT"
"LAK",0,0,0,1,0,1,0,1,2,1,0,4,"A","N","2020-01-18","202001180PHI"
"PHI",0,1,2,1,0,4,0,0,0,1,0,1,"H","N","2020-01-18","202001180PHI"
"CHI",0,3,3,0,0,6,0,0,2,0,0,2,"A","N","2020-01-18","202001180TOR"
"TOR",0,0,2,0,0,2,0,3,3,0,0,6,"H","N","2020-01-18","202001180TOR"
"SJS",0,0,0,1,0,1,0,0,1,3,0,4,"A","N","2020-01-18","202001180VAN"
"VAN",0,0,1,3,0,4,0,0,0,1,0,1,"H","N","2020-01-18","202001180VAN"
"CAR",0,1,0,0,1,2,0,0,1,0,0,1,"H","Y","2020-01-19","202001190CAR"
"NYI",0,0,1,0,0,1,0,1,0,0,1,2,"A","Y","2020-01-19","202001190CAR"
"CHI",0,2,0,3,0,5,0,0,1,1,0,2,"H","N","2020-01-19","202001190CHI"
"WPG",0,0,1,1,0,2,0,2,0,3,0,5,"A","N","2020-01-19","202001190CHI"
"CBJ",0,0,0,2,0,2,0,1,0,0,0,1,"A","N","2020-01-19","202001190NYR"
"NYR",0,1,0,0,0,1,0,0,0,2,0,2,"H","N","2020-01-19","202001190NYR"
"BOS",0,3,0,0,0,3,0,1,1,2,0,4,"A","N","2020-01-19","202001190PIT"
"PIT",0,1,1,2,0,4,0,3,0,0,0,3,"H","N","2020-01-19","202001190PIT"
"COL",0,0,2,4,0,6,0,1,0,2,0,3,"H","N","2020-01-20","202001200COL"
"DET",0,1,0,2,0,3,0,0,2,4,0,6,"A","N","2020-01-20","202001200COL"
"FLA",0,1,1,3,0,5,0,1,1,2,0,4,"A","N","2020-01-20","202001200MIN"
"MIN",0,1,1,2,0,4,0,1,1,3,0,5,"H","N","2020-01-20","202001200MIN"
"BOS",0,1,0,2,0,3,0,1,1,0,0,2,"H","N","2020-01-21","202001210BOS"
"VEG",0,1,1,0,0,2,0,1,0,2,0,3,"A","N","2020-01-21","202001210BOS"
"CAR",0,3,0,1,0,4,0,1,0,0,0,1,"H","N","2020-01-21","202001210CAR"
"WPG",0,1,0,0,0,1,0,3,0,1,0,4,"A","N","2020-01-21","202001210CAR"
"CHI",0,0,1,2,0,3,0,0,4,0,0,4,"H","N","2020-01-21","202001210CHI"
"FLA",0,0,4,0,0,4,0,0,1,2,0,3,"A","N","2020-01-21","202001210CHI"
"NYI",0,2,1,1,0,4,0,0,0,2,0,2,"A","N","2020-01-21","202001210NYR"
"NYR",0,0,0,2,0,2,0,2,1,1,0,4,"H","N","2020-01-21","202001210NYR"
"PHI",0,0,2,1,0,3,0,0,0,0,0,0,"H","N","2020-01-21","202001210PHI"
"PIT",0,0,0,0,0,0,0,0,2,1,0,3,"A","N","2020-01-21","202001210PHI"
"CBJ",0,1,2,1,0,4,0,2,1,0,0,3,"H","N","2020-01-22","202001220CBJ"
"WPG",0,2,1,0,0,3,0,1,2,1,0,4,"A","N","2020-01-22","202001220CBJ"
"DET",0,2,0,0,0,2,0,1,3,0,0,4,"A","N","2020-01-22","202001220MIN"
"MIN",0,1,3,0,0,4,0,2,0,0,0,2,"H","N","2020-01-22","202001220MIN"
"DAL",1,0,1,1,0,3,0,0,1,1,0,2,"H","N","2020-01-27","202001270DAL"
"TBL",0,0,1,1,0,2,1,0,1,1,0,3,"A","N","2020-01-27","202001270DAL"
"MTL",0,1,0,1,0,2,0,1,2,1,0,4,"H","N","2020-01-27","202001270MTL"
"WSH",0,1,2,1,0,4,0,1,0,1,0,2,"A","N","2020-01-27","202001270MTL"
"NSH",0,1,0,1,0,2,0,2,2,1,0,5,"H","N","2020-01-27","202001270NSH"
"TOR",0,2,2,1,0,5,0,1,0,1,0,2,"A","N","2020-01-27","202001270NSH"
"NJD",0,1,1,1,1,4,0,1,0,2,0,3,"A","Y","2020-01-27","202001270OTT"
"OTT",0,1,0,2,0,3,0,1,1,1,1,4,"H","Y","2020-01-27","202001270OTT"
"ANA",0,0,1,1,0,2,0,2,1,1,0,4,"A","N","2020-01-27","202001270SJS"
"SJS",0,2,1,1,0,4,0,0,1,1,0,2,"H","N","2020-01-27","202001270SJS"
"STL",0,1,0,0,0,1,0,0,2,1,0,3,"A","N","2020-01-27","202001270VAN"
"VAN",0,0,2,1,0,3,0,1,0,0,0,1,"H","N","2020-01-27","202001270VAN"
"BUF",0,1,1,0,0,2,0,1,1,3,0,5,"H","N","2020-01-28","202001280BUF"
"OTT",0,1,1,3,0,5,0,1,1,0,0,2,"A","N","2020-01-28","202001280BUF"
"CGY",0,2,2,0,0,4,0,3,0,1,1,5,"H","Y","2020-01-28","202001280CGY"
"STL",0,3,0,1,1,5,0,2,2,0,0,4,"A","Y","2020-01-28","202001280CGY"
"ANA",0,2,2,0,0,4,0,1,1,0,0,2,"H","N","2020-01-29","202001290ANA"
"ARI",0,1,1,0,0,2,0,2,2,0,0,4,"A","N","2020-01-29","202001290ANA"
"DAL",0,1,1,1,0,3,0,1,2,2,0,5,"H","N","2020-01-29","202001290DAL"
"TOR",0,1,2,2,0,5,0,1,1,1,0,3,"A","N","2020-01-29","202001290DAL"
"CGY",0,1,2,0,1,4,0,0,2,1,0,3,"A","Y","2020-01-29","202001290EDM"
"EDM",0,0,2,1,0,3,0,1,2,0,1,4,"H","Y","2020-01-29","202001290EDM"
"LAK",0,1,1,0,0,2,0,0,2,2,0,4,"H","N","2020-01-29","202001290LAK"
"TBL",0,0,2,2,0,4,0,1,1,0,0,2,"A","N","2020-01-29","202001290LAK"
"SJS",0,1,1,0,0,2,0,1,0,4,0,5,"H","N","2020-01-29","202001290SJS"
"VAN",0,1,0,4,0,5,0,1,1,0,0,2,"A","N","2020-01-29","202001290SJS"
"NSH",0,3,0,2,0,5,0,2,2,0,0,4,"A","N","2020-01-29","202001290WSH"
"WSH",0,2,2,0,0,4,0,3,0,2,0,5,"H","N","2020-01-29","202001290WSH"
"ARI",0,0,2,0,0,2,1,1,0,1,0,3,"H","N","2020-01-30","202001300ARI"
"LAK",1,1,0,1,0,3,0,0,2,0,0,2,"A","N","2020-01-30","202001300ARI"
"BUF",0,1,0,0,0,1,0,0,2,1,0,3,"H","N","2020-01-30","202001300BUF"
"MTL",0,0,2,1,0,3,0,1,0,0,0,1,"A","N","2020-01-30","202001300BUF"
"NJD",0,1,3,1,0,5,0,2,1,2,1,6,"H","Y","2020-01-30","202001300NJD"
"NSH",0,2,1,2,1,6,0,1,3,1,0,5,"A","Y","2020-01-30","202001300NJD"
"ANA",0,2,0,1,0,3,0,2,1,1,0,4,"H","N","2020-01-31","202001310ANA"
"TBL",0,2,1,1,0,4,0,2,0,1,0,3,"A","N","2020-01-31","202001310ANA"
"CAR",0,0,1,2,0,3,0,2,0,2,0,4,"H","N","2020-01-31","202001310CAR"
"VEG",0,2,0,2,0,4,0,0,1,2,0,3,"A","N","2020-01-31","202001310CAR"
"EDM",0,2,0,2,0,4,0,0,1,1,0,2,"H","N","2020-01-31","202001310EDM"
"STL",0,0,1,1,0,2,0,2,0,2,0,4,"A","N","2020-01-31","202001310EDM"
"DET",0,0,0,2,0,2,0,0,3,1,0,4,"A","N","2020-01-31","202001310NYR"
"NYR",0,0,3,1,0,4,0,0,0,2,0,2,"H","N","2020-01-31","202001310NYR"
"OTT",0,0,2,1,0,3,0,2,1,2,0,5,"H","N","2020-01-31","202001310OTT"
"WSH",0,2,1,2,0,5,0,0,2,1,0,3,"A","N","2020-01-31","202001310OTT"
"PHI",0,1,1,1,0,3,1,0,3,0,0,4,"A","N","2020-01-31","202001310PIT"
"PIT",1,0,3,0,0,4,0,1,1,1,0,3,"H","N","2020-01-31","202001310PIT"
"BOS",0,1,0,1,0,2,0,1,0,0,0,1,"A","N","2020-01-31","202001310WPG"
"WPG",0,1,0,0,0,1,0,1,0,1,0,2,"H","N","2020-01-31","202001310WPG"
"ARI",0,0,2,0,0,2,0,1,1,0,1,3,"H","Y","2020-02-01","202002010ARI"
"CHI",0,1,1,0,1,3,0,0,2,0,0,2,"A","Y","2020-02-01","202002010ARI"
"BUF",1,1,0,0,0,2,0,0,0,1,0,1,"H","N","2020-02-01","202002010BUF"
"CBJ",0,0,0,1,0,1,1,1,0,0,0,2,"A","N","2020-02-01","202002010BUF"
"CGY",0,1,2,0,0,3,0,3,3,2,0,8,"H","N","2020-02-01","202002010CGY"
"EDM",0,3,3,2,0,8,0,1,2,0,0,3,"A","N","2020-02-01","202002010CGY"
"DET",0,0,0,0,0,0,0,1,0,0,0,1,"H","N","2020-02-01","202002010DET"
"NYR",0,1,0,0,0,1,0,0,0,0,0,0,"A","N","2020-02-01","202002010DET"
"ANA",0,1,2,0,0,3,0,0,1,0,0,1,"A","N","2020-02-01","202002010LAK"
"LAK",0,0,1,0,0,1,0,1,2,0,0,3,"H","N","2020-02-01","202002010LAK"
"BOS",0,1,3,2,0,6,0,0,0,1,0,1,"A","N","2020-02-01","202002010MIN"
"MIN",0,0,0,1,0,1,0,1,3,2,0,6,"H","N","2020-02-01","202002010MIN"
"FLA",0,0,0,0,0,0,0,1,2,1,0,4,"A","N","2020-02-01","202002010MTL"
"MTL",0,1,2,1,0,4,0,0,0,0,0,0,"H","N","2020-02-01","202002010MTL"
"DAL",1,0,1,1,0,3,0,1,0,1,0,2,"A","N","2020-02-01","202002010NJD"
"NJD",0,1,0,1,0,2,1,0,1,1,0,3,"H","N","2020-02-01","202002010NJD"
"NSH",0,0,0,0,0,0,0,0,1,2,0,3,"H","N","2020-02-01","202002010NSH"
"VEG",0,0,1,2,0,3,0,0,0,0,0,0,"A","N","2020-02-01","202002010NSH"
"NYI",0,1,1,1,0,3,1,1,2,0,0,4,"H","N","2020-02-01","202002010NYI"
"VAN",1,1,2,0,0,4,0,1,1,1,0,3,"A","N","2020-02-01","202002010NYI"
"COL",0,0,2,1,0,3,0,2,1,3,0,6,"A","N","2020-02-01","202002010PHI"
"PHI",0,2,1,3,0,6,0,0,2,1,0,3,"H","N","2020-02-01","202002010PHI"
"SJS",0,0,0,0,0,0,0,0,1,2,0,3,"H","N","2020-02-01","202002010SJS"
"TBL",0,0,1,2,0,3,0,0,0,0,0,0,"A","N","2020-02-01","202002010SJS"
"OTT",0,0,1,0,0,1,1,0,1,0,0,2,"A","N","2020-02-01","202002010TOR"
"TOR",1,0,1,0,0,2,0,0,1,0,0,1,"H","N","2020-02-01","202002010TOR"
"STL",0,0,0,2,0,2,0,1,2,2,0,5,"A","N","2020-02-01","202002010WPG"
"WPG",0,1,2,2,0,5,0,0,0,2,0,2,"H","N","2020-02-01","202002010WPG"
"CAR",0,0,2,1,1,4,0,1,1,1,0,3,"H","Y","2020-02-02","202002020CAR"
"VAN",0,1,1,1,0,3,0,0,2,1,1,4,"A","Y","2020-02-02","202002020CAR"
"CBJ",0,1,2,1,0,4,0,0,1,2,0,3,"A","N","2020-02-02","202002020MTL"
"MTL",0,0,1,2,0,3,0,1,2,1,0,4,"H","N","2020-02-02","202002020MTL"
"PIT",0,2,1,1,0,4,0,1,0,2,0,3,"A","N","2020-02-02","202002020WSH"
"WSH",0,1,0,2,0,3,0,2,1,1,0,4,"H","N","2020-02-02","202002020WSH"
"DET",0,0,0,0,0,0,0,0,1,2,0,3,"H","N","2020-02-03","202002030DET"
"PHI",0,0,1,2,0,3,0,0,0,0,0,0,"A","N","2020-02-03","202002030DET"
"DAL",0,2,2,1,0,5,0,2,0,1,0,3,"A","N","2020-02-03","202002030NYR"
"NYR",0,2,0,1,0,3,0,2,2,1,0,5,"H","N","2020-02-03","202002030NYR"
"FLA",0,1,0,4,0,5,0,0,2,1,0,3,"A","N","2020-02-03","202002030TOR"
"TOR",0,0,2,1,0,3,0,1,0,4,0,5,"H","N","2020-02-03","202002030TOR"
"ARI",0,0,2,1,0,3,0,0,0,0,0,0,"H","N","2020-02-04","202002040ARI"
"EDM",0,0,0,0,0,0,0,0,2,1,0,3,"A","N","2020-02-04","202002040ARI"
"BOS",0,1,1,2,0,4,0,0,0,0,0,0,"H","N","2020-02-04","202002040BOS"
"VAN",0,0,0,0,0,0,0,1,1,2,0,4,"A","N","2020-02-04","202002040BOS"
"BUF",0,1,0,0,0,1,0,2,4,0,0,6,"H","N","2020-02-04","202002040BUF"
"COL",0,2,4,0,0,6,0,1,0,0,0,1,"A","N","2020-02-04","202002040BUF"
"CBJ",1,0,0,0,0,1,0,0,0,0,0,0,"H","N","2020-02-04","202002040CBJ"
"FLA",0,0,0,0,0,0,1,0,0,0,0,1,"A","N","2020-02-04","202002040CBJ"
"CGY",0,0,1,0,0,1,0,0,2,1,0,3,"H","N","2020-02-04","202002040CGY"
"SJS",0,0,2,1,0,3,0,0,1,0,0,1,"A","N","2020-02-04","202002040CGY"
"CHI",0,0,0,2,0,2,1,0,2,0,0,3,"A","N","2020-02-04","202002040MIN"
"MIN",1,0,2,0,0,3,0,0,0,2,0,2,"H","N","2020-02-04","202002040MIN"
"MTL",0,0,2,2,1,5,0,1,2,1,0,4,"A","Y","2020-02-04","202002040NJD"
"NJD",0,1,2,1,0,4,0,0,2,2,1,5,"H","Y","2020-02-04","202002040NJD"
"DAL",0,1,1,1,0,3,1,1,1,1,0,4,"A","N","2020-02-04","202002040NYI"
"NYI",1,1,1,1,0,4,0,1,1,1,0,3,"H","N","2020-02-04","202002040NYI"
"ANA",0,1,1,0,1,3,0,0,1,1,0,2,"A","Y","2020-02-04","202002040OTT"
"OTT",0,0,1,1,0,2,0,1,1,0,1,3,"H","Y","2020-02-04","202002040OTT"
"CAR",0,0,1,2,0,3,0,1,4,1,0,6,"A","N","2020-02-04","202002040STL"
"STL",0,1,4,1,0,6,0,0,1,2,0,3,"H","N","2020-02-04","202002040STL"
"TBL",0,2,0,2,0,4,0,1,0,1,0,2,"H","N","2020-02-04","202002040TBL"
"VEG",0,1,0,1,0,2,0,2,0,2,0,4,"A","N","2020-02-04","202002040TBL"
"NSH",1,1,0,0,0,2,0,1,0,0,0,1,"A","N","2020-02-04","202002040WPG"
"WPG",0,1,0,0,0,1,1,1,0,0,0,2,"H","N","2020-02-04","202002040WPG"
"LAK",0,1,0,1,0,2,0,0,1,3,0,4,"A","N","2020-02-04","202002040WSH"
"WSH",0,0,1,3,0,4,0,1,0,1,0,2,"H","N","2020-02-04","202002040WSH"
"BOS",1,0,1,0,0,2,0,0,1,0,0,1,"A","N","2020-02-05","202002050CHI"
"CHI",0,0,1,0,0,1,1,0,1,0,0,2,"H","N","2020-02-05","202002050CHI"
"NYR",0,3,1,1,0,5,0,1,1,1,0,3,"H","N","2020-02-05","202002050NYR"
"TOR",0,1,1,1,0,3,0,3,1,1,0,5,"A","N","2020-02-05","202002050NYR"
"ARI",0,1,1,1,0,3,0,0,3,2,0,5,"H","N","2020-02-06","202002060ARI"
"CAR",0,0,3,2,0,5,0,1,1,1,0,3,"A","N","2020-02-06","202002060ARI"
"BUF",0,0,0,3,0,3,0,2,0,1,1,4,"H","Y","2020-02-06","202002060BUF"
"DET",0,2,0,1,1,4,0,0,0,3,0,3,"A","Y","2020-02-06","202002060BUF"
"CGY",0,1,1,0,0,2,0,2,1,0,0,3,"H","N","2020-02-06","202002060CGY"
"NSH",0,2,1,0,0,3,0,1,1,0,0,2,"A","N","2020-02-06","202002060CGY"
"EDM",0,2,0,1,0,3,0,2,2,2,0,6,"H","N","2020-02-06","202002060EDM"
"SJS",0,2,2,2,0,6,0,2,0,1,0,3,"A","N","2020-02-06","202002060EDM"
"FLA",0,1,1,0,0,2,0,1,2,4,0,7,"H","N","2020-02-06","202002060FLA"
"VEG",0,1,2,4,0,7,0,1,1,0,0,2,"A","N","2020-02-06","202002060FLA"
"MIN",0,3,0,1,0,4,0,0,1,1,0,2,"H","N","2020-02-06","202002060MIN"
"VAN",0,0,1,1,0,2,0,3,0,1,0,4,"A","N","2020-02-06","202002060MIN"
"ANA",0,0,1,1,0,2,1,1,1,0,0,3,"A","N","2020-02-06","202002060MTL"
"MTL",1,1,1,0,0,3,0,0,1,1,0,2,"H","N","2020-02-06","202002060MTL"
"LAK",0,2,1,0,0,3,0,0,2,3,0,5,"A","N","2020-02-06","202002060NYI"
"NYI",0,0,2,3,0,5,0,2,1,0,0,3,"H","N","2020-02-06","202002060NYI"
"COL",0,1,2,1,0,4,0,1,0,0,0,1,"A","N","2020-02-06","202002060OTT"
"OTT",0,1,0,0,0,1,0,1,2,1,0,4,"H","N","2020-02-06","202002060OTT"
"NJD",0,1,1,3,0,5,0,0,0,0,0,0,"A","N","2020-02-06","202002060PHI"
"PHI",0,0,0,0,0,0,0,1,1,3,0,5,"H","N","2020-02-06","202002060PHI"
"STL",0,0,2,0,0,2,0,1,1,2,0,4,"H","N","2020-02-06","202002060STL"
"WPG",0,1,1,2,0,4,0,0,2,0,0,2,"A","N","2020-02-06","202002060STL"
"PIT",0,0,1,1,0,2,0,2,1,1,0,4,"A","N","2020-02-06","202002060TBL"
"TBL",0,2,1,1,0,4,0,0,1,1,0,2,"H","N","2020-02-06","202002060TBL"
"CBJ",0,0,1,1,0,2,0,0,0,0,0,0,"H","N","2020-02-07","202002070CBJ"
"DET",0,0,0,0,0,0,0,0,1,1,0,2,"A","N","2020-02-07","202002070CBJ"
"DAL",0,1,1,0,0,2,0,0,2,1,0,3,"H","N","2020-02-07","202002070DAL"
"MIN",0,0,2,1,0,3,0,1,1,0,0,2,"A","N","2020-02-07","202002070DAL"
"BUF",0,1,1,1,0,3,0,0,0,2,0,2,"A","N","2020-02-07","202002070NYR"
"NYR",0,0,0,2,0,2,0,1,1,1,0,3,"H","N","2020-02-07","202002070NYR"
"ANA",0,1,0,3,0,4,1,1,2,1,0,5,"A","N","2020-02-07","202002070TOR"
"TOR",1,1,2,1,0,5,0,1,0,3,0,4,"H","N","2020-02-07","202002070TOR"
"ARI",0,0,1,1,0,2,0,0,3,1,0,4,"A","N","2020-02-08","202002080BOS"
"BOS",0,0,3,1,0,4,0,0,1,1,0,2,"H","N","2020-02-08","202002080BOS"
"CBJ",0,0,1,0,0,1,0,0,0,2,0,2,"H","N","2020-02-08","202002080CBJ"
"COL",0,0,0,2,0,2,0,0,1,0,0,1,"A","N","2020-02-08","202002080CBJ"
"EDM",0,0,1,2,0,3,0,1,1,0,0,2,"H","N","2020-02-08","202002080EDM"
"NSH",0,1,1,0,0,2,0,0,1,2,0,3,"A","N","2020-02-08","202002080EDM"
"FLA",0,1,1,0,0,2,0,2,1,0,0,3,"H","N","2020-02-08","202002080FLA"
"PIT",0,2,1,0,0,3,0,1,1,0,0,2,"A","N","2020-02-08","202002080FLA"
"MTL",1,0,0,1,0,2,0,0,0,1,0,1,"H","N","2020-02-08","202002080MTL"
"TOR",0,0,0,1,0,1,1,0,0,1,0,2,"A","N","2020-02-08","202002080MTL"
"LAK",0,0,0,0,0,0,0,0,3,0,0,3,"A","N","2020-02-08","202002080NJD"
"NJD",0,0,3,0,0,3,0,0,0,0,0,0,"H","N","2020-02-08","202002080NJD"
"DAL",1,1,1,0,0,3,0,2,0,0,0,2,"A","N","2020-02-08","202002080STL"
"STL",0,2,0,0,0,2,1,1,1,0,0,3,"H","N","2020-02-08","202002080STL"
"NYI",0,0,0,1,0,1,0,0,1,2,0,3,"A","N","2020-02-08","202002080TBL"
"TBL",0,0,1,2,0,3,0,0,0,1,0,1,"H","N","2020-02-08","202002080TBL"
"CGY",0,2,1,3,0,6,0,2,0,0,0,2,"A","N","2020-02-08","202002080VAN"
"VAN",0,2,0,0,0,2,0,2,1,3,0,6,"H","N","2020-02-08","202002080VAN"
"CAR",0,1,0,4,1,6,0,2,1,2,0,5,"A","Y","2020-02-08","202002080VEG"
"VEG",0,2,1,2,0,5,0,1,0,4,1,6,"H","Y","2020-02-08","202002080VEG"
"OTT",0,0,2,0,0,2,0,1,3,1,0,5,"A","N","2020-02-08","202002080WPG"
"WPG",0,1,3,1,0,5,0,0,2,0,0,2,"H","N","2020-02-08","202002080WPG"
"PHI",0,1,3,3,0,7,0,1,0,1,0,2,"A","N","2020-02-08","202002080WSH"
"WSH",0,1,0,1,0,2,0,1,3,3,0,7,"H","N","2020-02-08","202002080WSH"
"ANA",0,3,0,0,0,3,0,1,1,0,0,2,"A","N","2020-02-09","202002090BUF"
"BUF",0,1,1,0,0,2,0,3,0,0,0,3,"H","N","2020-02-09","202002090BUF"
"BOS",0,0,0,1,0,1,0,0,1,2,0,3,"A","N","2020-02-09","202002090DET"
"DET",0,0,1,2,0,3,0,0,0,1,0,1,"H","N","2020-02-09","202002090DET"
"COL",0,0,3,0,0,3,0,0,2,0,0,2,"A","N","2020-02-09","202002090MIN"
"MIN",0,0,2,0,0,2,0,0,3,0,0,3,"H","N","2020-02-09","202002090MIN"
"LAK",0,0,0,1,0,1,0,1,0,3,0,4,"A","N","2020-02-09","202002090NYR"
"NYR",0,1,0,3,0,4,0,0,0,1,0,1,"H","N","2020-02-09","202002090NYR"
"CHI",0,2,0,0,0,2,0,0,1,4,0,5,"A","N","2020-02-09","202002090WPG"
"WPG",0,0,1,4,0,5,0,2,0,0,0,2,"H","N","2020-02-09","202002090WPG"
"CBJ",0,0,1,0,0,1,1,1,0,0,0,2,"H","N","2020-02-10","202002100CBJ"
"TBL",1,1,0,0,0,2,0,0,1,0,0,1,"A","N","2020-02-10","202002100CBJ"
"ARI",0,1,1,1,0,3,0,2,0,0,0,2,"A","N","2020-02-10","202002100MTL"
"MTL",0,2,0,0,0,2,0,1,1,1,0,3,"H","N","2020-02-10","202002100MTL"
"FLA",0,1,0,0,0,1,0,1,2,1,0,4,"A","N","2020-02-10","202002100PHI"
"PHI",0,1,2,1,0,4,0,1,0,0,0,1,"H","N","2020-02-10","202002100PHI"
"CGY",0,3,1,2,0,6,0,1,1,0,0,2,"A","N","2020-02-10","202002100SJS"
"SJS",0,1,1,0,0,2,0,3,1,2,0,6,"H","N","2020-02-10","202002100SJS"
"NSH",0,0,2,0,0,2,0,3,2,1,0,6,"A","N","2020-02-10","202002100VAN"
"VAN",0,3,2,1,0,6,0,0,2,0,0,2,"H","N","2020-02-10","202002100VAN"
"NYI",0,3,2,0,0,5,0,1,2,0,0,3,"A","N","2020-02-10","202002100WSH"
"WSH",0,1,2,0,0,3,0,3,2,0,0,5,"H","N","2020-02-10","202002100WSH"
"BUF",0,1,1,1,0,3,0,1,1,0,0,2,"H","N","2020-02-11","202002110BUF"
"DET",0,1,1,0,0,2,0,1,1,1,0,3,"A","N","2020-02-11","202002110BUF"
"COL",0,1,0,2,0,3,0,0,0,0,0,0,"H","N","2020-02-11","202002110COL"
"OTT",0,0,0,0,0,0,0,1,0,2,0,3,"A","N","2020-02-11","202002110COL"
"CAR",0,1,0,0,0,1,0,1,2,1,0,4,"A","N","2020-02-11","202002110DAL"
"DAL",0,1,2,1,0,4,0,1,0,0,0,1,"H","N","2020-02-11","202002110DAL"
"CHI",0,2,1,0,0,3,0,2,2,1,0,5,"A","N","2020-02-11","202002110EDM"
"EDM",0,2,2,1,0,5,0,2,1,0,0,3,"H","N","2020-02-11","202002110EDM"
"MIN",0,2,2,0,0,4,0,0,0,0,0,0,"H","N","2020-02-11","202002110MIN"
"VEG",0,0,0,0,0,0,0,2,2,0,0,4,"A","N","2020-02-11","202002110MIN"
"FLA",0,2,3,0,0,5,0,1,2,0,0,3,"A","N","2020-02-11","202002110NJD"
"NJD",0,1,2,0,0,3,0,2,3,0,0,5,"H","N","2020-02-11","202002110NJD"
"NYI",0,3,0,2,0,5,0,0,2,1,0,3,"H","N","2020-02-11","202002110NYI"
"PHI",0,0,2,1,0,3,0,3,0,2,0,5,"A","N","2020-02-11","202002110NYI"
"PIT",0,1,0,0,0,1,1,0,1,0,0,2,"H","N","2020-02-11","202002110PIT"
"TBL",1,0,1,0,0,2,0,1,0,0,0,1,"A","N","2020-02-11","202002110PIT"
"ARI",0,1,1,0,0,2,1,1,0,1,0,3,"A","N","2020-02-11","202002110TOR"
"TOR",1,1,0,1,0,3,0,1,1,0,0,2,"H","N","2020-02-11","202002110TOR"
"NYR",0,1,1,2,0,4,0,0,0,1,0,1,"A","N","2020-02-11","202002110WPG"
"WPG",0,0,0,1,0,1,0,1,1,2,0,4,"H","N","2020-02-11","202002110WPG"
"BOS",0,1,2,1,0,4,0,0,1,0,0,1,"H","N","2020-02-12","202002120BOS"
"MTL",0,0,1,0,0,1,0,1,2,1,0,4,"A","N","2020-02-12","202002120BOS"
"CGY",0,0,1,2,0,3,0,0,2,3,0,5,"A","N","2020-02-12","202002120LAK"
"LAK",0,0,2,3,0,5,0,0,1,2,0,3,"H","N","2020-02-12","202002120LAK"
"CHI",0,0,0,0,0,0,0,1,1,1,0,3,"A","N","2020-02-12","202002120VAN"
"VAN",0,1,1,1,0,3,0,0,0,0,0,0,"H","N","2020-02-12","202002120VAN"
"ANA",0,0,0,0,0,0,0,4,1,1,0,6,"H","N","2020-02-13","202002130ANA"
"CGY",0,4,1,1,0,6,0,0,0,0,0,0,"A","N","2020-02-13","202002130ANA"
"BUF",1,0,1,2,0,4,0,1,1,1,0,3,"H","N","2020-02-13","202002130BUF"
"CBJ",0,1,1,1,0,3,1,0,1,2,0,4,"A","N","2020-02-13","202002130BUF"
"COL",0,2,0,0,0,2,0,0,1,2,0,3,"H","N","2020-02-13","202002130COL"
"WSH",0,0,1,2,0,3,0,2,0,0,0,2,"A","N","2020-02-13","202002130COL"
"FLA",0,0,0,2,0,2,0,3,1,2,0,6,"H","N","2020-02-13","202002130FLA"
"PHI",0,3,1,2,0,6,0,0,0,2,0,2,"A","N","2020-02-13","202002130FLA"
"MIN",0,2,1,0,0,3,0,1,0,2,1,4,"H","Y","2020-02-13","202002130MIN"
"NYR",0,1,0,2,1,4,0,2,1,0,0,3,"A","Y","2020-02-13","202002130MIN"
"DET",0,0,1,0,0,1,0,0,0,4,0,4,"A","N","2020-02-13","202002130NJD"
"NJD",0,0,0,4,0,4,0,0,1,0,0,1,"H","N","2020-02-13","202002130NJD"
"NSH",0,3,2,0,0,5,0,0,0,0,0,0,"H","N","2020-02-13","202002130NSH"
"NYI",0,0,0,0,0,0,0,3,2,0,0,5,"A","N","2020-02-13","202002130NSH"
"ARI",0,0,1,1,0,2,0,2,0,1,0,3,"A","N","2020-02-13","202002130OTT"
"OTT",0,2,0,1,0,3,0,0,1,1,0,2,"H","N","2020-02-13","202002130OTT"
"EDM",0,0,1,0,0,1,0,0,2,1,0,3,"A","N","2020-02-13","202002130TBL"
"TBL",0,0,2,1,0,3,0,0,1,0,0,1,"H","N","2020-02-13","202002130TBL"
"DAL",0,1,1,1,0,3,0,0,1,1,0,2,"A","N","2020-02-13","202002130TOR"
"TOR",0,0,1,1,0,2,0,1,1,1,0,3,"H","N","2020-02-13","202002130TOR"
"STL",0,3,1,1,0,5,1,2,1,2,0,6,"A","N","2020-02-13","202002130VEG"
"VEG",1,2,1,2,0,6,0,3,1,1,0,5,"H","N","2020-02-13","202002130VEG"
"CAR",0,2,1,2,0,5,0,1,0,1,0,2,"H","N","2020-02-14","202002140CAR"
"NJD",0,1,0,1,0,2,0,2,1,2,0,5,"A","N","2020-02-14","202002140CAR"
"CBJ",0,0,1,0,0,1,0,1,0,2,0,3,"H","N","2020-02-14","202002140CBJ"
"NYR",0,1,0,2,0,3,0,0,1,0,0,1,"A","N","2020-02-14","202002140CBJ"
"MTL",0,0,1,0,0,1,0,0,3,1,0,4,"A","N","2020-02-14","202002140PIT"
"PIT",0,0,3,1,0,4,0,0,1,0,0,1,"H","N","2020-02-14","202002140PIT"
"SJS",0,1,0,2,0,3,0,0,2,0,0,2,"A","N","2020-02-14","202002140WPG"
"WPG",0,0,2,0,0,2,0,1,0,2,0,3,"H","N","2020-02-14","202002140WPG"
"ARI",0,0,1,2,0,3,0,0,1,0,0,1,"H","N","2020-02-15","202002150ARI"
"WSH",0,0,1,0,0,1,0,0,1,2,0,3,"A","N","2020-02-15","202002150ARI"
"BOS",0,0,3,1,0,4,0,1,0,0,0,1,"H","N","2020-02-15","202002150BOS"
"DET",0,1,0,0,0,1,0,0,3,1,0,4,"A","N","2020-02-15","202002150BOS"
"CGY",0,2,1,1,0,4,0,2,4,2,0,8,"H","N","2020-02-15","202002150CGY"
"CHI",0,2,4,2,0,8,0,2,1,1,0,4,"A","N","2020-02-15","202002150CGY"
"COL",0,0,1,0,0,1,0,1,0,2,0,3,"H","N","2020-02-15","202002150COL"
"LAK",0,1,0,2,0,3,0,0,1,0,0,1,"A","N","2020-02-15","202002150COL"
"EDM",0,1,0,3,0,4,0,0,0,1,0,1,"A","N","2020-02-15","202002150FLA"
"FLA",0,0,0,1,0,1,0,1,0,3,0,4,"H","N","2020-02-15","202002150FLA"
"MIN",0,0,0,0,0,0,0,0,0,2,0,2,"H","N","2020-02-15","202002150MIN"
"SJS",0,0,0,2,0,2,0,0,0,0,0,0,"A","N","2020-02-15","202002150MIN"
"DAL",1,0,2,1,0,4,0,1,2,0,0,3,"A","N","2020-02-15","202002150MTL"
"MTL",0,1,2,0,0,3,1,0,2,1,0,4,"H","N","2020-02-15","202002150MTL"
"OTT",0,0,1,1,0,2,0,1,2,1,0,4,"H","N","2020-02-15","202002150OTT"
"TOR",0,1,2,1,0,4,0,0,1,1,0,2,"A","N","2020-02-15","202002150OTT"
"NSH",0,2,1,1,0,4,0,0,3,0,0,3,"A","N","2020-02-15","202002150STL"
"STL",0,0,3,0,0,3,0,2,1,1,0,4,"H","N","2020-02-15","202002150STL"
"PHI",0,0,1,2,0,3,0,2,1,2,0,5,"A","N","2020-02-15","202002150TBL"
"TBL",0,2,1,2,0,5,0,0,1,2,0,3,"H","N","2020-02-15","202002150TBL"
"NYI",0,0,0,0,0,0,0,0,1,0,0,1,"A","N","2020-02-15","202002150VEG"
"VEG",0,0,1,0,0,1,0,0,0,0,0,0,"H","N","2020-02-15","202002150VEG"
"BUF",0,0,2,3,0,5,0,0,1,1,0,2,"H","N","2020-02-16","202002160BUF"
"TOR",0,0,1,1,0,2,0,0,2,3,0,5,"A","N","2020-02-16","202002160BUF"
"CAR",0,1,1,1,0,3,1,1,2,0,0,4,"H","N","2020-02-16","202002160CAR"
"EDM",1,1,2,0,0,4,0,1,1,1,0,3,"A","N","2020-02-16","202002160CAR"
"CBJ",0,2,0,1,0,3,0,0,3,0,1,4,"A","Y","2020-02-16","202002160NJD"
"NJD",0,0,3,0,1,4,0,2,0,1,0,3,"H","Y","2020-02-16","202002160NJD"
"NSH",0,0,1,1,0,2,0,0,1,0,0,1,"H","N","2020-02-16","202002160NSH"
"STL",0,0,1,0,0,1,0,0,1,1,0,2,"A","N","2020-02-16","202002160NSH"
"BOS",0,1,1,1,0,3,0,0,0,1,0,1,"A","N","2020-02-16","202002160NYR"
"NYR",0,0,0,1,0,1,0,1,1,1,0,3,"H","N","2020-02-16","202002160NYR"
"DAL",0,2,0,1,0,3,1,2,0,1,0,4,"A","N","2020-02-16","202002160OTT"
"OTT",1,2,0,1,0,4,0,2,0,1,0,3,"H","N","2020-02-16","202002160OTT"
"DET",0,1,0,0,0,1,0,2,3,0,0,5,"A","N","2020-02-16","202002160PIT"
"PIT",0,2,3,0,0,5,0,1,0,0,0,1,"H","N","2020-02-16","202002160PIT"
"ANA",0,2,1,2,0,5,0,0,1,0,0,1,"A","N","2020-02-16","202002160VAN"
"VAN",0,0,1,0,0,1,0,2,1,2,0,5,"H","N","2020-02-16","202002160VAN"
"CHI",0,1,1,0,0,2,0,0,2,1,0,3,"A","N","2020-02-16","202002160WPG"
"WPG",0,0,2,1,0,3,0,1,1,0,0,2,"H","N","2020-02-16","202002160WPG"
"ARI",0,1,0,1,0,2,0,0,0,1,0,1,"H","N","2020-02-17","202002170ARI"
"NYI",0,0,0,1,0,1,0,1,0,1,0,2,"A","N","2020-02-17","202002170ARI"
"ANA",0,0,2,2,0,4,0,0,1,5,0,6,"A","N","2020-02-17","202002170CGY"
"CGY",0,0,1,5,0,6,0,0,2,2,0,4,"H","N","2020-02-17","202002170CGY"
"COL",0,1,1,1,0,3,1,0,3,0,0,4,"H","N","2020-02-17","202002170COL"
"TBL",1,0,3,0,0,4,0,1,1,1,0,3,"A","N","2020-02-17","202002170COL"
"FLA",0,1,1,3,0,5,0,1,0,2,0,3,"A","N","2020-02-17","202002170SJS"
"SJS",0,1,0,2,0,3,0,1,1,3,0,5,"H","N","2020-02-17","202002170SJS"
"VEG",0,2,1,0,0,3,0,0,0,2,0,2,"H","N","2020-02-17","202002170VEG"
"WSH",0,0,0,2,0,2,0,2,1,0,0,3,"A","N","2020-02-17","202002170VEG"
"DET",0,0,1,3,0,4,0,2,1,0,0,3,"H","N","2020-02-18","202002180DET"
"MTL",0,2,1,0,0,3,0,0,1,3,0,4,"A","N","2020-02-18","202002180DET"
"CAR",0,1,2,1,0,4,0,0,1,0,0,1,"A","N","2020-02-18","202002180NSH"
"NSH",0,0,1,0,0,1,0,1,2,1,0,4,"H","N","2020-02-18","202002180NSH"
"BUF",0,2,2,0,0,4,0,4,1,2,0,7,"A","N","2020-02-18","202002180OTT"
"OTT",0,4,1,2,0,7,0,2,2,0,0,4,"H","N","2020-02-18","202002180OTT"
"CBJ",0,0,1,0,0,1,0,2,1,2,0,5,"A","N","2020-02-18","202002180PHI"
"PHI",0,2,1,2,0,5,0,0,1,0,0,1,"H","N","2020-02-18","202002180PHI"
"PIT",0,2,3,0,0,5,0,0,2,0,0,2,"H","N","2020-02-18","202002180PIT"
"TOR",0,0,2,0,0,2,0,2,3,0,0,5,"A","N","2020-02-18","202002180PIT"
"NJD",0,0,0,0,0,0,0,0,1,2,0,3,"A","N","2020-02-18","202002180STL"
"STL",0,0,1,2,0,3,0,0,0,0,0,0,"H","N","2020-02-18","202002180STL"
"LAK",0,1,0,2,0,3,0,0,3,3,0,6,"A","N","2020-02-18","202002180WPG"
"WPG",0,0,3,3,0,6,0,1,0,2,0,3,"H","N","2020-02-18","202002180WPG"
"ANA",0,1,0,0,0,1,0,1,2,1,0,4,"H","N","2020-02-19","202002190ANA"
"FLA",0,1,2,1,0,4,0,1,0,0,0,1,"A","N","2020-02-19","202002190ANA"
"CHI",0,0,1,2,0,3,0,1,0,5,0,6,"H","N","2020-02-19","202002190CHI"
"NYR",0,1,0,5,0,6,0,0,1,2,0,3,"A","N","2020-02-19","202002190CHI"
"COL",0,1,1,1,0,3,0,0,0,1,0,1,"H","N","2020-02-19","202002190COL"
"NYI",0,0,0,1,0,1,0,1,1,1,0,3,"A","N","2020-02-19","202002190COL"
"ARI",0,0,2,0,0,2,0,1,1,1,0,3,"A","N","2020-02-19","202002190DAL"
"DAL",0,1,1,1,0,3,0,0,2,0,0,2,"H","N","2020-02-19","202002190DAL"
"BOS",1,1,0,0,0,2,0,0,0,1,0,1,"A","N","2020-02-19","202002190EDM"
"EDM",0,0,0,1,0,1,1,1,0,0,0,2,"H","N","2020-02-19","202002190EDM"
"MIN",0,1,1,1,1,4,0,0,1,2,0,3,"A","Y","2020-02-19","202002190VAN"
"VAN",0,0,1,2,0,3,0,1,1,1,1,4,"H","Y","2020-02-19","202002190VAN"
"CBJ",0,2,1,0,0,3,1,1,2,0,0,4,"H","N","2020-02-20","202002200CBJ"
"PHI",1,1,2,0,0,4,0,2,1,0,0,3,"A","N","2020-02-20","202002200CBJ"
"FLA",0,2,1,1,0,4,0,2,2,1,0,5,"A","N","2020-02-20","202002200LAK"
"LAK",0,2,2,1,0,5,0,2,1,1,0,4,"H","N","2020-02-20","202002200LAK"
"NJD",0,0,1,1,0,2,0,1,0,0,0,1,"H","N","2020-02-20","202002200NJD"
"SJS",0,1,0,0,0,1,0,0,1,1,0,2,"A","N","2020-02-20","202002200NJD"
"OTT",0,1,0,0,0,1,0,2,2,1,0,5,"H","N","2020-02-20","202002200OTT"
"WPG",0,2,2,1,0,5,0,1,0,0,0,1,"A","N","2020-02-20","202002200OTT"
"ARI",0,0,0,0,0,0,0,0,0,1,0,1,"A","N","2020-02-20","202002200STL"
"STL",0,0,0,1,0,1,0,0,0,0,0,0,"H","N","2020-02-20","202002200STL"
"PIT",0,0,0,0,0,0,0,0,3,1,0,4,"A","N","2020-02-20","202002200TOR"
"TOR",0,0,3,1,0,4,0,0,0,0,0,0,"H","N","2020-02-20","202002200TOR"
"TBL",0,1,1,1,0,3,0,1,2,2,0,5,"A","N","2020-02-20","202002200VEG"
"VEG",0,1,2,2,0,5,0,1,1,1,0,3,"H","N","2020-02-20","202002200VEG"
"MTL",1,1,1,1,0,4,0,1,1,1,0,3,"A","N","2020-02-20","202002200WSH"
"WSH",0,1,1,1,0,3,1,1,1,1,0,4,"H","N","2020-02-20","202002200WSH"
"ANA",0,0,0,0,0,0,0,0,1,0,0,1,"H","N","2020-02-21","202002210ANA"
"COL",0,0,1,0,0,1,0,0,0,0,0,0,"A","N","2020-02-21","202002210ANA"
"CAR",0,0,1,1,0,2,0,1,2,2,0,5,"H","N","2020-02-21","202002210CAR"
"NYR",0,1,2,2,0,5,0,0,1,1,0,2,"A","N","2020-02-21","202002210CAR"
"BOS",0,3,1,0,0,4,0,3,0,0,0,3,"A","N","2020-02-21","202002210CGY"
"CGY",0,3,0,0,0,3,0,3,1,0,0,4,"H","N","2020-02-21","202002210CGY"
"CHI",1,0,0,1,0,2,0,0,1,0,0,1,"H","N","2020-02-21","202002210CHI"
"NSH",0,0,1,0,0,1,1,0,0,1,0,2,"A","N","2020-02-21","202002210CHI"
"DAL",0,0,0,1,0,1,0,2,2,1,0,5,"H","N","2020-02-21","202002210DAL"
"STL",0,2,2,1,0,5,0,0,0,1,0,1,"A","N","2020-02-21","202002210DAL"
"EDM",0,2,1,0,0,3,0,1,2,2,0,5,"H","N","2020-02-21","202002210EDM"
"MIN",0,1,2,2,0,5,0,2,1,0,0,3,"A","N","2020-02-21","202002210EDM"
"DET",0,0,0,1,0,1,0,1,1,2,0,4,"A","N","2020-02-21","202002210NYI"
"NYI",0,1,1,2,0,4,0,0,0,1,0,1,"H","N","2020-02-21","202002210NYI"
"ARI",0,2,2,3,0,7,0,1,2,0,0,3,"H","N","2020-02-22","202002220ARI"
"TBL",0,1,2,0,0,3,0,2,2,3,0,7,"A","N","2020-02-22","202002220ARI"
"COL",0,0,1,0,1,2,0,1,0,0,0,1,"A","Y","2020-02-22","202002220LAK"
"LAK",0,1,0,0,0,1,0,0,1,0,1,2,"H","Y","2020-02-22","202002220LAK"
"NJD",0,1,1,1,0,3,0,0,1,1,0,2,"H","N","2020-02-22","202002220NJD"
"WSH",0,0,1,1,0,2,0,1,1,1,0,3,"A","N","2020-02-22","202002220NJD"
"CBJ",0,0,3,0,0,3,0,2,1,0,1,4,"A","Y","2020-02-22","202002220NSH"
"NSH",0,2,1,0,1,4,0,0,3,0,0,3,"H","Y","2020-02-22","202002220NSH"
"NYR",0,1,1,1,0,3,0,1,1,0,0,2,"H","N","2020-02-22","202002220NYR"
"SJS",0,1,1,0,0,2,0,1,1,1,0,3,"A","N","2020-02-22","202002220NYR"
"MTL",0,2,1,0,0,3,0,0,0,0,0,0,"A","N","2020-02-22","202002220OTT"
"OTT",0,0,0,0,0,0,0,2,1,0,0,3,"H","N","2020-02-22","202002220OTT"
"PHI",0,2,1,1,0,4,0,0,1,1,0,2,"H","N","2020-02-22","202002220PHI"
"WPG",0,0,1,1,0,2,0,2,1,1,0,4,"A","N","2020-02-22","202002220PHI"
"BUF",0,3,0,2,0,5,0,0,1,1,0,2,"A","N","2020-02-22","202002220PIT"
"PIT",0,0,1,1,0,2,0,3,0,2,0,5,"H","N","2020-02-22","202002220PIT"
"CAR",0,0,4,2,0,6,0,1,2,0,0,3,"A","N","2020-02-22","202002220TOR"
"TOR",0,1,2,0,0,3,0,0,4,2,0,6,"H","N","2020-02-22","202002220TOR"
"BOS",0,1,0,2,0,3,0,2,3,4,0,9,"A","N","2020-02-22","202002220VAN"
"VAN",0,2,3,4,0,9,0,1,0,2,0,3,"H","N","2020-02-22","202002220VAN"
"FLA",0,1,1,1,0,3,0,1,2,2,0,5,"A","N","2020-02-22","202002220VEG"
"VEG",0,1,2,2,0,5,0,1,1,1,0,3,"H","N","2020-02-22","202002220VEG"
"ANA",0,1,1,3,0,5,1,1,2,2,0,6,"H","N","2020-02-23","202002230ANA"
"VEG",1,1,2,2,0,6,0,1,1,3,0,5,"A","N","2020-02-23","202002230ANA"
"BUF",0,1,0,1,0,2,0,1,0,0,0,1,"H","N","2020-02-23","202002230BUF"
"WPG",0,1,0,0,0,1,0,1,0,1,0,2,"A","N","2020-02-23","202002230BUF"
"CHI",0,0,1,0,0,1,0,1,1,0,0,2,"A","N","2020-02-23","202002230DAL"
"DAL",0,1,1,0,0,2,0,0,1,0,0,1,"H","N","2020-02-23","202002230DAL"
"CGY",0,2,1,1,0,4,0,1,0,1,0,2,"A","N","2020-02-23","202002230DET"
"DET",0,1,0,1,0,2,0,2,1,1,0,4,"H","N","2020-02-23","202002230DET"
"EDM",0,1,2,1,0,4,0,0,1,1,0,2,"A","N","2020-02-23","202002230LAK"
"LAK",0,0,1,1,0,2,0,1,2,1,0,4,"H","N","2020-02-23","202002230LAK"
"MIN",0,0,1,0,0,1,0,2,1,1,0,4,"H","N","2020-02-23","202002230MIN"
"STL",0,2,1,1,0,4,0,0,1,0,0,1,"A","N","2020-02-23","202002230MIN"
"NYI",0,1,2,1,0,4,0,1,0,0,0,1,"H","N","2020-02-23","202002230NYI"
"SJS",0,1,0,0,0,1,0,1,2,1,0,4,"A","N","2020-02-23","202002230NYI"
"PIT",0,0,2,1,0,3,0,1,0,4,0,5,"A","N","2020-02-23","202002230WSH"
"WSH",0,1,0,4,0,5,0,0,2,1,0,3,"H","N","2020-02-23","202002230WSH"
"CBJ",1,1,1,1,0,4,0,1,1,1,0,3,"H","N","2020-02-24","202002240CBJ"
"OTT",0,1,1,1,0,3,1,1,1,1,0,4,"A","N","2020-02-24","202002240CBJ"
"ANA",1,2,0,1,0,4,0,0,1,2,0,3,"H","N","2020-02-25","202002250ANA"
"EDM",0,0,1,2,0,3,1,2,0,1,0,4,"A","N","2020-02-25","202002250ANA"
"ARI",0,1,0,0,0,1,0,0,1,1,0,2,"H","N","2020-02-25","202002250ARI"
"FLA",0,0,1,1,0,2,0,1,0,0,0,1,"A","N","2020-02-25","202002250ARI"
"BOS",0,0,1,1,0,2,0,1,2,2,0,5,"H","N","2020-02-25","202002250BOS"
"CGY",0,1,2,2,0,5,0,0,1,1,0,2,"A","N","2020-02-25","202002250BOS"
"CAR",0,0,1,0,0,1,0,3,1,0,0,4,"H","N","2020-02-25","202002250CAR"
"DAL",0,3,1,0,0,4,0,0,1,0,0,1,"A","N","2020-02-25","202002250CAR"
"DET",0,0,0,1,0,1,0,1,2,1,0,4,"H","N","2020-02-25","202002250DET"
"NJD",0,1,2,1,0,4,0,0,0,1,0,1,"A","N","2020-02-25","202002250DET"
"CBJ",0,1,0,3,0,4,0,2,2,1,0,5,"A","N","2020-02-25","202002250MIN"
"MIN",0,2,2,1,0,5,0,1,0,3,0,4,"H","N","2020-02-25","202002250MIN"
"MTL",0,2,0,1,0,3,1,1,1,1,0,4,"H","N","2020-02-25","202002250MTL"
"VAN",1,1,1,1,0,4,0,2,0,1,0,3,"A","N","2020-02-25","202002250MTL"
"NSH",0,1,2,0,0,3,0,2,0,0,0,2,"H","N","2020-02-25","202002250NSH"
"OTT",0,2,0,0,0,2,0,1,2,0,0,3,"A","N","2020-02-25","202002250NSH"
"NYI",0,0,1,2,0,3,1,1,1,1,0,4,"H","N","2020-02-25","202002250NYI"
"NYR",1,1,1,1,0,4,0,0,1,2,0,3,"A","N","2020-02-25","202002250NYI"
"PHI",0,1,2,1,0,4,0,1,0,1,0,2,"H","N","2020-02-25","202002250PHI"
"SJS",0,1,0,1,0,2,0,1,2,1,0,4,"A","N","2020-02-25","202002250PHI"
"CHI",0,2,1,2,0,5,0,1,1,4,0,6,"A","N","2020-02-25","202002250STL"
"STL",0,1,1,4,0,6,0,2,1,2,0,5,"H","N","2020-02-25","202002250STL"
"TBL",0,1,1,1,0,3,0,2,2,0,0,4,"H","N","2020-02-25","202002250TBL"
"TOR",0,2,2,0,0,4,0,1,1,1,0,3,"A","N","2020-02-25","202002250TBL"
"WPG",0,0,1,2,0,3,0,2,1,0,1,4,"A","Y","2020-02-25","202002250WSH"
"WSH",0,2,1,0,1,4,0,0,1,2,0,3,"H","Y","2020-02-25","202002250WSH"
"BUF",0,1,1,0,0,2,0,1,1,1,0,3,"A","N","2020-02-26","202002260COL"
"COL",0,1,1,1,0,3,0,1,1,0,0,2,"H","N","2020-02-26","202002260COL"
"LAK",0,1,1,0,0,2,0,0,0,1,0,1,"H","N","2020-02-26","202002260LAK"
"PIT",0,0,0,1,0,1,0,1,1,0,0,2,"A","N","2020-02-26","202002260LAK"
"EDM",0,0,0,0,0,0,0,1,0,2,0,3,"A","N","2020-02-26","202002260VEG"
"VEG",0,1,0,2,0,3,0,0,0,0,0,0,"H","N","2020-02-26","202002260VEG"
"BOS",0,1,2,1,0,4,0,1,0,2,0,3,"H","N","2020-02-27","202002270BOS"
"DAL",0,1,0,2,0,3,0,1,2,1,0,4,"A","N","2020-02-27","202002270BOS"
"DET",0,0,1,0,0,1,0,3,3,1,0,7,"H","N","2020-02-27","202002270DET"
"MIN",0,3,3,1,0,7,0,0,1,0,0,1,"A","N","2020-02-27","202002270DET"
"FLA",0,3,0,0,0,3,0,3,0,2,0,5,"H","N","2020-02-27","202002270FLA"
"TOR",0,3,0,2,0,5,0,3,0,0,0,3,"A","N","2020-02-27","202002270FLA"
"MTL",0,1,1,0,0,2,0,0,1,4,0,5,"H","N","2020-02-27","202002270MTL"
"NYR",0,0,1,4,0,5,0,1,1,0,0,2,"A","N","2020-02-27","202002270MTL"
"CGY",0,0,2,1,0,3,1,1,0,2,0,4,"A","N","2020-02-27","202002270NSH"
"NSH",1,1,0,2,0,4,0,0,2,1,0,3,"H","N","2020-02-27","202002270NSH"
"OTT",0,2,0,3,0,5,0,0,1,1,0,2,"H","N","2020-02-27","202002270OTT"
"VAN",0,0,1,1,0,2,0,2,0,3,0,5,"A","N","2020-02-27","202002270OTT"
"NJD",0,2,0,0,0,2,1,0,2,0,0,3,"A","N","2020-02-27","202002270SJS"
"SJS",1,0,2,0,0,3,0,2,0,0,0,2,"H","N","2020-02-27","202002270SJS"
"NYI",0,2,0,0,0,2,1,1,0,1,0,3,"A","N","2020-02-27","202002270STL"
"STL",1,1,0,1,0,3,0,2,0,0,0,2,"H","N","2020-02-27","202002270STL"
"CHI",0,0,0,5,0,5,0,0,1,1,0,2,"A","N","2020-02-27","202002270TBL"
"TBL",0,0,1,1,0,2,0,0,0,5,0,5,"H","N","2020-02-27","202002270TBL"
"WPG",0,1,0,2,0,3,0,0,0,0,0,0,"H","N","2020-02-27","202002270WPG"
"WSH",0,0,0,0,0,0,0,1,0,2,0,3,"A","N","2020-02-27","202002270WPG"
"ANA",0,1,2,0,0,3,0,0,1,1,0,2,"H","N","2020-02-28","202002280ANA"
"PIT",0,0,1,1,0,2,0,1,2,0,0,3,"A","N","2020-02-28","202002280ANA"
"CAR",0,0,0,2,0,2,0,1,1,1,0,3,"H","N","2020-02-28","202002280CAR"
"COL",0,1,1,1,0,3,0,0,0,2,0,2,"A","N","2020-02-28","202002280CAR"
"CBJ",0,0,0,0,0,0,0,2,2,1,0,5,"H","N","2020-02-28","202002280CBJ"
"MIN",0,2,2,1,0,5,0,0,0,0,0,0,"A","N","2020-02-28","202002280CBJ"
"NYR",0,1,0,1,0,2,0,1,2,2,0,5,"A","N","2020-02-28","202002280PHI"
"PHI",0,1,2,2,0,5,0,1,0,1,0,2,"H","N","2020-02-28","202002280PHI"
"BUF",0,1,0,1,0,2,0,1,0,3,0,4,"A","N","2020-02-28","202002280VEG"
"VEG",0,1,0,3,0,4,0,1,0,1,0,2,"H","N","2020-02-28","202002280VEG"
"ARI",0,0,3,2,0,5,0,2,0,0,0,2,"H","N","2020-02-29","202002290ARI"
"BUF",0,2,0,0,0,2,0,0,3,2,0,5,"A","N","2020-02-29","202002290ARI"
"EDM",0,1,1,1,0,3,0,0,2,0,0,2,"H","N","2020-02-29","202002290EDM"
"WPG",0,0,2,0,0,2,0,1,1,1,0,3,"A","N","2020-02-29","202002290EDM"
"CHI",0,1,1,0,1,3,0,1,0,1,0,2,"A","Y","2020-02-29","202002290FLA"
"FLA",0,1,0,1,0,2,0,1,1,0,1,3,"H","Y","2020-02-29","202002290FLA"
"LAK",1,0,1,0,0,2,0,1,0,0,0,1,"H","N","2020-02-29","202002290LAK"
"NJD",0,1,0,0,0,1,1,0,1,0,0,2,"A","N","2020-02-29","202002290LAK"
"CAR",0,0,1,2,0,3,1,1,2,0,0,4,"A","N","2020-02-29","202002290MTL"
"MTL",1,1,2,0,0,4,0,0,1,2,0,3,"H","N","2020-02-29","202002290MTL"
"COL",0,0,2,1,0,3,0,0,0,2,0,2,"A","N","2020-02-29","202002290NSH"
"NSH",0,0,0,2,0,2,0,0,2,1,0,3,"H","N","2020-02-29","202002290NSH"
"BOS",0,2,0,2,0,4,0,0,0,0,0,0,"A","N","2020-02-29","202002290NYI"
"NYI",0,0,0,0,0,0,0,2,0,2,0,4,"H","N","2020-02-29","202002290NYI"
"DET",0,1,1,1,0,3,0,0,1,2,1,4,"A","Y","2020-02-29","202002290OTT"
"OTT",0,0,1,2,1,4,0,1,1,1,0,3,"H","Y","2020-02-29","202002290OTT"
"PIT",0,0,0,0,0,0,0,1,2,2,0,5,"A","N","2020-02-29","202002290SJS"
"SJS",0,1,2,2,0,5,0,0,0,0,0,0,"H","N","2020-02-29","202002290SJS"
"DAL",0,1,1,1,0,3,0,1,2,0,1,4,"A","Y","2020-02-29","202002290STL"
"STL",0,1,2,0,1,4,0,1,1,1,0,3,"H","Y","2020-02-29","202002290STL"
"CGY",0,0,2,1,0,3,0,1,3,0,0,4,"A","N","2020-02-29","202002290TBL"
"TBL",0,1,3,0,0,4,0,0,2,1,0,3,"H","N","2020-02-29","202002290TBL"
"TOR",0,2,0,2,0,4,0,2,0,0,0,2,"H","N","2020-02-29","202002290TOR"
"VAN",0,2,0,0,0,2,0,2,0,2,0,4,"A","N","2020-02-29","202002290TOR"
"ANA",0,0,0,0,0,0,0,1,1,1,0,3,"H","N","2020-03-01","202003010ANA"
"NJD",0,1,1,1,0,3,0,0,0,0,0,0,"A","N","2020-03-01","202003010ANA"
"CBJ",0,1,0,4,0,5,0,2,1,0,0,3,"H","N","2020-03-01","202003010CBJ"
"VAN",0,2,1,0,0,3,0,1,0,4,0,5,"A","N","2020-03-01","202003010CBJ"
"CGY",0,1,1,1,0,3,0,0,0,0,0,0,"A","N","2020-03-01","202003010FLA"
"FLA",0,0,0,0,0,0,0,1,1,1,0,3,"H","N","2020-03-01","202003010FLA"
"MIN",0,2,0,1,0,3,0,3,0,1,0,4,"H","N","2020-03-01","202003010MIN"
"WSH",0,3,0,1,0,4,0,2,0,1,0,3,"A","N","2020-03-01","202003010MIN"
"NYR",0,0,1,2,0,3,0,3,2,0,0,5,"H","N","2020-03-01","202003010NYR"
"PHI",0,3,2,0,0,5,0,0,1,2,0,3,"A","N","2020-03-01","202003010NYR"
"LAK",0,2,2,0,0,4,0,0,1,0,0,1,"A","N","2020-03-01","202003010VEG"
"VEG",0,0,1,0,0,1,0,2,2,0,0,4,"H","N","2020-03-01","202003010VEG"
"COL",0,1,1,0,0,2,0,1,0,0,0,1,"A","N","2020-03-02","202003020DET"
"DET",0,1,0,0,0,1,0,1,1,0,0,2,"H","N","2020-03-02","202003020DET"
"EDM",0,2,1,5,0,8,0,0,3,0,0,3,"A","N","2020-03-02","202003020NSH"
"NSH",0,0,3,0,0,3,0,2,1,5,0,8,"H","N","2020-03-02","202003020NSH"
"ANA",0,0,1,1,0,2,0,1,4,1,0,6,"A","N","2020-03-03","202003030CHI"
"CHI",0,1,4,1,0,6,0,0,1,1,0,2,"H","N","2020-03-03","202003030CHI"
"DAL",0,0,0,1,0,1,1,0,1,0,0,2,"H","N","2020-03-03","202003030DAL"
"EDM",1,0,1,0,0,2,0,0,0,1,0,1,"A","N","2020-03-03","202003030DAL"
"MIN",0,2,0,1,0,3,0,0,0,1,0,1,"H","N","2020-03-03","202003030MIN"
"NSH",0,0,0,1,0,1,0,2,0,1,0,3,"A","N","2020-03-03","202003030MIN"
"MTL",0,3,1,2,0,6,0,0,0,2,0,2,"A","N","2020-03-03","202003030NYI"
"NYI",0,0,0,2,0,2,0,3,1,2,0,6,"H","N","2020-03-03","202003030NYI"
"NYR",0,1,0,0,0,1,0,0,1,2,0,3,"H","N","2020-03-03","202003030NYR"
"STL",0,0,1,2,0,3,0,1,0,0,0,1,"A","N","2020-03-03","202003030NYR"
"OTT",0,1,0,2,0,3,0,3,1,3,0,7,"A","N","2020-03-03","202003030PIT"
"PIT",0,3,1,3,0,7,0,1,0,2,0,3,"H","N","2020-03-03","202003030PIT"
"SJS",0,1,1,3,0,5,0,0,2,0,0,2,"H","N","2020-03-03","202003030SJS"
"TOR",0,0,2,0,0,2,0,1,1,3,0,5,"A","N","2020-03-03","202003030SJS"
"BOS",0,1,1,0,0,2,0,0,1,0,0,1,"A","N","2020-03-03","202003030TBL"
"TBL",0,0,1,0,0,1,0,1,1,0,0,2,"H","N","2020-03-03","202003030TBL"
"NJD",0,0,0,0,0,0,0,0,1,2,0,3,"A","N","2020-03-03","202003030VEG"
"VEG",0,0,1,2,0,3,0,0,0,0,0,0,"H","N","2020-03-03","202003030VEG"
"BUF",0,0,1,0,0,1,0,2,1,0,0,3,"A","N","2020-03-03","202003030WPG"
"WPG",0,2,1,0,0,3,0,0,1,0,0,1,"H","N","2020-03-03","202003030WPG"
"CBJ",0,2,0,0,0,2,1,0,0,2,0,3,"A","N","2020-03-04","202003040CGY"
"CGY",1,0,0,2,0,3,0,2,0,0,0,2,"H","N","2020-03-04","202003040CGY"
"ANA",1,2,1,0,0,4,0,2,0,1,0,3,"A","N","2020-03-04","202003040COL"
"COL",0,2,0,1,0,3,1,2,1,0,0,4,"H","N","2020-03-04","202003040COL"
"ARI",0,1,0,3,0,4,0,0,0,2,0,2,"A","N","2020-03-04","202003040VAN"
"VAN",0,0,0,2,0,2,0,1,0,3,0,4,"H","N","2020-03-04","202003040VAN"
"PHI",0,0,3,2,0,5,0,1,1,0,0,2,"A","N","2020-03-04","202003040WSH"
"WSH",0,1,1,0,0,2,0,0,3,2,0,5,"H","N","2020-03-04","202003040WSH"
"BUF",0,1,0,1,0,2,0,2,1,1,0,4,"H","N","2020-03-05","202003050BUF"
"PIT",0,2,1,1,0,4,0,1,0,1,0,2,"A","N","2020-03-05","202003050BUF"
"CHI",0,1,3,0,0,4,0,0,1,2,0,3,"H","N","2020-03-05","202003050CHI"
"EDM",0,0,1,2,0,3,0,1,3,0,0,4,"A","N","2020-03-05","202003050CHI"
"BOS",1,0,1,0,0,2,0,0,1,0,0,1,"A","N","2020-03-05","202003050FLA"
"FLA",0,0,1,0,0,1,1,0,1,0,0,2,"H","N","2020-03-05","202003050FLA"
"LAK",0,0,0,0,1,1,0,0,0,0,0,0,"H","Y","2020-03-05","202003050LAK"
"TOR",0,0,0,0,0,0,0,0,0,0,1,1,"A","Y","2020-03-05","202003050LAK"
"DAL",0,0,0,0,0,0,0,1,1,0,0,2,"A","N","2020-03-05","202003050NSH"
"NSH",0,1,1,0,0,2,0,0,0,0,0,0,"H","N","2020-03-05","202003050NSH"
"NYR",1,1,2,2,0,6,0,1,2,2,0,5,"H","N","2020-03-05","202003050NYR"
"WSH",0,1,2,2,0,5,1,1,2,2,0,6,"A","N","2020-03-05","202003050NYR"
"NYI",0,1,1,1,0,3,0,1,2,1,0,4,"A","N","2020-03-05","202003050OTT"
"OTT",0,1,2,1,0,4,0,1,1,1,0,3,"H","N","2020-03-05","202003050OTT"
"CAR",0,0,0,1,0,1,0,1,1,2,0,4,"A","N","2020-03-05","202003050PHI"
"PHI",0,1,1,2,0,4,0,0,0,1,0,1,"H","N","2020-03-05","202003050PHI"
"MIN",0,1,2,0,0,3,0,1,0,1,0,2,"A","N","2020-03-05","202003050SJS"
"SJS",0,1,0,1,0,2,0,1,2,0,0,3,"H","N","2020-03-05","202003050SJS"
"MTL",0,0,0,0,0,0,0,2,1,1,0,4,"A","N","2020-03-05","202003050TBL"
"TBL",0,2,1,1,0,4,0,0,0,0,0,0,"H","N","2020-03-05","202003050TBL"
"ANA",0,1,0,1,0,2,0,0,0,1,0,1,"H","N","2020-03-06","202003060ANA"
"TOR",0,0,0,1,0,1,0,1,0,1,0,2,"A","N","2020-03-06","202003060ANA"
"ARI",0,1,1,0,0,2,0,2,1,0,0,3,"A","N","2020-03-06","202003060CGY"
"CGY",0,2,1,0,0,3,0,1,1,0,0,2,"H","N","2020-03-06","202003060CGY"
"CHI",0,0,1,0,0,1,0,0,2,0,0,2,"A","N","2020-03-06","202003060DET"
"DET",0,0,2,0,0,2,0,0,1,0,0,1,"H","N","2020-03-06","202003060DET"
"NJD",0,1,2,1,0,4,0,1,0,1,0,2,"H","N","2020-03-06","202003060NJD"
"STL",0,1,0,1,0,2,0,1,2,1,0,4,"A","N","2020-03-06","202003060NJD"
"COL",0,1,2,0,0,3,0,2,2,2,0,6,"A","N","2020-03-06","202003060VAN"
"VAN",0,2,2,2,0,6,0,1,2,0,0,3,"H","N","2020-03-06","202003060VAN"
"VEG",0,0,0,0,0,0,0,3,1,0,0,4,"A","N","2020-03-06","202003060WPG"
"WPG",0,3,1,0,0,4,0,0,0,0,0,0,"H","N","2020-03-06","202003060WPG"
"BOS",0,0,2,1,0,3,0,2,1,2,0,5,"H","N","2020-03-07","202003070BOS"
"TBL",0,2,1,2,0,5,0,0,2,1,0,3,"A","N","2020-03-07","202003070BOS"
"DAL",0,0,0,0,0,0,0,0,1,0,0,1,"H","N","2020-03-07","202003070DAL"
"NSH",0,0,1,0,0,1,0,0,0,0,0,0,"A","N","2020-03-07","202003070DAL"
"CBJ",0,0,0,1,0,1,0,1,0,3,0,4,"A","N","2020-03-07","202003070EDM"
"EDM",0,1,0,3,0,4,0,0,0,1,0,1,"H","N","2020-03-07","202003070EDM"
"FLA",0,0,1,3,0,4,0,0,0,1,0,1,"H","N","2020-03-07","202003070FLA"
"MTL",0,0,0,1,0,1,0,0,1,3,0,4,"A","N","2020-03-07","202003070FLA"
"LAK",0,1,2,4,0,7,0,0,1,2,0,3,"H","N","2020-03-07","202003070LAK"
"MIN",0,0,1,2,0,3,0,1,2,4,0,7,"A","N","2020-03-07","202003070LAK"
"CAR",1,1,0,1,0,3,0,0,1,1,0,2,"A","N","2020-03-07","202003070NYI"
"NYI",0,0,1,1,0,2,1,1,0,1,0,3,"H","N","2020-03-07","202003070NYI"
"NJD",0,1,4,1,0,6,0,2,0,2,0,4,"A","N","2020-03-07","202003070NYR"
"NYR",0,2,0,2,0,4,0,1,4,1,0,6,"H","N","2020-03-07","202003070NYR"
"BUF",0,0,1,0,0,1,0,0,1,2,0,3,"A","N","2020-03-07","202003070PHI"
"PHI",0,0,1,2,0,3,0,0,1,0,0,1,"H","N","2020-03-07","202003070PHI"
"PIT",0,0,0,2,0,2,0,3,0,2,0,5,"H","N","2020-03-07","202003070PIT"
"WSH",0,3,0,2,0,5,0,0,0,2,0,2,"A","N","2020-03-07","202003070PIT"
"OTT",1,1,0,0,0,2,0,1,0,0,0,1,"A","N","2020-03-07","202003070SJS"
"SJS",0,1,0,0,0,1,1,1,0,0,0,2,"H","N","2020-03-07","202003070SJS"
"ANA",0,1,2,1,0,4,1,2,0,2,0,5,"H","N","2020-03-08","202003080ANA"
"MIN",1,2,0,2,0,5,0,1,2,1,0,4,"A","N","2020-03-08","202003080ANA"
"CGY",0,0,2,1,0,3,0,2,1,2,0,5,"H","N","2020-03-08","202003080CGY"
"VEG",0,2,1,2,0,5,0,0,2,1,0,3,"A","N","2020-03-08","202003080CGY"
"CHI",0,0,0,0,0,0,0,0,1,1,0,2,"H","N","2020-03-08","202003080CHI"
"STL",0,0,1,1,0,2,0,0,0,0,0,0,"A","N","2020-03-08","202003080CHI"
"DET",0,1,1,2,1,5,0,0,2,2,0,4,"H","Y","2020-03-08","202003080DET"
"TBL",0,0,2,2,0,4,0,1,1,2,1,5,"A","Y","2020-03-08","202003080DET"
"CAR",0,1,2,3,0,6,0,2,0,0,0,2,"A","N","2020-03-08","202003080PIT"
"PIT",0,2,0,0,0,2,0,1,2,3,0,6,"H","N","2020-03-08","202003080PIT"
"COL",0,1,2,1,0,4,0,1,1,1,0,3,"A","N","2020-03-08","202003080SJS"
"SJS",0,1,1,1,0,3,0,1,2,1,0,4,"H","N","2020-03-08","202003080SJS"
"CBJ",0,0,2,0,0,2,0,0,0,1,0,1,"A","N","2020-03-08","202003080VAN"
"VAN",0,0,0,1,0,1,0,0,2,0,0,2,"H","N","2020-03-08","202003080VAN"
"BUF",0,1,1,0,1,3,0,0,0,2,0,2,"H","Y","2020-03-09","202003090BUF"
"WSH",0,0,0,2,0,2,0,1,1,0,1,3,"A","Y","2020-03-09","202003090BUF"
"EDM",0,1,0,1,0,2,1,1,0,1,0,3,"H","N","2020-03-09","202003090EDM"
"VEG",1,1,0,1,0,3,0,1,0,1,0,2,"A","N","2020-03-09","202003090EDM"
"COL",0,0,0,1,0,1,0,2,0,1,0,3,"A","N","2020-03-09","202003090LAK"
"LAK",0,2,0,1,0,3,0,0,0,1,0,1,"H","N","2020-03-09","202003090LAK"
"FLA",0,0,1,1,0,2,0,0,1,0,0,1,"A","N","2020-03-09","202003090STL"
"STL",0,0,1,0,0,1,0,0,1,1,0,2,"H","N","2020-03-09","202003090STL"
"ARI",0,2,0,0,0,2,0,0,2,2,0,4,"A","N","2020-03-09","202003090WPG"
"WPG",0,0,2,2,0,4,0,2,0,0,0,2,"H","N","2020-03-09","202003090WPG"
"ANA",0,4,1,0,0,5,0,0,1,1,0,2,"H","N","2020-03-10","202003100ANA"
"OTT",0,0,1,1,0,2,0,4,1,0,0,5,"A","N","2020-03-10","202003100ANA"
"DAL",0,0,0,2,0,2,0,2,2,0,0,4,"H","N","2020-03-10","202003100DAL"
"NYR",0,2,2,0,0,4,0,0,0,2,0,2,"A","N","2020-03-10","202003100DAL"
"CAR",0,1,1,3,0,5,0,1,1,0,0,2,"A","N","2020-03-10","202003100DET"
"DET",0,1,1,0,0,2,0,1,1,3,0,5,"H","N","2020-03-10","202003100DET"
"MTL",0,0,0,2,0,2,0,0,4,0,0,4,"H","N","2020-03-10","202003100MTL"
"NSH",0,0,4,0,0,4,0,0,0,2,0,2,"A","N","2020-03-10","202003100MTL"
"NJD",0,1,0,1,0,2,0,1,1,3,0,5,"H","N","2020-03-10","202003100NJD"
"PIT",0,1,1,3,0,5,0,1,0,1,0,2,"A","N","2020-03-10","202003100NJD"
"BOS",0,0,1,1,0,2,0,0,0,0,0,0,"A","N","2020-03-10","202003100PHI"
"PHI",0,0,0,0,0,0,0,0,1,1,0,2,"H","N","2020-03-10","202003100PHI"
"TBL",0,0,1,0,0,1,0,1,0,1,0,2,"A","N","2020-03-10","202003100TOR"
"TOR",0,1,0,1,0,2,0,0,1,0,0,1,"H","N","2020-03-10","202003100TOR"
"NYI",0,2,1,1,0,4,0,2,2,0,1,5,"A","Y","2020-03-10","202003100VAN"
"VAN",0,2,2,0,1,5,0,2,1,1,0,4,"H","Y","2020-03-10","202003100VAN"
"ANA",0,1,1,0,0,2,0,2,1,1,0,4,"H","N","2020-03-11","202003110ANA"
"STL",0,2,1,1,0,4,0,1,1,0,0,2,"A","N","2020-03-11","202003110ANA"
"CHI",0,0,3,3,0,6,0,1,0,1,0,2,"H","N","2020-03-11","202003110CHI"
"SJS",0,1,0,1,0,2,0,0,3,3,0,6,"A","N","2020-03-11","202003110CHI"
"COL",1,1,1,0,0,3,0,1,0,1,0,2,"H","N","2020-03-11","202003110COL"
"NYR",0,1,0,1,0,2,1,1,1,0,0,3,"A","N","2020-03-11","202003110COL"
"EDM",0,0,2,0,0,2,0,0,2,2,0,4,"H","N","2020-03-11","202003110EDM"
"WPG",0,0,2,2,0,4,0,0,2,0,0,2,"A","N","2020-03-11","202003110EDM"
"LAK",0,1,0,2,0,3,0,1,0,1,0,2,"H","N","2020-03-11","202003110LAK"
"OTT",0,1,0,1,0,2,0,1,0,2,0,3,"A","N","2020-03-11","202003110LAK"
"CAR",0,1,1,1,0,3,0,0,1,1,0,2,"H","N","2020-08-01","202008010CAR"
"NYR",0,0,1,1,0,2,0,1,1,1,0,3,"A","N","2020-08-01","202008010CAR"
"CGY",0,0,3,1,0,4,0,1,0,0,0,1,"H","N","2020-08-01","202008010CGY"
"WPG",0,1,0,0,0,1,0,0,3,1,0,4,"A","N","2020-08-01","202008010CGY"
"CHI",0,4,2,0,0,6,0,1,1,2,0,4,"A","N","2020-08-01","202008010EDM"
"EDM",0,1,1,2,0,4,0,4,2,0,0,6,"H","N","2020-08-01","202008010EDM"
"FLA",0,0,0,1,0,1,0,1,1,0,0,2,"A","N","2020-08-01","202008010NYI"
"NYI",0,1,1,0,0,2,0,0,0,1,0,1,"H","N","2020-08-01","202008010NYI"
"MTL",1,1,1,0,0,3,0,0,2,0,0,2,"A","N","2020-08-01","202008010PIT"
"PIT",0,0,2,0,0,2,1,1,1,0,0,3,"H","N","2020-08-01","202008010PIT"
"BOS",0,0,1,0,0,1,0,0,3,1,0,4,"H","N","2020-08-02","202008020BOS"
"PHI",0,0,3,1,0,4,0,0,1,0,0,1,"A","N","2020-08-02","202008020BOS"
"COL",0,0,0,2,0,2,0,1,0,0,0,1,"H","N","2020-08-02","202008020COL"
"STL",0,1,0,0,0,1,0,0,0,2,0,2,"A","N","2020-08-02","202008020COL"
"ARI",0,3,1,0,0,4,0,1,0,2,0,3,"A","N","2020-08-02","202008020NSH"
"NSH",0,1,0,2,0,3,0,3,1,0,0,4,"H","N","2020-08-02","202008020NSH"
"CBJ",0,0,0,2,0,2,0,0,0,0,0,0,"A","N","2020-08-02","202008020TOR"
"TOR",0,0,0,0,0,0,0,0,0,2,0,2,"H","N","2020-08-02","202008020TOR"
"MIN",0,1,1,1,0,3,0,0,0,0,0,0,"A","N","2020-08-02","202008020VAN"
"VAN",0,0,0,0,0,0,0,1,1,1,0,3,"H","N","2020-08-02","202008020VAN"
"CAR",0,1,2,1,0,4,0,1,0,0,0,1,"H","N","2020-08-03","202008030CAR"
"NYR",0,1,0,0,0,1,0,1,2,1,0,4,"A","N","2020-08-03","202008030CAR"
"CGY",0,0,2,0,0,2,0,1,1,1,0,3,"H","N","2020-08-03","202008030CGY"
"WPG",0,1,1,1,0,3,0,0,2,0,0,2,"A","N","2020-08-03","202008030CGY"
"CHI",0,1,2,0,0,3,0,2,2,2,0,6,"A","N","2020-08-03","202008030EDM"
"EDM",0,2,2,2,0,6,0,1,2,0,0,3,"H","N","2020-08-03","202008030EDM"
"MTL",0,0,0,1,0,1,0,1,0,2,0,3,"A","N","2020-08-03","202008030PIT"
"PIT",0,1,0,2,0,3,0,0,0,1,0,1,"H","N","2020-08-03","202008030PIT"
"TBL",0,1,1,0,1,3,0,0,2,0,0,2,"H","Y","2020-08-03","202008030TBL"
"WSH",0,0,2,0,0,2,0,1,1,0,1,3,"A","Y","2020-08-03","202008030TBL"
"DAL",0,0,3,0,0,3,0,1,0,4,0,5,"A","N","2020-08-03","202008030VEG"
"VEG",0,1,0,4,0,5,0,0,3,0,0,3,"H","N","2020-08-03","202008030VEG"
"ARI",0,0,0,2,0,2,0,2,1,1,0,4,"A","N","2020-08-04","202008040NSH"
"NSH",0,2,1,1,0,4,0,0,0,2,0,2,"H","N","2020-08-04","202008040NSH"
"FLA",0,1,1,0,0,2,0,0,3,1,0,4,"A","N","2020-08-04","202008040NYI"
"NYI",0,0,3,1,0,4,0,1,1,0,0,2,"H","N","2020-08-04","202008040NYI"
"CAR",0,0,1,3,0,4,0,0,1,0,0,1,"A","N","2020-08-04","202008040NYR"
"NYR",0,0,1,0,0,1,0,0,1,3,0,4,"H","N","2020-08-04","202008040NYR"
"CBJ",0,0,0,0,0,0,0,0,1,2,0,3,"A","N","2020-08-04","202008040TOR"
"TOR",0,0,1,2,0,3,0,0,0,0,0,0,"H","N","2020-08-04","202008040TOR"
"MIN",0,1,0,2,0,3,0,1,2,1,0,4,"A","N","2020-08-04","202008040VAN"
"VAN",0,1,2,1,0,4,0,1,0,2,0,3,"H","N","2020-08-04","202008040VAN"
"CGY",0,1,3,2,0,6,0,1,1,0,0,2,"A","N","2020-08-04","202008040WPG"
"WPG",0,1,1,0,0,2,0,1,3,2,0,6,"H","N","2020-08-04","202008040WPG"
"ARI",0,1,0,3,0,4,0,0,1,0,0,1,"H","N","2020-08-05","202008050ARI"
"NSH",0,0,1,0,0,1,0,1,0,3,0,4,"A","N","2020-08-05","202008050ARI"
"BOS",0,0,1,1,0,2,0,2,0,1,0,3,"H","N","2020-08-05","202008050BOS"
"TBL",0,2,0,1,0,3,0,0,1,1,0,2,"A","N","2020-08-05","202008050BOS"
"CHI",0,2,0,2,0,4,0,1,2,0,0,3,"H","N","2020-08-05","202008050CHI"
"EDM",0,1,2,0,0,3,0,2,0,2,0,4,"A","N","2020-08-05","202008050CHI"
"COL",0,2,1,1,0,4,0,0,0,0,0,0,"A","N","2020-08-05","202008050DAL"
"DAL",0,0,0,0,0,0,0,2,1,1,0,4,"H","N","2020-08-05","202008050DAL"
"FLA",0,0,1,2,0,3,0,0,1,1,0,2,"H","N","2020-08-05","202008050FLA"
"NYI",0,0,1,1,0,2,0,0,1,2,0,3,"A","N","2020-08-05","202008050FLA"
"MTL",0,1,2,1,0,4,0,2,1,0,0,3,"H","N","2020-08-05","202008050MTL"
"PIT",0,2,1,0,0,3,0,1,2,1,0,4,"A","N","2020-08-05","202008050MTL"
"CBJ",1,0,1,2,0,4,0,1,2,0,0,3,"H","N","2020-08-06","202008060CBJ"
"TOR",0,1,2,0,0,3,1,0,1,2,0,4,"A","N","2020-08-06","202008060CBJ"
"MIN",0,0,0,0,0,0,0,0,1,2,0,3,"H","N","2020-08-06","202008060MIN"
"VAN",0,0,1,2,0,3,0,0,0,0,0,0,"A","N","2020-08-06","202008060MIN"
"PHI",0,1,1,1,0,3,0,0,0,1,0,1,"H","N","2020-08-06","202008060PHI"
"WSH",0,0,0,1,0,1,0,1,1,1,0,3,"A","N","2020-08-06","202008060PHI"
"STL",0,1,3,0,0,4,0,0,3,3,0,6,"H","N","2020-08-06","202008060STL"
"VEG",0,0,3,3,0,6,0,1,3,0,0,4,"A","N","2020-08-06","202008060STL"
"CGY",0,2,0,2,0,4,0,0,0,0,0,0,"A","N","2020-08-06","202008060WPG"
"WPG",0,0,0,0,0,0,0,2,0,2,0,4,"H","N","2020-08-06","202008060WPG"
"ARI",1,1,1,1,0,4,0,0,2,1,0,3,"H","N","2020-08-07","202008070ARI"
"NSH",0,0,2,1,0,3,1,1,1,1,0,4,"A","N","2020-08-07","202008070ARI"
"CBJ",0,1,1,1,0,3,1,0,0,3,0,4,"H","N","2020-08-07","202008070CBJ"
"TOR",1,0,0,3,0,4,0,1,1,1,0,3,"A","N","2020-08-07","202008070CBJ"
"CHI",0,2,0,1,0,3,0,1,1,0,0,2,"H","N","2020-08-07","202008070CHI"
"EDM",0,1,1,0,0,2,0,2,0,1,0,3,"A","N","2020-08-07","202008070CHI"
"FLA",0,1,0,0,0,1,0,2,1,2,0,5,"H","N","2020-08-07","202008070FLA"
"NYI",0,2,1,2,0,5,0,1,0,0,0,1,"A","N","2020-08-07","202008070FLA"
"MIN",0,2,2,0,0,4,1,1,2,1,0,5,"H","N","2020-08-07","202008070MIN"
"VAN",1,1,2,1,0,5,0,2,2,0,0,4,"A","N","2020-08-07","202008070MIN"
"MTL",0,0,0,2,0,2,0,0,0,0,0,0,"H","N","2020-08-07","202008070MTL"
"PIT",0,0,0,0,0,0,0,0,0,2,0,2,"A","N","2020-08-07","202008070MTL"
"COL",0,0,2,1,0,3,1,0,2,1,0,4,"H","N","2020-08-08","202008080COL"
"VEG",1,0,2,1,0,4,0,0,2,1,0,3,"A","N","2020-08-08","202008080COL"
"PHI",0,2,1,1,0,4,0,0,1,0,0,1,"A","N","2020-08-08","202008080TBL"
"TBL",0,0,1,0,0,1,0,2,1,1,0,4,"H","N","2020-08-08","202008080TBL"
"DAL",0,0,0,1,1,2,0,1,0,0,0,1,"A","Y","2020-08-09","202008090STL"
"STL",0,1,0,0,0,1,0,0,0,1,1,2,"H","Y","2020-08-09","202008090STL"
"CBJ",0,1,0,2,0,3,0,0,0,0,0,0,"A","N","2020-08-09","202008090TOR"
"TOR",0,0,0,0,0,0,0,1,0,2,0,3,"H","N","2020-08-09","202008090TOR"
"BOS",0,0,0,1,0,1,0,1,0,1,0,2,"A","N","2020-08-09","202008090WSH"
"WSH",0,1,0,1,0,2,0,0,0,1,0,1,"H","N","2020-08-09","202008090WSH"
"CGY",0,2,1,0,0,3,0,0,2,0,0,2,"A","N","2020-08-11","202008110DAL"
"DAL",0,0,2,0,0,2,0,2,1,0,0,3,"H","N","2020-08-11","202008110DAL"
"CBJ",0,1,1,0,0,2,1,1,0,1,0,3,"A","N","2020-08-11","202008110TBL"
"TBL",1,1,0,1,0,3,0,1,1,0,0,2,"H","N","2020-08-11","202008110TBL"
"CHI",0,0,1,0,0,1,0,0,2,2,0,4,"A","N","2020-08-11","202008110VEG"
"VEG",0,0,2,2,0,4,0,0,1,0,0,1,"H","N","2020-08-11","202008110VEG"
"BOS",1,1,1,1,0,4,0,1,1,1,0,3,"H","N","2020-08-12","202008120BOS"
"CAR",0,1,1,1,0,3,1,1,1,1,0,4,"A","N","2020-08-12","202008120BOS"
"ARI",0,0,0,0,0,0,0,0,0,3,0,3,"A","N","2020-08-12","202008120COL"
"COL",0,0,0,3,0,3,0,0,0,0,0,0,"H","N","2020-08-12","202008120COL"
"MTL",0,0,1,0,0,1,0,1,1,0,0,2,"A","N","2020-08-12","202008120PHI"
"PHI",0,1,1,0,0,2,0,0,1,0,0,1,"H","N","2020-08-12","202008120PHI"
"STL",0,1,1,0,0,2,0,1,1,3,0,5,"H","N","2020-08-12","202008120STL"
"VAN",0,1,1,3,0,5,0,1,1,0,0,2,"A","N","2020-08-12","202008120STL"
"NYI",0,0,1,3,0,4,0,0,2,0,0,2,"A","N","2020-08-12","202008120WSH"
"WSH",0,0,2,0,0,2,0,0,1,3,0,4,"H","N","2020-08-12","202008120WSH"
"BOS",0,1,1,0,0,2,0,0,2,1,0,3,"H","N","2020-08-13","202008130BOS"
"CAR",0,0,2,1,0,3,0,1,1,0,0,2,"A","N","2020-08-13","202008130BOS"
"CGY",0,1,1,2,0,4,0,2,2,1,0,5,"A","N","2020-08-13","202008130DAL"
"DAL",0,2,2,1,0,5,0,1,1,2,0,4,"H","N","2020-08-13","202008130DAL"
"CBJ",0,2,0,1,0,3,0,1,0,0,0,1,"A","N","2020-08-13","202008130TBL"
"TBL",0,1,0,0,0,1,0,2,0,1,0,3,"H","N","2020-08-13","202008130TBL"
"CHI",0,0,3,0,0,3,1,2,1,0,0,4,"A","N","2020-08-13","202008130VEG"
"VEG",1,2,1,0,0,4,0,0,3,0,0,3,"H","N","2020-08-13","202008130VEG"
"CGY",0,0,1,1,0,2,0,0,0,0,0,0,"H","N","2020-08-14","202008140CGY"
"DAL",0,0,0,0,0,0,0,0,1,1,0,2,"A","N","2020-08-14","202008140CGY"
"ARI",0,1,1,0,0,2,0,1,1,1,0,3,"A","N","2020-08-14","202008140COL"
"COL",0,1,1,1,0,3,0,1,1,0,0,2,"H","N","2020-08-14","202008140COL"
"MTL",0,2,2,1,0,5,0,0,0,0,0,0,"A","N","2020-08-14","202008140PHI"
"PHI",0,0,0,0,0,0,0,2,2,1,0,5,"H","N","2020-08-14","202008140PHI"
"STL",0,0,1,2,0,3,1,1,1,1,0,4,"H","N","2020-08-14","202008140STL"
"VAN",1,1,1,1,0,4,0,0,1,2,0,3,"A","N","2020-08-14","202008140STL"
"NYI",0,0,3,2,0,5,0,1,1,0,0,2,"A","N","2020-08-14","202008140WSH"
"WSH",0,1,1,0,0,2,0,0,3,2,0,5,"H","N","2020-08-14","202008140WSH"
"ARI",0,1,1,2,0,4,0,0,1,1,0,2,"H","N","2020-08-15","202008150ARI"
"COL",0,0,1,1,0,2,0,1,1,2,0,4,"A","N","2020-08-15","202008150ARI"
"BOS",0,0,1,2,0,3,0,0,0,1,0,1,"A","N","2020-08-15","202008150CAR"
"CAR",0,0,0,1,0,1,0,0,1,2,0,3,"H","N","2020-08-15","202008150CAR"
"CBJ",0,0,1,1,0,2,0,1,2,0,0,3,"H","N","2020-08-15","202008150CBJ"
"TBL",0,1,2,0,0,3,0,0,1,1,0,2,"A","N","2020-08-15","202008150CBJ"
"CHI",0,0,0,1,0,1,0,1,1,0,0,2,"H","N","2020-08-15","202008150CHI"
"VEG",0,1,1,0,0,2,0,0,0,1,0,1,"A","N","2020-08-15","202008150CHI"
"CGY",0,0,3,1,0,4,1,1,2,1,0,5,"H","N","2020-08-16","202008160CGY"
"DAL",1,1,2,1,0,5,0,0,3,1,0,4,"A","N","2020-08-16","202008160CGY"
"CHI",0,2,0,1,0,3,0,1,0,0,0,1,"H","N","2020-08-16","202008160CHI"
"VEG",0,1,0,0,0,1,0,2,0,1,0,3,"A","N","2020-08-16","202008160CHI"
"MTL",0,0,0,0,0,0,0,1,0,0,0,1,"H","N","2020-08-16","202008160MTL"
"PHI",0,1,0,0,0,1,0,0,0,0,0,0,"A","N","2020-08-16","202008160MTL"
"NYI",1,1,0,0,0,2,0,0,1,0,0,1,"H","N","2020-08-16","202008160NYI"
"WSH",0,0,1,0,0,1,1,1,0,0,0,2,"A","N","2020-08-16","202008160NYI"
"STL",1,0,2,0,0,3,0,0,2,0,0,2,"A","N","2020-08-16","202008160VAN"
"VAN",0,0,2,0,0,2,1,0,2,0,0,3,"H","N","2020-08-16","202008160VAN"
"ARI",0,0,1,0,0,1,0,3,1,3,0,7,"H","N","2020-08-17","202008170ARI"
"COL",0,3,1,3,0,7,0,0,1,0,0,1,"A","N","2020-08-17","202008170ARI"
"BOS",0,0,0,4,0,4,0,1,1,1,0,3,"A","N","2020-08-17","202008170CAR"
"CAR",0,1,1,1,0,3,0,0,0,4,0,4,"H","N","2020-08-17","202008170CAR"
"CBJ",0,0,1,0,0,1,0,0,2,0,0,2,"H","N","2020-08-17","202008170CBJ"
"TBL",0,0,2,0,0,2,0,0,1,0,0,1,"A","N","2020-08-17","202008170CBJ"
"STL",0,1,2,0,0,3,0,0,1,0,0,1,"A","N","2020-08-17","202008170VAN"
"VAN",0,0,1,0,0,1,0,1,2,0,0,3,"H","N","2020-08-17","202008170VAN"
"CGY",0,1,0,0,0,1,0,1,0,1,0,2,"A","N","2020-08-18","202008180DAL"
"DAL",0,1,0,1,0,2,0,1,0,0,0,1,"H","N","2020-08-18","202008180DAL"
"MTL",0,0,0,0,0,0,0,1,1,0,0,2,"H","N","2020-08-18","202008180MTL"
"PHI",0,1,1,0,0,2,0,0,0,0,0,0,"A","N","2020-08-18","202008180MTL"
"NYI",0,2,0,0,0,2,0,0,2,1,0,3,"H","N","2020-08-18","202008180NYI"
"WSH",0,0,2,1,0,3,0,2,0,0,0,2,"A","N","2020-08-18","202008180NYI"
"CHI",0,2,1,0,0,3,0,1,2,1,0,4,"A","N","2020-08-18","202008180VEG"
"VEG",0,1,2,1,0,4,0,2,1,0,0,3,"H","N","2020-08-18","202008180VEG"
"BOS",0,0,2,0,0,2,0,1,0,0,0,1,"H","N","2020-08-19","202008190BOS"
"CAR",0,1,0,0,0,1,0,0,2,0,0,2,"A","N","2020-08-19","202008190BOS"
"ARI",0,0,0,1,0,1,0,3,3,1,0,7,"A","N","2020-08-19","202008190COL"
"COL",0,3,3,1,0,7,0,0,0,1,0,1,"H","N","2020-08-19","202008190COL"
"MTL",0,1,2,2,0,5,0,0,2,1,0,3,"A","N","2020-08-19","202008190PHI"
"PHI",0,0,2,1,0,3,0,1,2,2,0,5,"H","N","2020-08-19","202008190PHI"
"STL",0,2,1,0,0,3,0,1,3,0,0,4,"H","N","2020-08-19","202008190STL"
"VAN",0,1,3,0,0,4,0,2,1,0,0,3,"A","N","2020-08-19","202008190STL"
"CBJ",0,1,2,1,0,4,1,2,0,2,0,5,"A","N","2020-08-19","202008190TBL"
"TBL",1,2,0,2,0,5,0,1,2,1,0,4,"H","N","2020-08-19","202008190TBL"
"CGY",0,3,0,0,0,3,0,1,5,1,0,7,"H","N","2020-08-20","202008200CGY"
"DAL",0,1,5,1,0,7,0,3,0,0,0,3,"A","N","2020-08-20","202008200CGY"
"NYI",0,1,1,2,0,4,0,0,0,0,0,0,"A","N","2020-08-20","202008200WSH"
"WSH",0,0,0,0,0,0,0,1,1,2,0,4,"H","N","2020-08-20","202008200WSH"
"MTL",0,1,1,0,0,2,0,2,1,0,0,3,"H","N","2020-08-21","202008210MTL"
"PHI",0,2,1,0,0,3,0,1,1,0,0,2,"A","N","2020-08-21","202008210MTL"
"STL",0,0,0,2,0,2,0,1,3,2,0,6,"A","N","2020-08-21","202008210VAN"
"VAN",0,1,3,2,0,6,0,0,0,2,0,2,"H","N","2020-08-21","202008210VAN"
"COL",0,1,2,0,0,3,0,3,1,1,0,5,"H","N","2020-08-22","202008220COL"
"DAL",0,3,1,1,0,5,0,1,2,0,0,3,"A","N","2020-08-22","202008220COL"
"BOS",0,1,1,1,0,3,0,0,0,2,0,2,"A","N","2020-08-23","202008230TBL"
"TBL",0,0,0,2,0,2,0,1,1,1,0,3,"H","N","2020-08-23","202008230TBL"
"VAN",0,0,0,0,0,0,0,1,3,1,0,5,"A","N","2020-08-23","202008230VEG"
"VEG",0,1,3,1,0,5,0,0,0,0,0,0,"H","N","2020-08-23","202008230VEG"
"COL",0,1,1,0,0,2,0,0,4,1,0,5,"H","N","2020-08-24","202008240COL"
"DAL",0,0,4,1,0,5,0,1,1,0,0,2,"A","N","2020-08-24","202008240COL"
"NYI",0,1,0,3,0,4,0,0,0,0,0,0,"A","N","2020-08-24","202008240PHI"
"PHI",0,0,0,0,0,0,0,1,0,3,0,4,"H","N","2020-08-24","202008240PHI"
"BOS",0,1,1,1,0,3,1,1,1,1,0,4,"A","N","2020-08-25","202008250TBL"
"TBL",1,1,1,1,0,4,0,1,1,1,0,3,"H","N","2020-08-25","202008250TBL"
"VAN",0,2,1,2,0,5,0,0,1,1,0,2,"A","N","2020-08-25","202008250VEG"
"VEG",0,0,1,1,0,2,0,2,1,2,0,5,"H","N","2020-08-25","202008250VEG"
"BOS",0,0,1,0,0,1,0,2,4,1,0,7,"H","N","2020-08-26","202008260BOS"
"TBL",0,2,4,1,0,7,0,0,1,0,0,1,"A","N","2020-08-26","202008260BOS"
"COL",0,0,3,3,0,6,0,1,0,3,0,4,"A","N","2020-08-26","202008260DAL"
"DAL",0,1,0,3,0,4,0,0,3,3,0,6,"H","N","2020-08-26","202008260DAL"
"NYI",0,0,1,2,0,3,1,3,0,0,0,4,"A","N","2020-08-26","202008260PHI"
"PHI",1,3,0,0,0,4,0,0,1,2,0,3,"H","N","2020-08-26","202008260PHI"
"BOS",0,0,0,1,0,1,0,1,2,0,0,3,"H","N","2020-08-29","202008290BOS"
"TBL",0,1,2,0,0,3,0,0,0,1,0,1,"A","N","2020-08-29","202008290BOS"
"NYI",0,0,2,1,0,3,0,1,0,0,0,1,"H","N","2020-08-29","202008290NYI"
"PHI",0,1,0,0,0,1,0,0,2,1,0,3,"A","N","2020-08-29","202008290NYI"
"VAN",0,0,0,0,0,0,0,2,0,1,0,3,"H","N","2020-08-29","202008290VAN"
"VEG",0,2,0,1,0,3,0,0,0,0,0,0,"A","N","2020-08-29","202008290VAN"
"COL",0,0,2,2,0,4,0,3,0,2,0,5,"A","N","2020-08-30","202008300DAL"
"DAL",0,3,0,2,0,5,0,0,2,2,0,4,"H","N","2020-08-30","202008300DAL"
"NYI",0,0,1,2,0,3,0,0,1,1,0,2,"H","N","2020-08-30","202008300NYI"
"PHI",0,0,1,1,0,2,0,0,1,2,0,3,"A","N","2020-08-30","202008300NYI"
"VAN",0,1,2,0,0,3,0,2,0,3,0,5,"H","N","2020-08-30","202008300VAN"
"VEG",0,2,0,3,0,5,0,1,2,0,0,3,"A","N","2020-08-30","202008300VAN"
"COL",0,5,1,0,0,6,0,0,2,1,0,3,"H","N","2020-08-31","202008310COL"
"DAL",0,0,2,1,0,3,0,5,1,0,0,6,"A","N","2020-08-31","202008310COL"
"BOS",0,0,1,1,0,2,1,0,1,1,0,3,"A","N","2020-08-31","202008310TBL"
"TBL",1,0,1,1,0,3,0,0,1,1,0,2,"H","N","2020-08-31","202008310TBL"
"NYI",0,0,1,2,0,3,1,0,2,1,0,4,"A","N","2020-09-01","202009010PHI"
"PHI",1,0,2,1,0,4,0,0,1,2,0,3,"H","N","2020-09-01","202009010PHI"
"VAN",0,0,1,1,0,2,0,0,1,0,0,1,"A","N","2020-09-01","202009010VEG"
"VEG",0,0,1,0,0,1,0,0,1,1,0,2,"H","N","2020-09-01","202009010VEG"
"COL",0,1,1,2,0,4,0,1,0,0,0,1,"A","N","2020-09-02","202009020DAL"
"DAL",0,1,0,0,0,1,0,1,1,2,0,4,"H","N","2020-09-02","202009020DAL"
"NYI",0,1,3,0,0,4,1,2,1,1,0,5,"H","N","2020-09-03","202009030NYI"
"PHI",1,2,1,1,0,5,0,1,3,0,0,4,"A","N","2020-09-03","202009030NYI"
"VAN",0,1,0,3,0,4,0,0,0,0,0,0,"H","N","2020-09-03","202009030VAN"
"VEG",0,0,0,0,0,0,0,1,0,3,0,4,"A","N","2020-09-03","202009030VAN"
"COL",0,2,1,1,0,4,1,1,1,2,0,5,"H","N","2020-09-04","202009040COL"
"DAL",1,1,1,2,0,5,0,2,1,1,0,4,"A","N","2020-09-04","202009040COL"
"VAN",0,0,0,0,0,0,0,0,0,3,0,3,"A","N","2020-09-04","202009040VEG"
"VEG",0,0,0,3,0,3,0,0,0,0,0,0,"H","N","2020-09-04","202009040VEG"
"NYI",0,2,1,1,0,4,0,0,0,0,0,0,"A","N","2020-09-05","202009050PHI"
"PHI",0,0,0,0,0,0,0,2,1,1,0,4,"H","N","2020-09-05","202009050PHI"
"DAL",0,1,0,0,0,1,0,0,0,0,0,0,"A","N","2020-09-06","202009060VEG"
"VEG",0,0,0,0,0,0,0,1,0,0,0,1,"H","N","2020-09-06","202009060VEG"
"NYI",0,1,0,1,0,2,0,3,2,3,0,8,"A","N","2020-09-07","202009070TBL"
"TBL",0,3,2,3,0,8,0,1,0,1,0,2,"H","N","2020-09-07","202009070TBL"
"DAL",0,0,0,0,0,0,0,0,3,0,0,3,"A","N","2020-09-08","202009080VEG"
"VEG",0,0,3,0,0,3,0,0,0,0,0,0,"H","N","2020-09-08","202009080VEG"
"NYI",0,1,0,0,0,1,0,1,0,1,0,2,"A","N","2020-09-09","202009090TBL"
"TBL",0,1,0,1,0,2,0,1,0,0,0,1,"H","N","2020-09-09","202009090TBL"
"DAL",1,0,1,1,0,3,0,0,0,2,0,2,"H","N","2020-09-10","202009100DAL"
"VEG",0,0,0,2,0,2,1,0,1,1,0,3,"A","N","2020-09-10","202009100DAL"
"NYI",0,1,2,2,0,5,0,1,0,2,0,3,"H","N","2020-09-11","202009110NYI"
"TBL",0,1,0,2,0,3,0,1,2,2,0,5,"A","N","2020-09-11","202009110NYI"
"DAL",0,0,2,0,0,2,0,0,1,0,0,1,"H","N","2020-09-12","202009120DAL"
"VEG",0,0,1,0,0,1,0,0,2,0,0,2,"A","N","2020-09-12","202009120DAL"
"NYI",0,0,1,0,0,1,0,0,2,2,0,4,"H","N","2020-09-13","202009130NYI"
"TBL",0,0,2,2,0,4,0,0,1,0,0,1,"A","N","2020-09-13","202009130NYI"
"DAL",1,0,0,2,0,3,0,1,0,1,0,2,"A","N","2020-09-14","202009140VEG"
"VEG",0,1,0,1,0,2,1,0,0,2,0,3,"H","N","2020-09-14","202009140VEG"
"NYI",1,1,0,0,0,2,0,0,1,0,0,1,"A","N","2020-09-15","202009150TBL"
"TBL",0,0,1,0,0,1,1,1,0,0,0,2,"H","N","2020-09-15","202009150TBL"
"NYI",0,1,0,0,0,1,1,1,0,0,0,2,"H","N","2020-09-17","202009170NYI"
"TBL",1,1,0,0,0,2,0,1,0,0,0,1,"A","N","2020-09-17","202009170NYI"
"DAL",0,1,2,1,0,4,0,1,0,0,0,1,"A","N","2020-09-19","202009190TBL"
"TBL",0,1,0,0,0,1,0,1,2,1,0,4,"H","N","2020-09-19","202009190TBL"
"DAL",0,0,1,1,0,2,0,3,0,0,0,3,"A","N","2020-09-21","202009210TBL"
"TBL",0,3,0,0,0,3,0,0,1,1,0,2,"H","N","2020-09-21","202009210TBL"
"DAL",0,1,0,1,0,2,0,2,3,0,0,5,"H","N","2020-09-23","202009230DAL"
"TBL",0,2,3,0,0,5,0,1,0,1,0,2,"A","N","2020-09-23","202009230DAL"
"DAL",0,2,1,1,0,4,1,1,2,1,0,5,"H","N","2020-09-25","202009250DAL"
"TBL",1,1,2,1,0,5,0,2,1,1,0,4,"A","N","2020-09-25","202009250DAL"
"DAL",1,1,0,1,0,3,0,0,1,1,0,2,"A","N","2020-09-26","202009260TBL"
"TBL",0,0,1,1,0,2,1,1,0,1,0,3,"H","N","2020-09-26","202009260TBL"
"DAL",0,0,0,0,0,0,0,1,1,0,0,2,"H","N","2020-09-28","202009280DAL"
"TBL",0,1,1,0,0,2,0,0,0,0,0,0,"A","N","2020-09-28","202009280DAL"
"COL",0,1,0,0,0,1,0,2,0,2,0,4,"H","N","2021-01-13","202101130COL"
"STL",0,2,0,2,0,4,0,1,0,0,0,1,"A","N","2021-01-13","202101130COL"
"EDM",0,0,1,2,0,3,0,1,1,3,0,5,"H","N","2021-01-13","202101130EDM"
"VAN",0,1,1,3,0,5,0,0,1,2,0,3,"A","N","2021-01-13","202101130EDM"
"PHI",0,2,1,3,0,6,0,1,1,1,0,3,"H","N","2021-01-13","202101130PHI"
"PIT",0,1,1,1,0,3,0,2,1,3,0,6,"A","N","2021-01-13","202101130PHI"
"CHI",0,0,0,1,0,1,0,3,1,1,0,5,"A","N","2021-01-13","202101130TBL"
"TBL",0,3,1,1,0,5,0,0,0,1,0,1,"H","N","2021-01-13","202101130TBL"
"MTL",0,2,1,1,0,4,1,1,2,1,0,5,"A","N","2021-01-13","202101130TOR"
"TOR",1,1,2,1,0,5,0,2,1,1,0,4,"H","N","2021-01-13","202101130TOR"
"ARI",0,0,1,2,0,3,0,2,0,1,1,4,"H","Y","2021-01-14","202101140ARI"
"SJS",0,2,0,1,1,4,0,0,1,2,0,3,"A","Y","2021-01-14","202101140ARI"
"BUF",0,1,1,2,0,4,0,2,2,2,0,6,"H","N","2021-01-14","202101140BUF"
"WSH",0,2,2,2,0,6,0,1,1,2,0,4,"A","N","2021-01-14","202101140BUF"
"CAR",0,1,0,2,0,3,0,0,0,0,0,0,"A","N","2021-01-14","202101140DET"
"DET",0,0,0,0,0,0,0,1,0,2,0,3,"H","N","2021-01-14","202101140DET"
"EDM",0,2,2,1,0,5,0,0,2,0,0,2,"H","N","2021-01-14","202101140EDM"
"VAN",0,0,2,0,0,2,0,2,2,1,0,5,"A","N","2021-01-14","202101140EDM"
"LAK",0,1,2,0,0,3,1,1,0,2,0,4,"H","N","2021-01-14","202101140LAK"
"MIN",1,1,0,2,0,4,0,1,2,0,0,3,"A","N","2021-01-14","202101140LAK"
"BOS",0,1,0,1,1,3,0,0,0,2,0,2,"A","Y","2021-01-14","202101140NJD"
"NJD",0,0,0,2,0,2,0,1,0,1,1,3,"H","Y","2021-01-14","202101140NJD"
"CBJ",0,1,0,0,0,1,0,0,1,2,0,3,"A","N","2021-01-14","202101140NSH"
"NSH",0,0,1,2,0,3,0,1,0,0,0,1,"H","N","2021-01-14","202101140NSH"
"NYI",0,3,1,0,0,4,0,0,0,0,0,0,"A","N","2021-01-14","202101140NYR"
"NYR",0,0,0,0,0,0,0,3,1,0,0,4,"H","N","2021-01-14","202101140NYR"
"ANA",0,2,0,0,0,2,0,2,0,3,0,5,"A","N","2021-01-14","202101140VEG"
"VEG",0,2,0,3,0,5,0,2,0,0,0,2,"H","N","2021-01-14","202101140VEG"
"CGY",0,3,0,0,0,3,1,1,2,0,0,4,"A","N","2021-01-14","202101140WPG"
"WPG",1,1,2,0,0,4,0,3,0,0,0,3,"H","N","2021-01-14","202101140WPG"
"BUF",0,0,0,1,0,1,0,0,1,1,0,2,"H","N","2021-01-15","202101150BUF"
"WSH",0,0,1,1,0,2,0,0,0,1,0,1,"A","N","2021-01-15","202101150BUF"
"COL",0,0,4,4,0,8,0,0,0,0,0,0,"H","N","2021-01-15","202101150COL"
"STL",0,0,0,0,0,0,0,0,4,4,0,8,"A","N","2021-01-15","202101150COL"
"OTT",0,1,3,1,0,5,0,1,1,1,0,3,"H","N","2021-01-15","202101150OTT"
"TOR",0,1,1,1,0,3,0,1,3,1,0,5,"A","N","2021-01-15","202101150OTT"
"PHI",0,3,0,2,0,5,0,2,0,0,0,2,"H","N","2021-01-15","202101150PHI"
"PIT",0,2,0,0,0,2,0,3,0,2,0,5,"A","N","2021-01-15","202101150PHI"
"CHI",0,0,2,0,0,2,0,0,3,2,0,5,"A","N","2021-01-15","202101150TBL"
"TBL",0,0,3,2,0,5,0,0,2,0,0,2,"H","N","2021-01-15","202101150TBL"
"ARI",0,2,2,1,0,5,0,2,0,1,0,3,"H","N","2021-01-16","202101160ARI"
"SJS",0,2,0,1,0,3,0,2,2,1,0,5,"A","N","2021-01-16","202101160ARI"
"CGY",0,1,1,1,0,3,0,0,0,0,0,0,"H","N","2021-01-16","202101160CGY"
"VAN",0,0,0,0,0,0,0,1,1,1,0,3,"A","N","2021-01-16","202101160CGY"
"CAR",0,0,0,2,0,2,0,0,1,3,0,4,"A","N","2021-01-16","202101160DET"
"DET",0,0,1,3,0,4,0,0,0,2,0,2,"H","N","2021-01-16","202101160DET"
"EDM",0,0,0,1,0,1,0,1,3,1,0,5,"H","N","2021-01-16","202101160EDM"
"MTL",0,1,3,1,0,5,0,0,0,1,0,1,"A","N","2021-01-16","202101160EDM"
"LAK",0,1,2,0,0,3,1,1,0,2,0,4,"H","N","2021-01-16","202101160LAK"
"MIN",1,1,0,2,0,4,0,1,2,0,0,3,"A","N","2021-01-16","202101160LAK"
"BOS",0,0,1,0,0,1,1,1,0,0,0,2,"A","N","2021-01-16","202101160NJD"
"NJD",1,1,0,0,0,2,0,0,1,0,0,1,"H","N","2021-01-16","202101160NJD"
"CBJ",0,1,0,1,0,2,0,1,0,4,0,5,"A","N","2021-01-16","202101160NSH"
"NSH",0,1,0,4,0,5,0,1,0,1,0,2,"H","N","2021-01-16","202101160NSH"
"NYI",0,0,0,0,0,0,0,2,2,1,0,5,"A","N","2021-01-16","202101160NYR"
"NYR",0,2,2,1,0,5,0,0,0,0,0,0,"H","N","2021-01-16","202101160NYR"
"OTT",0,1,0,1,0,2,0,1,1,1,0,3,"H","N","2021-01-16","202101160OTT"
"TOR",0,1,1,1,0,3,0,1,0,1,0,2,"A","N","2021-01-16","202101160OTT"
"ANA",0,0,1,0,0,1,1,0,0,1,0,2,"A","N","2021-01-16","202101160VEG"
"VEG",1,0,0,1,0,2,0,0,1,0,0,1,"H","N","2021-01-16","202101160VEG"
"CHI",0,0,1,1,0,2,0,0,2,3,0,5,"A","N","2021-01-17","202101170FLA"
"FLA",0,0,2,3,0,5,0,0,1,1,0,2,"H","N","2021-01-17","202101170FLA"
"PIT",0,1,2,0,1,4,0,2,1,0,0,3,"H","Y","2021-01-17","202101170PIT"
"WSH",0,2,1,0,0,3,0,1,2,0,1,4,"A","Y","2021-01-17","202101170PIT"
"ANA",0,0,0,1,0,1,0,0,0,0,0,0,"H","N","2021-01-18","202101180ANA"
"MIN",0,0,0,0,0,0,0,0,0,1,0,1,"A","N","2021-01-18","202101180ANA"
"CGY",0,0,3,2,0,5,0,1,0,1,0,2,"H","N","2021-01-18","202101180CGY"
"VAN",0,1,0,1,0,2,0,0,3,2,0,5,"A","N","2021-01-18","202101180CGY"
"CBJ",0,0,1,2,0,3,0,1,0,1,0,2,"A","N","2021-01-18","202101180DET"
"DET",0,1,0,1,0,2,0,0,1,2,0,3,"H","N","2021-01-18","202101180DET"
"EDM",0,0,0,1,0,1,0,1,1,1,0,3,"H","N","2021-01-18","202101180EDM"
"MTL",0,1,1,1,0,3,0,0,0,1,0,1,"A","N","2021-01-18","202101180EDM"
"CAR",0,0,1,3,0,4,0,0,1,1,0,2,"A","N","2021-01-18","202101180NSH"
"NSH",0,0,1,1,0,2,0,0,1,3,0,4,"H","N","2021-01-18","202101180NSH"
"BOS",0,0,0,0,0,0,0,0,0,1,0,1,"A","N","2021-01-18","202101180NYI"
"NYI",0,0,0,1,0,1,0,0,0,0,0,0,"H","N","2021-01-18","202101180NYI"
"BUF",0,1,3,2,0,6,0,0,0,1,0,1,"A","N","2021-01-18","202101180PHI"
"PHI",0,0,0,1,0,1,0,1,3,2,0,6,"H","N","2021-01-18","202101180PHI"
"SJS",0,2,1,1,0,4,0,0,4,1,0,5,"A","N","2021-01-18","202101180STL"
"STL",0,0,4,1,0,5,0,2,1,1,0,4,"H","N","2021-01-18","202101180STL"
"TOR",0,0,2,1,0,3,0,0,1,0,0,1,"H","N","2021-01-18","202101180TOR"
"WPG",0,0,1,0,0,1,0,0,2,1,0,3,"A","N","2021-01-18","202101180TOR"
"ARI",0,1,1,0,0,2,0,0,1,3,0,4,"A","N","2021-01-18","202101180VEG"
"VEG",0,0,1,3,0,4,0,1,1,0,0,2,"H","N","2021-01-18","202101180VEG"
"CBJ",0,0,1,1,0,2,1,0,2,0,0,3,"A","N","2021-01-19","202101190DET"
"DET",1,0,2,0,0,3,0,0,1,1,0,2,"H","N","2021-01-19","202101190DET"
"CHI",0,1,2,1,0,4,1,2,1,1,0,5,"A","N","2021-01-19","202101190FLA"
"FLA",1,2,1,1,0,5,0,1,2,1,0,4,"H","N","2021-01-19","202101190FLA"
"COL",0,1,2,0,0,3,0,0,0,2,0,2,"A","N","2021-01-19","202101190LAK"
"LAK",0,0,0,2,0,2,0,1,2,0,0,3,"H","N","2021-01-19","202101190LAK"
"NJD",0,1,3,0,0,4,0,0,2,1,0,3,"A","N","2021-01-19","202101190NYR"
"NYR",0,0,2,1,0,3,0,1,3,0,0,4,"H","N","2021-01-19","202101190NYR"
"OTT",0,2,1,0,0,3,1,1,1,1,0,4,"H","N","2021-01-19","202101190OTT"
"WPG",1,1,1,1,0,4,0,2,1,0,0,3,"A","N","2021-01-19","202101190OTT"
"BUF",0,0,0,0,0,0,0,0,1,2,0,3,"A","N","2021-01-19","202101190PHI"
"PHI",0,0,1,2,0,3,0,0,0,0,0,0,"H","N","2021-01-19","202101190PHI"
"PIT",1,1,3,0,0,5,0,3,1,0,0,4,"H","N","2021-01-19","202101190PIT"
"WSH",0,3,1,0,0,4,1,1,3,0,0,5,"A","N","2021-01-19","202101190PIT"
"ANA",0,0,2,0,0,2,0,1,1,1,0,3,"H","N","2021-01-20","202101200ANA"
"MIN",0,1,1,1,0,3,0,0,2,0,0,2,"A","N","2021-01-20","202101200ANA"
"SJS",0,0,1,0,1,2,0,0,1,0,0,1,"A","Y","2021-01-20","202101200STL"
"STL",0,0,1,0,0,1,0,0,1,0,1,2,"H","Y","2021-01-20","202101200STL"
"EDM",0,1,0,2,0,3,0,0,0,1,0,1,"A","N","2021-01-20","202101200TOR"
"TOR",0,0,0,1,0,1,0,1,0,2,0,3,"H","N","2021-01-20","202101200TOR"
"MTL",0,0,3,2,0,5,0,1,2,2,1,6,"A","Y","2021-01-20","202101200VAN"
"VAN",0,1,2,2,1,6,0,0,3,2,0,5,"H","Y","2021-01-20","202101200VAN"
"ARI",0,0,1,1,0,2,0,2,1,2,0,5,"A","N","2021-01-20","202101200VEG"
"VEG",0,2,1,2,0,5,0,0,1,1,0,2,"H","N","2021-01-20","202101200VEG"
"BOS",0,0,0,4,1,5,0,0,2,2,0,4,"H","Y","2021-01-21","202101210BOS"
"PHI",0,0,2,2,0,4,0,0,0,4,1,5,"A","Y","2021-01-21","202101210BOS"
"CBJ",0,1,0,1,0,2,1,0,2,0,0,3,"H","N","2021-01-21","202101210CBJ"
"TBL",1,0,2,0,0,3,0,1,0,1,0,2,"A","N","2021-01-21","202101210CBJ"
"COL",0,2,0,0,0,2,0,0,2,2,0,4,"A","N","2021-01-21","202101210LAK"
"LAK",0,0,2,2,0,4,0,2,0,0,0,2,"H","N","2021-01-21","202101210LAK"
"NJD",0,0,1,0,0,1,0,2,0,2,0,4,"A","N","2021-01-21","202101210NYI"
"NYI",0,2,0,2,0,4,0,0,1,0,0,1,"H","N","2021-01-21","202101210NYI"
"OTT",0,0,0,1,0,1,0,1,3,0,0,4,"H","N","2021-01-21","202101210OTT"
"WPG",0,1,3,0,0,4,0,0,0,1,0,1,"A","N","2021-01-21","202101210OTT"
"MTL",0,2,4,1,0,7,0,2,0,1,0,3,"A","N","2021-01-21","202101210VAN"
"VAN",0,2,0,1,0,3,0,2,4,1,0,7,"H","N","2021-01-21","202101210VAN"
"ANA",0,0,1,1,0,2,1,1,0,1,0,3,"H","N","2021-01-22","202101220ANA"
"COL",1,1,0,1,0,3,0,0,1,1,0,2,"A","N","2021-01-22","202101220ANA"
"ARI",0,1,2,2,0,5,0,0,1,1,0,2,"H","N","2021-01-22","202101220ARI"
"VEG",0,0,1,1,0,2,0,1,2,2,0,5,"A","N","2021-01-22","202101220ARI"
"CHI",0,1,1,2,0,4,0,0,0,1,0,1,"H","N","2021-01-22","202101220CHI"
"DET",0,0,0,1,0,1,0,1,1,2,0,4,"A","N","2021-01-22","202101220CHI"
"DAL",0,0,5,2,0,7,0,0,0,0,0,0,"H","N","2021-01-22","202101220DAL"
"NSH",0,0,0,0,0,0,0,0,5,2,0,7,"A","N","2021-01-22","202101220DAL"
"MIN",0,1,1,2,0,4,0,1,0,0,0,1,"H","N","2021-01-22","202101220MIN"
"SJS",0,1,0,0,0,1,0,1,1,2,0,4,"A","N","2021-01-22","202101220MIN"
"NYR",0,0,3,0,0,3,0,1,1,1,1,4,"A","Y","2021-01-22","202101220PIT"
"PIT",0,1,1,1,1,4,0,0,3,0,0,3,"H","Y","2021-01-22","202101220PIT"
"EDM",0,0,1,1,0,2,0,0,2,2,0,4,"A","N","2021-01-22","202101220TOR"
"TOR",0,0,2,2,0,4,0,0,1,1,0,2,"H","N","2021-01-22","202101220TOR"
"BUF",0,1,2,0,0,3,0,1,2,0,1,4,"A","Y","2021-01-22","202101220WSH"
"WSH",0,1,2,0,1,4,0,1,2,0,0,3,"H","Y","2021-01-22","202101220WSH"
"BOS",0,1,2,3,0,6,0,0,1,0,0,1,"H","N","2021-01-23","202101230BOS"
"PHI",0,0,1,0,0,1,0,1,2,3,0,6,"A","N","2021-01-23","202101230BOS"
"CBJ",0,3,0,2,0,5,0,2,0,0,0,2,"H","N","2021-01-23","202101230CBJ"
"TBL",0,2,0,0,0,2,0,3,0,2,0,5,"A","N","2021-01-23","202101230CBJ"
"LAK",0,0,2,0,0,2,0,1,2,1,0,4,"A","N","2021-01-23","202101230STL"
"STL",0,1,2,1,0,4,0,0,2,0,0,2,"H","N","2021-01-23","202101230STL"
"MTL",0,1,1,3,0,5,0,0,0,2,0,2,"A","N","2021-01-23","202101230VAN"
"VAN",0,0,0,2,0,2,0,1,1,3,0,5,"H","N","2021-01-23","202101230VAN"
"OTT",0,0,3,0,0,3,0,1,1,4,0,6,"A","N","2021-01-23","202101230WPG"
"WPG",0,1,1,4,0,6,0,0,3,0,0,3,"H","N","2021-01-23","202101230WPG"
"ANA",0,1,1,1,0,3,0,0,0,1,0,1,"H","N","2021-01-24","202101240ANA"
"COL",0,0,0,1,0,1,0,1,1,1,0,3,"A","N","2021-01-24","202101240ANA"
"ARI",0,0,0,0,0,0,0,0,0,1,0,1,"H","N","2021-01-24","202101240ARI"
"VEG",0,0,0,1,0,1,0,0,0,0,0,0,"A","N","2021-01-24","202101240ARI"
"CGY",0,0,1,1,0,2,0,1,1,1,0,3,"H","N","2021-01-24","202101240CGY"
"TOR",0,1,1,1,0,3,0,0,1,1,0,2,"A","N","2021-01-24","202101240CGY"
"CHI",0,2,1,3,0,6,0,0,1,1,0,2,"H","N","2021-01-24","202101240CHI"
"DET",0,0,1,1,0,2,0,2,1,3,0,6,"A","N","2021-01-24","202101240CHI"
"DAL",0,1,1,1,0,3,0,0,1,1,0,2,"H","N","2021-01-24","202101240DAL"
"NSH",0,0,1,1,0,2,0,1,1,1,0,3,"A","N","2021-01-24","202101240DAL"
"MIN",0,1,1,1,0,3,0,1,2,2,0,5,"H","N","2021-01-24","202101240MIN"
"SJS",0,1,2,2,0,5,0,1,1,1,0,3,"A","N","2021-01-24","202101240MIN"
"NJD",0,2,0,0,0,2,0,0,0,0,0,0,"H","N","2021-01-24","202101240NJD"
"NYI",0,0,0,0,0,0,0,2,0,0,0,2,"A","N","2021-01-24","202101240NJD"
"NYR",0,1,1,0,0,2,0,0,1,2,0,3,"A","N","2021-01-24","202101240PIT"
"PIT",0,0,1,2,0,3,0,1,1,0,0,2,"H","N","2021-01-24","202101240PIT"
"LAK",0,2,3,1,0,6,0,1,0,2,0,3,"A","N","2021-01-24","202101240STL"
"STL",0,1,0,2,0,3,0,2,3,1,0,6,"H","N","2021-01-24","202101240STL"
"EDM",0,0,2,2,0,4,0,1,0,2,0,3,"A","N","2021-01-24","202101240WPG"
"WPG",0,1,0,2,0,3,0,0,2,2,0,4,"H","N","2021-01-24","202101240WPG"
"BUF",0,0,2,1,1,4,0,1,1,1,0,3,"A","Y","2021-01-24","202101240WSH"
"WSH",0,1,1,1,0,3,0,0,2,1,1,4,"H","Y","2021-01-24","202101240WSH"
"OTT",0,0,1,0,0,1,0,2,2,3,0,7,"A","N","2021-01-25","202101250VAN"
"VAN",0,2,2,3,0,7,0,0,1,0,0,1,"H","N","2021-01-25","202101250VAN"
"ANA",0,1,0,0,0,1,0,0,0,0,0,0,"A","N","2021-01-26","202101260ARI"
"ARI",0,0,0,0,0,0,0,1,0,0,0,1,"H","N","2021-01-26","202101260ARI"
"BOS",1,1,1,0,0,3,0,0,0,2,0,2,"H","N","2021-01-26","202101260BOS"
"PIT",0,0,0,2,0,2,1,1,1,0,0,3,"A","N","2021-01-26","202101260BOS"
"BUF",0,1,2,0,0,3,0,2,0,0,0,2,"H","N","2021-01-26","202101260BUF"
"NYR",0,2,0,0,0,2,0,1,2,0,0,3,"A","N","2021-01-26","202101260BUF"
"CBJ",0,2,0,1,0,3,0,1,1,1,1,4,"H","Y","2021-01-26","202101260CBJ"
"FLA",0,1,1,1,1,4,0,2,0,1,0,3,"A","Y","2021-01-26","202101260CBJ"
"CGY",0,0,2,1,0,3,0,2,1,1,0,4,"H","N","2021-01-26","202101260CGY"
"TOR",0,2,1,1,0,4,0,0,2,1,0,3,"A","N","2021-01-26","202101260CGY"
"COL",0,3,4,0,0,7,0,1,1,1,0,3,"H","N","2021-01-26","202101260COL"
"SJS",0,1,1,1,0,3,0,3,4,0,0,7,"A","N","2021-01-26","202101260COL"
"DAL",1,0,1,0,0,2,0,1,0,0,0,1,"H","N","2021-01-26","202101260DAL"
"DET",0,1,0,0,0,1,1,0,1,0,0,2,"A","N","2021-01-26","202101260DAL"
"LAK",0,0,1,1,0,2,0,0,0,1,0,1,"A","N","2021-01-26","202101260MIN"
"MIN",0,0,0,1,0,1,0,0,1,1,0,2,"H","N","2021-01-26","202101260MIN"
"NJD",0,0,2,1,0,3,0,1,1,3,0,5,"H","N","2021-01-26","202101260NJD"
"PHI",0,1,1,3,0,5,0,0,2,1,0,3,"A","N","2021-01-26","202101260NJD"
"CHI",0,1,1,0,0,2,1,0,1,1,0,3,"A","N","2021-01-26","202101260NSH"
"NSH",1,0,1,1,0,3,0,1,1,0,0,2,"H","N","2021-01-26","202101260NSH"
"STL",0,3,1,0,1,5,0,1,1,2,0,4,"A","Y","2021-01-26","202101260VEG"
"VEG",0,1,1,2,0,4,0,3,1,0,1,5,"H","Y","2021-01-26","202101260VEG"
"EDM",0,3,0,1,0,4,0,2,0,4,0,6,"A","N","2021-01-26","202101260WPG"
"WPG",0,2,0,4,0,6,0,3,0,1,0,4,"H","N","2021-01-26","202101260WPG"
"NYI",0,1,1,0,0,2,0,1,1,1,0,3,"A","N","2021-01-26","202101260WSH"
"WSH",0,1,1,1,0,3,0,1,1,0,0,2,"H","N","2021-01-26","202101260WSH"
"CHI",0,0,0,1,0,1,0,0,0,1,1,2,"A","Y","2021-01-27","202101270NSH"
"NSH",0,0,0,1,1,2,0,0,0,1,0,1,"H","Y","2021-01-27","202101270NSH"
"OTT",0,1,0,0,0,1,0,1,3,1,0,5,"A","N","2021-01-27","202101270VAN"
"VAN",0,1,3,1,0,5,0,1,0,0,0,1,"H","N","2021-01-27","202101270VAN"
"ANA",0,1,0,1,0,2,0,0,1,2,0,3,"A","N","2021-01-28","202101280ARI"
"ARI",0,0,1,2,0,3,0,1,0,1,0,2,"H","N","2021-01-28","202101280ARI"
"BOS",0,2,1,1,0,4,0,1,0,0,0,1,"H","N","2021-01-28","202101280BOS"
"PIT",0,1,0,0,0,1,0,2,1,1,0,4,"A","N","2021-01-28","202101280BOS"
"BUF",0,1,0,1,0,2,1,1,1,0,0,3,"H","N","2021-01-28","202101280BUF"
"NYR",1,1,1,0,0,3,0,1,0,1,0,2,"A","N","2021-01-28","202101280BUF"
"CAR",1,0,0,0,0,1,0,0,0,0,0,0,"H","N","2021-01-28","202101280CAR"
"TBL",0,0,0,0,0,0,1,0,0,0,0,1,"A","N","2021-01-28","202101280CAR"
"CBJ",0,1,0,1,1,3,0,0,1,1,0,2,"H","Y","2021-01-28","202101280CBJ"
"FLA",0,0,1,1,0,2,0,1,0,1,1,3,"A","Y","2021-01-28","202101280CBJ"
"COL",0,0,0,3,0,3,0,0,0,0,0,0,"H","N","2021-01-28","202101280COL"
"SJS",0,0,0,0,0,0,0,0,0,3,0,3,"A","N","2021-01-28","202101280COL"
"DAL",0,1,2,4,0,7,0,0,1,2,0,3,"H","N","2021-01-28","202101280DAL"
"DET",0,0,1,2,0,3,0,1,2,4,0,7,"A","N","2021-01-28","202101280DAL"
"EDM",0,0,1,2,0,3,0,2,0,2,0,4,"H","N","2021-01-28","202101280EDM"
"TOR",0,2,0,2,0,4,0,0,1,2,0,3,"A","N","2021-01-28","202101280EDM"
"LAK",0,0,2,1,0,3,0,3,1,1,0,5,"A","N","2021-01-28","202101280MIN"
"MIN",0,3,1,1,0,5,0,0,2,1,0,3,"H","N","2021-01-28","202101280MIN"
"CGY",0,0,0,2,0,2,0,2,2,0,0,4,"A","N","2021-01-28","202101280MTL"
"MTL",0,2,2,0,0,4,0,0,0,2,0,2,"H","N","2021-01-28","202101280MTL"
"NJD",0,1,0,0,0,1,0,1,0,2,0,3,"H","N","2021-01-28","202101280NJD"
"PHI",0,1,0,2,0,3,0,1,0,0,0,1,"A","N","2021-01-28","202101280NJD"
"OTT",0,0,1,0,0,1,0,2,1,1,0,4,"A","N","2021-01-28","202101280VAN"
"VAN",0,2,1,1,0,4,0,0,1,0,0,1,"H","N","2021-01-28","202101280VAN"
"NYI",0,3,0,0,0,3,0,0,5,1,0,6,"A","N","2021-01-28","202101280WSH"
"WSH",0,0,5,1,0,6,0,3,0,0,0,3,"H","N","2021-01-28","202101280WSH"
"CBJ",0,1,1,0,0,2,0,0,1,0,0,1,"A","N","2021-01-29","202101290CHI"
"CHI",0,0,1,0,0,1,0,1,1,0,0,2,"H","N","2021-01-29","202101290CHI"
"ANA",0,1,0,0,0,1,0,3,1,2,0,6,"H","N","2021-01-30","202101300ANA"
"STL",0,3,1,2,0,6,0,1,0,0,0,1,"A","N","2021-01-30","202101300ANA"
"BUF",0,0,1,2,1,4,0,0,1,2,0,3,"H","Y","2021-01-30","202101300BUF"
"NJD",0,0,1,2,0,3,0,0,1,2,1,4,"A","Y","2021-01-30","202101300BUF"
"CAR",0,2,2,0,0,4,0,0,0,1,0,1,"H","N","2021-01-30","202101300CAR"
"DAL",0,0,0,1,0,1,0,2,2,0,0,4,"A","N","2021-01-30","202101300CAR"
"DET",0,2,0,0,0,2,1,2,0,0,0,3,"H","N","2021-01-30","202101300DET"
"FLA",1,2,0,0,0,3,0,2,0,0,0,2,"A","N","2021-01-30","202101300DET"
"EDM",1,2,1,0,0,4,0,1,2,0,0,3,"H","N","2021-01-30","202101300EDM"
"TOR",0,1,2,0,0,3,1,2,1,0,0,4,"A","N","2021-01-30","202101300EDM"
"COL",0,2,1,2,0,5,0,1,0,0,0,1,"A","N","2021-01-30","202101300MIN"
"MIN",0,1,0,0,0,1,0,2,1,2,0,5,"H","N","2021-01-30","202101300MIN"
"CGY",0,1,0,1,0,2,0,0,0,0,0,0,"A","N","2021-01-30","202101300MTL"
"MTL",0,0,0,0,0,0,0,1,0,1,0,2,"H","N","2021-01-30","202101300MTL"
"NYR",0,1,3,0,0,4,1,2,1,1,0,5,"H","N","2021-01-30","202101300NYR"
"PIT",1,2,1,1,0,5,0,1,3,0,0,4,"A","N","2021-01-30","202101300NYR"
"NYI",0,0,2,0,0,2,1,2,0,0,0,3,"A","N","2021-01-30","202101300PHI"
"PHI",1,2,0,0,0,3,0,0,2,0,0,2,"H","N","2021-01-30","202101300PHI"
"NSH",0,1,0,2,0,3,0,0,4,0,0,4,"A","N","2021-01-30","202101300TBL"
"TBL",0,0,4,0,0,4,0,1,0,2,0,3,"H","N","2021-01-30","202101300TBL"
"VAN",0,2,1,1,0,4,0,1,0,0,0,1,"A","N","2021-01-30","202101300WPG"
"WPG",0,1,0,0,0,1,0,2,1,1,0,4,"H","N","2021-01-30","202101300WPG"
"BOS",0,0,1,2,0,3,1,1,2,0,0,4,"A","N","2021-01-30","202101300WSH"
"WSH",1,1,2,0,0,4,0,0,1,2,0,3,"H","N","2021-01-30","202101300WSH"
"ANA",0,1,0,0,0,1,0,0,2,2,0,4,"H","N","2021-01-31","202101310ANA"
"STL",0,0,2,2,0,4,0,1,0,0,0,1,"A","N","2021-01-31","202101310ANA"
"BUF",0,0,2,1,0,3,0,2,1,2,0,5,"H","N","2021-01-31","202101310BUF"
"NJD",0,2,1,2,0,5,0,0,2,1,0,3,"A","N","2021-01-31","202101310BUF"
"CAR",0,1,1,1,1,4,0,0,1,2,0,3,"H","Y","2021-01-31","202101310CAR"
"DAL",0,0,1,2,0,3,0,1,1,1,1,4,"A","Y","2021-01-31","202101310CAR"
"CBJ",0,1,0,0,0,1,0,1,0,2,0,3,"A","N","2021-01-31","202101310CHI"
"CHI",0,1,0,2,0,3,0,1,0,0,0,1,"H","N","2021-01-31","202101310CHI"
"DET",0,1,0,1,0,2,0,0,2,1,0,3,"H","N","2021-01-31","202101310DET"
"FLA",0,0,2,1,0,3,0,1,0,1,0,2,"A","N","2021-01-31","202101310DET"
"EDM",0,5,3,0,0,8,0,3,0,2,0,5,"H","N","2021-01-31","202101310EDM"
"OTT",0,3,0,2,0,5,0,5,3,0,0,8,"A","N","2021-01-31","202101310EDM"
"COL",0,1,1,1,0,3,1,1,1,1,0,4,"A","N","2021-01-31","202101310MIN"
"MIN",1,1,1,1,0,4,0,1,1,1,0,3,"H","N","2021-01-31","202101310MIN"
"NYI",0,0,1,2,0,3,1,1,2,0,0,4,"A","N","2021-01-31","202101310PHI"
"PHI",1,1,2,0,0,4,0,0,1,2,0,3,"H","N","2021-01-31","202101310PHI"
"MTL",0,3,3,0,0,6,0,1,0,1,0,2,"H","N","2021-02-01","202102010MTL"
"VAN",0,1,0,1,0,2,0,3,3,0,0,6,"A","N","2021-02-01","202102010MTL"
"NYR",0,0,1,2,0,3,0,1,0,0,0,1,"H","N","2021-02-01","202102010NYR"
"PIT",0,1,0,0,0,1,0,0,1,2,0,3,"A","N","2021-02-01","202102010NYR"
"NSH",0,0,0,2,0,2,0,3,1,1,0,5,"A","N","2021-02-01","202102010TBL"
"TBL",0,3,1,1,0,5,0,0,0,2,0,2,"H","N","2021-02-01","202102010TBL"
"CGY",0,0,1,2,1,4,0,2,0,1,0,3,"A","Y","2021-02-01","202102010WPG"
"WPG",0,2,0,1,0,3,0,0,1,2,1,4,"H","Y","2021-02-01","202102010WPG"
"BOS",0,0,1,4,0,5,0,2,1,0,0,3,"A","N","2021-02-01","202102010WSH"
"WSH",0,2,1,0,0,3,0,0,1,4,0,5,"H","N","2021-02-01","202102010WSH"
"CBJ",0,0,1,2,0,3,0,1,4,1,0,6,"H","N","2021-02-02","202102020CBJ"
"DAL",0,1,4,1,0,6,0,0,1,2,0,3,"A","N","2021-02-02","202102020CBJ"
"CAR",0,2,0,1,1,4,0,2,0,1,0,3,"A","Y","2021-02-02","202102020CHI"
"CHI",0,2,0,1,0,3,0,2,0,1,1,4,"H","Y","2021-02-02","202102020CHI"
"COL",0,1,1,0,0,2,0,0,1,0,0,1,"H","N","2021-02-02","202102020COL"
"MIN",0,0,1,0,0,1,0,1,1,0,0,2,"A","N","2021-02-02","202102020COL"
"EDM",0,3,1,0,0,4,0,0,1,1,0,2,"H","N","2021-02-02","202102020EDM"
"OTT",0,0,1,1,0,2,0,3,1,0,0,4,"A","N","2021-02-02","202102020EDM"
"ANA",0,1,1,1,0,3,0,0,1,0,0,1,"A","N","2021-02-02","202102020LAK"
"LAK",0,0,1,0,0,1,0,1,1,1,0,3,"H","N","2021-02-02","202102020LAK"
"MTL",0,2,2,1,0,5,0,0,1,2,0,3,"H","N","2021-02-02","202102020MTL"
"VAN",0,0,1,2,0,3,0,2,2,1,0,5,"A","N","2021-02-02","202102020MTL"
"ARI",0,1,1,1,0,3,0,1,2,1,0,4,"A","N","2021-02-02","202102020STL"
"STL",0,1,2,1,0,4,0,1,1,1,0,3,"H","N","2021-02-02","202102020STL"
"CGY",0,1,0,1,0,2,0,3,0,0,0,3,"A","N","2021-02-02","202102020WPG"
"WPG",0,3,0,0,0,3,0,1,0,1,0,2,"H","N","2021-02-02","202102020WPG"
"BOS",1,1,0,2,0,4,0,0,1,2,0,3,"A","N","2021-02-03","202102030PHI"
"PHI",0,0,1,2,0,3,1,1,0,2,0,4,"H","N","2021-02-03","202102030PHI"
"DET",0,0,1,0,0,1,0,3,2,0,0,5,"A","N","2021-02-03","202102030TBL"
"TBL",0,3,2,0,0,5,0,0,1,0,0,1,"H","N","2021-02-03","202102030TBL"
"CBJ",0,2,1,1,0,4,0,0,2,1,0,3,"H","N","2021-02-04","202102040CBJ"
"DAL",0,0,2,1,0,3,0,2,1,1,0,4,"A","N","2021-02-04","202102040CBJ"
"CAR",0,1,2,1,0,4,0,3,0,3,0,6,"A","N","2021-02-04","202102040CHI"
"CHI",0,3,0,3,0,6,0,1,2,1,0,4,"H","N","2021-02-04","202102040CHI"
"FLA",0,2,3,0,0,5,1,2,1,2,0,6,"H","N","2021-02-04","202102040FLA"
"NSH",1,2,1,2,0,6,0,2,3,0,0,5,"A","N","2021-02-04","202102040FLA"
"MTL",0,1,0,1,0,2,0,2,1,0,0,3,"H","N","2021-02-04","202102040MTL"
"OTT",0,2,1,0,0,3,0,1,0,1,0,2,"A","N","2021-02-04","202102040MTL"
"NYR",0,1,1,2,0,4,0,0,1,1,0,2,"H","N","2021-02-04","202102040NYR"
"WSH",0,0,1,1,0,2,0,1,1,2,0,4,"A","N","2021-02-04","202102040NYR"
"ARI",0,2,1,1,0,4,0,0,0,3,0,3,"A","N","2021-02-04","202102040STL"
"STL",0,0,0,3,0,3,0,2,1,1,0,4,"H","N","2021-02-04","202102040STL"
"TOR",0,2,3,2,0,7,0,1,1,1,0,3,"H","N","2021-02-04","202102040TOR"
"VAN",0,1,1,1,0,3,0,2,3,2,0,7,"A","N","2021-02-04","202102040TOR"
"CGY",0,1,0,0,0,1,0,0,3,1,0,4,"A","N","2021-02-04","202102040WPG"
"WPG",0,0,3,1,0,4,0,1,0,0,0,1,"H","N","2021-02-04","202102040WPG"
"ANA",0,0,3,1,0,4,0,1,0,3,1,5,"H","Y","2021-02-05","202102050ANA"
"SJS",0,1,0,3,1,5,0,0,3,1,0,4,"A","Y","2021-02-05","202102050ANA"
"FLA",0,0,2,0,0,2,0,1,0,0,0,1,"H","N","2021-02-05","202102050FLA"
"NSH",0,1,0,0,0,1,0,0,2,0,0,2,"A","N","2021-02-05","202102050FLA"
"BOS",0,0,0,2,0,2,0,0,0,1,0,1,"A","N","2021-02-05","202102050PHI"
"PHI",0,0,0,1,0,1,0,0,0,2,0,2,"H","N","2021-02-05","202102050PHI"
"DET",0,1,0,0,0,1,0,1,1,1,0,3,"A","N","2021-02-05","202102050TBL"
"TBL",0,1,1,1,0,3,0,1,0,0,0,1,"H","N","2021-02-05","202102050TBL"
"LAK",0,0,0,2,0,2,0,3,2,0,0,5,"A","N","2021-02-05","202102050VEG"
"VEG",0,3,2,0,0,5,0,0,0,2,0,2,"H","N","2021-02-05","202102050VEG"
"ANA",0,0,1,0,1,2,0,1,0,0,0,1,"H","Y","2021-02-06","202102060ANA"
"SJS",0,1,0,0,0,1,0,0,1,0,1,2,"A","Y","2021-02-06","202102060ANA"
"CGY",0,1,2,3,0,6,0,2,0,2,0,4,"H","N","2021-02-06","202102060CGY"
"EDM",0,2,0,2,0,4,0,1,2,3,0,6,"A","N","2021-02-06","202102060CGY"
"NYI",0,2,0,2,0,4,0,1,1,1,0,3,"H","N","2021-02-06","202102060NYI"
"PIT",0,1,1,1,0,3,0,2,0,2,0,4,"A","N","2021-02-06","202102060NYI"
"MTL",0,1,0,1,0,2,0,1,0,0,0,1,"A","N","2021-02-06","202102060OTT"
"OTT",0,1,0,0,0,1,0,1,0,1,0,2,"H","N","2021-02-06","202102060OTT"
"ARI",0,1,1,1,0,3,0,1,0,0,0,1,"A","N","2021-02-06","202102060STL"
"STL",0,1,0,0,0,1,0,1,1,1,0,3,"H","N","2021-02-06","202102060STL"
"TOR",0,2,1,2,0,5,0,0,0,1,0,1,"H","N","2021-02-06","202102060TOR"
"VAN",0,0,0,1,0,1,0,2,1,2,0,5,"A","N","2021-02-06","202102060TOR"
"CAR",0,1,3,2,0,6,0,2,1,2,0,5,"A","N","2021-02-07","202102070CBJ"
"CBJ",0,2,1,2,0,5,0,1,3,2,0,6,"H","N","2021-02-07","202102070CBJ"
"CHI",1,0,1,0,0,2,0,0,0,1,0,1,"A","N","2021-02-07","202102070DAL"
"DAL",0,0,0,1,0,1,1,0,1,0,0,2,"H","N","2021-02-07","202102070DAL"
"DET",0,0,2,2,0,4,0,0,0,1,0,1,"A","N","2021-02-07","202102070FLA"
"FLA",0,0,0,1,0,1,0,0,2,2,0,4,"H","N","2021-02-07","202102070FLA"
"LAK",0,2,1,0,0,3,0,3,0,1,0,4,"A","N","2021-02-07","202102070VEG"
"VEG",0,3,0,1,0,4,0,2,1,0,0,3,"H","N","2021-02-07","202102070VEG"
"PHI",0,1,3,3,0,7,0,2,2,0,0,4,"A","N","2021-02-07","202102070WSH"
"WSH",0,2,2,0,0,4,0,1,3,3,0,7,"H","N","2021-02-07","202102070WSH"
"CAR",0,0,2,0,0,2,0,1,1,1,0,3,"A","N","2021-02-08","202102080CBJ"
"CBJ",0,1,1,1,0,3,0,0,2,0,0,2,"H","N","2021-02-08","202102080CBJ"
"NSH",0,0,0,1,0,1,0,1,1,2,0,4,"H","N","2021-02-08","202102080NSH"
"TBL",0,1,1,2,0,4,0,0,0,1,0,1,"A","N","2021-02-08","202102080NSH"
"NYI",0,0,0,2,0,2,0,0,0,0,0,0,"A","N","2021-02-08","202102080NYR"
"NYR",0,0,0,0,0,0,0,0,0,2,0,2,"H","N","2021-02-08","202102080NYR"
"EDM",0,0,1,2,0,3,0,0,1,0,0,1,"A","N","2021-02-08","202102080OTT"
"OTT",0,0,1,0,0,1,0,0,1,2,0,3,"H","N","2021-02-08","202102080OTT"
"ARI",0,0,2,1,1,4,0,1,1,1,0,3,"A","Y","2021-02-08","202102080STL"
"STL",0,1,1,1,0,3,0,0,2,1,1,4,"H","Y","2021-02-08","202102080STL"
"TOR",0,1,0,2,0,3,0,0,1,0,0,1,"H","N","2021-02-08","202102080TOR"
"VAN",0,0,1,0,0,1,0,1,0,2,0,3,"A","N","2021-02-08","202102080TOR"
"CGY",0,0,2,1,0,3,0,0,2,0,0,2,"H","N","2021-02-09","202102090CGY"
"WPG",0,0,2,0,0,2,0,0,2,1,0,3,"A","N","2021-02-09","202102090CGY"
"CHI",1,0,1,0,0,2,0,1,0,0,0,1,"A","N","2021-02-09","202102090DAL"
"DAL",0,1,0,0,0,1,1,0,1,0,0,2,"H","N","2021-02-09","202102090DAL"
"DET",0,1,0,0,0,1,0,1,1,0,0,2,"A","N","2021-02-09","202102090FLA"
"FLA",0,1,1,0,0,2,0,1,0,0,0,1,"H","N","2021-02-09","202102090FLA"
"LAK",0,0,2,1,0,3,0,2,0,1,1,4,"H","Y","2021-02-09","202102090LAK"
"SJS",0,2,0,1,1,4,0,0,2,1,0,3,"A","Y","2021-02-09","202102090LAK"
"NSH",0,1,0,0,0,1,0,3,0,3,0,6,"H","N","2021-02-09","202102090NSH"
"TBL",0,3,0,3,0,6,0,1,0,0,0,1,"A","N","2021-02-09","202102090NSH"
"EDM",0,2,1,0,0,3,0,1,0,1,0,2,"A","N","2021-02-09","202102090OTT"
"OTT",0,1,0,1,0,2,0,2,1,0,0,3,"H","N","2021-02-09","202102090OTT"
"ANA",0,0,1,3,0,4,0,2,2,1,0,5,"A","N","2021-02-09","202102090VEG"
"VEG",0,2,2,1,0,5,0,0,1,3,0,4,"H","N","2021-02-09","202102090VEG"
"MTL",0,1,0,1,0,2,0,0,1,3,0,4,"H","N","2021-02-10","202102100MTL"
"TOR",0,0,1,3,0,4,0,1,0,1,0,2,"A","N","2021-02-10","202102100MTL"
"BOS",1,0,1,1,0,3,0,1,0,1,0,2,"A","N","2021-02-10","202102100NYR"
"NYR",0,1,0,1,0,2,1,0,1,1,0,3,"H","N","2021-02-10","202102100NYR"
"CBJ",0,1,1,4,0,6,0,0,3,2,0,5,"A","N","2021-02-11","202102110CHI"
"CHI",0,0,3,2,0,5,0,1,1,4,0,6,"H","N","2021-02-11","202102110CHI"
"CAR",0,1,2,2,0,5,0,0,3,0,0,3,"A","N","2021-02-11","202102110DAL"
"DAL",0,0,3,0,0,3,0,1,2,2,0,5,"H","N","2021-02-11","202102110DAL"
"FLA",0,1,3,1,0,5,0,0,1,1,0,2,"H","N","2021-02-11","202102110FLA"
"TBL",0,0,1,1,0,2,0,1,3,1,0,5,"A","N","2021-02-11","202102110FLA"
"LAK",0,3,0,3,0,6,0,1,1,0,0,2,"H","N","2021-02-11","202102110LAK"
"SJS",0,1,1,0,0,2,0,3,0,3,0,6,"A","N","2021-02-11","202102110LAK"
"EDM",0,1,1,1,0,3,0,0,0,0,0,0,"A","N","2021-02-11","202102110MTL"
"MTL",0,0,0,0,0,0,0,1,1,1,0,3,"H","N","2021-02-11","202102110MTL"
"DET",0,1,1,0,0,2,0,1,1,1,0,3,"A","N","2021-02-11","202102110NSH"
"NSH",0,1,1,1,0,3,0,1,1,0,0,2,"H","N","2021-02-11","202102110NSH"
"NYI",0,2,0,1,0,3,0,1,1,1,1,4,"H","Y","2021-02-11","202102110NYI"
"PIT",0,1,1,1,1,4,0,2,0,1,0,3,"A","Y","2021-02-11","202102110NYI"
"CGY",0,1,1,1,0,3,0,0,1,0,0,1,"A","N","2021-02-11","202102110VAN"
"VAN",0,0,1,0,0,1,0,1,1,1,0,3,"H","N","2021-02-11","202102110VAN"
"ANA",0,0,0,1,0,1,0,0,0,0,0,0,"A","N","2021-02-11","202102110VEG"
"VEG",0,0,0,0,0,0,0,0,0,1,0,1,"H","N","2021-02-11","202102110VEG"
"OTT",0,0,0,1,0,1,0,0,3,2,0,5,"A","N","2021-02-11","202102110WPG"
"WPG",0,0,3,2,0,5,0,0,0,1,0,1,"H","N","2021-02-11","202102110WPG"
"ARI",0,0,1,0,0,1,0,1,0,3,0,4,"H","N","2021-02-12","202102120ARI"
"STL",0,1,0,3,0,4,0,0,1,0,0,1,"A","N","2021-02-12","202102120ARI"
"BOS",0,0,1,0,0,1,0,0,0,0,0,0,"A","N","2021-02-12","202102120NYR"
"NYR",0,0,0,0,0,0,0,0,1,0,0,1,"H","N","2021-02-12","202102120NYR"
"ARI",0,1,1,2,0,4,1,2,1,1,0,5,"H","N","2021-02-13","202102130ARI"
"STL",1,2,1,1,0,5,0,1,1,2,0,4,"A","N","2021-02-13","202102130ARI"
"CBJ",0,1,1,0,0,2,1,0,1,1,0,3,"A","N","2021-02-13","202102130CHI"
"CHI",1,0,1,1,0,3,0,1,1,0,0,2,"H","N","2021-02-13","202102130CHI"
"CAR",0,0,2,1,1,4,0,0,1,2,0,3,"A","Y","2021-02-13","202102130DAL"
"DAL",0,0,1,2,0,3,0,0,2,1,1,4,"H","Y","2021-02-13","202102130DAL"
"FLA",0,0,0,1,0,1,0,0,4,2,0,6,"H","N","2021-02-13","202102130FLA"
"TBL",0,0,4,2,0,6,0,0,0,1,0,1,"A","N","2021-02-13","202102130FLA"
"DET",0,2,1,1,0,4,0,0,0,2,0,2,"A","N","2021-02-13","202102130NSH"
"NSH",0,0,0,2,0,2,0,2,1,1,0,4,"H","N","2021-02-13","202102130NSH"
"BOS",0,1,1,0,0,2,0,2,0,2,0,4,"A","N","2021-02-13","202102130NYI"
"NYI",0,2,0,2,0,4,0,1,1,0,0,2,"H","N","2021-02-13","202102130NYI"
"SJS",0,0,1,0,0,1,0,1,1,1,0,3,"H","N","2021-02-13","202102130SJS"
"VEG",0,1,1,1,0,3,0,0,1,0,0,1,"A","N","2021-02-13","202102130SJS"
"MTL",0,0,0,2,0,2,0,1,0,0,0,1,"A","N","2021-02-13","202102130TOR"
"TOR",0,1,0,0,0,1,0,0,0,2,0,2,"H","N","2021-02-13","202102130TOR"
"CGY",0,0,1,0,0,1,0,0,1,2,0,3,"A","N","2021-02-13","202102130VAN"
"VAN",0,0,1,2,0,3,0,0,1,0,0,1,"H","N","2021-02-13","202102130VAN"
"OTT",0,0,1,1,0,2,0,0,1,0,0,1,"A","N","2021-02-13","202102130WPG"
"WPG",0,0,1,0,0,1,0,0,1,1,0,2,"H","N","2021-02-13","202102130WPG"
"PIT",0,2,2,2,0,6,0,1,2,0,0,3,"H","N","2021-02-14","202102140PIT"
"WSH",0,1,2,0,0,3,0,2,2,2,0,6,"A","N","2021-02-14","202102140PIT"
"COL",0,0,0,0,0,0,0,0,1,0,0,1,"A","N","2021-02-14","202102140VEG"
"VEG",0,0,1,0,0,1,0,0,0,0,0,0,"H","N","2021-02-14","202102140VEG"
"ARI",0,0,1,0,0,1,0,0,0,0,0,0,"H","N","2021-02-15","202102150ARI"
"STL",0,0,0,0,0,0,0,0,1,0,0,1,"A","N","2021-02-15","202102150ARI"
"BUF",0,0,1,0,0,1,0,2,1,0,0,3,"H","N","2021-02-15","202102150BUF"
"NYI",0,2,1,0,0,3,0,0,1,0,0,1,"A","N","2021-02-15","202102150BUF"
"CAR",0,2,3,2,0,7,0,3,0,0,0,3,"H","N","2021-02-15","202102150CAR"
"CBJ",0,3,0,0,0,3,0,2,3,2,0,7,"A","N","2021-02-15","202102150CAR"
"CHI",1,2,0,0,0,3,0,1,0,1,0,2,"A","N","2021-02-15","202102150DET"
"DET",0,1,0,1,0,2,1,2,0,0,0,3,"H","N","2021-02-15","202102150DET"
"EDM",0,1,3,1,0,5,0,2,3,1,0,6,"H","N","2021-02-15","202102150EDM"
"WPG",0,2,3,1,0,6,0,1,3,1,0,5,"A","N","2021-02-15","202102150EDM"
"ANA",0,1,0,1,0,2,0,1,2,0,0,3,"A","N","2021-02-15","202102150SJS"
"SJS",0,1,2,0,0,3,0,1,0,1,0,2,"H","N","2021-02-15","202102150SJS"
"FLA",0,1,4,1,0,6,0,1,3,0,0,4,"A","N","2021-02-15","202102150TBL"
"TBL",0,1,3,0,0,4,0,1,4,1,0,6,"H","N","2021-02-15","202102150TBL"
"OTT",1,1,1,3,0,6,0,2,3,0,0,5,"A","N","2021-02-15","202102150TOR"
"TOR",0,2,3,0,0,5,1,1,1,3,0,6,"H","N","2021-02-15","202102150TOR"
"CGY",1,1,2,0,0,4,0,2,0,1,0,3,"A","N","2021-02-15","202102150VAN"
"VAN",0,2,0,1,0,3,1,1,2,0,0,4,"H","N","2021-02-15","202102150VAN"
"BUF",0,0,0,0,0,0,0,2,0,1,0,3,"H","N","2021-02-16","202102160BUF"
"NYI",0,2,0,1,0,3,0,0,0,0,0,0,"A","N","2021-02-16","202102160BUF"
"LAK",0,1,1,2,0,4,0,0,0,0,0,0,"H","N","2021-02-16","202102160LAK"
"MIN",0,0,0,0,0,0,0,1,1,2,0,4,"A","N","2021-02-16","202102160LAK"
"NJD",0,0,2,3,0,5,0,0,2,0,0,2,"A","N","2021-02-16","202102160NYR"
"NYR",0,0,2,0,0,2,0,0,2,3,0,5,"H","N","2021-02-16","202102160NYR"
"PIT",0,0,0,1,0,1,0,0,2,1,0,3,"H","N","2021-02-16","202102160PIT"
"WSH",0,0,2,1,0,3,0,0,0,1,0,1,"A","N","2021-02-16","202102160PIT"
"COL",0,1,1,1,0,3,0,0,1,1,0,2,"A","N","2021-02-16","202102160VEG"
"VEG",0,0,1,1,0,2,0,1,1,1,0,3,"H","N","2021-02-16","202102160VEG"
"CAR",0,2,0,1,0,3,1,0,1,2,0,4,"H","N","2021-02-17","202102170CAR"
"FLA",1,0,1,2,0,4,0,2,0,1,0,3,"A","N","2021-02-17","202102170CAR"
"CGY",0,0,1,0,0,1,0,1,3,1,0,5,"H","N","2021-02-17","202102170CGY"
"VAN",0,1,3,1,0,5,0,0,1,0,0,1,"A","N","2021-02-17","202102170CGY"
"CHI",0,0,1,1,0,2,0,0,0,0,0,0,"A","N","2021-02-17","202102170DET"
"DET",0,0,0,0,0,0,0,0,1,1,0,2,"H","N","2021-02-17","202102170DET"
"EDM",0,2,1,0,0,3,0,1,0,1,0,2,"H","N","2021-02-17","202102170EDM"
"WPG",0,1,0,1,0,2,0,2,1,0,0,3,"A","N","2021-02-17","202102170EDM"
"OTT",0,0,1,0,0,1,0,0,1,1,0,2,"A","N","2021-02-17","202102170TOR"
"TOR",0,0,1,1,0,2,0,0,1,0,0,1,"H","N","2021-02-17","202102170TOR"
"ANA",0,0,1,0,0,1,0,2,0,1,0,3,"H","N","2021-02-18","202102180ANA"
"MIN",0,2,0,1,0,3,0,0,1,0,0,1,"A","N","2021-02-18","202102180ANA"
"ARI",0,0,2,0,0,2,0,2,0,0,1,3,"H","Y","2021-02-18","202102180ARI"
"LAK",0,2,0,0,1,3,0,0,2,0,0,2,"A","Y","2021-02-18","202102180ARI"
"BOS",0,0,1,1,0,2,0,0,3,0,0,3,"H","N","2021-02-18","202102180BOS"
"NJD",0,0,3,0,0,3,0,0,1,1,0,2,"A","N","2021-02-18","202102180BOS"
"CBJ",0,1,1,1,0,3,0,0,0,0,0,0,"H","N","2021-02-18","202102180CBJ"
"NSH",0,0,0,0,0,0,0,1,1,1,0,3,"A","N","2021-02-18","202102180CBJ"
"NYR",0,0,1,1,1,3,0,1,0,1,0,2,"A","Y","2021-02-18","202102180PHI"
"PHI",0,1,0,1,0,2,0,0,1,1,1,3,"H","Y","2021-02-18","202102180PHI"
"NYI",0,0,0,1,0,1,0,1,1,2,0,4,"A","N","2021-02-18","202102180PIT"
"PIT",0,1,1,2,0,4,0,0,0,1,0,1,"H","N","2021-02-18","202102180PIT"
"SJS",0,0,2,0,0,2,1,1,0,1,0,3,"A","N","2021-02-18","202102180STL"
"STL",1,1,0,1,0,3,0,0,2,0,0,2,"H","N","2021-02-18","202102180STL"
"OTT",0,1,1,1,0,3,0,3,3,1,0,7,"A","N","2021-02-18","202102180TOR"
"TOR",0,3,3,1,0,7,0,1,1,1,0,3,"H","N","2021-02-18","202102180TOR"
"BUF",0,0,0,1,0,1,0,1,1,1,0,3,"A","N","2021-02-18","202102180WSH"
"WSH",0,1,1,1,0,3,0,0,0,1,0,1,"H","N","2021-02-18","202102180WSH"
"CAR",0,1,1,3,0,5,0,0,2,1,0,3,"H","N","2021-02-19","202102190CAR"
"CHI",0,0,2,1,0,3,0,1,1,3,0,5,"A","N","2021-02-19","202102190CAR"
"CGY",0,0,1,0,0,1,0,1,1,0,0,2,"H","N","2021-02-19","202102190CGY"
"EDM",0,1,1,0,0,2,0,0,1,0,0,1,"A","N","2021-02-19","202102190CGY"
"DET",0,1,0,1,0,2,0,4,1,2,0,7,"H","N","2021-02-19","202102190DET"
"FLA",0,4,1,2,0,7,0,1,0,1,0,2,"A","N","2021-02-19","202102190DET"
"VAN",0,0,0,0,0,0,0,1,0,1,0,2,"H","N","2021-02-19","202102190VAN"
"WPG",0,1,0,1,0,2,0,0,0,0,0,0,"A","N","2021-02-19","202102190VAN"
"ANA",0,0,1,0,0,1,0,2,1,2,0,5,"H","N","2021-02-20","202102200ANA"
"MIN",0,2,1,2,0,5,0,0,1,0,0,1,"A","N","2021-02-20","202102200ANA"
"ARI",0,0,1,1,0,2,0,0,1,3,0,4,"H","N","2021-02-20","202102200ARI"
"LAK",0,0,1,3,0,4,0,0,1,1,0,2,"A","N","2021-02-20","202102200ARI"
"CAR",0,0,2,2,0,4,0,0,0,0,0,0,"H","N","2021-02-20","202102200CAR"
"TBL",0,0,0,0,0,0,0,0,2,2,0,4,"A","N","2021-02-20","202102200CAR"
"CBJ",0,0,2,0,0,2,0,2,0,2,0,4,"H","N","2021-02-20","202102200CBJ"
"NSH",0,2,0,2,0,4,0,0,2,0,0,2,"A","N","2021-02-20","202102200CBJ"
"COL",0,1,1,1,0,3,0,0,1,1,0,2,"H","N","2021-02-20","202102200COL"
"VEG",0,0,1,1,0,2,0,1,1,1,0,3,"A","N","2021-02-20","202102200COL"
"DET",0,0,2,0,0,2,0,1,0,0,0,1,"H","N","2021-02-20","202102200DET"
"FLA",0,1,0,0,0,1,0,0,2,0,0,2,"A","N","2021-02-20","202102200DET"
"CGY",0,1,0,0,0,1,0,3,3,1,0,7,"A","N","2021-02-20","202102200EDM"
"EDM",0,3,3,1,0,7,0,1,0,0,0,1,"H","N","2021-02-20","202102200EDM"
"MTL",0,0,2,1,0,3,0,0,4,1,0,5,"H","N","2021-02-20","202102200MTL"
"TOR",0,0,4,1,0,5,0,0,2,1,0,3,"A","N","2021-02-20","202102200MTL"
"BUF",0,1,2,0,0,3,0,0,0,2,0,2,"A","N","2021-02-20","202102200NJD"
"NJD",0,0,0,2,0,2,0,1,2,0,0,3,"H","N","2021-02-20","202102200NJD"
"NYI",0,0,1,1,0,2,0,0,1,2,0,3,"A","N","2021-02-20","202102200PIT"
"PIT",0,0,1,2,0,3,0,0,1,1,0,2,"H","N","2021-02-20","202102200PIT"
"SJS",0,2,2,1,0,5,0,0,4,0,0,4,"A","N","2021-02-20","202102200STL"
"STL",0,0,4,0,0,4,0,2,2,1,0,5,"H","N","2021-02-20","202102200STL"
"NYR",0,1,2,1,0,4,0,0,1,0,0,1,"A","N","2021-02-20","202102200WSH"
"WSH",0,0,1,0,0,1,0,1,2,1,0,4,"H","N","2021-02-20","202102200WSH"
"BOS",0,2,4,1,0,7,0,2,0,1,0,3,"H","N","2021-02-21","202102210BOS"
"PHI",0,2,0,1,0,3,0,2,4,1,0,7,"A","N","2021-02-21","202102210BOS"
"MTL",0,1,0,1,0,2,1,1,0,1,0,3,"A","N","2021-02-21","202102210OTT"
"OTT",1,1,0,1,0,3,0,1,0,1,0,2,"H","N","2021-02-21","202102210OTT"
"VAN",0,2,0,1,0,3,1,0,1,2,0,4,"H","N","2021-02-21","202102210VAN"
"WPG",1,0,1,2,0,4,0,2,0,1,0,3,"A","N","2021-02-21","202102210VAN"
"NJD",0,1,1,1,0,3,0,0,1,3,0,4,"A","N","2021-02-21","202102210WSH"
"WSH",0,0,1,3,0,4,0,1,1,1,0,3,"H","N","2021-02-21","202102210WSH"
"ANA",0,2,1,0,0,3,0,0,3,1,0,4,"A","N","2021-02-22","202102220ARI"
"ARI",0,0,3,1,0,4,0,2,1,0,0,3,"H","N","2021-02-22","202102220ARI"
"CAR",0,1,1,0,0,2,0,0,2,2,0,4,"H","N","2021-02-22","202102220CAR"
"TBL",0,0,2,2,0,4,0,1,1,0,0,2,"A","N","2021-02-22","202102220CAR"
"COL",0,0,0,0,0,0,0,0,3,0,0,3,"H","N","2021-02-22","202102220COL"
"VEG",0,0,3,0,0,3,0,0,0,0,0,0,"A","N","2021-02-22","202102220COL"
"DAL",0,1,0,0,0,1,0,0,2,1,0,3,"A","N","2021-02-22","202102220FLA"
"FLA",0,0,2,1,0,3,0,1,0,0,0,1,"H","N","2021-02-22","202102220FLA"
"BUF",0,1,0,1,0,2,0,0,1,2,0,3,"A","N","2021-02-22","202102220NYI"
"NYI",0,0,1,2,0,3,0,1,0,1,0,2,"H","N","2021-02-22","202102220NYI"
"MIN",0,2,3,1,0,6,0,1,1,0,0,2,"A","N","2021-02-22","202102220SJS"
"SJS",0,1,1,0,0,2,0,2,3,1,0,6,"H","N","2021-02-22","202102220SJS"
"LAK",0,1,1,1,0,3,0,0,0,0,0,0,"A","N","2021-02-22","202102220STL"
"STL",0,0,0,0,0,0,0,1,1,1,0,3,"H","N","2021-02-22","202102220STL"
"CGY",0,1,1,1,0,3,0,0,0,0,0,0,"A","N","2021-02-22","202102220TOR"
"TOR",0,0,0,0,0,0,0,1,1,1,0,3,"H","N","2021-02-22","202102220TOR"
"CBJ",0,1,2,2,0,5,0,2,2,1,1,6,"H","Y","2021-02-23","202102230CBJ"
"CHI",0,2,2,1,1,6,0,1,2,2,0,5,"A","Y","2021-02-23","202102230CBJ"
"DET",0,0,0,0,0,0,0,0,0,2,0,2,"H","N","2021-02-23","202102230DET"
"NSH",0,0,0,2,0,2,0,0,0,0,0,0,"A","N","2021-02-23","202102230DET"
"BUF",0,0,1,3,0,4,0,0,0,1,0,1,"A","N","2021-02-23","202102230NJD"
"NJD",0,0,0,1,0,1,0,0,1,3,0,4,"H","N","2021-02-23","202102230NJD"
"MTL",0,1,2,1,0,4,0,2,1,1,1,5,"A","Y","2021-02-23","202102230OTT"
"OTT",0,2,1,1,1,5,0,1,2,1,0,4,"H","Y","2021-02-23","202102230OTT"
"EDM",0,1,0,3,0,4,0,3,0,0,0,3,"A","N","2021-02-23","202102230VAN"
"VAN",0,3,0,0,0,3,0,1,0,3,0,4,"H","N","2021-02-23","202102230VAN"
"PIT",1,1,1,0,0,3,0,0,2,0,0,2,"A","N","2021-02-23","202102230WSH"
"WSH",0,0,2,0,0,2,1,1,1,0,0,3,"H","N","2021-02-23","202102230WSH"
"ANA",0,1,2,0,0,3,0,0,0,3,1,4,"A","Y","2021-02-24","202102240ARI"
"ARI",0,0,0,3,1,4,0,1,2,0,0,3,"H","Y","2021-02-24","202102240ARI"
"COL",0,0,1,1,0,2,0,1,2,3,0,6,"H","N","2021-02-24","202102240COL"
"MIN",0,1,2,3,0,6,0,0,1,1,0,2,"A","N","2021-02-24","202102240COL"
"DAL",0,1,0,2,0,3,0,0,0,0,0,0,"A","N","2021-02-24","202102240FLA"
"FLA",0,0,0,0,0,0,0,1,0,2,0,3,"H","N","2021-02-24","202102240FLA"
"NYR",0,1,1,1,0,3,0,2,2,0,0,4,"A","N","2021-02-24","202102240PHI"
"PHI",0,2,2,0,0,4,0,1,1,1,0,3,"H","N","2021-02-24","202102240PHI"
"LAK",0,0,2,0,0,2,0,0,0,1,0,1,"A","N","2021-02-24","202102240STL"
"STL",0,0,0,1,0,1,0,0,2,0,0,2,"H","N","2021-02-24","202102240STL"
"CAR",0,0,0,0,0,0,0,2,0,1,0,3,"A","N","2021-02-24","202102240TBL"
"TBL",0,2,0,1,0,3,0,0,0,0,0,0,"H","N","2021-02-24","202102240TBL"
"CGY",0,0,0,1,0,1,1,0,0,1,0,2,"A","N","2021-02-24","202102240TOR"
"TOR",1,0,0,1,0,2,0,0,0,1,0,1,"H","N","2021-02-24","202102240TOR"
"BUF",0,1,1,1,0,3,1,0,1,2,0,4,"H","N","2021-02-25","202102250BUF"
"NJD",1,0,1,2,0,4,0,1,1,1,0,3,"A","N","2021-02-25","202102250BUF"
"CBJ",0,0,0,0,0,0,0,0,0,2,0,2,"H","N","2021-02-25","202102250CBJ"
"CHI",0,0,0,2,0,2,0,0,0,0,0,0,"A","N","2021-02-25","202102250CBJ"
"DET",0,1,1,3,0,5,0,1,0,1,0,2,"H","N","2021-02-25","202102250DET"
"NSH",0,1,0,1,0,2,0,1,1,3,0,5,"A","N","2021-02-25","202102250DET"
"DAL",0,0,2,0,0,2,0,0,0,3,0,3,"A","N","2021-02-25","202102250FLA"
"FLA",0,0,0,3,0,3,0,0,2,0,0,2,"H","N","2021-02-25","202102250FLA"
"BOS",0,1,1,0,0,2,0,2,0,5,0,7,"A","N","2021-02-25","202102250NYI"
"NYI",0,2,0,5,0,7,0,1,1,0,0,2,"H","N","2021-02-25","202102250NYI"
"CGY",0,0,1,0,0,1,0,2,2,2,0,6,"A","N","2021-02-25","202102250OTT"
"OTT",0,2,2,2,0,6,0,0,1,0,0,1,"H","N","2021-02-25","202102250OTT"
"CAR",0,1,0,0,0,1,0,0,1,2,0,3,"A","N","2021-02-25","202102250TBL"
"TBL",0,0,1,2,0,3,0,1,0,0,0,1,"H","N","2021-02-25","202102250TBL"
"EDM",0,0,1,2,0,3,0,0,0,0,0,0,"A","N","2021-02-25","202102250VAN"
"VAN",0,0,0,0,0,0,0,0,1,2,0,3,"H","N","2021-02-25","202102250VAN"
"MTL",0,2,1,0,0,3,0,0,3,3,0,6,"A","N","2021-02-25","202102250WPG"
"WPG",0,0,3,3,0,6,0,2,1,0,0,3,"H","N","2021-02-25","202102250WPG"
"PIT",0,0,0,2,0,2,0,1,0,4,0,5,"A","N","2021-02-25","202102250WSH"
"WSH",0,1,0,4,0,5,0,0,0,2,0,2,"H","N","2021-02-25","202102250WSH"
"ARI",0,0,0,2,0,2,0,0,1,2,0,3,"H","N","2021-02-26","202102260ARI"
"COL",0,0,1,2,0,3,0,0,0,2,0,2,"A","N","2021-02-26","202102260ARI"
"LAK",0,0,0,1,0,1,0,3,0,0,0,3,"A","N","2021-02-26","202102260MIN"
"MIN",0,3,0,0,0,3,0,0,0,1,0,1,"H","N","2021-02-26","202102260MIN"
"BOS",0,0,1,1,0,2,0,1,3,2,0,6,"A","N","2021-02-26","202102260NYR"
"NYR",0,1,3,2,0,6,0,0,1,1,0,2,"H","N","2021-02-26","202102260NYR"
"ANA",0,1,0,1,0,2,1,1,1,0,0,3,"H","N","2021-02-27","202102270ANA"
"VEG",1,1,1,0,0,3,0,1,0,1,0,2,"A","N","2021-02-27","202102270ANA"
"ARI",0,0,1,1,0,2,0,1,1,4,0,6,"H","N","2021-02-27","202102270ARI"
"COL",0,1,1,4,0,6,0,0,1,1,0,2,"A","N","2021-02-27","202102270ARI"
"BUF",0,0,0,0,0,0,0,1,2,0,0,3,"H","N","2021-02-27","202102270BUF"
"PHI",0,1,2,0,0,3,0,0,0,0,0,0,"A","N","2021-02-27","202102270BUF"
"CHI",0,0,1,2,0,3,0,1,2,2,0,5,"H","N","2021-02-27","202102270CHI"
"DET",0,1,2,2,0,5,0,0,1,2,0,3,"A","N","2021-02-27","202102270CHI"
"EDM",0,0,0,0,0,0,0,2,1,1,0,4,"H","N","2021-02-27","202102270EDM"
"TOR",0,2,1,1,0,4,0,0,0,0,0,0,"A","N","2021-02-27","202102270EDM"
"CAR",0,1,0,2,1,4,0,0,0,3,0,3,"A","Y","2021-02-27","202102270FLA"
"FLA",0,0,0,3,0,3,0,1,0,2,1,4,"H","Y","2021-02-27","202102270FLA"
"LAK",0,0,2,1,0,3,1,2,1,0,0,4,"A","N","2021-02-27","202102270MIN"
"MIN",1,2,1,0,0,4,0,0,2,1,0,3,"H","N","2021-02-27","202102270MIN"
"NJD",0,1,1,0,0,2,0,3,0,2,0,5,"H","N","2021-02-27","202102270NJD"
"WSH",0,3,0,2,0,5,0,1,1,0,0,2,"A","N","2021-02-27","202102270NJD"
"CBJ",0,1,0,0,0,1,0,0,2,0,0,2,"A","N","2021-02-27","202102270NSH"
"NSH",0,0,2,0,0,2,0,1,0,0,0,1,"H","N","2021-02-27","202102270NSH"
"NYI",0,1,2,0,0,3,1,0,2,1,0,4,"H","N","2021-02-27","202102270NYI"
"PIT",1,0,2,1,0,4,0,1,2,0,0,3,"A","N","2021-02-27","202102270NYI"
"CGY",0,3,3,0,0,6,0,1,1,1,0,3,"A","N","2021-02-27","202102270OTT"
"OTT",0,1,1,1,0,3,0,3,3,0,0,6,"H","N","2021-02-27","202102270OTT"
"SJS",0,2,2,2,0,6,0,1,3,3,0,7,"H","N","2021-02-27","202102270SJS"
"STL",0,1,3,3,0,7,0,2,2,2,0,6,"A","N","2021-02-27","202102270SJS"
"DAL",0,0,0,0,0,0,0,1,3,1,0,5,"A","N","2021-02-27","202102270TBL"
"TBL",0,1,3,1,0,5,0,0,0,0,0,0,"H","N","2021-02-27","202102270TBL"
"MTL",0,0,1,0,0,1,1,0,1,0,0,2,"A","N","2021-02-27","202102270WPG"
"WPG",1,0,1,0,0,2,0,0,1,0,0,1,"H","N","2021-02-27","202102270WPG"
"BUF",0,0,0,0,0,0,0,0,3,0,0,3,"H","N","2021-02-28","202102280BUF"
"PHI",0,0,3,0,0,3,0,0,0,0,0,0,"A","N","2021-02-28","202102280BUF"
"CHI",0,2,0,5,0,7,0,1,0,1,0,2,"H","N","2021-02-28","202102280CHI"
"DET",0,1,0,1,0,2,0,2,0,5,0,7,"A","N","2021-02-28","202102280CHI"
"NJD",0,1,1,0,0,2,0,1,2,0,0,3,"H","N","2021-02-28","202102280NJD"
"WSH",0,1,2,0,0,3,0,1,1,0,0,2,"A","N","2021-02-28","202102280NJD"
"CBJ",0,1,0,0,0,1,0,1,1,1,0,3,"A","N","2021-02-28","202102280NSH"
"NSH",0,1,1,1,0,3,0,1,0,0,0,1,"H","N","2021-02-28","202102280NSH"
"NYI",0,1,1,0,0,2,0,0,0,0,0,0,"H","N","2021-02-28","202102280NYI"
"PIT",0,0,0,0,0,0,0,1,1,0,0,2,"A","N","2021-02-28","202102280NYI"
"BOS",0,2,1,1,0,4,0,0,0,1,0,1,"A","N","2021-02-28","202102280NYR"
"NYR",0,0,0,1,0,1,0,2,1,1,0,4,"H","N","2021-02-28","202102280NYR"
"ANA",0,1,0,3,0,4,0,1,3,1,0,5,"H","N","2021-03-01","202103010ANA"
"STL",0,1,3,1,0,5,0,1,0,3,0,4,"A","N","2021-03-01","202103010ANA"
"EDM",0,0,0,0,0,0,0,3,0,0,0,3,"H","N","2021-03-01","202103010EDM"
"TOR",0,3,0,0,0,3,0,0,0,0,0,0,"A","N","2021-03-01","202103010EDM"
"CAR",1,1,0,1,0,3,0,0,0,2,0,2,"A","N","2021-03-01","202103010FLA"
"FLA",0,0,0,2,0,2,1,1,0,1,0,3,"H","N","2021-03-01","202103010FLA"
"CGY",0,0,1,0,0,1,0,0,3,2,0,5,"A","N","2021-03-01","202103010OTT"
"OTT",0,0,3,2,0,5,0,0,1,0,0,1,"H","N","2021-03-01","202103010OTT"
"COL",0,1,1,0,0,2,0,0,2,4,0,6,"A","N","2021-03-01","202103010SJS"
"SJS",0,0,2,4,0,6,0,1,1,0,0,2,"H","N","2021-03-01","202103010SJS"
"MIN",0,0,4,0,0,4,1,0,2,2,0,5,"A","N","2021-03-01","202103010VEG"
"VEG",1,0,2,2,0,5,0,0,4,0,0,4,"H","N","2021-03-01","202103010VEG"
"VAN",0,3,0,1,0,4,0,0,0,0,0,0,"A","N","2021-03-01","202103010WPG"
"WPG",0,0,0,0,0,0,0,3,0,1,0,4,"H","N","2021-03-01","202103010WPG"
"CBJ",0,1,3,0,0,4,0,1,0,0,0,1,"H","N","2021-03-02","202103020CBJ"
"DET",0,1,0,0,0,1,0,1,3,0,0,4,"A","N","2021-03-02","202103020CBJ"
"DAL",0,0,0,0,0,0,0,1,0,1,0,2,"H","N","2021-03-02","202103020DAL"
"TBL",0,1,0,1,0,2,0,0,0,0,0,0,"A","N","2021-03-02","202103020DAL"
"MTL",0,0,2,1,0,3,0,0,1,0,0,1,"H","N","2021-03-02","202103020MTL"
"OTT",0,0,1,0,0,1,0,0,2,1,0,3,"A","N","2021-03-02","202103020MTL"
"NJD",0,0,0,1,0,1,0,0,0,2,0,2,"H","N","2021-03-02","202103020NJD"
"NYI",0,0,0,2,0,2,0,0,0,1,0,1,"A","N","2021-03-02","202103020NJD"
"CAR",0,2,1,1,0,4,0,0,0,2,0,2,"A","N","2021-03-02","202103020NSH"
"NSH",0,0,0,2,0,2,0,2,1,1,0,4,"H","N","2021-03-02","202103020NSH"
"BUF",0,1,1,0,0,2,0,2,1,0,0,3,"A","N","2021-03-02","202103020NYR"
"NYR",0,2,1,0,0,3,0,1,1,0,0,2,"H","N","2021-03-02","202103020NYR"
"PHI",0,0,1,1,0,2,0,0,3,2,0,5,"A","N","2021-03-02","202103020PIT"
"PIT",0,0,3,2,0,5,0,0,1,1,0,2,"H","N","2021-03-02","202103020PIT"
"VAN",0,1,1,0,0,2,0,2,1,2,0,5,"A","N","2021-03-02","202103020WPG"
"WPG",0,2,1,2,0,5,0,1,1,0,0,2,"H","N","2021-03-02","202103020WPG"
"ANA",0,0,1,1,0,2,0,1,1,1,0,3,"H","N","2021-03-03","202103030ANA"
"STL",0,1,1,1,0,3,0,0,1,1,0,2,"A","N","2021-03-03","202103030ANA"
"BOS",0,0,0,1,0,1,0,0,0,1,1,2,"H","Y","2021-03-03","202103030BOS"
"WSH",0,0,0,1,1,2,0,0,0,1,0,1,"A","Y","2021-03-03","202103030BOS"
"EDM",0,0,1,0,0,1,0,1,4,1,0,6,"H","N","2021-03-03","202103030EDM"
"TOR",0,1,4,1,0,6,0,0,1,0,0,1,"A","N","2021-03-03","202103030EDM"
"ARI",0,0,3,0,0,3,0,0,1,1,0,2,"A","N","2021-03-03","202103030LAK"
"LAK",0,0,1,1,0,2,0,0,3,0,0,3,"H","N","2021-03-03","202103030LAK"
"COL",0,0,1,3,0,4,0,0,0,0,0,0,"A","N","2021-03-03","202103030SJS"
"SJS",0,0,0,0,0,0,0,0,1,3,0,4,"H","N","2021-03-03","202103030SJS"
"MIN",0,0,1,0,0,1,0,1,1,3,0,5,"A","N","2021-03-03","202103030VEG"
"VEG",0,1,1,3,0,5,0,0,1,0,0,1,"H","N","2021-03-03","202103030VEG"
"CAR",0,1,1,3,0,5,0,1,1,0,0,2,"H","N","2021-03-04","202103040CAR"
"DET",0,1,1,0,0,2,0,1,1,3,0,5,"A","N","2021-03-04","202103040CAR"
"CGY",0,4,1,2,0,7,0,1,0,2,0,3,"H","N","2021-03-04","202103040CGY"
"OTT",0,1,0,2,0,3,0,4,1,2,0,7,"A","N","2021-03-04","202103040CGY"
"CHI",0,0,2,0,0,2,1,0,0,2,0,3,"H","N","2021-03-04","202103040CHI"
"TBL",1,0,0,2,0,3,0,0,2,0,0,2,"A","N","2021-03-04","202103040CHI"
"CBJ",0,0,1,2,0,3,0,0,0,2,0,2,"A","N","2021-03-04","202103040DAL"
"DAL",0,0,0,2,0,2,0,0,1,2,0,3,"H","N","2021-03-04","202103040DAL"
"MTL",0,0,2,1,0,3,1,2,0,1,0,4,"H","N","2021-03-04","202103040MTL"
"WPG",1,2,0,1,0,4,0,0,2,1,0,3,"A","N","2021-03-04","202103040MTL"
"NJD",0,1,0,0,0,1,0,0,2,4,0,6,"H","N","2021-03-04","202103040NJD"
"NYR",0,0,2,4,0,6,0,1,0,0,0,1,"A","N","2021-03-04","202103040NJD"
"FLA",0,2,2,1,0,5,0,0,2,2,0,4,"A","N","2021-03-04","202103040NSH"
"NSH",0,0,2,2,0,4,0,2,2,1,0,5,"H","N","2021-03-04","202103040NSH"
"BUF",0,0,1,1,0,2,0,2,1,2,0,5,"A","N","2021-03-04","202103040NYI"
"NYI",0,2,1,2,0,5,0,0,1,1,0,2,"H","N","2021-03-04","202103040NYI"
"PHI",0,1,1,2,0,4,0,3,0,0,0,3,"A","N","2021-03-04","202103040PIT"
"PIT",0,3,0,0,0,3,0,1,1,2,0,4,"H","N","2021-03-04","202103040PIT"
"TOR",0,1,0,0,0,1,0,1,1,1,0,3,"A","N","2021-03-04","202103040VAN"
"VAN",0,1,1,1,0,3,0,1,0,0,0,1,"H","N","2021-03-04","202103040VAN"
"ARI",0,0,0,1,0,1,0,3,1,1,0,5,"H","N","2021-03-05","202103050ARI"
"MIN",0,3,1,1,0,5,0,0,0,1,0,1,"A","N","2021-03-05","202103050ARI"
"BOS",0,1,3,1,0,5,0,0,0,1,0,1,"H","N","2021-03-05","202103050BOS"
"WSH",0,0,0,1,0,1,0,1,3,1,0,5,"A","N","2021-03-05","202103050BOS"
"CHI",0,1,1,1,1,4,0,2,0,1,0,3,"H","Y","2021-03-05","202103050CHI"
"TBL",0,2,0,1,0,3,0,1,1,1,1,4,"A","Y","2021-03-05","202103050CHI"
"ANA",0,1,1,0,0,2,1,0,2,0,0,3,"A","N","2021-03-05","202103050COL"
"COL",1,0,2,0,0,3,0,1,1,0,0,2,"H","N","2021-03-05","202103050COL"
"LAK",0,0,1,1,0,2,1,1,0,1,0,3,"H","N","2021-03-05","202103050LAK"
"STL",1,1,0,1,0,3,0,0,1,1,0,2,"A","N","2021-03-05","202103050LAK"
"SJS",0,0,2,2,0,4,1,2,1,1,0,5,"H","N","2021-03-05","202103050SJS"
"VEG",1,2,1,1,0,5,0,0,2,2,0,4,"A","N","2021-03-05","202103050SJS"
"ARI",0,0,2,3,0,5,0,2,0,0,0,2,"H","N","2021-03-06","202103060ARI"
"MIN",0,2,0,0,0,2,0,0,2,3,0,5,"A","N","2021-03-06","202103060ARI"
"ANA",1,1,1,2,0,5,0,0,2,2,0,4,"A","N","2021-03-06","202103060COL"
"COL",0,0,2,2,0,4,1,1,1,2,0,5,"H","N","2021-03-06","202103060COL"
"CBJ",0,0,0,0,0,0,0,2,1,2,0,5,"A","N","2021-03-06","202103060DAL"
"DAL",0,2,1,2,0,5,0,0,0,0,0,0,"H","N","2021-03-06","202103060DAL"
"CGY",0,1,0,1,0,2,0,0,1,2,0,3,"A","N","2021-03-06","202103060EDM"
"EDM",0,0,1,2,0,3,0,1,0,1,0,2,"H","N","2021-03-06","202103060EDM"
"LAK",1,1,2,0,0,4,0,3,0,0,0,3,"H","N","2021-03-06","202103060LAK"
"STL",0,3,0,0,0,3,1,1,2,0,0,4,"A","N","2021-03-06","202103060LAK"
"MTL",0,1,4,2,0,7,0,0,0,1,0,1,"H","N","2021-03-06","202103060MTL"
"WPG",0,0,0,1,0,1,0,1,4,2,0,7,"A","N","2021-03-06","202103060MTL"
"NJD",0,2,0,1,0,3,0,3,1,2,0,6,"H","N","2021-03-06","202103060NJD"
"NYR",0,3,1,2,0,6,0,2,0,1,0,3,"A","N","2021-03-06","202103060NJD"
"FLA",0,1,3,2,0,6,0,1,0,1,0,2,"A","N","2021-03-06","202103060NSH"
"NSH",0,1,0,1,0,2,0,1,3,2,0,6,"H","N","2021-03-06","202103060NSH"
"BUF",0,1,0,1,0,2,0,0,4,1,0,5,"A","N","2021-03-06","202103060NYI"
"NYI",0,0,4,1,0,5,0,1,0,1,0,2,"H","N","2021-03-06","202103060NYI"
"PHI",0,1,2,0,0,3,0,2,1,1,0,4,"A","N","2021-03-06","202103060PIT"
"PIT",0,2,1,1,0,4,0,1,2,0,0,3,"H","N","2021-03-06","202103060PIT"
"SJS",0,0,0,0,0,0,0,1,2,1,0,4,"H","N","2021-03-06","202103060SJS"
"VEG",0,1,2,1,0,4,0,0,0,0,0,0,"A","N","2021-03-06","202103060SJS"
"TOR",0,1,1,0,0,2,0,1,0,3,0,4,"A","N","2021-03-06","202103060VAN"
"VAN",0,1,0,3,0,4,0,1,1,0,0,2,"H","N","2021-03-06","202103060VAN"
"BOS",0,0,0,0,0,0,0,0,0,1,0,1,"H","N","2021-03-07","202103070BOS"
"NJD",0,0,0,1,0,1,0,0,0,0,0,0,"A","N","2021-03-07","202103070BOS"
"CAR",0,1,1,2,0,4,0,0,1,1,0,2,"H","N","2021-03-07","202103070CAR"
"FLA",0,0,1,1,0,2,0,1,1,2,0,4,"A","N","2021-03-07","202103070CAR"
"CGY",0,0,1,2,0,3,0,2,1,0,1,4,"H","Y","2021-03-07","202103070CGY"
"OTT",0,2,1,0,1,4,0,0,1,2,0,3,"A","Y","2021-03-07","202103070CGY"
"CHI",0,2,1,0,0,3,0,0,4,2,0,6,"H","N","2021-03-07","202103070CHI"
"TBL",0,0,4,2,0,6,0,2,1,0,0,3,"A","N","2021-03-07","202103070CHI"
"DAL",0,0,0,3,0,3,0,2,1,0,1,4,"H","Y","2021-03-07","202103070DAL"
"NSH",0,2,1,0,1,4,0,0,0,3,0,3,"A","Y","2021-03-07","202103070DAL"
"BUF",0,0,0,2,0,2,0,0,3,2,0,5,"A","N","2021-03-07","202103070NYI"
"NYI",0,0,3,2,0,5,0,0,0,2,0,2,"H","N","2021-03-07","202103070NYI"
"PHI",0,1,0,0,0,1,0,0,2,1,0,3,"H","N","2021-03-07","202103070PHI"
"WSH",0,0,2,1,0,3,0,1,0,0,0,1,"A","N","2021-03-07","202103070PHI"
"NYR",0,1,0,0,0,1,0,3,0,2,0,5,"A","N","2021-03-07","202103070PIT"
"PIT",0,3,0,2,0,5,0,1,0,0,0,1,"H","N","2021-03-07","202103070PIT"
"ANA",1,2,3,0,0,6,0,1,2,2,0,5,"H","N","2021-03-08","202103080ANA"
"LAK",0,1,2,2,0,5,1,2,3,0,0,6,"A","N","2021-03-08","202103080ANA"
"ARI",0,2,0,1,0,3,0,0,2,0,0,2,"A","N","2021-03-08","202103080COL"
"COL",0,0,2,0,0,2,0,2,0,1,0,3,"H","N","2021-03-08","202103080COL"
"EDM",0,1,2,0,0,3,0,1,1,0,0,2,"H","N","2021-03-08","202103080EDM"
"OTT",0,1,1,0,0,2,0,1,2,0,0,3,"A","N","2021-03-08","202103080EDM"
"MIN",0,1,0,1,0,2,0,0,0,0,0,0,"H","N","2021-03-08","202103080MIN"
"VEG",0,0,0,0,0,0,0,1,0,1,0,2,"A","N","2021-03-08","202103080MIN"
"SJS",1,0,1,1,0,3,0,1,1,0,0,2,"H","N","2021-03-08","202103080SJS"
"STL",0,1,1,0,0,2,1,0,1,1,0,3,"A","N","2021-03-08","202103080SJS"
"MTL",0,1,0,0,0,1,0,0,0,1,1,2,"A","Y","2021-03-08","202103080VAN"
"VAN",0,0,0,1,1,2,0,1,0,0,0,1,"H","Y","2021-03-08","202103080VAN"
"CAR",1,0,2,0,0,3,0,0,2,0,0,2,"H","N","2021-03-09","202103090CAR"
"NSH",0,0,2,0,0,2,1,0,2,0,0,3,"A","N","2021-03-09","202103090CAR"
"CBJ",0,0,1,1,0,2,0,1,2,1,0,4,"H","N","2021-03-09","202103090CBJ"
"FLA",0,1,2,1,0,4,0,0,1,1,0,2,"A","N","2021-03-09","202103090CBJ"
"CHI",0,0,1,0,0,1,0,2,3,1,0,6,"A","N","2021-03-09","202103090DAL"
"DAL",0,2,3,1,0,6,0,0,1,0,0,1,"H","N","2021-03-09","202103090DAL"
"DET",0,1,2,0,0,3,1,2,0,1,0,4,"H","N","2021-03-09","202103090DET"
"TBL",1,2,0,1,0,4,0,1,2,0,0,3,"A","N","2021-03-09","202103090DET"
"BOS",0,1,0,0,0,1,0,0,1,0,1,2,"A","Y","2021-03-09","202103090NYI"
"NYI",0,0,1,0,1,2,0,1,0,0,0,1,"H","Y","2021-03-09","202103090NYI"
"BUF",0,3,1,0,0,4,0,1,2,1,1,5,"A","Y","2021-03-09","202103090PHI"
"PHI",0,1,2,1,1,5,0,3,1,0,0,4,"H","Y","2021-03-09","202103090PHI"
"NYR",0,1,0,1,0,2,0,1,2,1,0,4,"A","N","2021-03-09","202103090PIT"
"PIT",0,1,2,1,0,4,0,1,0,1,0,2,"H","N","2021-03-09","202103090PIT"
"TOR",0,2,0,1,0,3,0,1,2,1,0,4,"H","N","2021-03-09","202103090TOR"
"WPG",0,1,2,1,0,4,0,2,0,1,0,3,"A","N","2021-03-09","202103090TOR"
"NJD",0,0,1,3,0,4,1,1,3,0,0,5,"A","N","2021-03-09","202103090WSH"
"WSH",1,1,3,0,0,5,0,0,1,3,0,4,"H","N","2021-03-09","202103090WSH"
"ANA",0,0,1,0,0,1,0,1,2,2,0,5,"H","N","2021-03-10","202103100ANA"
"LAK",0,1,2,2,0,5,0,0,1,0,0,1,"A","N","2021-03-10","202103100ANA"
"ARI",0,0,1,0,0,1,1,1,0,0,0,2,"A","N","2021-03-10","202103100COL"
"COL",1,1,0,0,0,2,0,0,1,0,0,1,"H","N","2021-03-10","202103100COL"
"EDM",0,4,2,1,0,7,0,0,0,1,0,1,"H","N","2021-03-10","202103100EDM"
"OTT",0,0,0,1,0,1,0,4,2,1,0,7,"A","N","2021-03-10","202103100EDM"
"MIN",0,1,0,3,0,4,0,1,0,2,0,3,"H","N","2021-03-10","202103100MIN"
"VEG",0,1,0,2,0,3,0,1,0,3,0,4,"A","N","2021-03-10","202103100MIN"
"MTL",0,1,2,2,0,5,0,0,1,0,0,1,"A","N","2021-03-10","202103100VAN"
"VAN",0,0,1,0,0,1,0,1,2,2,0,5,"H","N","2021-03-10","202103100VAN"
"BOS",0,2,2,0,0,4,0,0,0,0,0,0,"H","N","2021-03-11","202103110BOS"
"NYR",0,0,0,0,0,0,0,2,2,0,0,4,"A","N","2021-03-11","202103110BOS"
"BUF",0,1,1,0,0,2,0,1,2,2,0,5,"H","N","2021-03-11","202103110BUF"
"PIT",0,1,2,2,0,5,0,1,1,0,0,2,"A","N","2021-03-11","202103110BUF"
"CAR",0,3,1,1,0,5,0,0,0,1,0,1,"H","N","2021-03-11","202103110CAR"
"NSH",0,0,0,1,0,1,0,3,1,1,0,5,"A","N","2021-03-11","202103110CAR"
"CBJ",0,0,2,2,0,4,1,0,1,3,0,5,"H","N","2021-03-11","202103110CBJ"
"FLA",1,0,1,3,0,5,0,0,2,2,0,4,"A","N","2021-03-11","202103110CBJ"
"CGY",0,0,2,0,0,2,0,0,0,1,0,1,"H","N","2021-03-11","202103110CGY"
"MTL",0,0,0,1,0,1,0,0,2,0,0,2,"A","N","2021-03-11","202103110CGY"
"CHI",0,1,3,0,0,4,0,0,0,2,0,2,"A","N","2021-03-11","202103110DAL"
"DAL",0,0,0,2,0,2,0,1,3,0,0,4,"H","N","2021-03-11","202103110DAL"
"DET",0,3,2,1,0,6,0,2,0,2,0,4,"H","N","2021-03-11","202103110DET"
"TBL",0,2,0,2,0,4,0,3,2,1,0,6,"A","N","2021-03-11","202103110DET"
"NJD",0,0,0,3,0,3,0,2,2,1,0,5,"A","N","2021-03-11","202103110NYI"
"NYI",0,2,2,1,0,5,0,0,0,3,0,3,"H","N","2021-03-11","202103110NYI"
"PHI",0,1,0,2,0,3,0,2,2,1,0,5,"H","N","2021-03-11","202103110PHI"
"WSH",0,2,2,1,0,5,0,1,0,2,0,3,"A","N","2021-03-11","202103110PHI"
"TOR",1,0,1,2,0,4,0,1,1,1,0,3,"H","N","2021-03-11","202103110TOR"
"WPG",0,1,1,1,0,3,1,0,1,2,0,4,"A","N","2021-03-11","202103110TOR"
"ANA",0,0,0,0,0,0,0,1,1,4,0,6,"H","N","2021-03-12","202103120ANA"
"SJS",0,1,1,4,0,6,0,0,0,0,0,0,"A","N","2021-03-12","202103120ANA"
"COL",0,0,1,1,0,2,0,0,0,0,0,0,"H","N","2021-03-12","202103120COL"
"LAK",0,0,0,0,0,0,0,0,1,1,0,2,"A","N","2021-03-12","202103120COL"
"EDM",0,2,2,2,0,6,0,1,1,0,0,2,"H","N","2021-03-12","202103120EDM"
"OTT",0,1,1,0,0,2,0,2,2,2,0,6,"A","N","2021-03-12","202103120EDM"
"ARI",0,0,0,0,0,0,0,0,0,4,0,4,"A","N","2021-03-12","202103120MIN"
"MIN",0,0,0,4,0,4,0,0,0,0,0,0,"H","N","2021-03-12","202103120MIN"
"STL",0,0,2,2,0,4,1,2,1,1,0,5,"H","N","2021-03-12","202103120STL"
"VEG",1,2,1,1,0,5,0,0,2,2,0,4,"A","N","2021-03-12","202103120STL"
"ANA",0,0,1,0,0,1,0,1,1,1,0,3,"H","N","2021-03-13","202103130ANA"
"SJS",0,1,1,1,0,3,0,0,1,0,0,1,"A","N","2021-03-13","202103130ANA"
"BOS",0,0,0,0,0,0,0,1,1,2,0,4,"H","N","2021-03-13","202103130BOS"
"NYR",0,1,1,2,0,4,0,0,0,0,0,0,"A","N","2021-03-13","202103130BOS"
"BUF",0,0,0,0,0,0,0,0,1,2,0,3,"H","N","2021-03-13","202103130BUF"
"PIT",0,0,1,2,0,3,0,0,0,0,0,0,"A","N","2021-03-13","202103130BUF"
"CBJ",1,1,2,0,0,4,0,1,1,1,0,3,"H","N","2021-03-13","202103130CBJ"
"DAL",0,1,1,1,0,3,1,1,2,0,0,4,"A","N","2021-03-13","202103130CBJ"
"CGY",0,2,1,0,0,3,0,0,1,0,0,1,"H","N","2021-03-13","202103130CGY"
"MTL",0,0,1,0,0,1,0,2,1,0,0,3,"A","N","2021-03-13","202103130CGY"
"CHI",0,0,1,1,0,2,0,0,3,1,0,4,"A","N","2021-03-13","202103130FLA"
"FLA",0,0,3,1,0,4,0,0,1,1,0,2,"H","N","2021-03-13","202103130FLA"
"NJD",0,1,1,0,0,2,0,1,0,2,0,3,"H","N","2021-03-13","202103130NJD"
"NYI",0,1,0,2,0,3,0,1,1,0,0,2,"A","N","2021-03-13","202103130NJD"
"PHI",0,0,2,2,0,4,0,2,2,1,0,5,"H","N","2021-03-13","202103130PHI"
"WSH",0,2,2,1,0,5,0,0,2,2,0,4,"A","N","2021-03-13","202103130PHI"
"STL",0,0,0,1,0,1,0,1,0,4,0,5,"H","N","2021-03-13","202103130STL"
"VEG",0,1,0,4,0,5,0,0,0,1,0,1,"A","N","2021-03-13","202103130STL"
"NSH",0,0,1,2,0,3,0,2,2,2,0,6,"A","N","2021-03-13","202103130TBL"
"TBL",0,2,2,2,0,6,0,0,1,2,0,3,"H","N","2021-03-13","202103130TBL"
"TOR",0,0,2,0,0,2,0,0,2,3,0,5,"H","N","2021-03-13","202103130TOR"
"WPG",0,0,2,3,0,5,0,0,2,0,0,2,"A","N","2021-03-13","202103130TOR"
"EDM",0,0,1,0,0,1,0,0,1,1,0,2,"A","N","2021-03-13","202103130VAN"
"VAN",0,0,1,1,0,2,0,0,1,0,0,1,"H","N","2021-03-13","202103130VAN"
"CBJ",0,0,0,1,0,1,0,1,0,0,1,2,"H","Y","2021-03-14","202103140CBJ"
"DAL",0,1,0,0,1,2,0,0,0,1,0,1,"A","Y","2021-03-14","202103140CBJ"
"COL",0,1,2,1,0,4,0,0,0,1,0,1,"H","N","2021-03-14","202103140COL"
"LAK",0,0,0,1,0,1,0,1,2,1,0,4,"A","N","2021-03-14","202103140COL"
"CAR",0,0,1,1,0,2,0,0,0,1,0,1,"A","N","2021-03-14","202103140DET"
"DET",0,0,0,1,0,1,0,0,1,1,0,2,"H","N","2021-03-14","202103140DET"
"ARI",0,1,0,0,0,1,0,0,1,3,0,4,"A","N","2021-03-14","202103140MIN"
"MIN",0,0,1,3,0,4,0,1,0,0,0,1,"H","N","2021-03-14","202103140MIN"
"NJD",0,1,1,0,0,2,0,2,0,0,1,3,"H","Y","2021-03-14","202103140NJD"
"NYI",0,2,0,0,1,3,0,1,1,0,0,2,"A","Y","2021-03-14","202103140NJD"
"OTT",0,2,2,0,0,4,0,1,0,2,0,3,"H","N","2021-03-14","202103140OTT"
"TOR",0,1,0,2,0,3,0,2,2,0,0,4,"A","N","2021-03-14","202103140OTT"
"BUF",0,0,0,0,0,0,0,1,3,2,0,6,"H","N","2021-03-15","202103150BUF"
"WSH",0,1,3,2,0,6,0,0,0,0,0,0,"A","N","2021-03-15","202103150BUF"
"CGY",0,0,3,1,0,4,0,0,2,1,0,3,"H","N","2021-03-15","202103150CGY"
"EDM",0,0,2,1,0,3,0,0,3,1,0,4,"A","N","2021-03-15","202103150CGY"
"CHI",0,1,2,0,0,3,0,1,2,3,0,6,"A","N","2021-03-15","202103150FLA"
"FLA",0,1,2,3,0,6,0,1,2,0,0,3,"H","N","2021-03-15","202103150FLA"
"NYR",0,0,3,1,0,4,1,2,1,1,0,5,"H","N","2021-03-15","202103150NYR"
"PHI",1,2,1,1,0,5,0,0,3,1,0,4,"A","N","2021-03-15","202103150NYR"
"OTT",0,0,1,1,0,2,1,2,0,0,0,3,"H","N","2021-03-15","202103150OTT"
"VAN",1,2,0,0,0,3,0,0,1,1,0,2,"A","N","2021-03-15","202103150OTT"
"BOS",0,1,0,0,0,1,0,2,1,1,0,4,"A","N","2021-03-15","202103150PIT"
"PIT",0,2,1,1,0,4,0,1,0,0,0,1,"H","N","2021-03-15","202103150PIT"
"NSH",0,0,3,1,0,4,0,0,0,1,0,1,"A","N","2021-03-15","202103150TBL"
"TBL",0,0,0,1,0,1,0,0,3,1,0,4,"H","N","2021-03-15","202103150TBL"
"SJS",0,0,0,1,0,1,0,1,0,1,0,2,"A","N","2021-03-15","202103150VEG"
"VEG",0,1,0,1,0,2,0,0,0,1,0,1,"H","N","2021-03-15","202103150VEG"
"MTL",0,1,2,1,0,4,0,0,1,1,0,2,"A","N","2021-03-15","202103150WPG"
"WPG",0,0,1,1,0,2,0,1,2,1,0,4,"H","N","2021-03-15","202103150WPG"
"ANA",0,4,0,0,0,4,0,2,2,4,0,8,"A","N","2021-03-16","202103160COL"
"COL",0,2,2,4,0,8,0,4,0,0,0,4,"H","N","2021-03-16","202103160COL"
"DAL",0,0,1,2,0,3,0,1,1,1,1,4,"H","Y","2021-03-16","202103160DAL"
"TBL",0,1,1,1,1,4,0,0,1,2,0,3,"A","Y","2021-03-16","202103160DAL"
"CAR",0,1,1,0,0,2,0,2,1,1,0,4,"A","N","2021-03-16","202103160DET"
"DET",0,2,1,1,0,4,0,1,1,0,0,2,"H","N","2021-03-16","202103160DET"
"ARI",0,0,0,0,0,0,0,1,0,2,0,3,"A","N","2021-03-16","202103160MIN"
"MIN",0,1,0,2,0,3,0,0,0,0,0,0,"H","N","2021-03-16","202103160MIN"
"BUF",0,0,2,0,0,2,0,1,1,1,0,3,"A","N","2021-03-16","202103160NJD"
"NJD",0,1,1,1,0,3,0,0,2,0,0,2,"H","N","2021-03-16","202103160NJD"
"BOS",0,1,0,1,0,2,0,1,0,0,0,1,"A","N","2021-03-16","202103160PIT"
"PIT",0,1,0,0,0,1,0,1,0,1,0,2,"H","N","2021-03-16","202103160PIT"
"NYI",0,0,0,1,0,1,0,0,2,1,0,3,"A","N","2021-03-16","202103160WSH"
"WSH",0,0,2,1,0,3,0,0,0,1,0,1,"H","N","2021-03-16","202103160WSH"
"CGY",0,0,1,2,0,3,0,2,1,4,0,7,"H","N","2021-03-17","202103170CGY"
"EDM",0,2,1,4,0,7,0,0,1,2,0,3,"A","N","2021-03-17","202103170CGY"
"LAK",0,3,0,1,0,4,0,0,1,0,0,1,"H","N","2021-03-17","202103170LAK"
"STL",0,0,1,0,0,1,0,3,0,1,0,4,"A","N","2021-03-17","202103170LAK"
"NYR",0,2,7,0,0,9,0,0,0,0,0,0,"H","N","2021-03-17","202103170NYR"
"PHI",0,0,0,0,0,0,0,2,7,0,0,9,"A","N","2021-03-17","202103170NYR"
"OTT",0,0,1,1,0,2,0,2,0,0,1,3,"H","Y","2021-03-17","202103170OTT"
"VAN",0,2,0,0,1,3,0,0,1,1,0,2,"A","Y","2021-03-17","202103170OTT"
"SJS",0,0,3,1,0,4,0,1,0,4,0,5,"A","N","2021-03-17","202103170VEG"
"VEG",0,1,0,4,0,5,0,0,3,1,0,4,"H","N","2021-03-17","202103170VEG"
"MTL",0,0,1,2,0,3,1,2,1,0,0,4,"A","N","2021-03-17","202103170WPG"
"WPG",1,2,1,0,0,4,0,0,1,2,0,3,"H","N","2021-03-17","202103170WPG"
"ANA",1,0,2,0,0,3,0,2,0,0,0,2,"H","N","2021-03-18","202103180ANA"
"ARI",0,2,0,0,0,2,1,0,2,0,0,3,"A","N","2021-03-18","202103180ANA"
"BOS",0,1,2,1,0,4,0,0,1,0,0,1,"A","N","2021-03-18","202103180BUF"
"BUF",0,0,1,0,0,1,0,1,2,1,0,4,"H","N","2021-03-18","202103180BUF"
"CAR",0,0,2,0,0,2,1,1,1,0,0,3,"H","N","2021-03-18","202103180CAR"
"CBJ",1,1,1,0,0,3,0,0,2,0,0,2,"A","N","2021-03-18","202103180CAR"
"COL",0,2,1,2,0,5,0,0,1,0,0,1,"H","N","2021-03-18","202103180COL"
"MIN",0,0,1,0,0,1,0,2,1,2,0,5,"A","N","2021-03-18","202103180COL"
"DAL",0,0,0,2,0,2,0,1,1,1,0,3,"A","N","2021-03-18","202103180DET"
"DET",0,1,1,1,0,3,0,0,0,2,0,2,"H","N","2021-03-18","202103180DET"
"EDM",0,0,2,0,0,2,0,0,1,0,0,1,"H","N","2021-03-18","202103180EDM"
"WPG",0,0,1,0,0,1,0,0,2,0,0,2,"A","N","2021-03-18","202103180EDM"
"FLA",0,1,0,0,0,1,0,0,1,1,0,2,"H","N","2021-03-18","202103180FLA"
"NSH",0,0,1,1,0,2,0,1,0,0,0,1,"A","N","2021-03-18","202103180FLA"
"NJD",0,1,2,0,0,3,0,0,1,1,0,2,"H","N","2021-03-18","202103180NJD"
"PIT",0,0,1,1,0,2,0,1,2,0,0,3,"A","N","2021-03-18","202103180NJD"
"NYI",0,0,0,3,0,3,0,0,3,1,0,4,"H","N","2021-03-18","202103180NYI"
"PHI",0,0,3,1,0,4,0,0,0,3,0,3,"A","N","2021-03-18","202103180NYI"
"CHI",0,2,0,0,0,2,0,2,0,2,0,4,"A","N","2021-03-18","202103180TBL"
"TBL",0,2,0,2,0,4,0,2,0,0,0,2,"H","N","2021-03-18","202103180TBL"
"LAK",0,1,1,0,0,2,0,2,1,1,0,4,"H","N","2021-03-19","202103190LAK"
"VEG",0,2,1,1,0,4,0,1,1,0,0,2,"A","N","2021-03-19","202103190LAK"
"MTL",0,1,0,1,0,2,1,0,2,0,0,3,"H","N","2021-03-19","202103190MTL"
"VAN",1,0,2,0,0,3,0,1,0,1,0,2,"A","N","2021-03-19","202103190MTL"
"SJS",0,0,1,0,0,1,0,0,0,1,1,2,"H","Y","2021-03-19","202103190SJS"
"STL",0,0,0,1,1,2,0,0,1,0,0,1,"A","Y","2021-03-19","202103190SJS"
"CGY",0,3,1,0,0,4,0,2,1,0,0,3,"A","N","2021-03-19","202103190TOR"
"TOR",0,2,1,0,0,3,0,3,1,0,0,4,"H","N","2021-03-19","202103190TOR"
"NYR",0,1,0,0,0,1,0,0,0,2,0,2,"A","N","2021-03-19","202103190WSH"
"WSH",0,0,0,2,0,2,0,1,0,0,0,1,"H","N","2021-03-19","202103190WSH"
"ANA",0,0,0,1,0,1,0,3,1,1,0,5,"H","N","2021-03-20","202103200ANA"
"ARI",0,3,1,1,0,5,0,0,0,1,0,1,"A","N","2021-03-20","202103200ANA"
"CAR",0,0,1,1,0,2,0,0,0,2,1,3,"H","Y","2021-03-20","202103200CAR"
"CBJ",0,0,0,2,1,3,0,0,1,1,0,2,"A","Y","2021-03-20","202103200CAR"
"COL",0,2,3,1,0,6,0,0,0,0,0,0,"H","N","2021-03-20","202103200COL"
"MIN",0,0,0,0,0,0,0,2,3,1,0,6,"A","N","2021-03-20","202103200COL"
"DAL",0,0,1,2,0,3,0,0,0,0,0,0,"A","N","2021-03-20","202103200DET"
"DET",0,0,0,0,0,0,0,0,1,2,0,3,"H","N","2021-03-20","202103200DET"
"EDM",0,1,0,3,0,4,0,2,0,0,0,2,"H","N","2021-03-20","202103200EDM"
"WPG",0,2,0,0,0,2,0,1,0,3,0,4,"A","N","2021-03-20","202103200EDM"
"FLA",0,0,1,1,0,2,0,0,0,0,0,0,"H","N","2021-03-20","202103200FLA"
"NSH",0,0,0,0,0,0,0,0,1,1,0,2,"A","N","2021-03-20","202103200FLA"
"MTL",0,1,2,1,1,5,0,0,2,2,0,4,"H","Y","2021-03-20","202103200MTL"
"VAN",0,0,2,2,0,4,0,1,2,1,1,5,"A","Y","2021-03-20","202103200MTL"
"NJD",0,1,0,0,0,1,0,0,2,1,0,3,"H","N","2021-03-20","202103200NJD"
"PIT",0,0,2,1,0,3,0,1,0,0,0,1,"A","N","2021-03-20","202103200NJD"
"NYI",0,4,0,2,0,6,0,1,0,0,0,1,"H","N","2021-03-20","202103200NYI"
"PHI",0,1,0,0,0,1,0,4,0,2,0,6,"A","N","2021-03-20","202103200NYI"
"SJS",0,1,1,0,0,2,0,2,0,3,0,5,"H","N","2021-03-20","202103200SJS"
"STL",0,2,0,3,0,5,0,1,1,0,0,2,"A","N","2021-03-20","202103200SJS"
"CHI",0,0,0,1,0,1,0,1,3,0,0,4,"A","N","2021-03-20","202103200TBL"
"TBL",0,1,3,0,0,4,0,0,0,1,0,1,"H","N","2021-03-20","202103200TBL"
"CGY",0,0,0,0,0,0,0,1,1,0,0,2,"A","N","2021-03-20","202103200TOR"
"TOR",0,1,1,0,0,2,0,0,0,0,0,0,"H","N","2021-03-20","202103200TOR"
"NYR",0,1,0,2,0,3,0,0,0,1,0,1,"A","N","2021-03-20","202103200WSH"
"WSH",0,0,0,1,0,1,0,1,0,2,0,3,"H","N","2021-03-20","202103200WSH"
"DAL",0,2,1,0,0,3,0,1,1,1,1,4,"H","Y","2021-03-21","202103210DAL"
"NSH",0,1,1,1,1,4,0,2,1,0,0,3,"A","Y","2021-03-21","202103210DAL"
"LAK",0,0,2,1,0,3,0,0,0,1,0,1,"H","N","2021-03-21","202103210LAK"
"VEG",0,0,0,1,0,1,0,0,2,1,0,3,"A","N","2021-03-21","202103210LAK"
"NJD",1,0,1,0,0,2,0,1,0,0,0,1,"A","N","2021-03-21","202103210PIT"
"PIT",0,1,0,0,0,1,1,0,1,0,0,2,"H","N","2021-03-21","202103210PIT"
"FLA",0,1,1,1,0,3,0,1,1,3,0,5,"A","N","2021-03-21","202103210TBL"
"TBL",0,1,1,3,0,5,0,1,1,1,0,3,"H","N","2021-03-21","202103210TBL"
"ARI",0,0,0,1,0,1,0,2,1,2,0,5,"H","N","2021-03-22","202103220ARI"
"COL",0,2,1,2,0,5,0,0,0,1,0,1,"A","N","2021-03-22","202103220ARI"
"CAR",0,1,2,0,0,3,0,0,0,0,0,0,"A","N","2021-03-22","202103220CBJ"
"CBJ",0,0,0,0,0,0,0,1,2,0,0,3,"H","N","2021-03-22","202103220CBJ"
"ANA",0,0,1,0,0,1,0,0,1,1,0,2,"A","N","2021-03-22","202103220MIN"
"MIN",0,0,1,1,0,2,0,0,1,0,0,1,"H","N","2021-03-22","202103220MIN"
"BUF",0,0,1,2,0,3,0,0,3,2,0,5,"A","N","2021-03-22","202103220NYR"
"NYR",0,0,3,2,0,5,0,0,1,2,0,3,"H","N","2021-03-22","202103220NYR"
"CGY",0,0,0,1,0,1,0,1,0,1,0,2,"A","N","2021-03-22","202103220OTT"
"OTT",0,1,0,1,0,2,0,0,0,1,0,1,"H","N","2021-03-22","202103220OTT"
"NYI",1,0,0,1,0,2,0,0,1,0,0,1,"A","N","2021-03-22","202103220PHI"
"PHI",0,0,1,0,0,1,1,0,0,1,0,2,"H","N","2021-03-22","202103220PHI"
"LAK",0,0,1,0,0,1,0,1,0,1,0,2,"A","N","2021-03-22","202103220SJS"
"SJS",0,1,0,1,0,2,0,0,1,0,0,1,"H","N","2021-03-22","202103220SJS"
"VAN",0,0,0,0,0,0,0,1,0,3,0,4,"H","N","2021-03-22","202103220VAN"
"WPG",0,1,0,3,0,4,0,0,0,0,0,0,"A","N","2021-03-22","202103220VAN"
"STL",0,0,1,0,0,1,0,1,0,4,0,5,"A","N","2021-03-22","202103220VEG"
"VEG",0,1,0,4,0,5,0,0,1,0,0,1,"H","N","2021-03-22","202103220VEG"
"ARI",0,2,0,2,1,5,0,2,1,1,0,4,"H","Y","2021-03-23","202103230ARI"
"COL",0,2,1,1,0,4,0,2,0,2,1,5,"A","Y","2021-03-23","202103230ARI"
"CHI",0,2,1,0,0,3,0,0,1,1,0,2,"H","N","2021-03-23","202103230CHI"
"FLA",0,0,1,1,0,2,0,2,1,0,0,3,"A","N","2021-03-23","202103230CHI"
"DAL",0,1,0,0,0,1,0,0,2,0,0,2,"H","N","2021-03-23","202103230DAL"
"TBL",0,0,2,0,0,2,0,1,0,0,0,1,"A","N","2021-03-23","202103230DAL"
"DET",0,0,0,0,0,0,0,1,1,0,0,2,"A","N","2021-03-23","202103230NSH"
"NSH",0,1,1,0,0,2,0,0,0,0,0,0,"H","N","2021-03-23","202103230NSH"
"NJD",0,2,2,0,0,4,0,1,0,2,0,3,"A","N","2021-03-23","202103230PHI"
"PHI",0,1,0,2,0,3,0,2,2,0,0,4,"H","N","2021-03-23","202103230PHI"
"ANA",0,1,1,0,0,2,0,2,1,0,0,3,"A","N","2021-03-24","202103240MIN"
"MIN",0,2,1,0,0,3,0,1,1,0,0,2,"H","N","2021-03-24","202103240MIN"
"CGY",0,0,1,0,0,1,0,0,0,3,0,3,"A","N","2021-03-24","202103240OTT"
"OTT",0,0,0,3,0,3,0,0,1,0,0,1,"H","N","2021-03-24","202103240OTT"
"BUF",0,1,0,1,0,2,0,2,2,1,0,5,"A","N","2021-03-24","202103240PIT"
"PIT",0,2,2,1,0,5,0,1,0,1,0,2,"H","N","2021-03-24","202103240PIT"
"LAK",0,0,1,1,0,2,0,0,2,2,0,4,"A","N","2021-03-24","202103240SJS"
"SJS",0,0,2,2,0,4,0,0,1,1,0,2,"H","N","2021-03-24","202103240SJS"
"VAN",0,0,0,1,0,1,0,0,3,2,0,5,"H","N","2021-03-24","202103240VAN"
"WPG",0,0,3,2,0,5,0,0,0,1,0,1,"A","N","2021-03-24","202103240VAN"
"BOS",0,2,0,1,0,3,1,0,1,2,0,4,"H","N","2021-03-25","202103250BOS"
"NYI",1,0,1,2,0,4,0,2,0,1,0,3,"A","N","2021-03-25","202103250BOS"
"CAR",1,0,2,1,0,4,0,0,1,2,0,3,"A","N","2021-03-25","202103250CBJ"
"CBJ",0,0,1,2,0,3,1,0,2,1,0,4,"H","N","2021-03-25","202103250CBJ"
"CHI",0,0,2,1,0,3,0,0,0,0,0,0,"H","N","2021-03-25","202103250CHI"
"FLA",0,0,0,0,0,0,0,0,2,1,0,3,"A","N","2021-03-25","202103250CHI"
"COL",0,0,4,1,0,5,0,1,0,0,0,1,"H","N","2021-03-25","202103250COL"
"VEG",0,1,0,0,0,1,0,0,4,1,0,5,"A","N","2021-03-25","202103250COL"
"DAL",0,0,3,1,0,4,0,0,2,1,0,3,"H","N","2021-03-25","202103250DAL"
"TBL",0,0,2,1,0,3,0,0,3,1,0,4,"A","N","2021-03-25","202103250DAL"
"MIN",0,0,2,0,0,2,0,0,0,0,0,0,"H","N","2021-03-25","202103250MIN"
"STL",0,0,0,0,0,0,0,0,2,0,0,2,"A","N","2021-03-25","202103250MIN"
"DET",0,1,0,0,0,1,0,4,1,2,0,7,"A","N","2021-03-25","202103250NSH"
"NSH",0,4,1,2,0,7,0,1,0,0,0,1,"H","N","2021-03-25","202103250NSH"
"OTT",0,1,0,1,0,2,1,0,1,1,0,3,"H","N","2021-03-25","202103250OTT"
"TOR",1,0,1,1,0,3,0,1,0,1,0,2,"A","N","2021-03-25","202103250OTT"
"NYR",0,3,3,2,0,8,0,0,2,1,0,3,"A","N","2021-03-25","202103250PHI"
"PHI",0,0,2,1,0,3,0,3,3,2,0,8,"H","N","2021-03-25","202103250PHI"
"BUF",0,0,0,0,0,0,0,1,1,2,0,4,"A","N","2021-03-25","202103250PIT"
"PIT",0,1,1,2,0,4,0,0,0,0,0,0,"H","N","2021-03-25","202103250PIT"
"NJD",0,1,1,1,0,3,0,1,2,1,0,4,"A","N","2021-03-25","202103250WSH"
"WSH",0,1,2,1,0,4,0,1,1,1,0,3,"H","N","2021-03-25","202103250WSH"
